Code du département,Code de la commune,Inscrits,Abstentions,Votants,Blancs et nuls,Exprimés,JOLY,LE PEN,SARKOZY,MÉLENCHON,POUTOU,ARTHAUD,CHEMINADE,BAYROU,DUPONT-AIGNAN,HOLLANDE
1,1,592,84,508,9,499,13,126,159,25,2,2,2,54,4,112
1,2,215,36,179,5,174,10,38,45,15,2,0,1,22,2,39
1,4,8205,1698,6507,126,6381,124,1359,1603,778,83,41,21,543,138,1691
1,5,1152,170,982,18,964,16,238,323,57,6,6,0,97,26,195
1,6,105,17,88,1,87,3,25,19,9,1,1,0,8,0,21
1,7,1702,222,1480,29,1451,26,330,371,190,10,12,5,141,34,332
1,8,549,68,481,7,474,8,112,109,51,8,0,1,55,5,125
1,9,269,40,229,4,225,5,40,69,33,4,1,2,27,6,38
1,10,681,99,582,12,570,7,155,130,68,4,6,1,47,15,137
1,11,255,30,225,7,218,4,50,62,34,2,0,1,22,6,37
1,12,287,55,232,7,225,4,42,54,46,2,3,1,19,2,52
1,13,140,16,124,2,122,2,31,40,9,0,0,0,18,2,20
1,14,2163,434,1729,24,1705,21,273,499,190,12,6,6,162,37,499
1,15,388,54,334,4,330,6,60,102,41,1,1,1,42,7,69
1,16,309,71,238,6,232,3,60,71,18,3,3,0,28,5,41
1,17,296,50,246,4,242,8,59,51,41,8,4,1,15,6,49
1,19,37,2,35,0,35,3,6,9,5,1,1,0,2,0,8
1,21,896,71,825,27,798,7,173,326,49,12,2,2,89,14,124
1,22,813,144,669,6,663,13,167,167,77,9,6,4,55,19,146
1,23,48,3,45,1,44,0,15,14,3,0,0,0,3,1,8
1,24,2052,249,1803,38,1765,30,400,523,164,28,4,3,224,35,354
1,25,2117,303,1814,61,1753,32,426,451,167,15,10,6,162,49,435
1,26,562,101,461,15,446,6,76,164,37,3,4,3,46,10,97
1,27,1071,145,926,19,907,14,231,298,64,4,7,1,83,26,179
1,28,434,84,350,13,337,9,92,115,29,3,2,1,22,4,60
1,29,406,76,330,6,324,4,88,86,34,3,2,2,31,6,68
1,30,520,96,424,7,417,10,111,122,39,7,2,1,33,10,82
1,31,2085,525,1560,28,1532,25,342,463,162,17,8,4,122,27,362
1,32,2015,368,1647,36,1611,29,453,422,137,17,13,3,143,36,358
1,33,6046,1343,4703,79,4624,108,801,1029,622,62,29,14,386,83,1490
1,34,5474,986,4488,113,4375,90,883,1191,539,51,15,8,382,79,1137
1,35,268,45,223,3,220,7,65,44,29,4,2,0,30,7,32
1,36,414,58,356,7,349,12,66,107,48,1,3,0,34,10,68
1,37,215,36,179,2,177,0,40,66,9,2,1,0,18,8,33
1,38,557,62,495,7,488,17,88,160,37,5,3,1,57,7,113
1,39,319,44,275,2,273,6,50,59,36,2,4,1,15,3,97
1,40,314,52,262,6,256,5,64,76,31,2,0,2,25,6,45
1,41,576,79,497,13,484,17,126,97,54,9,1,0,41,12,127
1,42,193,19,174,3,171,6,26,51,16,5,3,0,23,6,35
1,43,3310,520,2790,60,2730,78,432,1012,251,18,6,2,294,50,587
1,44,380,73,307,11,296,6,77,66,31,4,1,3,30,4,74
1,45,169,23,146,1,145,6,39,62,6,1,1,1,9,2,18
1,46,585,86,499,9,490,5,127,185,28,4,1,2,34,12,92
1,47,617,84,533,14,519,13,111,153,52,8,3,3,56,22,98
1,49,1946,253,1693,25,1668,39,391,500,168,11,7,3,155,36,358
1,50,216,33,183,6,177,1,67,52,12,0,3,0,11,6,25
1,51,98,18,80,2,78,2,19,13,9,2,0,0,4,4,25
1,52,251,36,215,2,213,8,41,86,11,1,3,0,19,7,37
1,53,23327,5388,17939,316,17623,406,2503,4876,1983,161,113,38,1665,268,5610
1,54,852,84,768,14,754,16,178,234,75,0,1,3,70,21,156
1,56,296,40,256,5,251,5,73,87,19,1,0,0,21,6,39
1,57,345,65,280,6,274,5,81,65,36,2,0,0,19,12,54
1,58,572,66,506,8,498,13,129,130,41,14,4,2,35,11,119
1,59,83,7,76,2,74,4,17,22,9,1,0,0,3,0,18
1,60,420,47,373,5,368,12,85,129,35,6,2,0,34,8,57
1,61,812,103,709,19,690,21,166,169,85,6,2,1,60,27,153
1,62,549,72,477,8,469,11,98,168,35,4,2,0,45,18,88
1,63,368,46,322,8,314,8,75,113,25,2,0,1,35,6,49
1,64,627,95,532,16,516,7,164,88,44,14,3,2,52,11,131
1,65,1230,113,1117,25,1092,18,212,332,93,6,5,2,106,29,289
1,66,78,13,65,0,65,3,12,15,14,3,1,2,5,2,8
1,67,199,39,160,2,158,2,39,49,17,3,2,0,19,1,26
1,68,514,85,429,9,420,13,119,113,40,6,3,1,54,7,64
1,69,1054,133,921,20,901,16,203,225,100,4,4,1,102,28,218
1,71,2250,410,1840,30,1810,66,271,706,128,9,9,5,242,42,332
1,72,2023,276,1747,28,1719,49,304,487,184,13,12,1,185,35,449
1,73,836,130,706,18,688,28,160,170,70,6,3,4,61,10,176
1,74,1472,217,1255,20,1235,26,318,390,112,22,4,3,112,21,227
1,75,830,112,718,15,703,16,190,249,58,5,4,3,57,14,107
1,76,118,23,95,5,90,2,22,24,11,4,0,0,4,0,23
1,77,142,17,125,1,124,1,28,41,18,3,0,1,11,0,21
1,78,726,138,588,16,572,20,75,214,51,9,3,3,74,13,110
1,79,534,86,448,12,436,15,90,125,65,3,7,1,44,6,80
1,80,343,68,275,11,264,8,74,49,48,9,2,1,14,3,56
1,81,506,66,440,11,429,23,81,124,59,5,1,2,54,5,75
1,82,399,90,309,4,305,10,55,53,48,4,2,1,43,13,76
1,83,627,90,537,5,532,10,155,189,36,3,2,0,47,9,81
1,84,488,59,429,11,418,9,105,126,29,3,0,1,39,8,98
1,85,273,31,242,4,238,12,64,77,9,2,1,0,26,14,33
1,87,214,31,183,2,181,4,34,66,27,2,1,2,14,6,25
1,88,681,89,592,4,588,8,169,172,57,6,1,0,55,21,99
1,89,1198,144,1054,18,1036,19,297,271,109,8,4,1,88,32,207
1,90,266,25,241,7,234,2,58,88,19,0,1,0,20,2,44
1,91,2144,403,1741,30,1711,30,385,446,176,19,15,5,195,36,404
1,92,1136,193,943,15,928,11,223,273,106,4,3,3,86,25,194
1,93,3341,625,2716,47,2669,46,531,982,215,21,22,10,234,67,541
1,94,524,96,428,7,421,8,112,113,43,1,2,2,34,11,95
1,95,401,40,361,3,358,13,84,78,48,4,2,0,41,7,81
1,96,718,92,626,20,606,11,144,174,53,7,5,7,71,17,117
1,97,180,30,150,2,148,3,25,42,21,0,0,0,13,7,37
1,98,545,93,452,5,447,8,90,137,68,2,6,3,46,5,82
1,99,1118,175,943,18,925,14,222,281,82,8,1,1,112,19,185
1,100,124,14,110,1,109,1,30,26,8,3,1,0,11,0,29
1,101,140,25,115,1,114,1,32,38,14,0,2,0,10,1,16
1,102,632,112,520,24,496,1,154,127,33,3,5,0,45,8,120
1,103,691,107,584,6,578,15,78,248,41,4,3,2,71,13,103
1,104,338,61,277,0,277,9,60,84,44,1,1,1,25,5,47
1,105,967,108,859,13,846,9,165,336,49,3,4,4,92,20,164
1,106,136,25,111,2,109,2,27,29,10,1,1,0,10,5,24
1,107,121,17,104,4,100,2,31,15,11,1,2,0,11,2,25
1,108,896,163,733,15,718,20,188,193,65,8,6,2,44,20,172
1,109,1064,217,847,16,831,31,171,260,86,14,7,3,80,20,159
1,110,115,20,95,1,94,2,15,15,21,1,1,0,10,2,27
1,111,108,19,89,4,85,3,20,24,7,4,0,0,9,2,16
1,112,259,32,227,5,222,2,56,85,27,0,2,0,16,6,28
1,113,546,86,460,11,449,9,81,175,23,6,3,0,42,12,98
1,114,363,70,293,11,282,4,63,71,34,6,4,2,36,10,52
1,115,840,126,714,17,697,11,168,214,63,4,10,2,70,23,132
1,116,411,57,354,7,347,10,76,79,41,4,3,0,25,7,102
1,117,113,20,93,4,89,1,26,20,14,0,2,0,8,0,18
1,118,748,142,606,18,588,12,126,169,69,8,2,4,53,12,133
1,119,167,24,143,2,141,3,28,35,15,1,1,0,22,13,23
1,121,86,10,76,1,75,3,19,30,6,0,2,0,2,1,12
1,122,625,69,556,17,539,11,117,148,63,11,8,1,57,6,117
1,123,736,90,646,10,636,15,114,214,52,9,6,2,67,22,135
1,124,492,80,412,8,404,4,103,83,50,13,4,1,44,9,93
1,125,468,76,392,12,380,16,74,102,41,4,4,4,26,15,94
1,127,379,44,335,10,325,12,53,96,44,6,3,0,45,4,62
1,128,209,38,171,3,168,4,41,62,11,1,1,0,16,2,30
1,129,190,27,163,1,162,7,41,53,9,1,1,0,15,4,31
1,130,924,111,813,13,800,17,157,257,56,8,4,2,75,32,192
1,133,298,30,268,12,256,8,62,54,35,3,0,0,25,3,66
1,134,1206,165,1041,24,1017,10,225,326,80,9,7,3,107,30,220
1,135,988,158,830,12,818,42,132,291,71,5,1,3,124,11,138
1,136,569,80,489,11,478,10,101,164,41,3,5,1,39,19,95
1,138,1859,340,1519,31,1488,22,318,332,177,22,6,7,113,32,459
1,139,341,65,276,4,272,1,68,76,12,3,2,1,39,5,65
1,140,515,52,463,8,455,14,125,133,41,3,6,0,42,10,81
1,141,346,41,305,12,293,5,49,72,39,7,0,1,44,7,69
1,142,2815,407,2408,44,2364,41,548,705,223,20,11,6,255,48,507
1,143,5150,1127,4023,54,3969,157,419,1846,217,32,9,9,530,82,668
1,144,618,88,530,17,513,12,108,156,56,4,1,1,58,7,110
1,145,802,105,697,8,689,13,193,207,62,5,4,1,74,15,115
1,146,269,24,245,4,241,4,43,100,20,5,1,1,16,3,48
1,147,374,61,313,3,310,3,78,73,23,1,1,1,33,8,89
1,148,1351,229,1122,20,1102,23,300,337,113,17,7,5,73,36,191
1,149,754,82,672,9,663,21,142,173,71,7,6,3,76,15,149
1,150,155,17,138,4,134,1,21,44,12,1,1,0,12,1,41
1,151,859,107,752,13,739,8,188,237,64,14,7,3,67,7,144
1,152,616,90,526,7,519,20,124,125,52,10,5,2,77,12,92
1,153,889,176,713,5,708,31,86,286,47,5,4,4,87,21,137
1,154,539,67,472,18,454,8,98,122,43,7,6,0,60,13,97
1,155,126,12,114,1,113,2,35,38,6,0,0,0,11,3,18
1,156,574,57,517,6,511,3,155,166,46,7,4,2,37,13,78
1,157,1591,248,1343,23,1320,30,283,445,125,16,7,1,133,28,252
1,158,477,82,395,7,388,26,85,135,35,2,3,1,39,7,55
1,159,2411,374,2037,56,1981,22,396,732,123,9,9,1,238,44,407
1,160,3636,727,2909,39,2870,140,255,892,278,35,13,6,351,35,865
1,162,65,5,60,0,60,3,7,20,4,2,0,0,3,2,19
1,163,1445,229,1216,27,1189,21,293,424,47,9,12,0,123,43,217
1,165,936,116,820,12,808,6,208,269,57,6,5,0,89,28,140
1,166,1510,178,1332,23,1309,25,251,492,88,11,4,4,139,31,264
1,167,501,53,448,16,432,13,90,129,37,9,2,0,50,16,86
1,169,383,54,329,7,322,11,76,107,29,2,4,1,33,9,50
1,170,594,76,518,9,509,9,144,153,40,4,7,1,46,16,89
1,171,616,89,527,14,513,10,108,179,52,2,3,1,47,9,102
1,172,128,17,111,2,109,2,22,37,11,4,1,1,8,4,19
1,173,5404,1269,4135,85,4050,168,578,1329,392,41,14,16,517,100,895
1,174,123,20,103,2,101,5,23,28,11,2,1,1,14,2,14
1,175,582,95,487,19,468,9,111,124,66,4,1,0,54,19,80
1,176,104,13,91,1,90,2,23,25,5,0,0,0,17,5,13
1,177,138,11,127,0,127,6,14,35,20,0,1,0,17,3,31
1,179,1385,190,1195,31,1164,14,263,368,80,11,8,4,129,28,259
1,180,474,91,383,10,373,18,39,183,22,2,1,3,44,3,58
1,181,746,83,663,18,645,5,150,240,45,8,5,0,63,15,114
1,182,280,39,241,2,239,8,51,83,24,7,3,0,30,4,29
1,183,921,122,799,17,782,13,202,253,58,7,5,3,96,21,124
1,184,561,67,494,10,484,16,104,127,51,7,4,0,43,7,125
1,185,2278,462,1816,41,1775,48,390,503,268,18,14,5,160,40,329
1,186,78,7,71,1,70,1,19,26,11,0,0,0,4,0,9
1,187,277,51,226,8,218,15,33,61,27,4,0,2,26,5,45
1,188,463,63,400,9,391,8,98,171,24,4,0,2,31,11,42
1,189,712,115,597,8,589,16,143,106,85,6,2,4,49,11,167
1,190,127,21,106,1,105,1,26,26,12,1,0,0,15,2,22
1,191,136,19,117,6,111,0,35,41,4,1,0,1,9,5,15
1,192,1466,232,1234,28,1206,23,301,383,128,8,7,2,104,46,204
1,193,186,33,153,8,145,6,21,37,21,3,1,0,12,3,41
1,194,3756,512,3244,53,3191,68,699,949,312,27,16,7,297,54,762
1,195,1154,135,1019,25,994,26,180,290,75,9,2,3,139,14,256
1,196,777,117,660,18,642,8,188,185,54,12,5,3,71,11,105
1,197,264,14,250,7,243,8,35,61,37,1,2,0,23,7,69
1,198,191,29,162,4,158,5,28,51,11,2,0,0,18,1,42
1,199,1416,216,1200,19,1181,38,271,300,136,15,5,5,102,26,283
1,200,121,18,103,2,101,3,23,23,14,1,0,0,9,4,24
1,202,4878,939,3939,94,3845,60,884,1042,502,46,26,15,312,97,861
1,203,859,122,737,11,726,12,166,207,56,13,4,2,70,18,178
1,204,186,22,164,4,160,13,22,50,20,2,3,0,15,5,30
1,205,731,155,576,14,562,16,132,138,57,14,2,0,47,23,133
1,206,233,44,189,6,183,10,38,50,21,4,1,1,17,2,39
1,207,221,20,201,6,195,1,45,93,15,3,0,0,12,9,17
1,208,131,16,115,3,112,3,26,29,9,0,0,0,10,2,33
1,209,389,65,324,6,318,11,69,94,19,4,2,2,33,5,79
1,210,189,39,150,6,144,7,19,62,16,0,1,1,17,5,16
1,211,978,145,833,25,808,13,177,238,62,12,4,1,69,28,204
1,212,519,82,437,9,428,7,141,114,33,5,5,1,27,10,85
1,213,826,104,722,15,707,11,217,150,66,14,3,1,69,13,163
1,214,121,16,105,2,103,10,24,19,12,1,1,0,18,1,17
1,215,45,10,35,4,31,1,6,8,1,0,1,1,3,3,7
1,216,654,124,530,12,518,15,157,151,36,7,4,2,63,8,75
1,218,83,21,62,3,59,3,25,16,4,0,1,1,2,0,7
1,219,136,28,108,1,107,2,28,45,8,2,0,1,4,0,17
1,221,131,17,114,3,111,6,16,33,9,4,1,0,4,0,38
1,224,1678,272,1406,25,1381,15,363,388,125,14,6,3,122,25,320
1,225,313,42,271,4,267,5,63,90,16,1,2,0,28,5,57
1,227,340,51,289,5,284,6,72,82,25,0,3,0,26,5,65
1,228,452,68,384,4,380,3,96,157,19,2,2,0,45,11,45
1,229,685,84,601,7,594,11,143,172,36,10,5,1,73,16,127
1,230,219,38,181,4,177,2,57,51,10,0,2,0,15,6,34
1,231,1422,202,1220,27,1193,21,245,431,84,10,7,1,155,25,214
1,232,1666,194,1472,32,1440,22,307,434,121,14,8,4,149,40,341
1,233,114,23,91,4,87,1,19,25,7,0,2,1,10,0,22
1,234,138,12,126,2,124,8,29,21,14,1,0,1,13,1,36
1,235,597,84,513,18,495,5,107,188,34,5,4,1,52,16,83
1,236,704,104,600,14,586,5,142,177,56,4,2,0,67,13,120
1,237,1029,121,908,25,883,16,210,301,87,13,4,1,78,21,152
1,238,1781,222,1559,38,1521,27,338,491,109,10,3,7,155,35,346
1,239,490,71,419,10,409,9,93,112,36,4,3,1,45,16,90
1,240,473,55,418,6,412,13,148,97,63,7,3,1,30,9,41
1,241,984,114,870,22,848,19,136,209,124,8,2,5,98,15,232
1,242,94,17,77,2,75,6,10,15,15,3,1,0,11,2,12
1,243,838,84,754,6,748,16,163,229,52,11,9,3,113,12,140
1,244,4954,961,3993,80,3913,83,774,1055,420,30,14,9,418,87,1023
1,245,651,79,572,8,564,18,150,119,64,8,4,2,85,13,101
1,246,1412,228,1184,29,1155,19,258,371,85,6,6,1,105,23,281
1,247,250,41,209,10,199,14,40,74,19,3,0,1,19,10,19
1,248,1522,194,1328,22,1306,33,297,403,114,13,6,4,126,19,291
1,249,6450,1218,5232,87,5145,125,979,1591,493,34,21,12,522,106,1262
1,250,1223,155,1068,18,1050,19,201,295,113,16,3,3,143,17,240
1,252,558,81,477,8,469,9,123,149,27,2,5,1,47,6,100
1,254,1357,169,1188,23,1165,25,201,421,102,9,7,3,117,23,257
1,255,388,62,326,5,321,7,57,90,36,4,4,0,26,7,90
1,257,286,50,236,9,227,13,66,55,25,5,4,2,19,6,32
1,258,808,92,716,14,702,10,200,248,41,6,6,1,63,16,111
1,259,437,62,375,10,365,5,114,107,25,3,2,2,26,6,75
1,260,197,31,166,3,163,3,33,71,7,2,1,0,20,3,23
1,261,432,44,388,2,386,10,83,142,23,2,1,2,33,16,74
1,262,4139,746,3393,77,3316,48,638,919,327,24,21,10,326,74,929
1,263,2675,446,2229,34,2195,52,468,787,169,24,5,8,227,51,404
1,264,642,64,578,13,565,15,137,186,25,8,1,1,54,24,114
1,265,2022,341,1681,30,1651,26,311,460,217,15,12,1,169,54,386
1,266,1724,289,1435,44,1391,17,296,395,112,17,7,5,126,35,381
1,267,697,95,602,17,585,6,176,176,44,5,3,4,61,19,91
1,268,207,35,172,2,170,1,52,50,18,2,1,0,11,8,27
1,269,1740,404,1336,20,1316,20,234,400,176,15,7,2,114,19,329
1,271,452,50,402,8,394,19,75,108,53,3,2,0,28,7,99
1,272,1026,138,888,12,876,10,225,316,68,6,5,1,69,21,155
1,273,1103,152,951,16,935,27,224,234,131,17,7,5,82,13,195
1,274,350,66,284,6,278,3,87,71,21,1,3,1,22,9,60
1,275,1722,228,1494,24,1470,30,286,574,100,4,3,3,144,22,304
1,276,1097,150,947,19,928,17,243,286,73,5,1,1,87,19,196
1,277,122,22,100,4,96,4,21,33,10,0,2,0,4,3,19
1,279,87,8,79,2,77,2,24,16,13,1,1,1,4,1,14
1,280,131,19,112,0,112,1,15,54,7,2,1,0,14,0,18
1,281,1653,296,1357,16,1341,52,153,481,98,8,3,3,204,33,306
1,282,186,35,151,3,148,7,36,43,15,1,1,0,12,5,28
1,283,11476,2859,8617,125,8492,139,1578,2391,1024,81,34,26,623,131,2465
1,284,425,66,359,5,354,4,76,97,34,8,7,2,30,12,84
1,285,731,72,659,10,649,21,123,245,43,3,3,1,67,21,122
1,286,313,26,287,5,282,16,37,33,74,7,0,1,15,6,93
1,288,1174,230,944,16,928,26,165,292,83,14,5,5,133,27,178
1,289,4340,643,3697,61,3636,82,576,1095,336,29,26,10,404,79,999
1,290,946,134,812,12,800,21,159,301,59,9,2,3,82,27,137
1,291,596,79,517,18,499,12,91,187,32,4,2,3,58,14,96
1,292,130,12,118,0,118,6,22,30,20,0,3,0,22,1,14
1,293,152,31,121,1,120,8,38,21,11,1,1,1,13,3,23
1,294,578,84,494,12,482,11,123,131,59,10,2,1,49,16,80
1,295,334,33,301,5,296,5,75,88,38,6,2,0,21,5,56
1,296,290,37,253,9,244,14,67,75,18,3,1,0,22,6,38
1,297,602,72,530,13,517,7,135,157,48,5,1,1,54,14,95
1,298,102,15,87,1,86,1,21,26,9,0,1,0,4,2,22
1,299,375,56,319,4,315,4,73,146,17,3,0,0,27,8,37
1,300,307,44,263,4,259,13,66,70,20,0,4,2,45,4,35
1,301,1793,251,1542,30,1512,21,325,509,93,10,6,3,190,44,311
1,302,139,17,122,1,121,3,21,29,16,2,0,1,11,1,37
1,303,1118,182,936,17,919,15,216,278,81,14,6,1,99,19,190
1,304,1647,280,1367,30,1337,10,336,375,117,25,8,3,111,32,320
1,305,1492,347,1145,31,1114,28,213,399,86,11,9,3,114,26,225
1,306,925,177,748,5,743,14,147,196,98,12,6,0,78,16,176
1,307,612,115,497,15,482,7,92,159,60,10,2,0,57,14,81
1,308,413,100,313,5,308,12,60,80,46,6,1,0,27,3,73
1,309,72,12,60,3,57,1,22,6,8,1,0,1,10,1,7
1,310,119,15,104,4,100,1,36,17,14,0,2,1,11,0,18
1,311,52,12,40,0,40,1,8,12,3,0,0,0,5,0,11
1,312,177,23,154,5,149,11,38,36,16,3,0,2,10,1,32
1,313,3335,737,2598,41,2557,129,238,997,207,22,6,10,364,44,540
1,314,1008,128,880,21,859,20,227,245,69,12,7,1,76,16,186
1,316,129,14,115,1,114,0,32,23,5,4,1,0,9,4,36
1,317,191,28,163,0,163,7,48,40,15,2,1,1,11,4,34
1,318,469,69,400,8,392,13,81,117,39,7,4,1,49,9,72
1,319,368,51,317,7,310,2,85,111,16,4,3,1,28,8,52
1,320,2568,334,2234,55,2179,26,409,734,160,27,10,4,236,52,521
1,321,544,67,477,10,467,7,62,150,52,7,3,1,49,10,126
1,322,3019,412,2607,43,2564,55,397,961,220,19,7,4,269,73,559
1,323,692,109,583,8,575,12,137,144,58,5,1,1,61,17,139
1,325,700,68,632,4,628,8,165,184,56,3,3,0,60,16,133
1,328,353,45,308,6,302,6,74,111,14,5,1,0,27,5,59
1,329,141,18,123,2,121,2,31,25,8,4,2,2,14,2,31
1,330,155,23,132,1,131,10,17,28,17,2,0,0,22,5,30
1,331,135,15,120,1,119,0,28,27,14,2,0,1,12,3,32
1,332,476,71,405,14,391,10,75,104,32,3,3,0,50,6,108
1,333,2199,307,1892,45,1847,38,409,530,188,22,5,2,185,35,433
1,334,377,62,315,5,310,7,93,106,20,2,1,1,25,6,49
1,335,229,24,205,4,201,4,45,72,17,0,2,1,21,7,32
1,336,840,138,702,15,687,6,152,196,50,6,2,2,71,18,184
1,337,852,124,728,12,716,12,166,216,56,4,10,4,76,16,156
1,338,566,85,481,9,472,11,110,162,36,9,2,4,43,19,76
1,339,1160,158,1002,16,986,21,162,411,62,4,3,1,115,16,191
1,340,115,18,97,3,94,1,21,12,14,1,1,0,12,3,29
1,341,134,9,125,0,125,8,22,41,11,1,1,0,13,1,27
1,342,386,39,347,0,347,12,64,133,40,2,2,0,29,11,54
1,343,1261,175,1086,34,1052,13,252,295,81,19,10,4,115,26,237
1,344,4317,649,3668,81,3587,73,548,1097,327,43,11,7,413,73,995
1,345,1668,314,1354,39,1315,20,329,311,169,14,14,3,110,37,308
1,346,605,86,519,16,503,8,107,159,32,4,5,4,70,23,91
1,347,1394,180,1214,25,1189,34,229,394,101,7,4,1,145,22,252
1,348,1981,374,1607,31,1576,27,396,564,97,14,6,4,152,54,262
1,349,377,55,322,14,308,10,62,109,32,1,4,0,41,8,41
1,350,1932,332,1600,33,1567,30,342,498,123,14,12,9,188,33,318
1,351,980,155,825,24,801,19,219,256,63,11,7,1,55,26,144
1,352,389,67,322,13,309,8,87,66,29,4,5,1,37,8,64
1,353,1036,121,915,18,897,27,163,280,72,8,4,2,109,17,215
1,354,3624,764,2860,40,2820,113,378,862,308,31,18,8,362,50,690
1,355,326,47,279,15,264,4,58,67,23,1,1,1,25,11,73
1,356,142,13,129,4,125,4,23,33,14,4,0,0,19,3,25
1,357,281,49,232,1,231,3,40,73,28,0,0,1,26,1,59
1,358,310,47,263,7,256,13,40,86,28,3,0,1,29,4,52
1,359,198,22,176,1,175,0,40,85,13,1,0,0,5,4,27
1,360,820,129,691,6,685,21,97,234,71,7,2,2,96,27,128
1,361,1091,151,940,11,929,25,243,313,66,6,5,5,118,16,132
1,362,526,49,477,12,465,11,123,154,20,3,3,0,50,9,92
1,363,1203,146,1057,20,1037,31,210,277,111,10,3,2,121,28,244
1,364,541,88,453,20,433,8,94,124,28,7,7,2,54,9,100
1,365,829,126,703,20,683,5,161,201,50,7,5,1,58,17,178
1,366,587,59,528,7,521,14,153,121,53,4,8,4,44,12,108
1,367,450,59,391,8,383,4,85,151,31,4,1,0,28,6,73
1,368,501,80,421,20,401,7,96,127,43,5,3,2,44,9,65
1,369,726,98,628,12,616,23,107,203,56,6,2,2,60,10,147
1,370,913,173,740,19,721,27,161,141,90,11,6,2,60,15,208
1,371,801,102,699,15,684,6,170,188,66,14,5,3,67,12,153
1,372,306,41,265,5,260,3,45,68,36,1,2,0,25,8,72
1,373,709,111,598,6,592,10,150,213,54,8,2,0,48,11,96
1,374,1219,122,1097,17,1080,20,223,342,84,12,6,3,121,29,240
1,375,568,86,482,10,472,12,118,119,35,8,2,3,60,14,101
1,376,2380,425,1955,30,1925,32,392,460,223,19,15,7,176,26,575
1,378,1784,205,1579,24,1555,35,418,496,107,12,7,6,162,40,272
1,379,510,56,454,7,447,7,137,101,37,9,3,1,38,16,98
1,380,537,126,411,7,404,8,80,119,34,7,1,1,51,11,92
1,381,555,77,478,5,473,8,148,121,41,4,2,2,38,19,90
1,382,251,33,218,2,216,5,71,71,7,0,0,0,29,4,29
1,383,998,139,859,21,838,10,242,244,68,7,10,1,67,17,172
1,384,1294,264,1030,21,1009,15,225,216,151,18,9,3,77,21,274
1,385,711,60,651,14,637,14,140,189,40,8,0,4,83,15,144
1,386,815,94,721,16,705,20,144,164,93,10,4,2,83,16,169
1,387,129,13,116,2,114,4,22,34,11,2,1,0,18,3,19
1,388,727,139,588,11,577,7,140,190,27,6,4,1,55,21,126
1,389,1291,239,1052,11,1041,8,296,368,67,10,7,1,85,17,182
1,390,604,75,529,14,515,4,165,169,38,5,3,1,35,12,83
1,391,251,31,220,14,206,1,40,74,19,1,0,0,15,7,49
1,392,459,48,411,9,402,9,100,131,30,7,0,0,43,19,63
1,393,377,46,331,8,323,3,83,136,19,6,1,0,25,6,44
1,396,642,126,516,9,507,7,108,173,60,6,5,1,47,9,91
1,397,613,119,494,11,483,15,67,160,34,8,1,1,79,11,107
1,398,851,114,737,13,724,10,190,262,40,6,5,2,81,21,107
1,399,993,233,760,10,750,39,119,291,42,8,3,5,107,16,120
1,400,147,18,129,5,124,2,22,39,14,1,1,1,13,5,26
1,401,908,152,756,12,744,34,82,300,57,3,6,3,105,18,136
1,402,473,76,397,8,389,4,91,75,47,7,1,2,30,21,111
1,403,843,143,700,20,680,6,141,186,100,10,13,2,53,17,152
1,404,130,29,101,2,99,1,26,36,6,1,1,2,9,5,12
1,405,721,116,605,8,597,10,167,151,56,5,3,4,68,19,114
1,406,127,23,104,1,103,2,17,41,15,2,1,1,7,2,15
1,407,552,101,451,3,448,13,93,108,48,9,4,2,42,9,120
1,408,490,65,425,12,413,13,92,102,61,5,0,0,46,15,79
1,409,117,21,96,2,94,3,17,32,5,0,0,0,14,5,18
1,410,254,29,225,4,221,7,48,56,27,6,2,0,31,3,41
1,411,204,32,172,4,168,2,56,53,17,1,0,1,13,4,21
1,412,428,62,366,15,351,7,91,91,33,3,1,4,48,14,59
1,413,75,19,56,0,56,0,18,26,3,1,0,0,3,0,5
1,414,187,36,151,2,149,7,25,38,9,1,0,2,23,5,39
1,415,297,39,258,7,251,5,60,69,25,2,2,0,23,7,58
1,416,722,186,536,16,520,5,127,122,61,6,9,2,37,9,142
1,417,290,37,253,8,245,8,46,67,37,1,1,0,21,4,60
1,418,719,73,646,12,634,10,132,225,50,1,0,2,46,13,155
1,419,2848,621,2227,35,2192,100,274,795,168,19,9,5,302,52,468
1,420,1045,273,772,18,754,17,172,265,63,14,6,2,57,10,148
1,421,503,74,429,2,427,9,123,94,53,9,3,1,34,15,86
1,422,1013,115,898,23,875,13,189,253,99,10,3,1,91,23,193
1,423,610,67,543,6,537,7,131,188,33,3,0,2,64,11,98
1,424,1251,152,1099,13,1086,14,213,407,70,8,4,4,106,29,231
1,425,224,51,173,4,169,1,39,52,9,0,0,0,19,2,47
1,426,1541,226,1315,24,1291,39,249,354,153,14,5,3,156,21,297
1,427,4056,742,3314,54,3260,85,588,869,369,39,26,7,358,86,833
1,428,75,4,71,1,70,2,17,34,5,0,0,0,3,2,7
1,429,437,42,395,4,391,7,124,95,23,2,4,0,38,13,85
1,430,396,53,343,3,340,10,90,115,39,5,3,0,18,5,55
1,431,850,127,723,17,706,13,133,168,100,12,4,3,88,16,169
1,432,206,22,184,3,181,7,37,57,15,0,3,0,21,6,35
1,433,157,26,131,1,130,3,46,26,8,1,0,0,13,6,27
1,434,254,32,222,3,219,3,51,82,11,1,1,0,25,4,41
1,435,1103,231,872,17,855,35,126,278,77,10,5,0,110,20,194
1,436,365,58,307,7,300,25,23,125,20,6,3,1,53,7,37
1,437,154,26,128,4,124,2,33,33,9,3,0,0,17,5,22
1,439,75,8,67,0,67,2,16,25,7,1,0,0,5,2,9
1,441,459,65,394,7,387,7,93,131,36,2,3,0,32,12,71
1,442,318,39,279,6,273,2,46,86,24,3,1,0,32,6,73
1,443,3100,512,2588,41,2547,61,569,787,247,22,12,8,216,54,571
1,444,831,120,711,19,692,17,159,140,123,11,4,2,57,13,166
1,445,473,44,429,9,420,13,123,119,34,5,2,1,46,9,68
1,446,1003,167,836,15,821,15,190,338,52,3,4,3,76,22,118
1,447,810,135,675,15,660,15,182,160,67,5,1,5,55,20,150
1,448,271,32,239,9,230,3,38,76,31,3,1,1,26,6,45
1,449,508,64,444,6,438,6,105,131,46,4,2,1,36,7,100
1,450,2450,406,2044,40,2004,37,523,639,158,19,8,3,163,41,413
1,451,4396,605,3791,84,3707,54,718,1233,266,41,21,6,427,79,862
1,452,635,97,538,11,527,13,134,104,55,8,4,2,51,16,140
1,453,214,41,173,5,168,3,42,36,18,1,1,0,33,1,33
1,454,559,51,508,15,493,9,137,136,49,3,3,1,44,12,99
1,456,65,7,58,2,56,3,6,13,4,0,0,0,13,2,15
1,457,1903,349,1554,43,1511,29,266,520,136,14,5,4,148,28,361
2,1,386,76,310,2,308,3,122,76,22,3,7,0,15,6,54
2,2,392,43,349,10,339,3,119,76,29,7,5,1,9,6,84
2,3,787,152,635,10,625,11,196,121,51,14,9,2,47,12,162
2,4,158,22,136,2,134,0,36,48,10,0,1,0,8,4,27
2,5,313,43,270,9,261,2,68,60,15,4,3,0,21,9,79
2,6,231,28,203,2,201,0,64,62,14,3,2,1,5,9,41
2,7,90,8,82,2,80,1,11,27,6,1,2,1,5,4,22
2,8,178,21,157,2,155,4,35,35,18,2,2,0,6,3,50
2,9,378,45,333,4,329,4,115,65,30,3,4,2,16,5,85
2,10,124,14,110,0,110,3,49,20,9,0,0,0,7,0,22
2,11,907,157,750,8,742,12,198,230,60,8,4,1,55,6,168
2,12,60,10,50,0,50,0,14,14,4,0,0,1,2,0,15
2,13,303,57,246,4,242,1,59,81,27,3,3,1,11,8,48
2,14,515,62,453,9,444,5,121,92,48,3,3,0,37,15,120
2,15,61,11,50,0,50,0,16,16,2,0,0,0,3,0,13
2,16,159,14,145,3,142,2,26,29,24,4,1,2,7,2,45
2,17,223,22,201,3,198,0,31,56,16,2,1,0,25,9,58
2,18,1392,301,1091,8,1083,19,273,232,106,23,7,2,67,23,331
2,19,277,42,235,3,232,1,65,66,21,2,0,0,15,13,49
2,20,350,45,305,6,299,4,89,97,25,6,3,0,20,5,50
2,21,80,18,62,2,60,2,16,10,12,0,0,1,13,0,6
2,22,319,55,264,5,259,4,71,84,23,2,3,1,13,1,57
2,23,89,14,75,1,74,0,27,17,11,0,0,0,7,2,10
2,24,38,2,36,0,36,0,5,15,4,0,2,0,2,0,8
2,25,269,46,223,3,220,1,56,64,19,1,1,0,11,5,62
2,26,156,23,133,1,132,2,43,31,12,1,2,0,8,5,28
2,27,206,38,168,8,160,0,48,34,20,2,0,1,6,1,48
2,28,2044,344,1700,36,1664,12,441,322,197,22,10,3,118,28,511
2,29,297,27,270,7,263,6,84,55,41,4,0,1,16,4,52
2,30,224,25,199,2,197,1,47,75,9,1,1,1,15,15,32
2,31,465,73,392,7,385,0,138,97,38,1,2,1,17,10,81
2,32,199,41,158,1,157,0,75,40,8,0,2,0,2,4,26
2,33,87,7,80,0,80,0,12,12,6,0,1,0,8,1,40
2,34,76,12,64,2,62,1,11,25,3,1,0,0,4,0,17
2,35,180,22,158,3,155,0,36,34,13,1,0,4,19,5,43
2,36,66,9,57,0,57,0,22,21,6,0,0,0,2,0,6
2,37,1063,194,869,18,851,3,220,130,94,5,10,1,83,16,289
2,38,65,11,54,1,53,0,15,16,5,0,0,1,2,2,12
2,39,120,19,101,1,100,0,21,32,4,3,1,0,3,1,35
2,40,139,22,117,2,115,3,26,30,14,3,1,1,2,0,35
2,41,646,110,536,14,522,6,128,142,76,3,4,1,33,17,112
2,42,268,42,226,2,224,3,59,54,19,4,0,1,17,5,62
2,43,45,8,37,0,37,2,13,8,2,0,0,0,0,3,9
2,44,32,8,24,1,23,0,4,12,0,0,0,0,3,0,4
2,46,441,47,394,10,384,2,114,69,28,3,5,1,27,3,132
2,47,101,15,86,0,86,0,31,11,4,0,0,0,2,1,37
2,48,93,5,88,2,86,2,22,27,10,0,1,0,6,2,16
2,49,569,80,489,10,479,7,141,106,62,5,4,2,24,7,121
2,50,222,28,194,2,192,0,62,57,20,0,2,1,12,2,36
2,51,280,43,237,5,232,3,67,69,14,3,3,1,9,5,58
2,52,112,17,95,1,94,1,30,15,9,0,0,0,7,3,29
2,53,229,29,200,4,196,5,46,51,19,1,1,1,23,7,42
2,54,344,69,275,5,270,5,65,68,26,3,5,0,19,7,72
2,55,112,24,88,0,88,0,31,21,3,1,1,0,11,0,20
2,56,132,28,104,3,101,0,39,14,19,1,0,1,8,2,17
2,57,1024,208,816,17,799,8,302,242,45,6,7,1,36,16,136
2,58,482,65,417,4,413,3,113,118,35,6,0,2,24,11,101
2,59,1980,512,1468,16,1452,8,413,245,182,17,14,7,45,23,498
2,60,218,28,190,7,183,0,41,55,22,0,1,3,9,5,47
2,61,185,40,145,0,145,3,40,26,11,3,1,2,9,2,48
2,62,97,13,84,1,83,4,28,22,10,1,0,0,6,2,10
2,63,282,50,232,3,229,4,64,45,29,3,1,0,13,6,64
2,64,2574,546,2028,34,1994,13,551,374,250,14,13,7,127,36,609
2,65,481,86,395,5,390,0,161,83,43,3,3,0,16,3,78
2,66,171,33,138,1,137,0,41,46,14,0,0,0,9,2,25
2,67,174,27,147,6,141,0,39,37,10,3,0,0,11,4,37
2,68,68,9,59,0,59,2,15,7,7,2,2,0,7,9,8
2,69,89,12,77,1,76,0,20,28,2,1,1,0,4,1,19
2,70,341,47,294,7,287,4,80,62,15,3,3,0,18,13,89
2,71,469,72,397,5,392,3,79,118,39,8,2,0,34,8,101
2,72,142,18,124,1,123,0,27,36,9,1,0,2,12,0,36
2,73,375,66,309,5,304,1,82,77,26,7,4,2,15,6,84
2,74,474,93,381,2,379,4,129,74,49,7,6,1,24,3,82
2,75,164,20,144,2,142,0,35,35,13,0,1,1,14,4,39
2,76,103,15,88,3,85,0,18,35,7,1,1,1,8,2,12
2,77,309,50,259,4,255,8,66,61,17,2,1,0,22,4,74
2,78,97,17,80,1,79,1,16,18,14,0,0,0,5,8,17
2,79,126,20,106,1,105,0,28,35,8,1,2,1,8,1,21
2,80,300,56,244,6,238,5,36,74,18,4,0,0,18,5,78
2,81,281,34,247,3,244,3,77,43,31,7,3,0,26,3,51
2,82,98,14,84,2,82,1,30,14,8,1,3,0,5,0,20
2,83,514,113,401,8,393,10,138,93,26,3,1,1,24,11,86
2,84,189,24,165,3,162,4,47,44,17,1,0,1,16,9,23
2,85,561,75,486,9,477,5,115,115,50,5,4,1,41,17,124
2,86,723,85,638,15,623,2,164,153,59,11,1,1,31,9,192
2,87,24,1,23,0,23,0,1,7,0,0,0,0,2,1,12
2,88,59,10,49,0,49,0,13,13,5,1,2,0,5,1,9
2,89,855,122,733,11,722,5,234,153,65,12,5,0,50,16,182
2,90,164,24,140,3,137,5,44,36,9,4,1,1,7,1,29
2,91,76,17,59,2,57,1,10,22,5,0,1,0,4,2,12
2,93,893,177,716,17,699,12,241,174,60,20,4,1,42,11,134
2,94,313,34,279,8,271,5,55,85,31,8,1,0,17,5,64
2,95,3704,893,2811,63,2748,21,801,531,343,42,30,4,140,48,788
2,96,160,28,132,2,130,0,42,30,13,3,0,0,4,2,36
2,97,205,32,173,0,173,0,50,39,15,0,0,0,7,1,61
2,98,274,45,229,5,224,6,44,59,29,2,0,1,28,5,50
2,99,166,27,139,5,134,3,36,31,23,2,1,2,7,9,20
2,100,113,19,94,0,94,1,32,33,2,3,0,0,6,2,15
2,101,151,20,131,3,128,0,43,33,12,0,2,0,3,4,31
2,102,153,29,124,0,124,1,33,24,3,1,1,0,15,6,40
2,103,923,171,752,16,736,6,212,160,65,10,8,0,36,5,234
2,104,82,12,70,2,68,0,7,32,7,0,0,0,2,3,17
2,105,154,24,130,3,127,0,46,30,10,5,0,0,6,6,24
2,106,454,60,394,9,385,6,119,76,59,9,1,0,23,7,85
2,107,82,10,72,2,70,1,29,14,1,1,3,0,4,2,15
2,108,115,15,100,3,97,2,19,29,10,0,1,0,6,0,30
2,109,365,47,318,5,313,1,75,95,24,2,0,1,23,2,90
2,110,1370,245,1125,22,1103,12,323,283,95,10,7,3,71,26,273
2,111,526,82,444,4,440,4,115,72,62,8,9,1,31,14,124
2,112,482,87,395,3,392,4,133,93,26,4,3,0,21,22,86
2,114,934,140,794,17,777,7,187,207,73,13,8,3,65,23,191
2,115,155,15,140,3,137,0,29,29,14,1,1,0,1,4,58
2,116,131,23,108,0,108,1,30,31,12,4,1,0,7,5,17
2,117,57,10,47,2,45,0,21,10,4,0,0,1,3,1,5
2,118,90,10,80,3,77,0,21,16,4,2,1,0,2,4,27
2,119,241,29,212,1,211,4,81,52,24,3,2,1,11,7,26
2,120,162,15,147,3,144,0,39,31,3,3,4,0,15,4,45
2,121,164,19,145,1,144,1,62,22,15,6,2,0,13,2,21
2,122,43,7,36,0,36,0,9,10,1,0,0,1,2,0,13
2,123,214,20,194,1,193,3,55,45,17,1,1,4,23,3,41
2,124,516,64,452,9,443,1,139,131,35,4,3,1,33,10,86
2,125,157,27,130,1,129,6,28,45,17,3,0,0,13,0,17
2,126,446,80,366,2,364,3,107,73,29,3,0,1,31,11,106
2,127,140,20,120,0,120,3,29,28,13,1,2,1,8,3,32
2,128,1258,204,1054,18,1036,12,191,291,107,14,7,1,93,29,291
2,129,33,11,22,0,22,1,0,14,0,0,0,0,2,0,5
2,130,155,18,137,2,135,3,55,30,9,7,0,0,9,3,19
2,131,1469,208,1261,25,1236,21,326,296,112,14,8,2,99,22,336
2,132,146,31,115,4,111,2,36,40,10,0,0,1,9,2,11
2,133,301,49,252,3,249,1,58,70,19,3,3,0,14,4,77
2,134,665,109,556,7,549,4,169,101,54,5,5,0,29,12,170
2,135,845,132,713,20,693,6,221,153,42,9,12,3,33,17,197
2,136,128,26,102,4,98,0,37,36,3,2,2,0,3,1,14
2,137,84,12,72,0,72,0,26,27,3,0,1,0,2,4,9
2,138,153,20,133,6,127,2,31,56,12,0,2,0,5,0,19
2,139,362,83,279,8,271,2,89,78,28,3,1,0,15,4,51
2,140,310,56,254,2,252,6,94,66,26,5,3,0,13,6,33
2,141,1311,244,1067,26,1041,5,309,276,77,10,9,8,62,28,257
2,142,190,24,166,0,166,1,47,29,11,2,1,1,9,5,60
2,143,138,18,120,1,119,2,54,36,8,1,0,1,4,0,13
2,144,104,12,92,3,89,1,19,35,8,1,1,0,8,3,13
2,145,436,47,389,8,381,7,106,62,51,3,3,0,26,8,115
2,146,63,11,52,0,52,0,9,14,4,2,0,0,9,2,12
2,147,90,16,74,1,73,1,23,26,7,2,0,0,8,0,6
2,148,197,28,169,3,166,1,66,29,13,2,1,0,11,1,42
2,149,43,0,43,2,41,0,6,19,5,0,1,0,4,0,6
2,150,64,9,55,1,54,0,22,10,1,1,0,0,7,1,12
2,151,90,4,86,1,85,0,17,30,5,1,0,0,3,4,25
2,152,75,11,64,2,62,0,17,28,3,0,0,0,4,2,8
2,153,354,33,321,5,316,5,71,78,33,7,4,0,9,8,101
2,154,243,25,218,2,216,3,67,58,18,4,2,1,9,7,47
2,155,145,21,124,2,122,6,32,25,10,0,0,0,6,4,39
2,156,176,26,150,2,148,4,35,29,15,2,3,0,11,4,45
2,157,569,64,505,5,500,3,97,95,74,8,6,3,22,11,181
2,158,163,23,140,2,138,2,31,33,13,2,2,0,16,1,38
2,159,234,47,187,3,184,3,50,62,18,1,2,0,13,3,32
2,160,364,64,300,6,294,5,78,73,27,5,6,1,14,4,81
2,161,158,16,142,2,140,4,35,45,12,2,0,3,9,5,25
2,162,182,23,159,1,158,2,60,36,9,2,0,0,8,2,39
2,163,1625,292,1333,22,1311,16,358,373,127,18,10,5,107,34,263
2,164,236,29,207,6,201,0,56,50,22,3,5,1,19,5,40
2,165,1250,268,982,21,961,12,244,182,118,17,12,0,52,26,298
2,166,268,55,213,6,207,5,56,43,28,2,0,0,13,3,57
2,167,577,96,481,13,468,3,137,110,46,6,2,0,51,13,100
2,168,9499,2407,7092,122,6970,129,1352,1652,891,87,61,26,575,139,2058
2,169,84,10,74,4,70,0,19,24,11,1,0,0,1,2,12
2,170,108,19,89,0,89,0,22,30,6,1,0,0,7,3,20
2,171,71,12,59,1,58,0,29,15,4,0,0,0,0,0,10
2,172,163,25,138,1,137,0,45,30,16,1,0,3,9,2,31
2,173,7720,1961,5759,96,5663,61,1434,1228,685,63,39,13,378,104,1658
2,174,571,85,486,10,476,4,142,117,36,8,4,2,40,12,111
2,175,129,18,111,3,108,1,41,31,12,2,2,0,6,3,10
2,176,155,25,130,2,128,0,43,21,20,4,1,1,6,3,29
2,177,119,15,104,4,100,1,15,46,9,0,2,0,5,2,20
2,178,81,12,69,5,64,3,15,17,6,0,1,0,4,1,17
2,179,272,42,230,6,224,7,78,60,15,8,0,1,10,5,40
2,180,515,77,438,3,435,8,110,85,37,5,0,1,34,9,146
2,181,74,11,63,1,62,0,33,16,4,0,0,0,2,0,7
2,182,121,21,100,1,99,0,28,27,12,0,0,0,4,0,28
2,183,161,15,146,4,142,1,36,43,12,1,1,0,17,6,25
2,184,206,27,179,5,174,1,75,32,15,1,4,2,7,5,32
2,185,261,30,231,1,230,3,61,68,21,0,4,0,17,4,52
2,186,1004,193,811,11,800,15,218,259,75,11,7,0,64,16,135
2,187,825,138,687,9,678,14,122,187,72,13,5,3,52,16,194
2,188,135,31,104,2,102,2,37,22,5,1,0,0,5,2,28
2,189,258,35,223,2,221,2,90,30,13,2,1,0,9,4,70
2,190,440,86,354,6,348,4,111,78,29,5,3,1,26,9,82
2,191,339,41,298,2,296,5,70,77,27,4,6,0,11,5,91
2,192,259,44,215,1,214,3,57,69,13,2,2,0,28,3,37
2,193,63,6,57,1,56,3,15,18,2,0,0,0,3,0,15
2,194,179,17,162,3,159,0,59,40,8,0,3,0,4,2,43
2,195,632,95,537,9,528,3,160,135,48,3,2,1,40,11,125
2,196,251,34,217,2,215,2,58,78,12,1,1,0,13,4,46
2,197,399,51,348,11,337,9,95,128,15,4,2,0,24,10,50
2,198,198,46,152,3,149,2,35,34,22,0,2,1,7,1,45
2,199,421,67,354,5,349,2,116,63,44,3,5,0,17,10,89
2,200,95,18,77,2,75,1,11,14,9,1,3,0,9,3,24
2,201,235,39,196,2,194,7,63,51,16,0,2,1,11,6,37
2,203,806,152,654,12,642,7,203,165,54,7,5,2,52,11,136
2,204,70,19,51,1,50,0,12,20,1,0,1,0,9,1,6
2,205,124,14,110,1,109,0,38,22,20,1,0,2,6,1,19
2,206,69,12,57,1,56,0,15,17,1,0,0,0,3,1,19
2,207,163,25,138,4,134,4,28,30,14,2,1,0,15,3,37
2,208,200,27,173,2,171,1,54,28,31,1,2,0,14,6,34
2,209,468,101,367,8,359,1,109,100,31,2,1,3,34,11,67
2,210,299,51,248,11,237,1,94,42,22,4,1,0,19,1,53
2,211,182,42,140,3,137,0,33,44,10,4,3,0,7,2,34
2,212,539,76,463,9,454,6,93,100,67,8,2,0,31,7,140
2,213,231,36,195,2,193,8,41,40,31,4,1,2,19,6,41
2,214,41,4,37,0,37,0,8,10,1,0,1,1,1,1,14
2,215,495,60,435,7,428,7,115,99,44,5,5,1,27,7,118
2,216,233,33,200,2,198,8,48,42,18,7,1,0,15,5,54
2,217,647,99,548,10,538,8,123,138,81,8,1,0,30,5,144
2,218,398,62,336,5,331,1,71,68,25,5,1,0,34,15,111
2,219,119,24,95,1,94,0,17,18,13,2,1,1,6,0,36
2,220,309,46,263,4,259,4,61,85,25,3,1,0,30,6,44
2,221,132,25,107,2,105,3,29,31,5,2,0,1,9,7,18
2,222,26,5,21,0,21,0,9,6,1,0,0,0,0,0,5
2,223,228,41,187,4,183,8,56,53,20,1,0,0,14,8,23
2,224,271,41,230,3,227,1,100,34,24,3,6,1,10,5,43
2,225,62,4,58,1,57,3,23,13,4,1,0,0,5,0,8
2,226,1314,212,1102,26,1076,5,303,244,124,17,9,2,77,25,270
2,227,86,10,76,4,72,1,25,12,3,1,0,0,8,7,15
2,228,203,27,176,7,169,2,40,44,23,0,3,0,19,0,38
2,229,60,8,52,1,51,1,6,10,5,1,1,0,6,2,19
2,230,158,33,125,0,125,1,31,41,13,4,0,1,11,1,22
2,231,606,84,522,13,509,5,128,103,61,5,4,0,22,11,170
2,232,166,23,143,4,139,8,28,34,18,2,1,0,14,1,33
2,233,111,15,96,3,93,0,28,26,10,0,1,0,5,3,20
2,234,82,7,75,0,75,2,12,19,9,2,0,0,8,4,19
2,235,93,11,82,1,81,0,27,23,2,3,0,0,2,6,18
2,236,220,45,175,4,171,0,42,26,14,4,2,1,13,4,65
2,237,955,163,792,9,783,8,214,150,90,9,9,0,41,13,249
2,238,1258,213,1045,14,1031,10,304,250,90,14,10,2,52,11,288
2,239,727,162,565,8,557,2,152,108,70,12,8,3,40,11,151
2,240,176,23,153,4,149,1,25,46,16,2,0,1,11,0,47
2,241,87,7,80,1,79,2,26,29,8,1,1,0,3,1,8
2,242,398,79,319,1,318,9,94,101,20,10,2,0,25,7,50
2,243,1964,402,1562,33,1529,10,407,344,143,19,12,3,103,25,463
2,244,49,4,45,3,42,2,7,14,2,2,0,0,4,0,11
2,245,1101,188,913,9,904,9,252,230,106,11,7,1,46,15,227
2,246,455,81,374,8,366,2,116,81,31,5,4,3,19,7,98
2,248,116,18,98,0,98,1,26,18,8,0,1,0,7,0,37
2,249,86,22,64,0,64,1,19,16,5,1,2,1,8,1,10
2,250,61,14,47,0,47,1,15,12,5,1,0,0,0,3,10
2,251,35,8,27,1,26,0,4,16,1,0,0,0,2,1,2
2,252,61,7,54,0,54,1,14,9,13,0,1,0,3,0,13
2,253,277,50,227,0,227,5,55,57,17,2,2,0,22,5,62
2,254,89,13,76,4,72,0,15,19,13,1,0,0,7,0,17
2,255,102,19,83,3,80,2,29,20,7,3,0,0,4,0,15
2,256,126,28,98,0,98,2,36,37,2,1,3,0,5,0,12
2,257,343,56,287,3,284,5,83,90,22,4,2,0,20,11,47
2,258,310,55,255,1,254,6,57,74,31,1,5,0,18,5,57
2,259,313,31,282,6,276,4,80,74,31,5,5,2,13,3,59
2,260,445,76,369,8,361,4,104,75,29,3,3,0,15,8,120
2,261,283,38,245,3,242,5,68,45,21,0,3,0,15,4,81
2,262,185,32,153,2,151,0,40,28,24,2,3,0,9,1,44
2,263,106,20,86,0,86,0,26,34,3,1,0,1,9,0,12
2,264,564,111,453,8,445,0,107,100,46,4,3,2,32,12,139
2,265,83,16,67,0,67,0,18,25,4,2,0,0,1,0,17
2,266,49,11,38,2,36,0,8,12,3,2,0,0,7,0,4
2,267,216,40,176,2,174,3,39,42,26,2,1,0,7,6,48
2,268,450,67,383,8,375,3,112,97,37,4,2,2,29,4,85
2,269,123,16,107,2,105,0,20,50,4,1,1,1,9,2,17
2,270,108,27,81,3,78,0,24,22,6,0,0,0,3,2,21
2,271,110,16,94,1,93,1,20,44,4,0,0,0,8,0,16
2,272,69,9,60,0,60,1,11,28,5,0,0,0,6,1,8
2,273,158,21,137,2,135,2,37,44,9,1,0,0,9,4,29
2,274,153,25,128,2,126,4,29,44,2,4,1,0,7,3,32
2,275,257,50,207,1,206,0,69,38,17,2,2,0,6,4,68
2,276,109,21,88,3,85,1,21,25,11,0,0,0,6,1,20
2,277,229,42,187,5,182,2,53,26,25,1,3,1,11,4,56
2,278,49,6,43,0,43,0,7,20,1,0,0,0,7,2,6
2,279,417,73,344,7,337,8,97,98,25,4,4,0,26,5,70
2,280,304,59,245,6,239,3,74,49,14,8,5,1,23,6,56
2,281,177,32,145,2,143,0,44,42,12,1,2,0,10,2,30
2,282,305,53,252,6,246,2,52,58,19,4,2,2,15,1,91
2,283,215,37,178,4,174,1,49,48,8,2,1,0,9,5,51
2,284,83,18,65,0,65,1,24,16,3,2,0,0,5,2,12
2,286,642,133,509,15,494,6,163,160,39,5,5,1,41,6,68
2,287,912,124,788,12,776,9,202,217,45,5,7,1,69,12,209
2,288,264,30,234,5,229,3,83,47,28,1,3,0,7,4,53
2,289,356,63,293,9,284,6,78,73,31,1,1,1,27,8,58
2,290,1996,431,1565,27,1538,21,388,315,222,30,10,8,125,34,385
2,291,278,37,241,9,232,0,59,70,23,0,2,0,12,2,64
2,292,908,189,719,15,704,9,160,161,96,11,9,1,59,18,180
2,293,399,67,332,8,324,4,87,75,32,4,5,1,12,8,96
2,294,173,32,141,0,141,0,40,47,10,2,0,0,7,4,31
2,295,694,133,561,15,546,5,166,125,46,3,5,0,33,5,158
2,296,957,160,797,17,780,8,231,190,77,3,2,0,76,11,182
2,297,84,9,75,0,75,1,10,19,11,0,0,0,8,2,24
2,298,1092,228,864,14,850,1,283,144,75,19,15,2,36,26,249
2,299,379,67,312,9,303,1,107,68,25,10,0,1,14,8,69
2,301,218,32,186,6,180,2,45,53,27,3,3,1,10,2,34
2,302,256,59,197,5,192,0,55,54,22,3,3,1,11,2,41
2,303,555,68,487,10,477,5,78,237,19,1,1,1,40,14,81
2,304,1625,536,1089,21,1068,5,290,256,110,17,11,3,66,18,292
2,305,2069,382,1687,40,1647,18,490,406,152,20,15,4,117,27,398
2,306,448,78,370,5,365,4,98,82,27,3,3,0,25,3,120
2,307,1552,350,1202,20,1182,16,354,277,112,17,17,3,73,20,293
2,308,375,67,308,7,301,0,90,92,12,2,3,1,27,9,65
2,309,439,89,350,0,350,4,86,57,53,5,0,1,16,7,121
2,310,228,36,192,3,189,3,54,48,8,3,1,0,9,8,55
2,311,85,8,77,0,77,1,25,11,7,1,2,0,9,1,20
2,312,834,130,704,19,685,6,223,228,43,12,5,2,42,8,116
2,313,342,46,296,4,292,2,80,79,25,1,2,1,20,5,77
2,315,1035,160,875,19,856,5,209,199,125,12,9,5,58,18,216
2,316,135,14,121,2,119,1,25,43,9,2,0,1,6,5,27
2,317,173,26,147,1,146,1,39,41,11,2,0,0,8,5,39
2,318,1107,241,866,21,845,15,210,174,131,11,6,1,33,29,235
2,319,381,55,326,8,318,1,87,73,22,0,1,0,20,4,110
2,320,231,38,193,0,193,4,55,55,10,3,2,0,9,4,51
2,321,672,112,560,10,550,10,116,194,51,6,4,1,35,10,123
2,322,298,22,276,10,266,3,76,69,15,4,0,0,18,3,78
2,323,88,6,82,2,80,0,23,19,8,0,0,0,5,2,23
2,324,196,25,171,2,169,1,46,45,8,3,3,1,20,4,38
2,325,146,23,123,1,122,3,45,48,6,0,1,1,8,5,5
2,326,397,79,318,2,316,3,79,99,19,6,1,0,35,8,66
2,327,126,19,107,1,106,0,29,38,9,0,0,0,4,1,25
2,328,460,80,380,11,369,5,96,74,54,10,2,0,26,12,90
2,329,349,65,284,3,281,6,71,57,28,1,0,0,24,11,83
2,330,372,48,324,4,320,3,72,108,23,2,4,1,38,2,67
2,331,104,14,90,2,88,0,26,15,5,2,0,0,3,0,37
2,332,178,23,155,1,154,4,41,43,8,6,1,0,9,2,40
2,333,117,12,105,0,105,0,30,17,11,1,0,1,3,4,38
2,334,2207,433,1774,37,1737,9,443,352,184,28,15,3,103,16,584
2,335,169,36,133,1,132,1,44,32,14,1,0,1,7,1,31
2,336,735,117,618,10,608,5,195,103,85,10,4,3,35,16,152
2,337,170,27,143,0,143,0,43,34,12,1,1,0,9,2,41
2,338,197,27,170,4,166,5,37,46,9,2,1,2,7,2,55
2,339,495,92,403,10,393,4,126,86,57,9,1,0,22,10,78
2,340,4259,910,3349,37,3312,30,786,500,537,50,31,6,160,39,1173
2,341,221,30,191,1,190,6,58,30,24,3,3,0,12,8,46
2,342,113,15,98,2,96,0,25,40,7,1,0,1,5,1,16
2,343,62,8,54,0,54,2,12,23,3,0,0,0,0,1,13
2,344,48,8,40,1,39,0,15,9,2,0,0,0,4,0,9
2,345,32,5,27,1,26,0,7,7,8,0,1,1,1,1,0
2,346,524,60,464,9,455,3,138,99,30,10,2,1,13,4,155
2,347,393,61,332,8,324,3,106,93,20,2,6,0,26,6,62
2,348,143,18,125,3,122,2,46,38,15,1,0,0,10,1,9
2,349,35,1,34,0,34,0,3,15,6,0,0,0,1,1,8
2,350,108,12,96,1,95,1,19,26,6,1,1,0,6,0,35
2,351,84,14,70,1,69,2,15,15,7,2,0,0,7,4,17
2,352,404,70,334,9,325,3,97,67,33,3,4,3,25,5,85
2,353,215,25,190,0,190,3,48,43,16,2,3,0,9,3,63
2,354,70,10,60,3,57,1,14,15,2,0,1,0,6,1,17
2,355,658,86,572,7,565,1,115,158,64,3,3,0,47,8,166
2,356,132,24,108,0,108,1,38,17,12,1,0,0,6,0,33
2,357,52,9,43,1,42,0,5,19,2,0,1,0,6,1,8
2,358,310,68,242,6,236,0,71,54,13,3,3,0,10,9,73
2,359,741,84,657,11,646,4,163,117,69,14,3,0,44,21,211
2,360,1599,290,1309,32,1277,12,298,373,91,27,14,4,116,26,316
2,361,3379,729,2650,43,2607,18,652,515,255,26,27,6,106,38,964
2,362,205,45,160,1,159,1,39,34,28,1,2,0,5,4,45
2,363,317,49,268,5,263,1,82,39,27,4,4,0,12,5,89
2,364,193,41,152,2,150,1,37,43,12,2,2,0,11,0,42
2,366,202,35,167,2,165,2,51,41,9,3,3,0,11,1,44
2,367,115,13,102,3,99,2,38,15,11,2,3,0,8,0,20
2,368,422,58,364,9,355,5,109,95,32,10,0,1,29,8,66
2,369,204,19,185,0,185,2,52,42,19,4,1,0,8,2,55
2,370,380,45,335,3,332,1,117,67,40,6,5,0,19,7,70
2,371,1203,168,1035,26,1009,11,205,267,97,10,7,3,68,18,323
2,372,241,25,216,2,214,3,83,45,19,2,0,0,13,6,43
2,373,206,38,168,2,166,0,37,38,24,3,0,0,16,1,47
2,374,605,65,540,11,529,2,162,78,119,8,7,0,27,6,120
2,375,102,11,91,1,90,4,30,23,12,1,1,0,4,6,9
2,376,134,19,115,1,114,4,38,29,6,1,0,1,4,2,29
2,377,122,15,107,1,106,2,22,35,6,0,4,0,17,10,10
2,378,137,19,118,1,117,2,29,40,6,2,0,0,2,0,36
2,379,182,21,161,15,146,1,40,46,9,5,1,2,10,1,31
2,380,40,9,31,0,31,0,10,11,1,0,0,0,2,3,4
2,381,7032,2361,4671,89,4582,41,1145,946,600,66,35,19,261,58,1411
2,382,1103,147,956,13,943,10,216,219,106,17,6,1,71,22,275
2,383,1080,130,950,15,935,11,187,285,79,4,6,2,78,20,263
2,384,49,12,37,0,37,0,9,17,9,1,0,0,0,0,1
2,385,144,19,125,1,124,1,45,25,10,3,0,0,13,0,27
2,386,167,32,135,0,135,1,35,27,16,6,2,0,9,3,36
2,387,819,97,722,17,705,6,192,174,41,10,5,3,55,23,196
2,388,165,29,136,1,135,3,57,29,9,0,0,0,9,2,26
2,389,468,81,387,13,374,9,85,109,43,4,1,1,28,4,90
2,390,176,26,150,0,150,3,46,28,7,0,1,0,14,5,46
2,391,160,31,129,3,126,2,26,49,16,3,1,0,6,1,22
2,392,268,41,227,4,223,2,80,55,24,1,3,3,15,5,35
2,393,120,25,95,1,94,5,23,23,8,2,2,1,6,0,24
2,395,110,14,96,3,93,2,26,18,3,0,0,0,10,1,33
2,396,41,6,35,2,33,1,10,11,10,0,0,0,1,0,0
2,397,950,210,740,11,729,3,202,184,103,5,7,4,25,10,186
2,398,230,41,189,4,185,1,63,38,21,0,0,0,21,1,40
2,399,331,42,289,6,283,4,79,70,22,2,4,0,25,4,73
2,400,110,9,101,2,99,1,41,19,5,1,1,1,5,0,25
2,401,158,20,138,2,136,1,52,44,8,1,0,0,8,3,19
2,402,48,11,37,0,37,0,11,17,1,0,0,0,1,1,6
2,403,228,33,195,2,193,1,68,46,14,2,1,0,10,4,47
2,404,145,28,117,1,116,0,32,35,7,2,1,0,4,5,30
2,405,421,83,338,5,333,3,69,95,36,11,3,0,34,8,74
2,406,93,13,80,1,79,2,16,15,12,2,3,0,7,1,21
2,407,149,27,122,2,120,1,34,29,14,2,0,0,12,5,23
2,408,15410,4026,11384,188,11196,198,2303,2573,1212,150,96,26,867,182,3589
2,409,225,32,193,1,192,3,50,44,25,2,2,0,9,5,52
2,410,168,20,148,5,143,5,38,32,12,2,1,1,12,1,39
2,411,145,30,115,0,115,1,46,24,9,0,0,0,6,1,28
2,412,83,7,76,2,74,0,25,30,7,0,0,0,4,0,8
2,413,196,10,186,0,186,1,49,51,18,2,0,0,8,2,55
2,414,167,19,148,0,148,0,49,44,6,2,0,0,9,4,34
2,415,96,15,81,3,78,0,31,18,6,1,4,1,4,3,10
2,416,366,36,330,7,323,4,86,76,31,3,8,0,16,4,95
2,417,77,8,69,6,63,1,14,21,12,1,0,0,1,3,10
2,418,167,28,139,4,135,5,39,45,12,0,2,0,7,5,20
2,419,212,29,183,2,181,0,52,75,7,3,1,0,8,3,32
2,420,682,109,573,11,562,5,190,156,40,12,4,1,23,8,123
2,421,53,7,46,1,45,0,8,12,5,0,0,0,4,1,15
2,422,618,110,508,12,496,2,107,95,48,8,6,1,34,7,188
2,423,309,49,260,4,256,1,86,57,24,3,8,0,11,4,62
2,424,95,17,78,3,75,1,16,12,9,0,1,0,7,1,28
2,425,129,16,113,0,113,0,42,38,1,0,0,0,6,6,20
2,426,424,48,376,6,370,4,101,119,28,5,3,1,29,7,73
2,427,98,19,79,3,76,0,28,11,7,2,0,0,8,5,15
2,428,58,12,46,0,46,0,13,14,3,0,1,0,3,0,12
2,429,87,13,74,2,72,0,19,10,16,1,0,0,4,0,22
2,430,827,144,683,11,672,11,188,132,77,11,6,1,39,17,190
2,431,344,59,285,7,278,3,83,47,32,6,1,0,16,8,82
2,432,156,29,127,1,126,2,36,44,8,0,0,0,10,5,21
2,433,216,40,176,6,170,1,49,43,5,4,3,0,11,4,50
2,434,196,31,165,4,161,3,33,41,15,3,3,0,9,2,52
2,435,68,8,60,1,59,1,21,19,5,0,0,0,3,2,8
2,438,190,19,171,2,169,0,22,61,17,4,4,0,19,6,36
2,439,278,61,217,1,216,3,78,50,10,1,1,2,10,7,54
2,440,105,11,94,2,92,1,29,41,2,3,0,0,4,1,11
2,441,173,28,145,1,144,3,29,57,14,2,2,0,8,1,28
2,442,81,13,68,3,65,1,20,20,14,0,0,0,1,0,9
2,443,140,22,118,0,118,0,37,32,12,2,0,0,11,1,23
2,444,109,15,94,0,94,1,26,14,11,3,0,0,2,4,33
2,445,231,34,197,2,195,4,49,58,16,0,1,0,20,1,46
2,446,82,17,65,2,63,2,18,9,11,1,0,0,6,2,14
2,447,99,16,83,2,81,0,27,23,9,4,0,0,5,0,13
2,448,98,5,93,1,92,4,34,22,5,1,2,0,7,1,16
2,449,58,18,40,1,39,0,4,15,5,0,1,0,3,2,9
2,450,250,18,232,4,228,2,59,77,23,0,2,0,8,6,51
2,451,117,15,102,1,101,0,29,19,18,2,0,3,11,1,18
2,452,170,16,154,1,153,1,42,55,13,1,2,2,9,3,25
2,453,275,41,234,3,231,0,57,48,30,3,1,2,21,12,57
2,454,275,37,238,2,236,3,64,58,24,5,4,1,20,3,54
2,455,148,27,121,4,117,1,36,38,9,4,1,0,9,3,16
2,456,302,47,255,5,250,3,60,68,39,2,2,3,12,10,51
2,457,266,53,213,1,212,3,69,53,16,2,0,2,9,5,53
2,458,229,46,183,1,182,0,59,66,22,3,0,0,9,8,15
2,459,153,19,134,2,132,0,21,53,7,0,1,0,17,2,31
2,460,161,22,139,0,139,3,33,26,10,4,3,0,12,8,40
2,461,261,43,218,5,213,2,69,72,19,5,1,0,14,3,28
2,462,179,16,163,3,160,3,56,23,25,2,1,1,15,3,31
2,463,60,6,54,0,54,2,16,14,3,1,0,0,1,2,15
2,464,234,29,205,3,202,1,38,54,22,3,0,0,14,9,61
2,465,305,37,268,5,263,6,98,69,27,0,1,0,10,8,44
2,466,124,29,95,0,95,6,31,21,9,1,1,1,2,1,22
2,467,39,4,35,0,35,0,11,15,2,0,0,0,4,1,2
2,468,1638,305,1333,29,1304,9,333,236,125,33,17,4,73,20,454
2,469,348,41,307,4,303,3,89,84,22,3,1,0,32,11,58
2,470,319,64,255,5,250,2,65,75,31,3,0,0,14,8,52
2,471,86,9,77,2,75,3,22,20,7,2,0,0,2,2,17
2,472,366,78,288,6,282,5,69,54,39,8,2,0,18,7,80
2,473,141,19,122,1,121,0,33,23,15,0,2,0,7,2,39
2,474,273,33,240,2,238,2,56,46,33,4,2,1,17,4,73
2,475,253,41,212,4,208,3,42,53,16,5,0,0,28,5,56
2,476,477,97,380,7,373,2,141,67,30,4,0,2,16,1,110
2,477,694,110,584,4,580,4,121,188,34,8,3,4,56,14,148
2,478,180,18,162,3,159,3,39,14,24,6,2,0,19,1,51
2,479,48,5,43,1,42,0,10,13,3,0,0,2,1,6,7
2,480,248,43,205,4,201,2,48,43,20,4,2,0,4,6,72
2,481,359,28,331,3,328,4,62,146,23,4,1,0,28,4,56
2,482,40,5,35,0,35,0,11,2,5,2,2,0,4,0,9
2,483,412,49,363,1,362,5,96,109,26,3,3,2,21,6,91
2,484,348,56,292,11,281,3,68,59,40,4,3,2,26,8,68
2,485,73,15,58,1,57,1,15,15,4,0,0,0,11,2,9
2,486,61,9,52,3,49,0,10,11,9,0,0,0,1,5,13
2,487,504,63,441,4,437,5,137,114,36,10,2,0,26,11,96
2,488,121,30,91,1,90,1,38,27,9,1,0,0,2,0,12
2,489,240,36,204,2,202,9,56,29,31,7,2,0,21,2,45
2,490,116,17,99,2,97,6,21,33,7,1,2,0,3,2,22
2,491,280,42,238,3,235,1,67,78,7,7,0,0,8,6,61
2,492,339,40,299,4,295,5,90,44,22,3,2,0,10,2,117
2,493,151,16,135,0,135,1,34,40,4,3,1,0,9,0,43
2,494,111,15,96,1,95,0,21,32,3,0,1,1,4,3,30
2,495,761,164,597,8,589,3,176,149,51,2,5,2,49,14,138
2,496,77,14,63,1,62,1,10,14,4,1,1,0,6,3,22
2,497,826,111,715,12,703,8,168,174,72,11,4,2,61,11,192
2,498,502,106,396,3,393,4,106,104,32,2,3,0,36,11,95
2,499,41,9,32,2,30,2,3,12,0,0,0,0,3,0,10
2,500,629,107,522,6,516,9,121,105,44,6,3,1,42,7,178
2,501,68,13,55,0,55,0,14,8,9,4,0,0,5,1,14
2,502,1068,198,870,7,863,6,236,184,74,17,12,0,48,11,275
2,503,674,112,562,8,554,5,133,81,76,13,2,1,25,14,204
2,504,1154,220,934,12,922,4,262,94,130,11,2,0,37,10,372
2,505,152,21,131,0,131,12,50,40,1,0,1,0,7,0,20
2,506,171,23,148,1,147,6,22,50,12,2,2,2,11,1,39
2,507,33,4,29,0,29,1,6,9,2,1,0,0,1,3,6
2,508,97,8,89,0,89,0,21,33,12,1,0,0,0,1,21
2,509,124,22,102,1,101,1,36,34,12,1,1,0,4,2,10
2,510,110,18,92,1,91,3,23,23,10,1,2,1,5,3,20
2,511,215,31,184,7,177,1,56,56,12,2,3,0,8,3,36
2,512,192,38,154,4,150,8,52,42,14,2,0,0,9,2,21
2,513,127,15,112,2,110,4,25,29,12,3,1,0,3,0,33
2,514,544,76,468,6,462,13,155,64,50,5,1,2,34,10,128
2,515,62,16,46,0,46,0,15,7,6,0,0,0,5,1,12
2,516,51,4,47,4,43,0,16,8,4,0,0,0,7,3,5
2,517,226,23,203,6,197,2,63,47,10,1,2,0,8,1,63
2,518,217,38,179,4,175,5,60,48,11,1,2,0,14,8,26
2,519,141,10,131,1,130,2,26,37,14,2,1,1,20,2,25
2,520,467,78,389,9,380,3,152,79,36,7,2,0,22,6,73
2,521,851,114,737,18,719,8,197,195,55,8,7,2,56,26,165
2,522,49,10,39,0,39,0,13,17,0,1,0,0,3,0,5
2,523,64,2,62,1,61,0,19,12,4,1,0,0,10,3,12
2,524,513,84,429,10,419,4,117,106,43,3,1,0,40,5,100
2,525,485,61,424,9,415,3,123,108,36,4,4,1,30,8,98
2,526,76,23,53,0,53,1,11,14,4,1,0,0,8,3,11
2,527,313,48,265,1,264,1,93,73,17,2,5,1,19,6,47
2,528,183,15,168,8,160,3,52,42,15,2,5,2,9,3,27
2,529,164,19,145,2,143,4,41,44,5,1,2,1,5,1,39
2,530,67,12,55,1,54,0,16,11,0,0,0,1,3,3,20
2,531,101,14,87,2,85,1,21,20,10,0,0,0,7,2,24
2,532,744,119,625,4,621,9,170,141,73,5,8,2,31,18,164
2,533,100,16,84,1,83,1,27,30,6,2,0,0,4,1,12
2,534,37,2,35,0,35,2,5,12,1,0,1,0,5,0,9
2,535,114,14,100,2,98,0,16,51,4,0,4,0,9,0,14
2,536,69,8,61,4,57,2,7,17,7,2,0,0,4,2,16
2,537,127,20,107,4,103,0,23,33,5,0,3,0,9,5,25
2,538,60,6,54,1,53,0,24,17,1,0,1,0,2,1,7
2,539,542,76,466,7,459,1,101,78,132,7,2,2,22,6,108
2,540,873,130,743,12,731,12,171,180,78,7,9,4,50,24,196
2,541,292,49,243,5,238,5,66,81,16,1,4,0,13,6,46
2,542,71,8,63,4,59,0,18,16,7,0,2,0,3,2,11
2,543,1420,307,1113,16,1097,13,359,255,112,18,13,2,82,14,229
2,544,439,93,346,1,345,2,109,71,21,7,3,0,15,12,105
2,545,126,16,110,1,109,1,31,35,8,1,0,0,6,0,27
2,546,143,19,124,5,119,3,29,29,16,6,1,0,6,3,26
2,547,43,0,43,1,42,0,11,10,2,0,0,0,2,1,16
2,548,295,66,229,2,227,3,68,57,9,2,1,2,13,3,69
2,549,682,80,602,5,597,7,171,143,60,5,3,1,31,18,158
2,550,82,15,67,3,64,3,14,15,5,0,0,0,7,0,20
2,551,79,7,72,1,71,0,21,14,8,2,0,0,1,5,20
2,552,133,17,116,0,116,1,29,34,10,2,2,0,3,6,29
2,553,184,29,155,3,152,4,43,57,3,3,1,0,16,4,21
2,554,832,138,694,12,682,11,171,193,71,11,6,1,53,13,152
2,555,1446,343,1103,32,1071,11,303,250,107,15,10,3,82,22,268
2,556,70,10,60,0,60,1,17,18,3,1,0,0,8,0,12
2,557,101,20,81,1,80,1,25,16,3,0,0,0,8,0,27
2,558,1823,332,1491,41,1450,13,415,398,110,23,10,1,73,20,387
2,559,375,80,295,2,293,2,99,60,26,6,2,0,15,6,77
2,560,204,25,179,3,176,3,59,52,7,1,1,0,11,1,41
2,561,133,23,110,5,105,1,22,32,4,0,0,0,14,1,31
2,562,145,34,111,3,108,2,34,29,15,0,0,0,7,2,19
2,563,160,27,133,2,131,1,35,44,12,2,0,0,4,2,31
2,564,383,53,330,7,323,3,103,65,34,4,3,1,25,4,81
2,565,174,20,154,6,148,1,32,25,29,1,6,0,4,6,44
2,566,928,172,756,15,741,5,210,167,83,10,3,3,60,19,181
2,567,239,27,212,5,207,1,56,41,28,2,4,2,4,0,69
2,568,153,25,128,1,127,2,36,39,10,0,0,0,19,3,18
2,569,299,47,252,2,250,5,84,69,6,8,0,0,15,6,57
2,570,121,13,108,1,107,0,33,33,13,1,0,0,1,3,23
2,571,523,65,458,10,448,9,117,130,38,4,1,0,35,9,105
2,572,342,45,297,8,289,7,72,89,15,6,2,2,21,10,65
2,573,59,11,48,0,48,1,7,14,7,2,0,0,6,1,10
2,574,1099,215,884,12,872,11,237,247,89,13,7,2,61,22,183
2,575,1304,283,1021,20,1001,9,309,185,110,15,17,3,41,11,301
2,576,251,47,204,4,200,0,65,45,15,7,0,0,17,4,47
2,577,77,11,66,2,64,0,21,19,10,0,0,2,7,0,5
2,578,58,5,53,1,52,1,15,15,2,0,1,0,4,2,12
2,579,102,12,90,0,90,4,22,25,11,4,0,0,10,0,14
2,580,540,93,447,9,438,9,142,71,45,7,8,3,22,7,124
2,581,226,30,196,6,190,1,60,45,17,0,7,1,2,2,55
2,582,62,10,52,0,52,0,11,18,6,0,0,0,1,3,13
2,583,52,6,46,0,46,0,11,11,9,0,0,0,2,0,13
2,584,86,6,80,3,77,0,28,25,5,3,2,0,6,1,7
2,585,201,19,182,1,181,0,43,35,20,6,3,0,18,3,53
2,586,136,17,119,1,118,2,30,44,8,2,0,1,9,4,18
2,587,273,41,232,6,226,2,42,56,26,2,1,0,22,1,74
2,588,58,6,52,2,50,1,16,11,2,0,0,0,4,0,16
2,589,196,15,181,2,179,5,48,27,27,2,3,1,19,3,44
2,590,138,20,118,1,117,1,22,45,13,3,1,0,6,0,26
2,591,107,20,87,1,86,0,31,20,1,1,8,0,1,1,23
2,592,177,25,152,3,149,0,32,62,8,2,1,1,13,2,28
2,593,852,131,721,16,705,11,180,177,63,4,1,0,57,21,191
2,594,124,25,99,1,98,2,42,15,9,2,0,0,6,1,21
2,595,120,19,101,2,99,1,29,48,7,0,0,0,5,2,7
2,596,538,106,432,12,420,7,143,57,41,11,2,1,42,12,104
2,597,59,1,58,1,57,0,14,16,6,1,1,0,0,2,17
2,598,514,88,426,8,418,2,124,98,66,3,1,2,26,7,89
2,599,214,41,173,1,172,3,46,33,25,2,2,0,15,3,43
2,600,280,47,233,4,229,1,67,47,20,5,2,0,10,2,75
2,601,129,20,109,3,106,0,35,31,12,2,1,0,4,0,21
2,602,1197,238,959,13,946,6,238,168,122,18,10,0,52,19,313
2,604,55,9,46,0,46,0,14,15,5,0,0,1,3,1,7
2,605,151,24,127,1,126,1,48,34,6,2,3,0,7,4,21
2,606,75,16,59,0,59,1,17,22,3,0,0,1,6,1,8
2,607,56,7,49,0,49,0,13,18,2,1,1,0,2,1,11
2,608,334,55,279,4,275,1,98,87,22,1,1,1,12,6,46
2,609,27,2,25,0,25,1,2,18,0,1,0,0,1,0,2
2,610,450,52,398,3,395,5,81,135,27,4,0,2,20,2,119
2,612,99,20,79,0,79,0,31,15,12,0,0,1,0,1,19
2,613,389,42,347,4,343,3,87,95,33,2,2,0,35,8,78
2,614,203,24,179,7,172,4,41,45,14,1,1,0,17,0,49
2,615,276,29,247,1,246,7,53,52,31,4,0,2,23,4,70
2,616,140,26,114,3,111,2,25,34,11,2,0,0,6,1,30
2,617,385,46,339,4,335,2,102,40,31,6,6,2,18,5,123
2,618,519,104,415,15,400,3,112,115,21,5,1,1,30,19,93
2,619,310,66,244,3,241,3,57,48,29,8,0,0,15,11,70
2,620,276,57,219,5,214,1,83,49,19,2,0,0,13,5,42
2,621,318,48,270,2,268,4,59,83,16,6,1,0,21,7,71
2,622,44,5,39,0,39,5,15,11,4,0,0,0,2,1,1
2,623,89,6,83,1,82,0,20,19,13,3,1,0,6,4,16
2,624,232,50,182,1,181,0,63,36,13,4,0,0,13,3,49
2,625,129,18,111,3,108,0,34,28,4,2,0,0,6,0,34
2,626,347,79,268,3,265,3,66,68,19,4,2,0,16,7,80
2,627,88,16,72,1,71,0,17,25,7,1,0,0,5,1,15
2,628,181,30,151,0,151,2,35,45,14,1,0,1,14,3,36
2,629,222,29,193,3,190,1,57,74,8,1,3,0,9,0,37
2,631,290,46,244,1,243,1,90,53,25,2,5,0,9,8,50
2,632,56,5,51,1,50,1,10,21,5,0,1,0,6,0,6
2,633,52,9,43,0,43,3,10,11,5,1,1,0,2,0,10
2,634,53,5,48,1,47,2,14,18,0,3,0,0,2,0,8
2,635,129,19,110,0,110,5,36,21,16,0,2,0,5,1,24
2,636,158,16,142,2,140,1,44,43,13,0,2,0,6,7,24
2,637,258,28,230,2,228,2,48,70,15,6,1,0,20,3,63
2,638,196,25,171,4,167,3,42,28,15,2,2,2,12,5,56
2,639,265,44,221,3,218,2,56,64,14,5,3,2,20,4,48
2,640,131,24,107,1,106,3,14,38,11,5,0,1,2,2,30
2,641,102,15,87,2,85,0,23,22,6,5,3,0,11,1,14
2,642,142,26,116,5,111,0,47,33,1,1,0,0,8,2,19
2,643,590,77,513,4,509,7,134,137,59,6,8,3,27,8,120
2,644,286,34,252,11,241,3,67,84,9,2,2,1,14,4,55
2,645,151,31,120,2,118,2,28,25,14,0,0,0,6,3,40
2,646,42,8,34,0,34,0,15,7,1,2,0,0,1,2,6
2,647,55,12,43,1,42,0,10,14,5,0,0,0,4,2,7
2,648,1525,237,1288,14,1274,16,351,310,106,20,14,3,79,13,362
2,649,243,32,211,3,208,7,85,38,18,1,0,0,17,4,38
2,650,314,58,256,0,256,0,69,92,13,1,0,1,19,13,48
2,651,79,17,62,2,60,0,7,25,4,3,0,0,6,1,14
2,652,92,18,74,0,74,0,14,22,10,0,4,0,2,2,20
2,653,333,40,293,4,289,10,76,81,31,3,1,0,19,6,62
2,654,67,8,59,0,59,0,13,21,6,1,1,0,3,2,12
2,655,106,13,93,0,93,0,31,34,3,0,0,2,11,1,11
2,656,281,42,239,5,234,7,64,53,17,4,3,1,30,3,52
2,657,151,18,133,1,132,1,25,29,7,3,2,0,9,1,55
2,658,185,29,156,2,154,1,28,49,12,6,0,0,12,4,42
2,659,384,30,354,8,346,1,81,131,13,2,1,2,26,8,81
2,660,44,6,38,0,38,3,5,15,0,2,1,0,6,0,6
2,661,156,23,133,0,133,3,20,35,14,4,0,0,13,2,42
2,662,263,80,183,2,181,3,43,59,16,8,1,0,8,5,38
2,663,177,27,150,5,145,1,41,45,18,2,0,1,5,2,30
2,664,91,20,71,5,66,0,18,20,5,0,0,0,8,4,11
2,665,247,55,192,0,192,2,62,47,14,5,1,0,12,9,40
2,666,775,176,599,6,593,11,165,125,32,10,6,2,40,18,184
2,667,180,33,147,4,143,4,39,37,20,0,0,0,6,3,34
2,668,689,92,597,15,582,2,159,132,39,5,7,1,56,8,173
2,669,94,12,82,7,75,1,27,23,5,3,1,0,7,1,7
2,670,122,16,106,3,103,2,27,37,7,1,3,0,1,1,24
2,671,248,43,205,7,198,1,71,44,14,1,4,1,11,5,46
2,672,188,28,160,2,158,0,58,43,12,2,2,0,12,3,26
2,673,315,59,256,1,255,1,73,82,25,0,0,0,14,2,58
2,674,55,8,47,2,45,0,23,11,1,0,0,0,7,0,3
2,675,113,12,101,1,100,1,35,13,12,1,3,2,10,6,17
2,676,1320,300,1020,23,997,9,316,258,82,14,8,2,78,32,198
2,677,184,26,158,2,156,0,41,43,19,2,6,2,10,6,27
2,678,51,7,44,0,44,0,13,8,3,1,0,0,6,2,11
2,679,98,14,84,3,81,0,22,13,12,3,0,0,5,3,23
2,680,1491,296,1195,13,1182,18,264,273,167,16,11,3,59,29,342
2,681,216,41,175,5,170,4,28,56,15,2,0,0,8,4,53
2,682,93,20,73,3,70,0,13,21,7,1,0,0,3,1,24
2,683,90,13,77,2,75,0,27,16,4,0,1,0,6,1,20
2,684,2383,592,1791,18,1773,16,510,328,223,23,18,2,70,26,557
2,685,97,9,88,1,87,2,26,18,0,2,0,0,2,3,34
2,686,326,49,277,3,274,1,78,56,35,2,7,0,24,8,63
2,687,282,46,236,4,232,2,55,75,20,1,0,0,24,4,51
2,688,46,8,38,0,38,0,9,13,2,1,0,0,9,1,3
2,689,57,16,41,1,40,0,5,20,3,0,0,0,3,2,7
2,690,68,12,56,0,56,1,9,12,8,0,0,0,9,0,17
2,691,33673,7701,25972,422,25550,330,5714,6597,2473,247,184,60,1763,454,7728
2,693,171,26,145,0,145,2,29,56,12,5,2,0,10,1,28
2,694,459,84,375,5,370,3,97,87,35,4,1,0,20,4,119
2,695,50,9,41,1,40,2,4,8,6,0,0,0,4,2,14
2,696,62,12,50,2,48,4,6,8,10,1,0,0,1,1,17
2,697,282,31,251,4,247,2,60,49,26,3,2,0,16,4,85
2,698,88,14,74,1,73,1,23,19,2,1,2,0,3,3,19
2,699,234,32,202,2,200,2,68,41,16,1,2,0,12,7,51
2,701,471,85,386,7,379,3,104,105,38,2,2,1,28,4,92
2,702,472,69,403,8,395,3,117,86,38,2,2,1,39,12,95
2,703,752,125,627,17,610,1,174,120,75,9,6,0,36,6,183
2,704,174,30,144,2,142,0,58,32,12,1,0,0,9,3,27
2,705,164,26,138,2,136,0,45,40,12,2,1,0,10,7,19
2,706,413,43,370,3,367,7,117,75,41,6,3,1,18,7,92
2,707,148,38,110,2,108,4,20,24,21,1,1,0,6,1,30
2,708,180,21,159,3,156,5,32,46,8,0,0,0,13,6,46
2,709,293,53,240,2,238,3,75,61,18,3,7,0,14,5,52
2,710,561,76,485,9,476,0,146,94,41,6,6,4,19,16,144
2,711,219,24,195,0,195,3,50,62,15,2,2,0,13,4,44
2,712,120,18,102,2,100,4,34,25,10,1,4,0,9,0,13
2,713,228,24,204,2,202,1,57,51,16,2,3,0,15,2,55
2,714,224,33,191,4,187,2,70,42,17,3,1,2,7,6,37
2,715,38,4,34,0,34,2,2,5,10,0,0,0,6,0,9
2,716,215,34,181,1,180,2,40,55,17,1,0,0,13,2,50
2,717,494,97,397,7,390,3,99,93,46,6,1,1,17,4,120
2,718,123,23,100,0,100,5,19,34,9,0,3,0,3,2,25
2,719,1640,309,1331,21,1310,13,382,260,156,17,6,7,91,39,339
2,720,1281,217,1064,27,1037,12,262,245,93,26,16,2,70,22,289
2,721,364,49,315,5,310,5,86,104,21,1,0,2,14,6,71
2,722,17361,4888,12473,198,12275,146,2680,3355,1281,140,89,35,903,217,3429
2,723,86,19,67,0,67,1,15,32,4,3,0,0,5,1,6
2,724,44,6,38,1,37,1,4,15,6,0,0,0,4,0,7
2,725,112,10,102,4,98,0,33,37,7,0,0,0,5,1,15
2,726,129,15,114,1,113,1,37,30,8,0,2,0,3,3,29
2,727,179,36,143,2,141,0,46,36,8,4,3,0,9,1,34
2,728,217,25,192,3,189,4,59,47,15,3,0,3,9,3,46
2,729,78,11,67,0,67,0,17,28,7,0,0,0,2,1,12
2,730,207,28,179,5,174,3,47,40,20,3,2,0,14,7,38
2,731,128,20,108,3,105,0,32,23,7,1,2,0,10,1,29
2,732,75,8,67,1,66,0,28,22,4,0,0,0,2,2,8
2,733,213,29,184,2,182,7,48,40,25,4,4,0,12,3,39
2,734,203,35,168,5,163,1,36,61,16,5,1,1,4,3,35
2,735,17,0,17,0,17,0,4,6,2,0,0,0,1,0,4
2,736,119,17,102,1,101,5,23,30,4,0,3,0,9,3,24
2,737,466,78,388,7,381,3,71,85,53,4,2,0,18,6,139
2,738,10262,2556,7706,140,7566,58,1935,1111,1156,108,79,18,380,111,2610
2,739,230,33,197,2,195,1,70,52,10,5,2,0,14,6,35
2,740,218,31,187,6,181,2,50,64,16,2,4,1,7,6,29
2,741,411,71,340,3,337,2,90,49,47,2,3,0,13,7,124
2,742,85,20,65,0,65,4,14,17,4,1,0,0,1,2,22
2,743,115,8,107,0,107,0,27,37,0,0,4,0,4,0,35
2,744,67,10,57,2,55,0,20,16,5,0,0,0,1,0,13
2,745,104,23,81,2,79,0,7,27,10,1,1,0,2,0,31
2,746,521,100,421,10,411,3,115,100,56,4,5,2,29,6,91
2,747,62,6,56,0,56,3,13,18,0,0,0,0,2,1,19
2,748,755,121,634,10,624,9,171,207,60,6,4,0,56,13,98
2,749,163,20,143,2,141,2,41,33,21,4,2,0,10,2,26
2,750,428,76,352,7,345,4,98,86,31,2,1,0,27,8,88
2,751,120,12,108,2,106,0,35,13,15,0,2,1,4,4,32
2,752,222,32,190,2,188,3,34,50,25,1,4,0,15,6,50
2,753,262,41,221,2,219,1,45,42,28,8,1,0,4,1,89
2,754,138,14,124,3,121,1,35,41,9,1,2,0,8,0,24
2,755,394,43,351,7,344,6,80,79,26,1,2,1,21,4,124
2,756,482,68,414,4,410,3,83,126,35,4,3,0,41,15,100
2,757,417,46,371,3,368,4,101,64,40,4,4,1,20,3,127
2,758,1480,282,1198,15,1183,5,304,301,112,16,11,2,92,32,308
2,759,219,32,187,6,181,1,54,40,12,4,1,0,24,3,42
2,760,135,20,115,5,110,0,40,34,9,0,0,0,8,3,16
2,761,122,16,106,0,106,1,24,27,7,0,2,0,17,2,26
2,762,112,19,93,6,87,6,26,10,11,2,2,0,7,1,22
2,763,147,24,123,1,122,2,53,23,7,1,0,0,10,0,26
2,764,57,6,51,0,51,1,6,11,2,0,0,0,7,3,21
2,765,193,19,174,4,170,5,46,40,11,2,0,1,15,3,47
2,766,183,37,146,1,145,2,50,17,20,3,4,1,7,2,39
2,767,275,54,221,5,216,3,57,52,21,2,1,2,21,6,51
2,768,329,51,278,2,276,2,78,47,43,0,3,0,24,7,72
2,769,642,106,536,12,524,4,155,109,55,8,7,4,26,17,139
2,770,646,79,567,3,564,6,167,163,51,4,3,2,42,7,119
2,771,66,5,61,2,59,1,17,8,9,2,0,0,4,1,17
2,772,97,6,91,1,90,0,29,30,5,0,0,0,4,0,22
2,773,40,6,34,0,34,0,10,9,3,1,0,1,2,0,8
2,774,88,19,69,0,69,1,19,22,3,0,0,0,3,0,21
2,775,695,103,592,11,581,3,157,130,58,6,3,1,44,20,159
2,776,406,80,326,5,321,3,89,81,39,3,3,1,23,3,76
2,777,129,26,103,0,103,3,21,42,6,1,0,0,11,3,16
2,778,102,10,92,0,92,6,26,24,5,0,0,0,3,1,27
2,779,173,28,145,3,142,0,52,31,5,4,3,0,5,3,39
2,780,897,193,704,13,691,10,198,168,64,6,4,2,47,10,182
2,781,322,42,280,8,272,6,77,53,23,5,2,1,32,6,67
2,782,160,12,148,1,147,0,46,28,15,2,1,0,8,0,47
2,783,103,19,84,1,83,0,21,14,0,2,2,0,11,2,31
2,784,134,19,115,1,114,1,51,20,4,1,0,0,5,6,26
2,785,807,97,710,13,697,11,174,189,60,5,7,3,50,12,186
2,786,118,20,98,2,96,1,31,26,8,3,2,0,7,1,17
2,787,177,20,157,4,153,5,45,24,18,1,3,1,8,4,44
2,788,301,56,245,3,242,0,75,59,16,3,1,0,13,7,68
2,789,1737,363,1374,33,1341,13,335,274,128,14,12,5,69,17,474
2,790,185,14,171,2,169,7,45,30,27,4,1,0,20,6,29
2,791,207,36,171,4,167,2,31,27,31,3,0,0,7,6,60
2,792,123,23,100,1,99,1,31,24,13,0,0,0,14,3,13
2,793,100,15,85,1,84,0,29,24,7,0,0,0,9,1,14
2,794,137,13,124,4,120,5,24,41,6,4,0,0,13,2,25
2,795,1181,208,973,8,965,5,282,223,92,9,5,2,69,16,262
2,796,73,8,65,0,65,0,19,17,9,0,0,0,6,0,14
2,797,116,13,103,0,103,1,25,20,7,0,0,0,3,0,47
2,798,705,177,528,12,516,10,137,160,58,9,3,1,41,12,85
2,799,271,44,227,3,224,0,95,34,18,1,0,0,8,3,65
2,800,199,20,179,3,176,3,59,48,19,1,0,0,17,4,25
2,801,217,34,183,6,177,4,43,66,12,4,2,0,4,4,38
2,802,147,20,127,4,123,0,43,35,8,1,2,0,6,1,27
2,803,89,7,82,0,82,1,30,13,8,3,1,0,3,2,21
2,804,160,34,126,1,125,2,42,38,7,2,1,1,7,0,25
2,805,1651,316,1335,23,1312,12,375,255,147,17,12,2,83,18,391
2,806,197,20,177,2,175,2,49,38,20,4,2,0,12,7,41
2,807,516,74,442,6,436,10,121,125,34,10,4,2,31,10,89
2,808,229,43,186,2,184,0,70,31,20,0,1,0,7,0,55
2,809,74,11,63,1,62,3,9,25,2,1,0,3,3,2,14
2,810,6718,1576,5142,103,5039,63,1328,1188,561,70,51,10,303,98,1367
2,811,112,23,89,1,88,1,28,23,5,1,0,0,4,2,24
2,812,145,18,127,4,123,2,32,35,9,2,0,0,13,4,26
2,813,167,20,147,1,146,0,40,43,10,2,4,2,8,3,34
2,814,157,14,143,1,142,1,23,48,11,2,0,0,17,8,32
2,815,379,73,306,5,301,3,72,68,39,5,1,0,18,10,85
2,816,326,36,290,2,288,2,77,63,29,6,5,1,20,4,81
2,817,49,5,44,0,44,0,11,14,1,2,0,0,1,1,14
2,818,582,95,487,5,482,8,142,124,43,5,1,2,45,6,106
2,819,97,22,75,0,75,2,18,22,7,0,0,0,3,1,22
2,820,1459,232,1227,27,1200,2,355,246,127,24,8,4,98,23,313
2,821,514,81,433,2,431,6,95,129,38,3,4,0,48,7,101
2,822,300,51,249,6,243,5,72,70,23,6,3,3,13,6,42
2,823,61,9,52,1,51,1,12,26,0,0,0,0,3,2,7
2,824,315,27,288,2,286,7,64,96,14,4,1,0,32,7,61
2,826,311,37,274,6,268,0,69,71,30,5,5,1,9,9,69
2,827,238,29,209,1,208,1,46,53,22,5,3,0,13,5,60
2,828,72,8,64,3,61,2,17,13,4,0,1,0,11,1,12
2,829,26,3,23,3,20,1,3,8,0,0,0,0,4,0,4
2,830,674,155,519,5,514,2,144,115,59,5,3,4,36,7,139
2,831,285,41,244,1,243,3,72,53,21,4,0,0,15,6,69
2,832,173,38,135,6,129,0,28,39,9,1,0,1,7,2,42
2,833,349,73,276,5,271,4,65,100,21,2,1,1,20,6,51
2,834,122,16,106,4,102,0,22,25,21,1,0,1,7,2,23
3,1,2010,318,1692,38,1654,17,389,449,151,17,7,3,144,42,435
3,2,248,25,223,6,217,14,29,46,54,2,0,0,17,1,54
3,3,825,139,686,23,663,14,129,180,90,5,2,2,52,20,169
3,4,225,49,176,4,172,0,32,60,17,2,5,0,20,3,33
3,5,227,29,198,7,191,10,39,34,21,3,1,1,19,5,58
3,6,601,140,461,6,455,9,82,67,77,9,2,0,36,12,161
3,7,284,46,238,8,230,6,40,58,27,4,0,2,28,1,64
3,8,308,39,269,2,267,8,49,68,30,8,1,0,35,9,59
3,9,89,18,71,1,70,2,15,12,7,2,0,0,9,0,23
3,10,351,34,317,7,310,2,81,57,41,4,3,0,17,8,97
3,11,279,42,237,2,235,4,48,74,30,2,3,0,19,10,45
3,12,246,23,223,2,221,16,34,33,55,2,2,0,17,2,60
3,13,2975,407,2568,56,2512,21,430,533,299,41,15,1,205,56,911
3,14,133,21,112,1,111,0,6,31,12,2,0,0,12,8,40
3,15,233,40,193,3,190,3,28,52,33,4,1,0,22,6,41
3,16,115,15,100,4,96,3,12,29,17,5,0,0,4,6,20
3,17,166,27,139,3,136,3,33,32,7,0,2,0,21,3,35
3,18,481,53,428,13,415,8,127,87,53,8,2,1,34,7,88
3,19,1362,249,1113,40,1073,8,186,228,198,18,6,3,82,19,325
3,20,236,32,204,3,201,7,36,42,40,2,3,1,16,3,51
3,21,199,31,168,1,167,2,35,34,22,1,1,0,18,6,48
3,22,826,136,690,20,670,14,134,134,119,8,11,3,45,8,194
3,23,6019,936,5083,97,4986,95,825,1632,398,45,26,11,445,100,1409
3,24,210,24,186,4,182,1,55,30,13,3,3,0,23,6,48
3,25,1064,153,911,18,893,10,168,201,127,6,6,2,50,25,298
3,26,650,86,564,8,556,15,84,154,80,3,1,0,64,18,137
3,27,640,109,531,11,520,5,107,95,96,9,4,0,30,13,161
3,28,292,34,258,6,252,3,71,37,45,4,3,0,11,6,72
3,29,663,106,557,11,546,7,108,99,83,11,2,0,43,12,181
3,30,626,93,533,11,522,13,119,116,47,4,5,2,67,5,144
3,31,238,36,202,3,199,4,28,64,16,2,1,0,35,1,48
3,32,178,22,156,5,151,5,36,39,27,1,3,0,7,5,28
3,33,140,22,118,4,114,5,16,17,16,4,1,1,15,3,36
3,34,397,67,330,14,316,4,87,53,36,5,3,1,27,11,89
3,35,174,28,146,1,145,1,22,47,14,2,2,2,11,3,41
3,36,1899,283,1616,38,1578,67,208,355,342,16,7,2,118,35,428
3,37,199,36,163,2,161,3,46,29,20,3,0,1,21,6,32
3,38,397,62,335,11,324,9,56,63,39,7,6,1,30,11,102
3,39,295,48,247,6,241,3,57,57,30,1,0,0,17,5,71
3,40,885,81,804,18,786,10,112,187,102,3,2,6,76,10,278
3,41,292,44,248,4,244,5,63,55,36,0,2,0,28,4,51
3,42,462,76,386,9,377,5,102,88,29,4,7,2,33,6,101
3,43,879,136,743,23,720,11,166,162,69,17,8,1,83,9,194
3,44,1123,140,983,25,958,13,217,238,100,8,4,2,105,20,251
3,45,692,112,580,16,564,4,116,170,58,5,0,2,61,6,142
3,46,831,121,710,15,695,12,136,101,184,6,4,4,48,12,188
3,47,366,73,293,8,285,3,76,59,48,7,1,3,16,1,71
3,48,1136,203,933,22,911,20,130,225,186,8,10,3,74,16,239
3,49,313,46,267,9,258,6,62,53,30,3,1,0,25,8,70
3,50,189,35,154,1,153,5,35,36,28,1,0,0,24,3,21
3,51,239,51,188,3,185,3,43,23,26,2,1,0,19,1,67
3,52,748,98,650,15,635,5,125,128,101,8,3,0,48,17,200
3,53,817,129,688,17,671,7,125,193,81,7,5,2,64,8,179
3,54,179,32,147,2,145,0,29,47,13,0,2,0,6,1,47
3,55,785,126,659,15,644,7,133,123,101,17,8,0,46,17,192
3,56,348,61,287,6,281,5,57,51,41,0,1,0,36,6,84
3,57,184,26,158,1,157,0,26,43,13,5,0,1,16,2,51
3,58,163,28,135,5,130,3,19,25,40,0,2,0,10,4,27
3,59,268,33,235,14,221,5,42,65,21,3,6,0,21,6,52
3,60,578,67,511,12,499,7,114,160,30,5,5,0,38,11,129
3,61,285,51,234,4,230,2,49,56,33,1,2,0,19,6,62
3,62,313,48,265,5,260,6,50,82,24,3,1,1,20,10,63
3,63,708,87,621,12,609,1,167,100,58,6,8,2,43,19,205
3,64,148,16,132,2,130,2,38,23,24,4,2,0,10,5,22
3,65,424,64,360,12,348,4,60,73,54,8,3,1,31,4,110
3,66,349,81,268,4,264,5,51,64,50,1,1,1,21,3,67
3,67,138,10,128,5,123,2,20,41,12,1,2,0,10,3,32
3,68,121,27,94,0,94,2,28,16,12,1,0,0,10,6,19
3,69,221,26,195,8,187,9,25,38,60,1,3,0,12,1,38
3,70,118,21,97,6,91,0,18,22,16,0,0,1,10,3,21
3,71,194,41,153,1,152,1,26,38,22,2,0,0,11,4,48
3,72,361,44,317,9,308,5,46,62,62,7,4,1,10,9,102
3,73,474,61,413,10,403,6,67,95,67,7,1,0,28,9,123
3,74,540,87,453,12,441,3,73,113,49,4,2,1,52,4,140
3,75,127,16,111,3,108,1,19,24,21,3,1,0,10,3,26
3,76,155,25,130,4,126,4,26,43,7,1,2,1,17,4,21
3,77,104,20,84,2,82,0,22,16,15,3,1,1,5,2,17
3,78,219,33,186,8,178,5,28,46,25,4,0,1,19,4,46
3,79,252,43,209,6,203,6,45,50,23,3,2,0,17,6,51
3,80,495,47,448,10,438,7,98,114,61,13,3,0,36,8,98
3,81,263,37,226,8,218,4,34,38,34,5,4,0,17,8,74
3,82,4869,937,3932,96,3836,38,585,680,671,53,38,9,260,59,1443
3,83,544,63,481,10,471,6,111,112,63,6,2,0,36,13,122
3,84,1677,246,1431,43,1388,18,196,300,279,25,7,2,119,25,417
3,85,520,62,458,11,447,12,88,103,65,4,4,0,36,10,125
3,86,263,54,209,6,203,0,45,50,27,1,1,0,15,3,61
3,87,457,86,371,8,363,2,95,68,67,2,2,2,15,6,104
3,88,262,45,217,8,209,2,58,43,29,2,2,0,11,5,57
3,89,108,14,94,2,92,2,15,26,16,2,0,0,7,1,23
3,90,238,48,190,6,184,1,35,42,30,2,0,0,20,6,48
3,91,341,58,283,9,274,0,66,52,40,7,2,1,16,4,86
3,92,562,65,497,9,488,10,97,115,88,6,2,1,50,13,106
3,93,754,92,662,21,641,15,147,123,80,7,4,1,79,13,172
3,94,2814,393,2421,50,2371,41,459,666,252,24,12,6,243,58,610
3,95,8798,1398,7400,187,7213,116,1423,1716,903,74,46,17,599,117,2202
3,96,87,13,74,3,71,1,13,21,10,1,0,0,4,1,20
3,97,250,28,222,8,214,4,32,42,41,4,1,0,19,1,70
3,98,3616,606,3010,65,2945,39,464,535,515,36,22,3,250,48,1033
3,99,325,46,279,7,272,4,44,83,40,4,0,2,32,9,54
3,100,1102,214,888,18,870,7,153,204,82,10,6,2,62,20,324
3,101,7119,1070,6049,156,5893,51,1033,1099,1009,65,33,13,420,105,2065
3,102,2433,492,1941,58,1883,26,312,458,225,26,19,5,162,28,622
3,103,795,118,677,16,661,4,125,162,52,3,7,0,62,15,231
3,104,924,143,781,18,763,2,175,135,147,10,6,3,79,7,199
3,105,290,43,247,7,240,5,70,57,15,2,1,1,28,6,55
3,106,952,143,809,16,793,17,135,164,130,17,9,1,73,15,232
3,107,894,144,750,16,734,11,122,248,82,8,7,1,65,21,169
3,108,256,35,221,3,218,10,40,48,32,5,2,0,12,4,65
3,109,542,72,470,13,457,8,95,110,70,4,2,0,28,10,130
3,110,672,80,592,21,571,6,133,121,70,4,2,2,60,8,165
3,111,866,91,775,20,755,5,146,168,114,12,3,2,61,11,233
3,112,519,92,427,13,414,5,78,101,36,5,7,2,35,10,135
3,113,444,78,366,14,352,8,73,81,35,5,3,1,40,9,97
3,114,228,23,205,2,203,1,46,48,17,4,2,2,16,9,58
3,115,268,39,229,6,223,4,43,64,24,5,4,1,29,5,44
3,116,189,34,155,4,151,4,27,43,12,4,2,0,14,4,41
3,117,351,43,308,8,300,12,47,62,63,3,3,0,20,5,85
3,118,4260,923,3337,74,3263,47,596,787,384,42,26,7,276,59,1039
3,119,352,60,292,6,286,3,56,98,24,1,3,0,31,6,64
3,120,540,63,477,10,467,9,98,123,34,9,4,1,39,4,146
3,121,496,59,437,8,429,7,73,109,51,2,2,0,32,8,145
3,122,175,20,155,3,152,7,27,29,22,0,0,0,23,8,36
3,123,214,29,185,6,179,2,45,31,28,3,1,0,14,2,53
3,124,191,36,155,5,150,4,41,38,10,3,0,0,20,4,30
3,125,139,35,104,7,97,3,30,23,14,0,1,0,7,3,16
3,126,822,106,716,16,700,9,154,149,79,15,4,3,60,21,206
3,127,480,63,417,9,408,8,64,109,61,5,4,0,43,5,109
3,128,2043,279,1764,34,1730,29,321,270,271,20,22,1,143,28,625
3,129,290,29,261,4,257,5,46,44,48,2,5,1,18,5,83
3,130,230,36,194,1,193,3,31,53,38,4,2,0,20,0,42
3,131,392,64,328,5,323,2,80,102,30,6,1,1,30,7,64
3,132,534,100,434,20,414,5,70,115,43,6,2,1,35,4,133
3,133,429,58,371,9,362,7,58,97,58,6,3,0,33,6,94
3,134,162,20,142,4,138,4,24,29,23,4,4,0,16,2,32
3,135,283,57,226,5,221,2,39,52,26,1,2,0,13,3,83
3,136,123,26,97,0,97,3,18,16,21,0,0,0,8,1,30
3,137,185,26,159,2,157,0,34,29,30,4,3,0,12,3,42
3,138,2229,382,1847,66,1781,23,345,474,184,25,18,3,170,45,494
3,139,310,56,254,6,248,5,84,44,25,3,7,1,24,9,46
3,140,892,95,797,28,769,13,120,163,131,8,3,1,53,21,256
3,141,202,30,172,9,163,3,33,43,14,3,2,0,31,0,34
3,142,247,51,196,8,188,0,62,47,8,2,3,0,8,6,52
3,143,104,23,81,3,78,1,21,13,10,3,2,1,6,5,16
3,144,200,37,163,3,160,0,33,45,13,2,1,0,11,7,48
3,145,599,89,510,14,496,19,105,73,81,7,4,2,44,6,155
3,146,123,25,98,0,98,2,9,30,17,3,0,0,9,5,23
3,147,150,30,120,3,117,2,24,34,13,1,3,0,15,3,22
3,148,278,40,238,4,234,0,85,54,25,5,0,0,13,3,49
3,149,380,51,329,6,323,6,41,88,44,8,1,0,25,8,102
3,150,198,25,173,1,172,5,38,24,45,1,0,0,16,6,37
3,151,155,33,122,4,118,2,22,19,25,1,0,0,19,3,27
3,152,227,55,172,5,167,2,27,39,11,2,1,0,9,2,74
3,153,211,31,180,6,174,0,25,29,30,4,1,1,31,4,49
3,154,229,40,189,7,182,0,37,44,29,5,2,0,27,2,36
3,155,1506,252,1254,30,1224,13,270,337,142,20,12,1,90,24,315
3,156,1218,154,1064,25,1039,17,185,234,126,10,8,0,91,27,341
3,157,585,66,519,13,506,10,139,99,46,8,9,1,48,8,138
3,158,250,42,208,6,202,8,45,32,49,3,1,1,15,2,46
3,159,580,94,486,4,482,7,105,55,74,4,4,0,38,7,188
3,160,258,24,234,3,231,4,55,73,28,1,0,1,17,1,51
3,161,724,101,623,29,594,13,90,204,54,6,6,2,63,13,143
3,162,167,15,152,5,147,9,17,35,23,0,0,2,25,3,33
3,163,557,66,491,11,480,6,116,77,73,8,7,1,36,6,150
3,164,202,16,186,2,184,2,48,65,14,4,1,0,17,1,32
3,165,1089,178,911,27,884,22,173,222,88,24,5,2,83,19,246
3,166,243,23,220,3,217,4,39,41,28,2,1,0,36,2,64
3,167,248,42,206,8,198,2,41,55,21,2,2,2,24,10,39
3,168,644,88,556,9,547,8,137,150,66,7,3,2,31,10,133
3,169,229,28,201,4,197,5,35,55,37,2,3,1,15,9,35
3,170,118,16,102,1,101,3,8,26,12,1,0,0,14,1,36
3,171,194,39,155,12,143,1,22,28,33,2,2,0,10,4,41
3,172,127,32,95,3,92,1,23,18,9,1,0,0,12,4,24
3,173,926,145,781,19,762,5,149,196,86,9,9,1,64,16,227
3,174,699,73,626,16,610,17,126,156,72,8,6,2,75,10,138
3,175,240,38,202,6,196,2,45,36,21,3,5,1,24,7,52
3,176,420,47,373,14,359,10,78,86,56,11,4,1,24,5,84
3,177,251,67,184,3,181,4,36,29,30,0,3,0,13,4,62
3,178,258,39,219,4,215,0,35,48,30,6,3,0,22,9,62
3,179,289,47,242,6,236,4,34,80,25,1,1,0,23,9,59
3,180,489,53,436,7,429,3,101,87,58,5,2,1,37,16,119
3,181,273,51,222,6,216,1,48,33,28,6,2,0,22,5,71
3,182,205,20,185,4,181,6,41,59,17,2,2,0,14,0,40
3,183,338,56,282,7,275,3,44,73,46,8,4,1,19,4,73
3,184,404,49,355,2,353,1,78,76,51,8,2,0,39,8,90
3,185,26429,6994,19435,450,18985,261,2733,4610,2943,240,127,45,1453,295,6278
3,186,1029,163,866,21,845,5,158,195,145,17,11,2,84,13,215
3,187,372,53,319,12,307,6,89,37,45,8,2,2,22,10,86
3,188,196,43,153,2,151,2,29,43,22,5,2,0,11,6,31
3,189,579,93,486,8,478,13,94,92,86,9,3,1,32,12,136
3,190,13530,3599,9931,192,9739,166,1566,2476,1162,87,55,22,833,177,3195
3,191,214,43,171,3,168,2,31,28,43,5,1,1,20,2,35
3,192,93,16,77,1,76,2,20,11,16,2,0,2,5,0,18
3,193,128,12,116,1,115,1,22,22,10,2,1,1,16,1,39
3,194,108,25,83,3,80,0,14,19,7,2,0,0,15,1,22
3,195,2054,307,1747,34,1713,29,233,493,219,18,8,4,192,34,483
3,196,208,31,177,1,176,0,32,38,30,1,2,0,22,2,49
3,197,1149,172,977,30,947,10,155,224,146,10,9,4,78,19,292
3,198,129,18,111,1,110,0,35,22,20,1,1,0,8,1,22
3,200,1257,133,1124,26,1098,20,150,271,153,6,4,2,111,16,365
3,201,243,49,194,2,192,10,51,43,13,0,0,0,24,4,47
3,202,468,92,376,8,368,12,64,82,59,8,3,2,25,4,109
3,203,313,51,262,9,253,3,76,44,28,5,3,0,14,7,73
3,204,479,69,410,14,396,1,84,100,52,4,1,1,44,9,100
3,205,369,62,307,7,300,2,74,57,42,2,5,0,24,6,88
3,206,153,13,140,5,135,4,21,33,14,1,1,1,19,1,40
3,207,398,56,342,10,332,4,77,57,43,2,3,0,38,7,101
3,208,291,59,232,8,224,0,53,46,26,5,2,1,20,5,66
3,209,126,17,109,1,108,0,23,24,14,1,0,0,12,3,31
3,210,333,45,288,8,280,7,46,63,84,2,3,0,19,7,49
3,211,1870,286,1584,30,1554,21,259,357,210,6,9,4,119,29,540
3,212,1075,140,935,21,914,16,177,214,104,10,10,0,81,19,283
3,213,211,24,187,10,177,3,33,44,35,3,0,0,14,6,39
3,214,226,23,203,7,196,5,50,26,52,3,1,1,14,5,39
3,215,460,50,410,11,399,3,94,98,42,7,7,1,28,6,113
3,216,160,20,140,1,139,2,21,28,16,4,2,0,24,3,39
3,217,619,90,529,26,503,7,86,118,64,12,1,0,62,10,143
3,218,235,34,201,8,193,16,28,53,42,3,2,0,14,6,29
3,219,191,32,159,0,159,3,24,51,27,1,0,0,16,3,34
3,220,503,73,430,18,412,6,75,128,46,13,7,2,31,15,89
3,221,550,81,469,11,458,8,101,148,54,3,4,0,27,13,100
3,222,70,11,59,0,59,2,10,13,7,1,0,0,8,1,17
3,223,363,43,320,9,311,2,69,80,33,8,0,0,25,11,83
3,224,320,53,267,7,260,9,40,62,21,12,0,1,31,9,75
3,225,374,74,300,7,293,6,57,62,55,7,2,4,38,9,53
3,226,201,27,174,12,162,1,41,33,23,1,3,1,10,2,47
3,227,279,29,250,6,244,3,65,63,21,6,3,1,27,5,50
3,228,50,1,49,0,49,0,19,13,2,0,0,0,6,0,9
3,229,498,92,406,14,392,4,104,86,45,12,3,0,30,8,100
3,230,358,40,318,6,312,3,76,64,42,1,6,0,29,8,83
3,231,179,27,152,3,149,0,19,51,8,1,0,0,22,2,46
3,232,246,29,217,7,210,2,31,39,45,0,3,3,13,6,68
3,233,269,43,226,8,218,6,62,34,31,2,2,0,21,2,58
3,234,325,51,274,11,263,2,52,64,21,3,1,1,26,9,84
3,235,720,117,603,20,583,6,134,136,76,5,8,1,46,12,159
3,236,2580,414,2166,44,2122,38,433,469,268,38,19,6,147,44,660
3,237,343,38,305,9,296,10,58,58,47,3,3,1,32,8,76
3,238,398,65,333,21,312,5,54,67,71,6,3,0,22,5,79
3,239,230,39,191,6,185,4,27,37,35,2,1,0,14,3,62
3,240,515,100,415,16,399,6,79,94,58,2,1,0,26,3,130
3,241,284,39,245,5,240,3,44,50,47,3,0,0,16,3,74
3,242,469,55,414,8,406,2,103,79,52,0,2,0,34,6,128
3,243,128,5,123,0,123,1,20,27,27,0,0,0,18,9,21
3,244,152,27,125,5,120,1,22,43,8,0,1,0,14,3,28
3,245,113,20,93,2,91,1,10,41,3,2,0,0,7,0,27
3,246,462,81,381,14,367,4,87,80,51,5,3,1,36,6,94
3,247,770,111,659,17,642,44,88,77,160,9,6,2,63,10,183
3,248,169,22,147,1,146,6,41,23,15,5,0,0,17,4,35
3,249,163,30,133,2,131,0,24,24,27,0,0,0,10,3,43
3,250,306,40,266,11,255,6,45,64,26,2,1,0,29,8,74
3,251,287,31,256,7,249,18,39,49,58,5,1,0,19,9,51
3,252,450,70,380,10,370,10,77,96,33,6,4,2,38,10,94
3,253,338,55,283,12,271,1,65,71,27,3,0,0,26,3,75
3,254,3794,741,3053,73,2980,43,560,802,334,54,27,11,240,55,854
3,255,126,16,110,1,109,2,22,26,10,2,0,0,9,4,34
3,256,185,28,157,3,154,0,29,42,28,3,3,0,17,2,30
3,257,630,93,537,15,522,9,130,110,37,8,5,0,50,13,160
3,258,1302,198,1104,35,1069,18,293,276,115,6,5,2,96,22,236
3,259,294,62,232,8,224,2,56,33,42,4,2,0,27,3,55
3,260,174,20,154,3,151,1,28,30,40,3,2,0,10,4,33
3,261,162,16,146,2,144,1,22,31,25,3,1,1,15,5,40
3,262,1617,163,1454,43,1411,11,276,347,197,18,11,3,98,27,423
3,263,145,44,101,5,96,2,17,22,9,4,4,1,9,5,23
3,264,2105,355,1750,45,1705,19,347,329,275,21,18,1,126,26,543
3,265,605,108,497,14,483,3,113,117,54,7,7,1,32,10,139
3,266,187,19,168,3,165,1,47,31,14,3,2,3,10,4,50
3,267,532,59,473,9,464,9,100,113,60,2,10,5,39,14,112
3,268,282,37,245,6,239,1,58,51,29,5,1,0,34,6,54
3,269,82,10,72,1,71,0,17,30,8,1,0,0,2,0,13
3,270,126,9,117,2,115,1,30,22,23,1,1,2,20,0,15
3,271,592,65,527,9,518,10,116,146,48,0,2,0,42,11,143
3,272,208,38,170,8,162,3,32,34,22,3,0,1,14,0,53
3,273,393,36,357,14,343,5,82,58,38,5,1,1,31,4,118
3,274,251,49,202,7,195,4,35,41,29,5,2,1,28,4,46
3,275,1427,227,1200,25,1175,19,231,258,184,18,12,5,114,26,308
3,276,94,8,86,1,85,3,9,18,18,2,1,0,12,1,21
3,277,224,32,192,0,192,3,26,66,31,0,1,0,22,1,42
3,278,184,36,148,7,141,4,12,58,18,2,0,0,7,4,36
3,279,427,37,390,8,382,6,90,87,60,3,10,0,26,11,89
3,280,184,24,160,6,154,4,23,33,28,2,1,0,10,5,48
3,281,326,43,283,6,277,4,38,81,52,3,4,0,31,6,58
3,282,317,32,285,6,279,7,23,65,69,4,1,0,27,9,74
3,283,839,159,680,22,658,9,114,146,73,9,5,1,60,12,229
3,284,259,41,218,9,209,1,44,50,35,1,2,2,11,8,55
3,285,151,18,133,6,127,8,21,32,18,7,0,0,12,4,25
3,286,895,98,797,22,775,3,124,220,77,10,3,0,82,24,232
3,287,307,59,248,10,238,2,54,57,38,3,2,0,22,3,57
3,288,409,108,301,9,292,4,55,55,49,2,3,1,35,2,86
3,289,392,49,343,9,334,3,95,72,38,4,4,0,27,15,76
3,290,1193,120,1073,15,1058,14,161,205,142,16,3,3,120,22,372
3,291,318,50,268,9,259,3,55,84,38,4,2,1,19,2,51
3,292,683,110,573,13,560,3,68,86,188,4,4,0,48,5,154
3,293,230,32,198,1,197,3,56,42,15,6,1,0,22,3,49
3,294,143,24,119,4,115,1,25,29,15,3,2,0,13,2,25
3,295,69,11,58,0,58,1,9,12,2,1,0,0,13,0,20
3,296,308,43,265,6,259,2,59,63,39,2,3,0,16,5,70
3,297,1271,205,1066,35,1031,18,199,214,118,12,6,3,83,27,351
3,298,2755,453,2302,43,2259,15,496,521,265,34,19,5,175,57,672
3,299,195,28,167,4,163,2,41,36,19,2,0,0,17,5,41
3,300,419,59,360,10,350,10,70,58,29,5,4,3,28,9,134
3,301,793,93,700,16,684,9,154,106,123,9,4,1,66,12,200
3,302,53,11,42,1,41,0,8,17,3,0,0,0,2,3,8
3,303,180,17,163,2,161,11,23,27,39,1,3,2,22,6,27
3,304,1810,240,1570,47,1523,27,334,451,138,18,6,1,118,28,402
3,305,436,51,385,13,372,4,63,74,64,4,6,2,38,5,112
3,306,1398,142,1256,30,1226,15,231,295,161,14,4,9,130,30,337
3,307,211,20,191,3,188,3,19,36,37,1,1,0,16,3,72
3,308,130,15,115,2,113,1,14,19,27,4,0,0,13,7,28
3,309,425,102,323,6,317,1,55,84,60,5,1,0,17,9,85
3,310,17600,4190,13410,241,13169,236,2255,4559,1095,124,60,29,1237,262,3312
3,311,289,45,244,7,237,8,36,71,44,2,3,1,25,2,45
3,312,205,31,174,3,171,6,9,34,57,1,1,0,11,1,51
3,313,221,25,196,4,192,7,37,52,44,6,0,0,18,5,23
3,314,933,107,826,21,805,7,163,174,106,11,5,1,109,21,208
3,315,960,158,802,19,783,3,158,179,138,10,4,3,71,15,202
3,316,709,119,590,10,580,4,112,145,87,12,4,3,47,24,142
3,317,268,53,215,6,209,2,61,43,33,0,0,1,22,3,44
3,318,101,10,91,3,88,0,17,30,12,0,0,0,9,0,20
3,319,353,46,307,12,295,6,54,92,57,3,3,2,16,7,55
3,320,617,80,537,19,518,10,75,80,131,9,5,0,52,16,140
3,321,9495,1480,8015,183,7832,157,1067,1631,1092,73,48,18,630,113,3003
4,1,862,112,750,13,737,20,150,146,107,14,6,2,70,15,207
4,4,394,65,329,5,324,6,79,66,64,6,1,0,16,2,84
4,5,95,8,87,2,85,1,24,18,15,3,3,0,3,0,18
4,6,573,103,470,7,463,12,84,188,66,12,3,1,29,6,62
4,7,68,12,56,0,56,2,19,5,9,2,0,0,4,1,14
4,8,884,121,763,16,747,18,177,208,96,14,9,1,65,13,146
4,9,39,2,37,0,37,5,6,18,2,0,0,0,0,1,5
4,12,88,14,74,2,72,5,14,10,19,3,0,0,4,1,16
4,13,421,46,375,5,370,5,76,79,41,6,6,1,37,16,103
4,16,67,9,58,3,55,6,3,18,10,0,0,1,3,1,13
4,17,98,14,84,3,81,9,12,5,33,4,1,0,8,1,8
4,18,759,100,659,7,652,15,124,180,96,6,5,0,34,12,180
4,19,1912,392,1520,35,1485,54,230,533,180,20,6,3,138,29,292
4,20,138,32,106,3,103,3,25,18,29,8,2,0,2,1,15
4,21,116,18,98,0,98,2,20,14,22,4,0,0,18,0,18
4,22,380,60,320,7,313,7,97,73,30,8,1,0,16,9,72
4,23,212,37,175,3,172,8,28,37,42,4,4,1,7,5,36
4,24,135,18,117,4,113,2,17,20,22,2,1,1,8,3,37
4,25,361,61,300,8,292,9,58,70,59,5,1,0,14,3,73
4,26,135,18,117,1,116,3,31,22,15,0,0,0,13,5,27
4,27,167,19,148,7,141,7,29,43,24,0,0,2,11,0,25
4,28,116,16,100,3,97,4,19,10,22,4,0,0,4,1,33
4,30,74,13,61,0,61,6,15,8,15,0,2,0,5,0,10
4,31,441,54,387,7,380,12,91,74,76,7,1,1,19,10,89
4,32,164,27,137,1,136,8,26,40,26,2,1,0,11,2,20
4,33,294,42,252,2,250,15,35,59,24,5,1,0,27,3,81
4,34,662,124,538,16,522,20,139,110,72,2,0,1,22,8,148
4,35,181,40,141,5,136,0,41,32,17,5,0,0,8,0,33
4,36,826,110,716,20,696,32,132,131,111,11,3,4,54,11,207
4,37,75,24,51,0,51,0,27,6,2,0,0,0,1,2,13
4,39,1156,191,965,26,939,29,174,260,112,20,9,3,67,14,251
4,40,74,18,56,4,52,4,3,12,14,1,1,0,2,1,14
4,41,212,35,177,4,173,3,39,49,24,5,1,0,11,5,36
4,42,143,19,124,0,124,0,27,28,18,2,1,0,7,1,40
4,43,95,19,76,0,76,1,11,21,14,0,0,0,6,0,23
4,45,1104,243,861,10,851,26,191,249,115,16,4,1,66,14,169
4,46,560,79,481,9,472,26,98,89,89,7,2,2,33,7,119
4,47,571,80,491,17,474,13,95,133,56,8,4,1,44,8,112
4,49,3906,694,3212,76,3136,63,568,639,585,45,17,16,201,55,947
4,50,30,6,24,0,24,0,1,5,12,1,0,0,2,0,3
4,51,73,13,60,0,60,6,16,15,5,0,0,1,1,2,14
4,53,398,46,352,10,342,8,96,77,51,4,2,0,29,5,70
4,54,75,10,65,2,63,0,4,29,3,1,1,1,6,0,18
4,55,142,17,125,2,123,5,24,28,19,0,1,0,7,0,39
4,57,172,21,151,6,145,6,34,32,26,5,1,0,7,3,31
4,58,188,40,148,0,148,6,34,30,13,1,1,0,14,4,45
4,59,185,31,154,3,151,6,35,30,30,2,1,0,9,3,35
4,61,352,40,312,4,308,11,66,95,24,4,1,1,28,8,70
4,62,165,29,136,3,133,3,40,31,21,1,2,0,7,0,28
4,63,824,104,720,12,708,17,197,183,104,6,0,0,49,18,134
4,65,541,65,476,8,468,11,113,125,73,6,4,4,21,8,103
4,66,362,41,321,10,311,7,91,94,25,4,2,1,30,10,47
4,67,51,7,44,1,43,7,7,8,7,0,0,0,3,0,11
4,68,628,87,541,8,533,18,120,131,89,6,1,0,46,10,112
4,69,96,12,84,2,82,0,13,24,10,0,0,0,10,7,18
4,70,11949,2468,9481,208,9273,273,1798,2255,1290,121,36,24,717,142,2617
4,72,83,8,75,1,74,4,18,14,14,1,1,0,3,0,19
4,73,451,79,372,6,366,8,45,160,39,4,2,2,37,3,66
4,74,102,15,87,2,85,5,20,14,14,3,1,1,6,2,19
4,75,282,30,252,5,247,13,37,57,55,1,0,0,40,3,41
4,76,679,98,581,10,571,19,154,167,65,9,3,1,42,9,102
4,77,125,16,109,2,107,2,21,18,33,0,0,1,11,1,20
4,79,970,137,833,20,813,16,184,147,149,8,2,1,56,22,228
4,81,361,44,317,10,307,5,51,103,52,11,3,2,17,5,58
4,84,429,74,355,6,349,15,69,63,79,2,2,0,15,4,100
4,85,50,8,42,5,37,1,4,11,4,0,0,0,7,0,10
4,86,251,37,214,3,211,9,29,61,35,4,1,3,27,7,35
4,87,130,18,112,2,110,2,21,19,29,4,2,1,8,1,23
4,88,3496,594,2902,38,2864,102,444,768,492,37,11,6,204,39,761
4,90,224,33,191,7,184,4,59,36,34,2,0,0,12,1,36
4,91,87,19,68,2,66,0,15,24,14,1,0,0,3,2,7
4,92,91,14,77,1,76,3,20,24,3,2,0,0,5,2,17
4,93,57,6,51,1,50,2,4,16,7,0,0,0,6,0,15
4,94,2255,387,1868,31,1837,34,443,583,196,22,9,3,124,31,392
4,95,99,6,93,2,91,5,18,12,24,3,0,0,3,0,26
4,96,803,132,671,23,648,25,117,196,98,13,10,0,56,12,121
4,97,292,41,251,2,249,5,50,53,40,4,0,2,16,4,75
4,99,108,8,100,1,99,2,17,26,12,3,0,0,10,0,29
4,100,71,22,49,1,48,1,11,16,3,0,0,1,6,2,8
4,101,114,13,101,1,100,5,14,16,17,1,0,0,12,1,34
4,102,241,45,196,3,193,4,41,59,27,4,1,1,17,8,31
4,104,195,38,157,2,155,17,25,18,44,1,0,1,8,3,38
4,106,293,40,253,2,251,13,35,64,46,4,2,2,24,5,56
4,107,20,5,15,0,15,0,2,3,3,0,0,0,0,0,7
4,108,1227,194,1033,20,1013,14,254,212,169,13,11,1,73,20,246
4,109,235,29,206,1,205,4,38,49,50,2,0,0,19,5,38
4,110,758,121,637,18,619,10,140,118,115,7,3,5,42,10,169
4,111,1070,206,864,20,844,30,155,216,132,24,5,4,70,10,198
4,112,15351,3312,12039,234,11805,289,2238,3294,1542,121,49,29,941,188,3114
4,113,369,33,336,2,334,14,78,79,44,0,2,0,19,5,93
4,115,174,41,133,2,131,8,39,39,12,1,1,0,10,4,17
4,116,2477,481,1996,36,1960,49,392,435,386,32,17,5,129,38,477
4,118,121,17,104,1,103,2,15,32,21,0,1,0,8,1,23
4,120,64,14,50,1,49,1,10,20,5,2,0,0,6,2,3
4,121,489,60,429,15,414,14,100,90,59,5,1,0,21,6,118
4,122,398,52,346,13,333,4,70,49,77,3,0,0,29,6,95
4,123,850,113,737,19,718,15,159,194,97,12,4,1,65,10,161
4,124,395,58,337,6,331,14,86,80,56,4,1,0,13,2,75
4,126,425,76,349,3,346,7,69,134,30,5,2,2,22,6,69
4,127,269,29,240,6,234,5,51,52,47,0,2,0,14,3,60
4,128,167,30,137,2,135,7,22,36,12,4,1,1,18,6,28
4,129,49,9,40,1,39,4,5,4,8,1,1,0,2,1,13
4,130,138,25,113,2,111,3,24,25,25,2,0,0,5,1,26
4,132,119,13,106,2,104,7,20,27,13,1,0,0,7,3,26
4,133,199,39,160,2,158,5,36,35,31,0,2,1,22,4,22
4,134,393,42,351,14,337,8,87,79,40,6,0,0,17,10,90
4,135,580,89,491,4,487,26,66,175,68,10,5,0,33,10,94
4,136,270,48,222,5,217,3,58,53,23,5,0,0,15,4,56
4,137,45,9,36,1,35,3,5,5,8,0,0,0,3,0,11
4,138,206,28,178,7,171,5,31,42,35,1,0,3,18,4,32
4,139,385,58,327,12,315,15,77,75,37,4,3,0,20,6,78
4,140,116,16,100,4,96,10,16,32,13,2,0,0,8,1,14
4,141,303,34,269,8,261,11,60,53,49,3,0,2,18,8,57
4,142,73,10,63,1,62,5,4,10,13,2,0,0,7,1,20
4,143,4031,625,3406,79,3327,55,878,862,376,43,16,10,236,75,776
4,144,298,53,245,3,242,7,36,39,68,16,1,1,13,2,59
4,145,1023,141,882,28,854,12,245,186,132,12,2,1,56,16,192
4,148,266,28,238,3,235,8,75,42,31,2,0,1,12,6,58
4,149,2024,330,1694,43,1651,32,426,367,224,22,9,1,122,32,416
4,150,109,16,93,1,92,3,5,35,18,2,0,1,8,4,16
4,151,416,33,383,5,378,14,66,82,84,0,2,0,31,3,96
4,152,3161,563,2598,51,2547,64,474,826,312,26,7,14,227,57,540
4,154,87,15,72,2,70,4,14,24,7,0,1,0,3,2,15
4,155,249,28,221,7,214,7,55,55,31,3,1,0,15,4,43
4,156,249,28,221,7,214,2,57,65,26,2,0,1,11,4,46
4,157,556,104,452,13,439,11,93,114,55,5,2,3,36,9,111
4,158,381,61,320,3,317,19,84,72,36,3,3,0,18,2,80
4,159,93,9,84,2,82,4,18,30,8,2,1,1,14,0,4
4,160,1183,149,1034,17,1017,40,185,248,234,11,4,1,74,14,206
4,161,320,82,238,4,234,9,40,61,31,7,0,2,25,4,55
4,162,238,40,198,3,195,13,25,25,39,3,0,3,19,9,59
4,163,420,64,356,5,351,11,73,104,52,3,4,0,23,6,75
4,164,85,24,61,1,60,6,13,18,10,0,1,0,4,2,6
4,166,1411,204,1207,26,1181,21,230,342,150,14,4,5,73,31,311
4,167,295,39,256,4,252,11,65,57,32,5,3,3,20,4,52
4,169,91,9,82,0,82,1,20,24,10,0,1,0,6,2,18
4,170,69,15,54,3,51,0,16,7,9,2,0,0,2,1,14
4,171,121,13,108,0,108,4,11,27,24,2,1,0,11,0,28
4,172,568,97,471,15,456,10,105,124,83,10,1,1,22,8,92
4,173,692,81,611,11,600,11,118,200,75,10,6,1,38,18,123
4,174,177,28,149,4,145,4,37,30,16,3,0,1,21,0,33
4,175,68,14,54,0,54,3,4,19,14,0,1,0,3,3,7
4,176,131,17,114,6,108,0,6,64,7,1,0,1,7,3,19
4,177,38,2,36,0,36,0,6,10,4,2,0,0,3,1,10
4,178,1002,120,882,12,870,34,178,225,174,7,3,3,57,14,175
4,179,100,17,83,0,83,5,14,19,21,3,0,0,6,1,14
4,180,57,7,50,0,50,2,11,10,8,1,0,0,2,0,16
4,181,66,7,59,1,58,3,8,21,6,1,0,0,5,0,14
4,182,148,11,137,4,133,0,26,39,20,1,0,0,4,3,40
4,183,151,21,130,0,130,7,28,36,18,5,0,0,6,2,28
4,184,151,24,127,2,125,6,15,22,27,2,1,0,10,2,40
4,186,97,9,88,0,88,2,29,20,15,3,0,0,5,3,11
4,187,65,14,51,0,51,3,11,13,11,0,0,1,5,0,7
4,188,579,82,497,9,488,18,121,91,102,6,4,2,19,8,117
4,189,485,84,401,12,389,16,80,101,74,7,1,0,21,7,82
4,190,87,15,72,1,71,4,18,13,17,2,1,0,4,1,11
4,191,32,9,23,0,23,0,8,11,1,0,0,0,0,0,3
4,192,935,143,792,11,781,40,135,152,156,12,0,2,62,14,208
4,193,248,31,217,4,213,7,29,44,45,0,1,2,23,10,52
4,194,123,15,108,2,106,4,24,40,17,0,1,0,2,0,18
4,195,536,74,462,14,448,14,93,126,69,7,1,1,48,5,84
4,197,2444,363,2081,45,2036,41,474,369,516,22,5,10,108,32,459
4,198,274,39,235,2,233,4,55,36,47,6,0,0,13,8,64
4,199,190,37,153,0,153,12,39,38,22,1,0,0,6,2,33
4,200,449,46,403,17,386,9,87,72,88,7,5,1,28,1,88
4,201,116,21,95,0,95,3,19,29,21,0,1,0,5,2,15
4,202,119,8,111,2,109,4,21,31,14,1,0,0,7,4,27
4,203,423,66,357,9,348,15,52,102,56,7,1,0,30,9,76
4,204,179,31,148,4,144,7,32,47,17,0,2,0,10,2,27
4,205,1193,211,982,27,955,16,194,238,125,18,5,4,92,28,235
4,206,341,65,276,3,273,15,47,49,66,11,0,0,18,5,62
4,207,71,9,62,1,61,2,8,19,12,0,1,0,9,1,9
4,208,528,77,451,10,441,17,79,102,69,7,1,0,35,6,125
4,209,5464,959,4505,110,4395,89,883,1148,569,61,19,15,355,96,1160
4,210,159,21,138,0,138,1,28,39,16,0,0,0,15,1,38
4,211,134,15,119,0,119,2,30,31,18,1,3,0,5,0,29
4,214,146,26,120,0,120,3,31,37,26,3,0,0,5,3,12
4,216,191,23,168,4,164,9,38,40,19,0,1,0,11,6,40
4,217,519,82,437,12,425,36,85,64,91,10,4,2,30,5,98
4,218,227,35,192,1,191,4,38,60,31,3,1,0,5,2,47
4,219,258,64,194,1,193,5,51,59,30,1,1,0,15,1,30
4,220,333,69,264,8,256,4,68,73,33,5,1,0,27,6,39
4,222,240,33,207,4,203,5,46,43,36,3,1,0,19,4,46
4,224,121,21,100,1,99,4,24,14,18,2,0,0,5,1,31
4,226,602,119,483,12,471,25,78,186,38,13,1,2,48,14,66
4,227,235,30,205,2,203,12,30,37,62,1,2,0,13,5,41
4,228,53,4,49,0,49,3,2,16,7,0,0,0,2,2,17
4,229,200,21,179,5,174,5,30,29,37,7,0,1,9,4,52
4,230,2305,361,1944,40,1904,65,452,489,268,20,5,6,149,50,400
4,231,208,26,182,2,180,9,44,42,25,2,0,0,14,4,40
4,233,232,27,205,0,205,12,36,47,30,3,0,0,11,7,59
4,234,192,20,172,1,171,11,49,27,26,3,1,0,13,3,38
4,235,64,12,52,0,52,1,3,13,10,0,1,0,6,2,16
4,236,149,33,116,0,116,1,20,47,14,2,0,0,4,4,24
4,237,172,26,146,0,146,6,19,31,22,1,1,0,11,1,54
4,240,252,34,218,8,210,9,45,63,35,2,0,0,15,3,38
4,241,139,25,114,2,112,4,20,28,20,2,0,0,4,1,33
4,242,2875,517,2358,41,2317,66,551,575,314,32,18,10,171,48,532
4,244,1244,119,1125,13,1112,35,217,271,161,14,3,3,87,19,302
4,245,2317,365,1952,45,1907,53,446,480,261,16,9,10,118,33,481
5,1,312,39,273,6,267,20,15,58,81,11,2,1,20,3,56
5,2,268,44,224,3,221,5,42,60,23,2,2,0,34,5,48
5,3,293,49,244,4,240,5,22,83,43,2,2,2,28,5,48
5,4,802,119,683,11,672,8,134,231,75,10,2,3,57,20,132
5,5,122,6,116,3,113,4,17,30,18,2,0,0,12,3,27
5,6,1628,280,1348,22,1326,54,202,286,242,22,10,4,112,26,368
5,7,334,45,289,6,283,14,29,99,34,1,3,0,29,7,67
5,8,289,47,242,8,234,3,65,53,30,1,1,0,19,2,60
5,9,132,18,114,3,111,1,17,41,16,1,1,0,9,0,25
5,10,674,116,558,16,542,12,131,137,91,6,2,1,41,7,114
5,11,305,43,262,5,257,10,76,58,28,3,1,1,30,8,42
5,12,382,38,344,9,335,7,57,97,47,2,6,1,31,13,74
5,13,121,20,101,1,100,5,15,9,29,2,1,0,2,0,37
5,14,174,34,140,4,136,5,18,41,29,1,0,0,7,0,35
5,16,177,25,152,2,150,10,28,35,26,4,1,0,15,0,31
5,17,1671,190,1481,37,1444,40,331,297,207,9,5,1,141,45,368
5,18,280,31,249,5,244,8,39,76,32,4,1,0,29,3,52
5,19,173,20,153,6,147,5,20,25,24,5,3,0,14,1,50
5,20,251,29,222,2,220,5,33,76,36,5,2,1,13,3,46
5,21,125,15,110,1,109,4,22,39,16,0,2,0,3,3,20
5,22,163,19,144,5,139,5,18,38,16,1,0,1,20,3,37
5,23,8017,1775,6242,157,6085,278,964,1437,998,103,37,22,541,102,1603
5,24,87,14,73,0,73,1,27,23,8,1,1,0,3,0,9
5,25,156,21,135,1,134,6,35,32,16,1,0,0,8,2,34
5,26,278,59,219,6,213,5,37,78,19,2,2,1,30,5,34
5,27,157,33,124,3,121,8,24,29,22,2,2,0,5,5,24
5,28,135,15,120,0,120,12,20,30,17,2,1,0,9,3,26
5,29,661,73,588,14,574,19,99,205,53,12,4,2,40,11,129
5,31,192,41,151,1,150,14,20,36,21,0,0,0,14,2,43
5,32,145,17,128,4,124,6,22,14,24,4,0,0,9,7,38
5,33,49,6,43,1,42,1,9,7,7,2,2,0,2,0,12
5,34,260,31,229,2,227,8,57,37,58,1,1,3,15,2,45
5,35,34,5,29,1,28,0,3,7,7,1,0,0,2,1,7
5,36,890,133,757,22,735,44,94,214,82,14,5,2,73,22,185
5,37,370,43,327,8,319,15,49,109,20,1,1,0,55,15,54
5,38,285,47,238,7,231,8,22,78,28,10,1,0,21,2,61
5,39,352,58,294,10,284,9,59,77,31,1,3,0,29,7,68
5,40,2083,276,1807,24,1783,54,360,492,245,31,4,2,169,36,390
5,42,60,4,56,0,56,1,9,11,9,0,0,0,9,0,17
5,43,155,18,137,3,134,2,25,22,19,3,4,1,21,2,35
5,44,140,21,119,3,116,6,7,51,11,7,1,0,11,4,18
5,45,739,114,625,13,612,27,131,158,61,7,6,0,61,10,151
5,46,4979,1066,3913,79,3834,165,602,1065,578,53,18,14,337,72,930
5,47,85,23,62,3,59,25,1,3,14,1,0,0,2,1,12
5,48,184,24,160,5,155,6,19,28,44,1,2,0,8,2,45
5,49,49,6,43,0,43,0,5,13,3,0,0,0,3,5,14
5,50,510,93,417,6,411,5,110,100,46,2,3,2,35,6,102
5,51,32,5,27,1,26,1,3,1,11,1,1,0,3,0,5
5,52,558,78,480,12,468,13,89,147,60,3,1,2,40,13,100
5,53,233,47,186,6,180,3,43,30,42,1,3,0,8,4,46
5,54,295,49,246,6,240,10,52,66,34,5,0,0,13,4,56
5,55,310,43,267,3,264,11,45,33,45,3,2,0,33,3,89
5,56,223,30,193,7,186,6,30,64,18,5,0,0,26,4,33
5,57,175,18,157,5,152,6,23,50,16,2,1,1,25,4,24
5,58,183,47,136,2,134,10,23,22,26,1,0,0,15,4,33
5,59,489,39,450,4,446,14,99,121,42,2,0,1,53,15,99
5,60,153,25,128,3,125,14,10,21,16,1,0,0,11,4,48
5,61,28219,5733,22486,445,22041,640,3806,5771,2733,218,94,55,2434,390,5900
5,62,184,40,144,4,140,6,52,31,15,1,0,0,8,1,26
5,63,462,89,373,7,366,19,50,144,38,3,2,1,43,6,60
5,64,116,0,116,3,113,1,20,31,12,1,2,0,12,0,34
5,65,1764,316,1448,26,1422,56,253,428,181,22,12,2,131,27,310
5,66,17,3,14,1,13,0,3,1,3,0,1,0,0,1,4
5,67,30,6,24,2,22,0,7,3,5,0,0,0,2,0,5
5,68,333,40,293,9,284,12,83,65,31,5,0,0,29,10,49
5,69,223,21,202,1,201,10,42,30,36,2,5,0,23,4,49
5,70,2609,436,2173,56,2117,41,456,495,318,26,8,5,164,43,561
5,71,266,26,240,3,237,11,53,57,16,2,1,0,24,6,67
5,72,214,30,184,6,178,5,30,37,22,2,2,1,17,4,58
5,73,282,31,251,4,247,5,62,61,31,6,0,0,13,7,62
5,74,156,11,145,2,143,2,29,62,15,4,0,0,7,2,22
5,75,368,44,324,5,319,21,67,75,41,2,0,1,36,6,70
5,76,82,15,67,0,67,3,14,15,10,2,0,0,8,0,15
5,77,323,49,274,6,268,7,15,109,37,2,2,0,32,7,57
5,78,222,32,190,5,185,2,48,73,10,2,3,3,20,2,22
5,79,996,162,834,22,812,55,113,255,89,16,6,1,79,17,181
5,80,76,16,60,2,58,5,6,8,9,0,3,0,6,1,20
5,81,43,7,36,0,36,9,6,2,8,0,0,0,0,2,9
5,82,116,10,106,2,104,9,9,22,22,5,0,0,9,0,28
5,84,396,64,332,6,326,5,67,106,24,6,1,0,34,9,74
5,85,395,45,350,11,339,23,47,117,43,4,1,1,25,8,70
5,86,99,17,82,3,79,3,20,22,9,1,0,0,7,2,15
5,87,445,70,375,7,368,12,62,74,71,4,5,2,44,7,87
5,88,92,23,69,2,67,1,18,20,6,2,0,0,5,3,12
5,89,52,4,48,3,45,0,9,8,8,0,1,0,3,1,15
5,90,196,42,154,1,153,12,26,38,26,2,1,1,9,3,35
5,91,52,4,48,0,48,0,7,8,13,0,0,1,12,1,6
5,92,602,80,522,9,513,12,83,171,57,2,7,1,59,12,109
5,93,333,62,271,7,264,16,18,50,49,5,1,0,39,7,79
5,94,14,1,13,0,13,1,0,5,2,0,0,0,1,2,2
5,95,236,27,209,4,205,2,53,64,26,0,2,2,10,1,45
5,96,681,92,589,15,574,8,109,200,60,11,3,2,58,18,105
5,97,303,36,267,2,265,7,50,41,50,7,1,1,28,5,75
5,98,440,99,341,3,338,11,53,135,42,4,3,1,30,7,52
5,99,82,9,73,2,71,0,9,16,15,0,1,0,9,2,19
5,100,527,79,448,11,437,13,71,132,51,3,0,2,45,4,116
5,101,430,81,349,9,340,19,32,73,69,11,3,0,42,2,89
5,102,98,20,78,6,72,6,11,11,14,0,0,0,6,1,23
5,103,535,59,476,13,463,6,92,116,70,11,3,1,50,18,96
5,104,288,37,251,6,245,14,62,56,32,1,2,3,12,3,60
5,106,248,33,215,8,207,10,37,72,23,2,2,0,27,2,32
5,107,368,58,310,5,305,34,25,72,58,11,3,1,23,4,74
5,108,140,21,119,1,118,10,11,28,22,1,1,0,10,5,30
5,109,449,66,383,5,378,18,61,83,65,8,0,0,37,7,99
5,110,284,62,222,1,221,8,36,57,19,4,0,2,18,3,74
5,111,186,19,167,2,165,11,36,17,40,1,2,0,16,5,37
5,112,102,14,88,1,87,6,9,11,24,2,0,0,9,0,26
5,113,317,31,286,10,276,21,55,49,39,1,0,0,32,7,72
5,114,273,45,228,4,224,14,25,54,35,6,0,0,31,7,52
5,115,371,58,313,8,305,7,93,40,28,5,3,1,28,3,97
5,116,178,25,153,5,148,15,14,33,25,3,0,0,10,5,43
5,117,104,16,88,4,84,5,18,15,17,1,1,0,10,0,17
5,118,641,79,562,9,553,22,120,110,95,6,4,2,61,8,125
5,119,676,82,594,19,575,17,112,191,61,5,2,3,44,8,132
5,120,84,16,68,2,66,2,1,18,22,0,2,0,11,0,10
5,121,153,19,134,1,133,3,26,22,26,0,0,1,17,4,34
5,122,649,123,526,13,513,23,91,93,112,13,2,0,35,7,137
5,123,1104,145,959,20,939,35,217,207,107,12,5,0,96,26,234
5,124,381,35,346,8,338,9,87,74,34,1,2,0,38,1,92
5,126,379,50,329,2,327,10,58,71,50,3,2,1,27,17,88
5,127,127,16,111,2,109,0,19,39,13,0,0,0,9,7,22
5,128,530,73,457,11,446,18,71,142,61,6,2,1,40,9,96
5,129,176,19,157,0,157,9,22,34,34,2,1,1,11,2,41
5,130,117,19,98,1,97,6,16,29,5,1,1,0,11,1,27
5,131,67,8,59,0,59,0,3,6,15,3,13,1,3,3,12
5,132,1326,177,1149,26,1123,44,193,294,110,14,7,4,117,20,320
5,133,1277,191,1086,26,1060,44,195,354,134,12,4,1,84,26,206
5,134,242,27,215,2,213,3,47,46,45,1,2,0,28,4,37
5,135,60,11,49,2,47,3,3,4,4,0,0,0,3,0,30
5,136,572,103,469,11,458,18,96,122,63,13,3,0,46,12,85
5,138,137,30,107,3,104,5,26,19,11,1,0,0,13,0,29
5,139,427,81,346,5,341,7,66,117,41,8,0,0,48,5,49
5,140,238,19,219,6,213,2,60,70,23,2,1,1,22,10,22
5,141,154,20,134,1,133,2,32,46,6,3,0,0,9,0,35
5,142,456,69,387,7,380,13,62,90,69,2,2,4,27,9,102
5,143,56,6,50,1,49,2,8,14,10,1,2,0,3,0,9
5,144,160,14,146,1,145,2,30,23,27,2,0,0,10,0,51
5,145,748,110,638,7,631,20,119,193,78,8,2,1,82,27,101
5,146,117,18,99,1,98,8,17,25,18,3,1,0,4,2,20
5,147,292,28,264,5,259,4,41,105,26,3,0,1,27,5,47
5,148,414,57,357,10,347,10,48,134,33,5,2,0,40,6,69
5,149,240,41,199,1,198,4,21,67,15,0,0,0,26,11,54
5,150,34,2,32,2,30,0,11,2,3,0,0,0,6,0,8
5,151,903,148,755,27,728,32,129,137,127,17,7,2,69,13,195
5,152,159,29,130,1,129,2,26,37,15,0,1,1,11,2,34
5,153,312,70,242,5,237,9,44,81,19,6,0,0,37,4,37
5,154,169,27,142,1,141,5,30,27,28,3,2,0,14,3,29
5,155,37,6,31,0,31,2,8,5,3,0,0,0,2,0,11
5,156,346,61,285,1,284,11,48,86,33,3,1,0,27,4,71
5,157,227,34,193,4,189,6,23,74,24,1,0,0,25,4,32
5,158,114,17,97,1,96,6,14,19,20,0,0,0,8,2,27
5,159,69,4,65,0,65,0,12,17,7,1,0,0,5,4,19
5,160,85,14,71,1,70,3,16,15,19,0,0,0,4,2,11
5,161,892,151,741,15,726,23,116,267,71,8,2,2,60,21,156
5,162,848,137,711,17,694,28,161,196,74,12,4,3,60,24,132
5,163,116,20,96,4,92,3,16,34,8,0,0,1,18,2,10
5,164,810,123,687,14,673,20,124,195,89,17,5,0,71,14,138
5,165,214,47,167,5,162,7,28,34,33,3,0,3,21,3,30
5,166,968,149,819,18,801,24,149,214,126,9,6,2,55,25,191
5,167,84,8,76,1,75,7,8,14,14,0,0,0,7,0,25
5,168,559,70,489,6,483,37,63,83,80,8,2,1,58,16,135
5,169,49,3,46,0,46,0,3,20,4,0,0,0,4,1,14
5,170,1470,177,1293,33,1260,34,298,338,149,14,8,2,135,16,266
5,171,184,17,167,3,164,5,34,56,12,5,1,0,24,4,23
5,172,300,39,261,2,259,9,34,60,55,4,1,0,25,8,63
5,173,344,37,307,6,301,5,77,57,32,3,4,0,44,9,70
5,174,429,59,370,8,362,18,67,66,61,1,0,1,33,11,104
5,175,690,112,578,9,569,43,42,150,102,14,4,0,60,16,138
5,176,190,25,165,0,165,7,35,32,34,3,0,0,12,10,32
5,177,583,109,474,12,462,14,71,205,45,11,0,3,37,13,63
5,178,417,58,359,6,353,5,70,66,76,4,2,1,44,10,75
5,179,2424,335,2089,42,2047,59,327,342,491,22,19,3,190,45,549
5,180,395,75,320,3,317,27,29,72,44,10,5,2,20,7,101
5,181,257,43,214,3,211,23,23,59,29,6,4,2,13,2,50
5,182,56,8,48,0,48,0,10,21,6,0,0,0,5,2,4
5,183,1176,197,979,20,959,31,173,227,156,15,5,1,71,18,262
5,184,159,9,150,3,147,5,32,39,30,2,2,0,11,1,25
6,1,116,18,98,0,98,3,29,36,6,2,0,0,5,1,16
6,2,57,10,47,0,47,4,15,6,9,0,0,0,0,1,12
6,3,479,87,392,6,386,14,122,109,34,4,3,1,31,16,52
6,4,51617,10634,40983,659,40324,854,8215,16866,2898,280,100,87,2976,635,7413
6,5,249,36,213,2,211,5,41,72,48,2,0,1,5,2,35
6,6,1841,345,1496,16,1480,34,373,544,137,10,2,2,103,26,249
6,7,2179,298,1881,23,1858,45,457,721,144,14,4,3,142,38,290
6,8,46,7,39,0,39,5,10,10,4,0,0,1,1,1,7
6,9,102,16,86,2,84,3,24,25,7,1,1,0,1,3,19
6,10,2144,439,1705,24,1681,72,346,479,214,18,7,3,146,30,366
6,11,2787,530,2257,26,2231,29,533,1059,128,8,7,3,124,32,308
6,12,7994,2734,5260,73,5187,83,1293,2054,396,36,21,13,285,84,922
6,13,757,125,632,7,625,18,143,191,99,4,1,0,26,6,137
6,14,711,129,582,11,571,9,186,137,108,5,2,2,20,14,88
6,15,1073,212,861,11,850,15,273,237,108,10,4,2,57,10,134
6,16,532,87,445,4,441,6,134,149,25,3,0,0,42,5,77
6,17,225,35,190,3,187,5,59,66,13,0,2,0,14,0,28
6,18,6503,1044,5459,76,5383,175,920,2163,450,39,18,11,511,96,1000
6,19,1310,196,1114,15,1099,16,390,336,128,6,1,1,57,21,143
6,20,571,90,481,8,473,10,133,140,47,4,0,0,47,8,84
6,21,668,100,568,10,558,16,173,135,64,4,3,2,36,18,107
6,22,439,61,378,6,372,13,117,116,36,2,4,0,21,6,57
6,23,1979,418,1561,33,1528,31,404,345,236,19,5,3,98,36,351
6,24,214,19,195,1,194,15,32,42,29,6,0,0,13,5,52
6,25,1004,166,838,13,825,24,234,207,138,11,2,0,46,14,149
6,26,1212,154,1058,12,1046,34,199,408,81,10,1,2,94,23,194
6,27,33796,7122,26674,328,26346,499,6693,10383,1724,172,54,47,1732,444,4598
6,28,351,65,286,1,285,11,67,102,28,2,2,0,23,5,45
6,29,50720,11451,39269,522,38747,677,8365,17204,2490,235,87,66,2239,511,6873
6,30,29363,6670,22693,287,22406,416,5003,9261,1558,156,65,48,1463,299,4137
6,31,1126,167,959,13,946,16,317,224,122,3,2,1,46,12,203
6,32,3149,666,2483,37,2446,66,568,962,185,19,4,5,153,43,441
6,33,8232,1838,6394,125,6269,132,1700,1691,755,78,25,17,369,106,1396
6,34,1272,162,1110,17,1093,30,339,379,95,2,2,4,55,18,169
6,35,732,136,596,10,586,11,135,238,44,11,4,1,34,11,97
6,36,279,52,227,3,224,5,74,69,25,3,1,0,12,3,32
6,37,288,38,250,3,247,8,64,98,19,4,2,0,14,8,30
6,38,2141,354,1787,31,1756,46,348,772,113,10,5,2,143,35,282
6,39,688,90,598,13,585,12,211,178,43,4,2,1,40,8,86
6,40,96,28,68,1,67,2,9,26,6,2,0,0,8,0,14
6,41,301,60,241,1,240,12,52,87,41,3,0,0,8,3,34
6,42,658,119,539,6,533,18,137,175,38,9,2,2,37,9,106
6,43,697,99,598,6,592,25,161,138,94,8,1,0,33,8,124
6,44,5887,1050,4837,79,4758,121,933,1977,319,34,11,8,373,85,897
6,45,114,20,94,1,93,3,32,30,5,0,0,0,4,5,14
6,46,2414,328,2086,28,2058,46,596,729,147,15,3,7,129,31,355
6,47,102,12,90,0,90,0,29,29,9,1,1,1,1,5,14
6,48,5451,948,4503,73,4430,65,1432,1114,820,31,7,14,227,71,649
6,49,102,13,89,2,87,4,31,26,5,0,0,0,3,0,18
6,50,387,63,324,8,316,12,68,106,31,4,3,2,26,4,60
6,51,145,12,133,2,131,5,29,35,21,3,0,0,10,2,26
6,52,154,27,127,3,124,2,40,28,15,0,0,0,5,2,32
6,53,159,27,132,2,130,2,41,34,9,1,0,0,14,6,23
6,54,3101,705,2396,58,2338,22,750,538,413,14,8,5,86,36,466
6,55,139,15,124,4,120,3,49,16,20,1,2,0,6,1,22
6,56,204,54,150,1,149,7,31,34,28,2,0,0,2,2,43
6,57,1923,342,1581,26,1555,28,566,377,210,11,11,3,80,18,251
6,58,427,65,362,9,353,15,117,69,50,5,1,1,24,5,66
6,59,2010,389,1621,29,1592,37,386,712,80,11,3,0,131,26,206
6,60,1633,226,1407,15,1392,43,354,601,83,3,5,1,97,11,194
6,61,109,6,103,3,100,1,18,35,12,1,3,0,5,4,21
6,62,401,65,336,2,334,7,89,84,45,2,3,1,16,7,80
6,63,92,15,77,0,77,5,12,13,12,1,0,0,2,0,32
6,64,3098,557,2541,42,2499,66,657,857,256,17,10,7,179,44,406
6,65,5068,683,4385,57,4328,100,1005,1625,336,36,7,8,365,98,748
6,66,1136,206,930,14,916,21,275,242,106,11,5,5,62,13,176
6,67,957,174,783,10,773,18,214,290,83,8,1,3,44,16,96
6,68,328,36,292,3,289,7,65,91,23,2,4,3,27,6,61
6,69,30997,6852,24145,363,23782,631,5474,7642,2419,206,68,64,1838,383,5057
6,70,500,85,415,5,410,15,133,103,34,6,1,2,30,6,80
6,71,653,137,516,7,509,19,104,172,55,7,0,1,39,6,106
6,72,138,28,110,1,109,0,35,30,16,0,1,0,4,0,23
6,73,800,158,642,12,630,19,119,265,48,9,3,0,37,10,120
6,74,1342,213,1129,16,1113,21,352,287,99,8,7,2,63,17,257
6,75,3866,678,3188,50,3138,70,1007,930,281,24,11,5,220,57,533
6,76,35,4,31,2,29,1,13,3,4,1,0,0,0,2,5
6,77,1061,159,902,15,887,24,267,212,142,10,4,0,64,11,153
6,78,244,39,205,3,202,4,71,51,16,0,0,0,7,4,49
6,79,16624,2733,13891,240,13651,219,3170,6192,822,67,21,21,831,217,2091
6,80,129,25,104,1,103,2,27,39,11,1,1,0,5,5,12
6,81,133,23,110,4,106,3,47,19,8,0,1,0,11,1,16
6,82,188,34,154,1,153,1,42,68,11,1,0,0,4,7,19
6,83,20470,4197,16273,270,16003,316,4107,5887,1232,135,67,41,955,351,2912
6,84,7846,1234,6612,76,6536,257,1156,2446,519,67,12,17,562,107,1393
6,85,13440,2735,10705,210,10495,210,2014,4992,573,56,19,25,818,203,1585
6,86,297,49,248,5,243,11,53,69,37,2,1,1,12,0,57
6,87,36,10,26,2,24,0,3,13,3,0,0,1,0,1,3
6,88,214405,47471,166934,2488,164446,3245,37856,56988,15152,1026,431,360,10332,2277,36779
6,89,1575,235,1340,22,1318,69,201,613,92,8,0,7,113,22,193
6,90,5175,881,4294,66,4228,80,1239,1485,294,36,10,6,305,75,698
6,91,1801,349,1452,22,1430,23,428,425,193,13,5,4,84,23,232
6,92,1064,153,911,14,897,21,334,249,90,2,1,3,34,8,155
6,93,262,39,223,4,219,7,38,67,45,2,0,0,11,6,43
6,94,844,135,709,9,700,12,174,247,60,4,0,4,50,15,134
6,95,5981,1005,4976,73,4903,111,1150,1817,353,40,11,7,421,107,886
6,96,97,20,77,1,76,0,17,28,7,1,1,0,6,4,12
6,97,318,67,251,1,250,4,63,63,37,4,1,0,17,1,60
6,98,105,19,86,0,86,4,19,27,11,1,1,0,4,1,18
6,99,1326,200,1126,24,1102,24,320,273,153,9,6,5,71,22,219
6,100,168,26,142,1,141,0,41,46,18,1,1,0,9,3,22
6,101,259,58,201,6,195,1,54,57,24,3,0,0,11,4,41
6,102,126,21,105,0,105,0,38,21,12,0,1,0,8,4,21
6,103,1563,242,1321,29,1292,23,333,383,165,13,5,2,81,34,253
6,104,8798,1886,6912,113,6799,165,1508,3047,416,40,21,20,444,117,1021
6,105,4784,744,4040,59,3981,94,688,1862,207,31,9,10,420,75,585
6,106,424,75,349,15,334,7,88,99,37,1,5,1,18,8,70
6,107,92,18,74,0,74,1,29,15,5,1,0,0,4,4,15
6,108,3828,603,3225,37,3188,61,795,1249,233,21,11,9,210,50,549
6,109,694,85,609,11,598,8,166,132,128,7,1,0,26,8,122
6,110,157,34,123,1,122,3,28,35,14,2,0,0,7,3,30
6,111,209,51,158,1,157,8,40,50,14,1,0,0,10,0,34
6,112,2758,420,2338,28,2310,89,427,910,174,21,6,7,237,43,396
6,113,919,127,792,12,780,19,240,268,49,8,2,1,55,34,104
6,114,3533,713,2820,36,2784,36,968,777,251,22,10,6,175,41,498
6,115,109,20,89,1,88,2,30,8,22,1,0,1,5,2,17
6,116,271,44,227,1,226,2,73,44,33,1,0,1,19,2,51
6,117,708,88,620,8,612,13,234,166,57,3,2,2,39,9,87
6,118,2861,393,2468,44,2424,73,688,771,224,15,9,5,177,43,419
6,119,148,33,115,2,113,1,22,48,10,3,0,2,13,2,12
6,120,1455,268,1187,15,1172,23,257,485,111,10,6,1,89,28,162
6,121,1535,410,1125,19,1106,16,282,543,46,9,3,3,59,23,122
6,122,3104,571,2533,39,2494,97,495,759,224,35,9,9,229,51,586
6,123,22375,4410,17965,358,17607,327,4777,6775,1152,88,51,25,1100,256,3056
6,124,107,21,86,4,82,2,19,21,17,3,0,1,6,2,11
6,125,198,49,149,3,146,2,32,39,19,1,5,0,4,8,36
6,126,1779,251,1528,10,1518,16,401,434,237,18,6,4,89,32,281
6,127,1440,198,1242,15,1227,21,261,529,84,7,1,0,80,25,219
6,128,2617,472,2145,33,2112,42,378,1055,105,15,3,8,158,45,303
6,129,365,39,326,3,323,5,76,89,36,4,2,2,22,3,84
6,130,2453,448,2005,33,1972,54,592,652,186,10,7,6,146,33,286
6,131,60,9,51,2,49,2,13,8,8,1,0,0,7,0,10
6,132,451,101,350,5,345,23,35,37,106,7,5,0,10,6,116
6,133,144,26,118,2,116,6,24,34,21,3,0,0,9,0,19
6,134,399,71,328,8,320,8,92,107,24,3,1,2,19,5,59
6,135,235,45,190,4,186,5,48,57,31,1,1,0,4,2,37
6,136,2866,552,2314,46,2268,56,608,638,250,22,11,3,171,59,450
6,137,1052,184,868,22,846,27,160,365,60,7,3,1,72,11,140
6,138,1268,254,1014,14,1000,19,230,509,48,9,2,2,58,16,107
6,139,119,14,105,1,104,0,14,39,7,0,0,1,9,0,34
6,140,2437,398,2039,26,2013,34,500,771,136,11,5,4,161,40,351
6,141,320,84,236,4,232,5,82,54,16,5,0,0,13,3,54
6,142,246,28,218,8,210,4,65,34,68,2,1,0,2,3,31
6,143,492,58,434,8,426,13,116,142,39,10,1,0,26,10,69
6,144,611,134,477,8,469,17,150,108,89,3,3,0,16,6,77
6,145,180,31,149,4,145,2,42,35,20,0,0,0,7,2,37
6,146,153,29,124,4,120,0,57,31,7,1,0,0,10,1,13
6,147,3482,527,2955,59,2896,45,973,994,190,20,15,8,186,46,419
6,148,3134,500,2634,35,2599,84,449,1074,214,22,7,6,226,41,476
6,149,7033,1345,5688,90,5598,74,1895,1379,833,42,18,10,283,78,986
6,150,2438,525,1913,24,1889,29,516,879,80,15,1,3,132,28,206
6,151,905,170,735,6,729,8,211,237,92,5,2,2,39,11,122
6,152,7958,1513,6445,128,6317,296,966,2046,627,38,18,20,606,100,1600
6,153,1033,158,875,12,863,34,197,285,95,6,1,1,57,21,166
6,154,357,47,310,4,306,9,90,107,15,2,1,2,23,5,52
6,155,18180,4303,13877,206,13671,282,2986,5292,1185,91,31,21,824,203,2756
6,156,260,26,234,4,230,1,51,103,32,1,0,0,4,2,36
6,157,12986,2501,10485,187,10298,305,2008,4006,873,53,26,17,868,178,1964
6,158,676,111,565,8,557,18,174,123,99,4,3,0,27,10,99
6,159,4161,830,3331,51,3280,67,765,1487,220,19,7,12,191,49,463
6,160,148,29,119,3,116,1,29,38,15,0,0,1,7,1,24
6,161,11376,2358,9018,186,8832,206,2009,3733,583,49,12,17,682,161,1380
6,162,782,174,608,7,601,25,151,224,55,2,1,0,36,15,92
6,163,1518,318,1200,27,1173,53,266,359,123,20,6,3,69,35,239
7,1,367,42,325,9,316,10,72,85,37,4,1,0,42,7,58
7,2,398,39,359,5,354,9,56,60,75,2,2,2,29,2,117
7,3,177,25,152,0,152,8,20,15,51,3,3,0,14,4,34
7,4,95,11,84,1,83,5,7,15,27,3,2,0,2,3,19
7,5,1070,158,912,24,888,39,139,196,155,9,5,0,79,19,247
7,6,142,24,118,3,115,2,30,21,29,1,0,0,6,1,25
7,7,683,75,608,11,597,14,135,131,86,11,3,1,61,12,143
7,8,1014,109,905,27,878,20,179,186,132,10,6,3,82,14,246
7,9,730,119,611,19,592,9,143,131,56,7,2,2,47,15,180
7,10,11552,2895,8657,166,8491,247,1424,1948,1264,136,65,27,786,139,2455
7,11,463,66,397,6,391,18,56,51,129,4,3,1,18,2,109
7,12,325,49,276,7,269,7,39,63,46,3,2,1,34,5,69
7,13,790,81,709,18,691,11,198,116,86,11,7,4,82,9,167
7,14,314,40,274,6,268,13,43,93,19,5,1,0,30,8,56
7,15,343,53,290,6,284,10,48,48,44,6,4,2,30,6,86
7,16,342,56,286,7,279,5,69,48,50,6,3,1,15,2,80
7,17,527,62,465,3,462,14,69,67,108,7,2,1,36,8,150
7,18,61,17,44,2,42,1,8,6,6,0,2,0,6,1,12
7,19,8129,1876,6253,126,6127,165,1062,1661,881,62,26,19,513,97,1641
7,20,351,56,295,6,289,17,85,37,48,1,1,0,15,8,77
7,22,690,76,614,16,598,9,152,112,110,10,2,2,38,13,150
7,23,289,37,252,4,248,20,33,62,37,10,3,0,24,3,56
7,24,596,74,522,11,511,30,67,122,102,8,5,3,36,6,132
7,25,209,38,171,2,169,12,35,32,37,1,1,0,13,0,38
7,26,305,52,253,3,250,6,52,82,18,3,0,0,33,4,52
7,27,1200,162,1038,27,1011,30,226,182,158,17,6,2,108,20,262
7,28,398,45,353,9,344,11,47,90,60,9,3,1,36,5,82
7,29,216,31,185,0,185,16,7,23,61,4,1,0,12,2,59
7,30,212,25,187,2,185,6,37,34,24,5,1,0,8,5,65
7,31,574,86,488,6,482,30,56,114,81,10,2,0,42,5,142
7,32,127,8,119,0,119,1,11,24,38,3,0,0,7,1,34
7,33,166,21,145,3,142,6,31,48,21,1,1,1,15,0,18
7,34,174,20,154,3,151,17,39,23,22,1,1,0,9,2,37
7,35,521,76,445,10,435,25,73,103,89,16,8,2,19,9,91
7,36,302,28,274,12,262,2,65,58,24,2,6,1,23,4,77
7,37,186,32,154,1,153,5,42,28,10,2,3,0,28,4,31
7,38,44,0,44,0,44,1,5,15,6,1,0,0,9,1,6
7,39,207,26,181,2,179,8,39,61,19,1,1,0,17,4,29
7,40,220,19,201,3,198,6,56,65,20,3,2,0,13,2,31
7,41,1653,249,1404,28,1376,22,339,371,129,21,15,2,154,34,289
7,42,5448,1125,4323,64,4259,53,1193,1018,447,27,25,15,312,74,1095
7,44,173,34,139,0,139,3,20,41,17,0,2,1,14,1,40
7,45,457,104,353,8,345,15,81,78,46,4,1,0,16,8,96
7,47,82,9,73,2,71,0,12,22,5,1,0,0,16,1,14
7,48,299,44,255,8,247,10,30,73,38,2,1,0,21,5,67
7,49,71,13,58,2,56,0,11,19,7,2,0,0,2,2,13
7,50,534,79,455,8,447,17,58,93,93,7,1,3,33,5,137
7,51,392,37,355,6,349,3,57,114,33,3,3,2,33,11,90
7,52,433,53,380,10,370,22,69,96,43,10,1,0,30,12,87
7,53,382,45,337,7,330,6,51,84,56,3,1,0,47,4,78
7,54,233,29,204,3,201,8,25,43,36,3,2,0,15,9,60
7,55,1846,254,1592,33,1559,30,377,380,167,16,13,4,150,33,389
7,56,543,88,455,8,447,6,109,91,53,2,4,0,45,6,131
7,58,687,96,591,9,582,26,102,112,101,21,5,0,44,10,161
7,59,168,19,149,2,147,1,28,48,28,2,2,0,13,1,24
7,60,182,20,162,4,158,8,10,38,28,3,0,0,16,5,50
7,61,302,47,255,6,249,8,47,79,38,4,0,0,21,9,43
7,62,104,26,78,0,78,3,19,14,17,5,0,0,6,3,11
7,63,237,28,209,7,202,8,45,41,26,2,0,1,25,3,51
7,64,2619,483,2136,56,2080,35,312,607,217,32,15,11,250,46,555
7,65,241,46,195,4,191,24,41,26,34,3,1,1,16,0,45
7,66,2310,354,1956,30,1926,31,374,406,317,35,9,3,170,47,534
7,67,234,31,203,4,199,5,36,45,16,2,0,0,36,7,52
7,68,511,70,441,6,435,9,107,147,37,8,4,1,29,8,85
7,69,518,65,453,11,442,6,85,112,69,15,3,0,55,10,87
7,70,1746,199,1547,33,1514,29,329,427,145,20,5,6,176,28,349
7,71,635,81,554,14,540,3,128,182,44,5,1,2,65,4,106
7,72,1356,160,1196,38,1158,34,175,255,167,13,2,2,118,28,364
7,73,427,52,375,3,372,8,98,98,34,3,3,2,34,10,82
7,74,122,17,105,1,104,6,8,15,21,1,3,0,11,0,39
7,75,195,36,159,2,157,4,27,55,20,1,0,1,13,5,31
7,76,2151,394,1757,35,1722,21,423,269,402,22,8,4,100,35,438
7,77,202,29,173,4,169,3,36,24,23,2,1,0,11,1,68
7,78,2380,344,2036,50,1986,39,396,567,205,29,10,5,205,53,477
7,79,929,135,794,19,775,34,103,137,135,11,12,5,81,15,242
7,80,256,41,215,4,211,5,35,34,27,2,3,1,17,6,81
7,81,82,14,68,1,67,8,17,9,13,0,0,0,1,2,17
7,82,219,37,182,4,178,1,48,25,21,2,2,1,26,8,44
7,83,355,58,297,6,291,16,49,54,48,6,2,1,14,10,91
7,84,717,76,641,6,635,15,159,135,100,9,0,3,65,16,133
7,85,431,53,378,4,374,12,66,118,54,3,3,0,46,7,65
7,86,542,47,495,8,487,17,103,96,94,8,4,1,41,15,108
7,87,300,42,258,2,256,9,32,39,47,13,0,0,19,6,91
7,88,93,4,89,3,86,3,3,27,18,4,0,0,10,1,20
7,89,1122,152,970,23,947,29,193,262,95,7,7,2,114,28,210
7,90,835,97,738,17,721,16,161,151,90,8,5,0,50,15,225
7,91,256,24,232,8,224,7,42,40,34,3,1,0,22,4,71
7,92,53,5,48,0,48,3,7,23,2,0,0,0,7,1,5
7,93,252,32,220,6,214,5,38,43,51,2,2,0,27,5,41
7,94,144,28,116,1,115,6,19,20,21,5,0,1,12,4,27
7,95,361,42,319,3,316,7,78,117,33,5,3,1,25,6,41
7,96,343,46,297,4,293,10,38,64,54,2,1,0,24,8,92
7,97,440,42,398,4,394,10,83,103,45,14,2,0,39,13,85
7,98,78,16,62,1,61,2,12,14,12,4,1,0,2,3,11
7,99,435,49,386,6,380,22,71,65,79,5,1,3,27,13,94
7,100,340,46,294,6,288,16,39,58,69,4,1,0,21,4,76
7,101,645,102,543,8,535,14,103,119,111,9,4,1,26,10,138
7,102,7989,1082,6907,139,6768,139,1227,2040,579,50,42,17,693,116,1865
7,103,124,12,112,4,108,3,22,24,15,2,1,0,21,1,19
7,104,115,34,81,1,80,2,15,11,19,2,1,0,3,4,23
7,105,146,16,130,2,128,1,31,28,15,1,0,0,10,2,40
7,106,158,36,122,2,120,4,33,24,8,0,0,2,25,0,24
7,107,952,141,811,15,796,44,118,171,199,13,3,2,45,10,191
7,108,106,8,98,6,92,1,15,23,12,3,1,4,7,2,24
7,109,274,31,243,10,233,12,29,22,70,6,1,0,19,2,72
7,110,1245,273,972,15,957,38,146,266,155,13,5,4,65,6,259
7,111,155,29,126,3,123,3,34,18,13,3,0,0,10,1,41
7,112,220,36,184,4,180,8,40,19,41,3,1,0,21,6,41
7,113,174,18,156,6,150,7,19,36,22,1,0,0,16,3,46
7,114,203,25,178,5,173,6,36,46,17,4,4,2,13,6,39
7,115,575,96,479,8,471,20,73,141,56,5,1,2,25,10,138
7,116,1084,217,867,23,844,5,222,197,110,16,5,0,61,11,217
7,117,1520,208,1312,31,1281,43,246,309,193,16,6,4,119,27,318
7,118,117,16,101,2,99,10,11,7,26,2,1,0,6,3,33
7,119,226,36,190,5,185,2,46,71,12,0,1,1,13,8,31
7,120,68,11,57,2,55,4,16,15,3,0,1,1,9,0,6
7,121,233,50,183,2,181,2,46,48,17,2,0,1,23,2,40
7,122,1087,163,924,21,903,26,162,193,120,8,4,1,85,25,279
7,123,165,30,135,2,133,1,22,42,11,4,0,0,19,6,28
7,124,64,22,42,1,41,3,9,13,3,0,0,0,5,3,5
7,126,805,87,718,14,704,39,125,131,156,10,4,0,55,5,179
7,127,828,143,685,20,665,17,139,158,93,12,5,1,52,12,176
7,128,344,52,292,6,286,5,69,104,14,3,3,0,45,5,38
7,129,1962,262,1700,32,1668,42,250,481,170,28,12,2,195,29,459
7,130,194,35,159,4,155,1,47,69,10,0,2,0,7,1,18
7,131,315,44,271,13,258,8,51,35,41,4,3,1,15,9,91
7,132,1293,325,968,9,959,29,143,226,154,14,7,2,80,16,288
7,133,111,13,98,1,97,1,16,14,35,3,1,0,6,5,16
7,134,694,88,606,11,595,15,115,158,79,5,4,1,44,9,165
7,135,35,6,29,0,29,0,3,15,0,0,0,0,5,0,6
7,136,104,10,94,2,92,2,10,29,6,1,0,1,16,0,27
7,137,80,8,72,0,72,2,16,21,3,0,1,0,8,0,21
7,138,1489,152,1337,29,1308,24,304,282,243,25,4,3,91,24,308
7,139,123,18,105,4,101,6,25,20,17,1,2,0,7,1,22
7,140,543,68,475,9,466,20,97,101,50,7,6,2,38,12,133
7,141,176,19,157,1,156,12,24,29,26,1,2,0,10,3,49
7,142,267,49,218,5,213,2,58,45,20,3,0,0,38,5,42
7,143,562,88,474,12,462,9,129,105,56,8,6,2,39,8,100
7,144,37,7,30,0,30,1,4,9,0,0,0,0,9,0,7
7,145,828,109,719,12,707,17,117,130,111,11,4,0,74,17,226
7,146,497,62,435,7,428,25,68,91,66,2,2,2,36,8,128
7,147,231,58,173,4,169,24,5,17,50,6,6,2,10,2,47
7,148,201,40,161,2,159,12,34,26,32,4,0,1,9,2,39
7,149,189,24,165,7,158,6,19,38,24,3,3,1,13,5,46
7,150,589,87,502,11,491,10,103,134,58,3,7,1,51,12,112
7,151,222,38,184,9,175,5,32,40,16,4,0,0,23,4,51
7,152,949,130,819,11,808,15,207,210,78,6,3,1,87,17,184
7,153,228,34,194,3,191,3,40,47,24,3,0,0,19,2,53
7,154,192,45,147,3,144,5,38,34,16,3,1,1,29,4,13
7,155,1019,142,877,10,867,41,147,182,148,13,4,0,83,9,240
7,156,695,98,597,8,589,16,121,114,109,6,4,2,44,10,163
7,157,1085,198,887,18,869,12,269,142,152,6,5,3,51,16,213
7,158,109,19,90,1,89,7,22,17,13,0,0,0,10,2,18
7,159,353,31,322,2,320,19,63,63,41,2,3,1,44,9,75
7,160,54,13,41,3,38,3,7,7,5,1,1,1,4,1,8
7,161,658,91,567,13,554,21,129,131,90,5,0,2,28,16,132
7,162,397,42,355,13,342,17,71,80,52,6,0,2,37,5,72
7,163,90,12,78,1,77,0,10,9,19,0,1,0,12,1,25
7,165,162,20,142,5,137,5,24,27,26,6,2,0,17,2,28
7,166,218,37,181,0,181,8,32,47,25,5,1,2,20,3,38
7,167,763,155,608,8,600,19,117,117,73,11,8,5,57,13,180
7,168,415,58,357,4,353,11,86,85,52,1,6,0,30,5,77
7,169,285,50,235,3,232,4,64,43,24,4,2,1,33,5,52
7,170,251,44,207,5,202,14,41,47,38,5,1,0,22,1,33
7,171,393,59,334,6,328,23,31,68,72,5,4,0,20,3,102
7,172,1571,235,1336,33,1303,28,294,386,115,11,11,1,147,36,274
7,173,56,10,46,1,45,2,7,15,7,0,0,0,4,2,8
7,174,334,43,291,6,285,3,77,53,47,2,2,0,16,7,78
7,175,56,13,43,3,40,3,6,19,4,0,0,0,2,0,6
7,176,106,22,84,2,82,3,20,17,13,0,0,0,6,4,19
7,177,605,94,511,13,498,13,127,164,28,8,4,0,65,9,80
7,178,435,67,368,3,365,9,76,67,69,3,0,0,26,5,110
7,179,152,20,132,0,132,13,17,32,32,1,1,0,11,1,24
7,181,1831,300,1531,35,1496,13,405,307,217,22,10,3,106,34,379
7,182,928,135,793,15,778,24,210,169,119,8,2,3,43,10,190
7,183,336,47,289,11,278,4,67,70,47,3,0,1,21,3,62
7,184,416,52,364,8,356,20,68,62,51,4,2,1,27,6,115
7,185,478,69,409,7,402,13,101,74,59,6,1,1,43,11,93
7,186,6173,1479,4694,89,4605,146,758,1004,711,51,19,10,411,74,1421
7,187,112,11,101,2,99,13,14,19,12,3,2,0,6,0,30
7,188,1122,111,1011,29,982,25,230,232,127,17,7,3,106,18,217
7,189,217,14,203,4,199,15,17,60,35,3,0,0,12,4,53
7,190,178,18,160,3,157,4,35,26,33,1,1,0,8,5,44
7,191,1611,266,1345,31,1314,18,297,276,207,17,7,4,99,22,367
7,192,273,34,239,11,228,5,35,93,18,3,0,0,25,5,44
7,193,158,20,138,0,138,7,30,32,24,0,2,1,8,3,31
7,194,319,32,287,6,281,11,38,77,40,1,2,0,16,1,95
7,195,82,9,73,2,71,1,2,20,12,0,0,0,15,1,20
7,196,199,21,178,6,172,15,23,29,41,9,0,0,15,2,38
7,197,2087,228,1859,32,1827,53,410,436,195,36,16,7,201,47,426
7,198,747,81,666,12,654,14,140,138,106,9,14,3,70,10,150
7,199,983,158,825,11,814,33,134,197,103,10,5,0,87,8,237
7,200,85,16,69,0,69,1,17,20,5,1,2,0,8,2,13
7,201,1833,375,1458,26,1432,30,345,391,176,18,15,2,112,29,314
7,202,167,33,134,3,131,8,7,30,37,2,2,0,8,0,37
7,203,132,16,116,2,114,4,24,24,10,2,2,0,29,0,19
7,204,2087,381,1706,43,1663,22,223,394,201,34,20,9,187,23,550
7,205,1040,121,919,17,902,29,226,196,142,15,6,2,93,19,174
7,206,86,19,67,2,65,2,18,15,1,2,0,0,13,3,11
7,207,793,108,685,15,670,29,126,160,98,13,2,2,47,7,186
7,208,94,10,84,2,82,4,9,19,12,3,0,0,11,2,22
7,209,77,25,52,1,51,3,6,17,4,0,1,0,14,1,5
7,210,449,62,387,6,381,34,59,57,91,7,2,0,19,2,110
7,211,380,45,335,11,324,17,48,65,63,6,6,0,20,4,95
7,212,202,32,170,2,168,6,46,54,19,5,0,0,10,4,24
7,213,135,18,117,1,116,17,7,26,28,2,1,0,4,2,29
7,214,147,25,122,2,120,6,12,24,22,1,0,0,10,2,43
7,215,190,30,160,5,155,8,34,40,19,3,2,1,15,4,29
7,216,421,49,372,11,361,9,50,107,58,3,3,0,29,21,81
7,217,632,78,554,12,542,16,150,157,35,5,4,1,63,8,103
7,218,295,44,251,8,243,9,57,61,27,3,1,0,19,2,64
7,219,216,31,185,3,182,6,33,30,39,5,0,2,16,5,46
7,220,112,17,95,3,92,5,10,18,19,3,2,1,6,1,27
7,221,211,28,183,5,178,9,46,39,15,1,0,0,13,5,50
7,222,181,14,167,3,164,0,15,53,21,2,0,0,32,1,40
7,223,116,12,104,2,102,4,10,23,19,4,0,1,6,0,35
7,224,252,44,208,4,204,3,64,56,8,1,0,0,26,4,42
7,225,850,107,743,16,727,19,111,251,65,11,6,4,104,27,129
7,226,113,20,93,3,90,4,8,31,9,3,0,0,16,0,19
7,227,907,108,799,22,777,16,188,195,81,12,1,1,105,23,155
7,228,606,76,530,9,521,15,87,127,71,5,5,1,62,14,134
7,229,591,72,519,9,510,7,111,128,49,12,5,3,54,9,132
7,230,284,35,249,7,242,11,38,47,46,9,3,0,23,2,63
7,231,1842,237,1605,35,1570,30,295,422,187,15,5,4,155,30,427
7,232,320,59,261,1,260,3,70,80,15,4,0,1,34,0,53
7,233,181,35,146,0,146,15,17,36,30,2,4,0,6,3,33
7,234,181,19,162,5,157,0,30,48,21,1,1,1,22,3,30
7,235,210,30,180,5,175,2,28,60,18,0,1,0,30,4,32
7,236,890,111,779,12,767,22,139,246,71,8,5,3,87,23,163
7,237,541,89,452,8,444,16,73,99,69,6,4,1,39,12,125
7,238,234,32,202,5,197,5,37,36,43,3,0,1,14,4,54
7,239,96,17,79,1,78,5,17,14,11,0,0,0,6,1,24
7,240,1516,179,1337,22,1315,22,247,335,136,27,6,1,131,19,391
7,241,477,54,423,6,417,19,108,81,61,9,6,0,37,5,91
7,242,94,14,80,2,78,0,19,19,7,2,0,0,15,5,11
7,243,212,35,177,3,174,5,52,27,20,5,2,1,20,9,33
7,244,211,37,174,0,174,9,19,21,54,3,1,0,11,0,56
7,245,1952,230,1722,20,1702,35,320,462,202,22,3,2,209,23,424
7,247,470,65,405,7,398,13,73,73,65,6,2,0,32,9,125
7,248,221,24,197,3,194,6,24,49,31,1,0,0,24,1,58
7,249,110,24,86,3,83,1,17,24,10,1,0,2,6,2,20
7,250,330,43,287,9,278,8,64,50,47,4,2,0,29,4,70
7,251,150,31,119,2,117,1,25,11,31,2,0,0,14,4,29
7,252,171,33,138,3,135,6,24,45,11,5,1,1,14,2,26
7,253,177,33,144,1,143,9,15,40,20,3,0,0,13,5,38
7,254,672,81,591,15,576,34,114,106,105,7,1,2,38,14,155
7,255,982,171,811,13,798,23,234,141,82,16,5,3,61,22,211
7,256,292,51,241,10,231,9,28,79,33,9,0,0,15,5,53
7,257,94,6,88,1,87,1,6,13,13,1,4,0,11,3,35
7,258,226,33,193,1,192,7,60,39,17,4,0,0,24,3,38
7,259,1215,177,1038,25,1013,11,289,248,121,9,5,1,81,26,222
7,260,658,73,585,14,571,20,161,110,93,16,4,1,53,16,97
7,261,1197,158,1039,22,1017,38,181,259,128,15,6,0,106,17,267
7,262,138,16,122,2,120,6,17,32,23,1,1,0,18,0,22
7,263,119,28,91,1,90,7,7,17,11,2,2,0,11,0,33
7,264,1818,126,1692,33,1659,46,495,420,184,12,8,2,139,34,319
7,265,997,83,914,21,893,15,279,173,94,12,9,1,79,21,210
7,266,101,9,92,2,90,9,12,15,12,1,4,0,10,3,24
7,267,261,50,211,2,209,5,43,55,21,3,1,1,21,3,56
7,268,751,99,652,11,641,10,122,205,80,19,1,1,58,14,131
7,269,996,150,846,27,819,15,123,210,132,9,6,1,71,7,245
7,270,355,36,319,5,314,5,56,50,69,7,0,1,36,5,85
7,272,251,29,222,5,217,5,38,63,22,2,0,0,24,2,61
7,273,173,20,153,1,152,1,22,34,53,1,1,0,15,0,25
7,274,165,28,137,3,134,3,25,9,39,3,2,0,11,5,37
7,275,97,17,80,1,79,4,6,16,15,1,1,0,8,1,27
7,276,188,17,171,4,167,4,33,30,24,1,4,1,20,7,43
7,277,127,22,105,5,100,4,20,15,23,4,0,0,4,0,30
7,278,309,48,261,8,253,18,16,27,87,6,1,2,20,6,70
7,279,1386,169,1217,20,1197,20,314,254,177,17,8,3,96,23,285
7,280,761,109,652,11,641,26,133,135,151,4,3,2,30,11,146
7,281,5655,797,4858,78,4780,158,727,1476,432,57,24,16,570,99,1221
7,282,394,66,328,31,297,6,90,87,24,0,0,3,20,8,59
7,283,52,4,48,0,48,4,10,15,8,0,0,0,4,0,7
7,284,133,25,108,3,105,2,13,28,20,5,0,0,11,1,25
7,285,86,28,58,1,57,2,7,30,7,1,1,0,3,1,5
7,286,395,49,346,14,332,21,56,94,43,4,1,0,31,6,76
7,287,232,18,214,5,209,9,30,57,25,1,1,0,22,5,59
7,288,966,110,856,22,834,18,163,139,111,11,5,0,74,20,293
7,289,1309,210,1099,14,1085,32,234,242,151,7,9,4,80,15,311
7,290,210,28,182,4,178,9,43,39,31,2,1,0,16,2,35
7,291,745,100,645,10,635,24,187,131,83,7,2,4,33,14,150
7,292,786,83,703,14,689,14,178,141,91,13,10,3,81,12,146
7,293,547,47,500,7,493,31,104,112,53,2,1,2,70,18,100
7,294,433,49,384,7,377,7,91,89,74,2,2,4,29,5,74
7,295,937,149,788,18,770,14,139,177,99,9,6,4,61,11,250
7,296,1256,215,1041,16,1025,26,194,240,152,22,8,2,99,19,263
7,297,364,46,318,7,311,15,64,106,40,3,0,3,34,6,40
7,298,614,75,539,15,524,17,99,105,50,7,3,1,57,4,181
7,299,140,22,118,1,117,4,24,24,19,2,3,0,16,3,22
7,300,335,36,299,5,294,2,62,65,56,3,0,1,26,3,76
7,301,741,98,643,13,630,13,149,145,69,7,6,1,86,13,141
7,302,647,90,557,16,541,17,108,103,70,5,3,3,32,18,182
7,303,208,26,182,2,180,13,15,26,31,3,0,0,18,7,67
7,304,524,80,444,7,437,9,63,88,85,9,0,1,24,11,147
7,305,282,38,244,8,236,8,26,56,56,4,0,0,19,5,62
7,306,191,15,176,0,176,2,38,51,31,2,2,0,8,1,41
7,307,378,64,314,5,309,17,51,54,62,6,5,1,23,11,79
7,308,1570,251,1319,28,1291,33,310,252,146,20,5,2,126,38,359
7,309,1223,181,1042,24,1018,20,213,262,112,15,12,4,112,34,234
7,310,653,68,585,13,572,14,131,145,62,10,6,2,81,6,115
7,311,124,18,106,2,104,8,6,22,24,2,1,0,8,5,28
7,312,375,42,333,12,321,5,65,70,36,4,2,2,30,10,97
7,313,782,130,652,11,641,8,145,172,107,12,3,2,42,17,133
7,314,319,31,288,1,287,15,31,60,52,8,2,0,43,5,71
7,315,365,61,304,6,298,14,29,57,52,8,0,0,29,7,102
7,316,1657,203,1454,36,1418,29,239,438,151,12,5,4,151,33,356
7,317,769,92,677,16,661,6,157,162,76,16,10,1,83,11,139
7,318,165,28,137,1,136,8,27,39,21,3,1,1,8,0,28
7,319,5865,1177,4688,65,4623,60,1256,850,668,52,24,13,320,76,1304
7,321,181,36,145,4,141,3,35,31,17,2,3,0,14,3,33
7,322,928,138,790,16,774,10,188,212,148,7,4,4,48,12,141
7,323,1301,167,1134,18,1116,43,239,248,138,15,5,5,99,32,292
7,324,7381,1358,6023,114,5909,131,992,1596,749,62,26,16,580,110,1647
7,325,1436,170,1266,26,1240,40,256,337,188,10,4,4,109,24,268
7,326,125,19,106,0,106,7,30,27,9,0,2,0,11,1,19
7,327,327,56,271,5,266,3,51,73,41,7,1,2,17,3,68
7,328,391,57,334,5,329,3,65,66,73,1,2,0,18,10,91
7,329,291,47,244,2,242,14,44,48,62,6,0,0,15,2,51
7,330,1922,347,1575,31,1544,52,263,326,308,25,10,3,82,30,445
7,331,3122,612,2510,52,2458,56,493,663,374,26,16,4,167,37,622
7,332,382,50,332,5,327,12,45,94,46,8,1,1,28,3,89
7,333,702,87,615,18,597,17,133,125,84,11,9,2,66,12,138
7,334,2189,369,1820,29,1791,71,255,424,324,14,12,4,129,26,532
7,335,169,23,146,7,139,7,38,37,19,1,0,0,8,2,27
7,336,189,27,162,6,156,10,13,31,26,4,3,0,15,4,50
7,337,1745,203,1542,37,1505,49,352,335,183,26,7,4,173,34,342
7,338,1375,189,1186,28,1158,25,198,342,115,19,7,4,72,28,348
7,339,1257,159,1098,12,1086,33,221,248,178,11,10,5,79,12,289
7,340,1339,174,1165,18,1147,29,174,230,172,17,3,4,115,25,378
7,341,1814,281,1533,31,1502,43,326,309,284,19,6,0,132,29,354
7,342,921,105,816,10,806,11,239,156,96,14,8,0,78,15,189
7,343,997,138,859,7,852,35,148,169,166,13,5,0,72,13,231
7,344,277,20,257,2,255,12,48,64,23,6,4,0,26,6,66
7,345,703,94,609,10,599,13,116,129,82,7,4,1,49,12,186
7,346,2799,443,2356,43,2313,61,611,446,331,25,8,7,179,53,592
7,347,517,114,403,10,393,6,106,82,57,7,2,5,30,9,89
7,348,680,80,600,17,583,23,102,138,104,6,2,0,40,10,158
7,349,3655,853,2802,60,2742,50,639,449,458,40,21,8,193,61,823
8,1,338,44,294,6,288,1,68,90,18,0,1,0,25,9,76
8,3,1320,173,1147,17,1130,26,289,281,77,9,4,2,100,22,320
8,4,144,15,129,2,127,4,11,54,16,2,2,1,15,2,20
8,5,79,8,71,2,69,1,13,33,2,0,0,0,13,1,6
8,6,190,25,165,5,160,0,43,48,14,1,1,1,13,3,36
8,7,64,14,50,1,49,2,7,13,8,0,1,1,6,0,11
8,8,483,83,400,10,390,10,120,64,35,12,4,0,32,18,95
8,9,152,24,128,0,128,1,34,29,15,3,1,0,10,4,31
8,10,120,17,103,2,101,1,27,33,6,0,0,0,4,6,24
8,11,179,41,138,5,133,1,42,12,17,0,1,1,14,0,45
8,13,320,51,269,3,266,3,73,40,33,5,5,0,14,8,85
8,14,96,10,86,4,82,3,12,33,3,0,0,0,11,4,16
8,15,101,11,90,3,87,0,17,34,6,1,0,1,5,2,21
8,16,168,31,137,2,135,1,35,33,10,2,0,0,11,7,36
8,17,106,15,91,4,87,0,20,29,5,0,0,2,5,2,24
8,18,66,9,57,0,57,3,21,20,1,0,0,1,3,0,8
8,19,47,5,42,4,38,1,3,12,8,0,0,0,5,0,9
8,20,51,8,43,0,43,0,9,14,6,1,0,0,4,4,5
8,21,140,23,117,5,112,2,33,33,4,0,1,2,9,2,26
8,22,261,32,229,3,226,3,48,54,14,1,1,0,29,3,73
8,23,56,5,51,1,50,1,14,14,3,0,2,0,10,1,5
8,24,786,126,660,9,651,4,151,209,47,11,7,2,69,18,133
8,25,821,178,643,13,630,11,177,159,48,8,10,1,44,11,161
8,26,230,33,197,0,197,2,72,57,14,3,2,1,14,3,29
8,27,93,20,73,2,71,1,19,16,2,4,2,0,8,2,17
8,28,633,99,534,3,531,4,88,70,72,6,6,0,46,18,221
8,29,55,6,49,1,48,1,14,17,0,1,0,0,5,3,7
8,30,65,12,53,0,53,3,9,24,4,0,0,2,1,1,9
8,31,42,3,39,1,38,0,11,15,1,0,0,0,8,1,2
8,32,139,20,119,1,118,0,33,46,4,1,0,0,9,3,22
8,33,73,10,63,0,63,0,2,30,1,0,1,1,13,2,13
8,34,245,38,207,2,205,2,36,62,20,6,0,0,14,9,56
8,35,54,18,36,1,35,1,5,13,5,1,0,0,4,0,6
8,36,129,26,103,0,103,1,31,17,9,1,0,1,11,3,29
8,37,567,104,463,11,452,4,144,95,30,6,3,1,19,9,141
8,38,227,48,179,4,175,3,43,51,12,2,0,0,20,3,41
8,39,385,85,300,6,294,2,95,76,21,4,2,1,24,3,66
8,40,571,95,476,9,467,2,106,125,51,0,3,1,42,10,127
8,41,190,39,151,3,148,0,47,38,11,3,0,1,10,4,34
8,42,174,35,139,1,138,1,41,51,7,1,0,0,13,2,22
8,43,1311,259,1052,21,1031,13,233,293,78,11,8,6,71,22,296
8,44,79,16,63,2,61,0,9,10,8,5,0,0,7,2,20
8,45,211,31,180,1,179,5,54,56,9,5,3,0,8,9,30
8,46,124,11,113,3,110,0,29,39,6,1,0,0,18,1,16
8,47,97,19,78,1,77,4,26,17,10,1,0,0,4,1,14
8,48,290,28,262,2,260,2,54,100,13,1,1,1,35,11,42
8,49,84,8,76,2,74,6,18,17,2,3,2,0,9,0,17
8,52,107,16,91,1,90,1,20,34,4,0,0,0,9,1,21
8,53,1306,243,1063,14,1049,9,284,245,99,14,6,3,85,19,285
8,55,305,50,255,1,254,3,97,57,19,0,2,0,16,5,55
8,56,47,14,33,1,32,0,8,9,4,0,1,0,5,2,3
8,57,177,33,144,3,141,0,32,50,14,2,2,0,8,5,28
8,58,173,23,150,0,150,7,26,54,16,5,0,0,9,4,29
8,59,36,7,29,1,28,0,3,13,3,1,0,0,2,1,5
8,60,164,12,152,1,151,2,31,61,15,2,0,0,16,3,21
8,61,40,6,34,0,34,1,10,13,0,0,0,0,7,0,3
8,62,120,13,107,3,104,0,26,46,2,1,1,0,9,6,13
8,63,98,17,81,2,79,5,24,21,4,1,0,0,8,1,15
8,64,219,29,190,1,189,0,43,55,14,2,1,0,20,8,46
8,65,54,7,47,0,47,1,13,18,3,0,1,0,7,2,2
8,66,54,5,49,3,46,0,8,22,1,0,1,0,8,0,6
8,67,896,218,678,17,661,4,161,139,74,13,6,1,36,18,209
8,69,142,14,128,0,128,0,31,39,7,0,0,0,8,6,37
8,70,241,44,197,4,193,2,60,55,10,2,1,0,26,4,33
8,71,100,20,80,1,79,4,17,33,8,0,1,0,7,2,7
8,72,334,52,282,4,278,5,74,73,18,2,4,1,17,6,78
8,73,82,11,71,1,70,2,17,28,4,1,2,1,2,1,12
8,74,55,5,50,0,50,0,16,20,2,0,1,0,7,0,4
8,75,119,24,95,3,92,12,19,15,12,3,0,0,7,0,24
8,76,782,162,620,10,610,5,191,124,44,16,4,0,44,10,172
8,77,47,4,43,1,42,0,13,11,4,0,0,0,2,2,10
8,78,599,127,472,6,466,2,171,98,17,2,3,0,28,6,139
8,79,229,58,171,1,170,4,53,19,21,3,3,1,13,2,51
8,80,82,7,75,0,75,1,15,27,3,1,0,0,15,3,10
8,81,3669,948,2721,42,2679,38,843,373,333,43,23,11,114,32,869
8,82,74,10,64,0,64,0,10,31,2,1,0,0,6,0,14
8,83,274,42,232,5,227,0,59,43,31,7,11,0,12,3,61
8,84,142,20,122,1,121,1,31,49,8,2,0,2,10,0,18
8,85,155,22,133,4,129,0,48,36,5,3,1,0,13,2,21
8,86,92,10,82,1,81,0,28,31,2,0,0,0,3,0,17
8,87,90,21,69,2,67,3,25,20,2,0,0,0,6,2,9
8,88,106,19,87,2,85,1,10,24,22,1,0,0,9,1,17
8,89,314,86,228,3,225,2,51,60,16,1,2,1,40,6,46
8,90,2175,546,1629,20,1609,13,381,351,156,23,17,6,143,26,493
8,92,143,18,125,4,121,0,25,56,4,0,2,2,11,4,17
8,94,40,10,30,0,30,0,5,13,2,0,1,0,4,0,5
8,95,143,22,121,4,117,4,27,31,6,4,0,0,11,8,26
8,96,514,80,434,6,428,4,104,142,29,4,4,1,38,6,96
8,97,354,75,279,7,272,1,84,52,32,1,0,0,19,6,77
8,98,67,7,60,1,59,2,15,18,3,0,0,0,6,0,15
8,99,102,13,89,5,84,2,13,39,5,1,0,0,7,1,16
8,100,55,1,54,0,54,1,9,20,4,1,1,0,5,1,12
8,101,124,16,108,1,107,0,19,37,7,3,0,0,9,0,32
8,102,81,11,70,0,70,3,24,17,2,3,0,0,2,4,15
8,103,176,22,154,1,153,5,39,44,17,3,2,0,10,4,29
8,104,40,10,30,0,30,1,1,7,2,2,0,0,2,0,15
8,105,29975,8236,21739,330,21409,341,4176,4793,2287,272,150,45,1603,303,7439
8,106,76,13,63,0,63,1,16,13,4,1,0,1,5,0,22
8,107,884,176,708,15,693,10,171,187,54,3,11,0,52,21,184
8,109,153,28,125,1,124,1,25,46,11,2,1,1,4,4,29
8,110,129,23,106,1,105,0,45,29,4,0,1,1,4,2,19
8,111,472,73,399,7,392,4,94,123,23,3,3,1,35,9,97
8,113,376,92,284,5,279,2,97,83,11,2,3,1,23,7,50
8,114,108,7,101,3,98,2,27,21,5,0,1,0,9,4,29
8,115,353,73,280,3,277,4,65,94,18,1,3,0,43,3,46
8,116,734,146,588,10,578,5,140,187,45,8,10,1,49,16,117
8,117,109,17,92,3,89,1,14,23,14,3,3,0,10,0,21
8,119,316,37,279,10,269,7,60,66,22,7,0,0,31,5,71
8,120,58,7,51,0,51,4,10,17,4,2,1,1,4,0,8
8,121,115,25,90,3,87,2,25,24,11,0,0,0,6,3,16
8,122,602,103,499,9,490,6,120,101,47,7,2,2,39,9,157
8,123,61,9,52,0,52,0,18,13,4,0,0,0,6,0,11
8,124,278,34,244,10,234,3,59,53,26,0,1,0,25,5,62
8,125,227,31,196,5,191,3,46,60,14,4,0,1,19,4,40
8,126,163,33,130,1,129,1,33,37,14,3,2,0,8,1,30
8,128,69,14,55,0,55,0,19,17,8,1,2,0,2,1,5
8,130,65,14,51,2,49,0,13,21,1,0,0,1,5,1,7
8,131,78,9,69,1,68,1,12,30,6,0,0,0,5,1,13
8,132,116,23,93,0,93,0,27,31,9,1,1,2,3,1,18
8,133,339,54,285,2,283,2,84,54,17,3,3,0,16,6,98
8,134,83,11,72,0,72,1,10,38,3,0,0,0,12,0,8
8,135,106,12,94,1,93,1,21,22,6,1,2,1,8,6,25
8,136,239,46,193,3,190,1,46,38,18,5,0,0,12,2,68
8,137,315,30,285,4,281,6,45,102,28,3,0,0,20,5,72
8,138,150,23,127,1,126,0,45,46,3,0,0,0,9,0,23
8,139,755,130,625,15,610,4,135,77,128,10,6,0,33,5,212
8,140,838,169,669,5,664,3,166,152,67,9,3,1,40,19,204
8,141,150,15,135,3,132,1,39,47,10,0,0,0,11,2,22
8,142,1716,343,1373,31,1342,15,329,275,164,19,13,3,89,18,417
8,143,75,11,64,0,64,0,13,24,4,0,0,0,7,0,16
8,144,52,7,45,0,45,0,10,13,2,1,2,1,6,2,8
8,145,1221,188,1033,20,1013,8,265,197,117,19,9,2,75,19,302
8,146,74,11,63,0,63,2,20,19,1,0,0,0,2,1,18
8,147,52,13,39,0,39,0,10,13,2,1,0,0,2,0,11
8,148,133,16,117,0,117,1,37,35,5,1,0,0,8,2,28
8,149,124,18,106,1,105,3,31,35,6,0,2,0,15,0,13
8,150,137,20,117,0,117,1,20,33,18,5,2,0,14,3,21
8,151,221,21,200,2,198,5,40,64,12,0,0,0,14,7,56
8,152,67,7,60,3,57,0,11,17,5,1,0,0,6,3,14
8,153,244,49,195,1,194,1,49,45,10,2,2,1,20,4,60
8,154,70,14,56,0,56,0,3,31,7,1,0,0,7,2,5
8,155,75,14,61,2,59,0,20,24,2,1,0,0,2,0,10
8,156,331,42,289,2,287,5,102,79,24,1,4,0,15,7,50
8,158,195,17,178,1,177,3,39,46,29,0,4,1,12,3,40
8,159,81,13,68,1,67,0,18,38,0,0,1,0,2,0,8
8,160,156,19,137,2,135,5,33,35,14,1,1,0,15,4,27
8,161,25,2,23,0,23,3,3,10,0,0,0,0,2,0,5
8,162,299,33,266,5,261,10,69,83,18,2,2,0,8,10,59
8,163,190,40,150,3,147,1,43,48,14,3,1,1,15,3,18
8,164,263,35,228,3,225,3,56,49,22,2,2,0,13,5,73
8,165,46,8,38,0,38,1,7,12,0,0,0,0,8,2,8
8,166,183,25,158,1,157,1,31,40,9,2,1,2,3,1,67
8,167,77,18,59,1,58,2,10,15,6,3,2,0,7,0,13
8,168,134,18,116,1,115,1,38,37,0,1,4,2,6,1,25
8,169,114,29,85,1,84,1,28,28,4,0,0,0,11,3,9
8,170,153,21,132,2,130,2,31,34,8,2,3,2,9,0,39
8,171,85,11,74,2,72,2,26,21,3,1,0,0,4,1,14
8,172,140,42,98,0,98,2,43,14,5,1,0,0,2,2,29
8,173,825,133,692,5,687,10,194,167,68,6,1,1,64,16,160
8,174,1769,312,1457,21,1436,13,350,359,120,13,9,3,112,30,427
8,175,170,28,142,1,141,2,35,30,14,0,1,0,17,3,39
8,176,53,13,40,2,38,0,9,15,2,0,0,0,7,1,4
8,178,178,35,143,3,140,0,37,50,8,2,3,0,9,1,30
8,179,441,80,361,4,357,5,92,75,31,8,3,0,23,5,115
8,180,1169,179,990,17,973,7,229,209,85,20,4,5,75,14,325
8,182,69,19,50,1,49,0,9,13,2,2,0,0,2,2,19
8,183,780,190,590,4,586,2,125,143,58,7,2,1,33,11,204
8,184,66,16,50,1,49,0,19,19,2,1,0,0,2,0,6
8,185,2703,805,1898,25,1873,9,344,393,224,30,6,3,73,14,777
8,186,42,15,27,0,27,0,8,1,4,1,0,0,4,0,9
8,187,277,38,239,2,237,3,63,62,18,3,1,0,37,3,47
8,188,854,139,715,13,702,10,221,116,76,10,10,2,49,10,198
8,189,120,25,95,2,93,0,34,20,6,3,1,0,13,7,9
8,190,4237,1084,3153,51,3102,37,564,613,318,42,17,6,177,57,1271
8,191,844,164,680,11,669,18,136,208,57,8,3,1,56,17,165
8,192,78,13,65,3,62,1,13,25,0,0,0,1,5,0,17
8,193,178,16,162,2,160,1,32,43,13,2,4,3,20,6,36
8,194,641,102,539,10,529,5,122,137,42,5,6,3,40,12,157
8,195,244,42,202,7,195,0,44,57,28,3,0,0,13,3,47
8,196,67,12,55,0,55,0,21,9,2,2,0,0,2,2,17
8,197,53,11,42,0,42,2,9,9,1,4,1,0,3,1,12
8,198,326,39,287,4,283,4,52,91,17,2,0,1,31,14,71
8,199,565,75,490,8,482,4,171,112,22,2,4,2,19,10,136
8,200,146,19,127,0,127,2,40,48,2,3,1,0,13,2,16
8,201,67,9,58,0,58,1,11,16,3,1,0,0,9,2,15
8,202,359,89,270,5,265,0,58,89,15,5,1,0,19,2,76
8,203,215,33,182,3,179,5,38,48,16,2,1,0,19,7,43
8,204,81,13,68,1,67,0,18,16,6,0,0,0,6,8,13
8,205,54,8,46,1,45,0,20,13,5,0,1,0,5,0,1
8,206,278,36,242,2,240,0,91,61,11,1,3,1,19,4,49
8,207,180,50,130,0,130,5,47,30,5,0,1,1,13,4,24
8,208,140,23,117,3,114,4,22,22,9,0,0,0,9,1,47
8,209,358,43,315,1,314,5,80,73,37,7,4,1,24,0,83
8,210,91,10,81,0,81,1,13,37,3,3,1,0,3,1,19
8,211,578,106,472,10,462,4,103,101,39,4,2,0,40,11,158
8,212,355,67,288,2,286,4,95,69,19,2,5,1,24,8,59
8,214,377,71,306,4,302,2,88,77,33,5,0,4,15,9,69
8,215,43,9,34,0,34,0,5,13,3,0,1,0,3,0,9
8,216,212,26,186,2,184,1,48,66,9,2,0,1,22,2,33
8,217,71,10,61,4,57,2,9,10,11,1,1,0,2,0,21
8,218,1149,262,887,8,879,8,269,221,78,10,10,3,49,14,217
8,219,84,13,71,1,70,0,23,20,0,2,1,0,12,3,9
8,220,220,29,191,4,187,0,47,67,14,3,1,0,23,7,25
8,222,1488,259,1229,26,1203,9,321,284,113,15,11,6,56,17,371
8,223,89,12,77,0,77,1,17,25,6,0,0,0,17,1,10
8,225,139,19,120,1,119,1,28,44,11,0,0,1,11,6,17
8,226,164,36,128,2,126,1,32,43,17,1,0,1,11,0,20
8,228,132,13,119,3,116,0,33,34,9,1,0,4,9,2,24
8,229,105,8,97,1,96,2,21,40,11,1,1,0,7,0,13
8,230,250,30,220,4,216,0,71,63,12,1,1,0,17,2,49
8,232,308,49,259,11,248,3,75,49,21,2,1,0,12,5,80
8,233,42,4,38,0,38,0,2,14,3,2,0,0,6,1,10
8,234,74,13,61,3,58,1,16,17,2,4,0,1,8,0,9
8,235,327,30,297,2,295,5,108,63,27,1,1,1,13,1,75
8,236,179,21,158,2,156,0,40,47,9,0,2,0,16,0,42
8,237,545,74,471,13,458,6,103,84,63,6,0,0,29,8,159
8,238,66,7,59,3,56,4,18,20,1,1,0,0,7,1,4
8,239,823,105,718,10,708,14,185,201,41,7,5,1,82,16,156
8,240,135,19,116,1,115,4,52,21,9,5,0,0,6,2,16
8,242,393,75,318,7,311,2,103,53,24,3,1,1,11,0,113
8,243,161,17,144,2,142,1,27,51,13,4,2,0,15,1,28
8,244,77,14,63,0,63,0,15,17,4,0,1,0,7,1,18
8,245,46,7,39,1,38,0,12,12,2,0,0,0,2,0,10
8,246,86,14,72,2,70,0,23,29,0,1,0,0,7,0,10
8,247,121,31,90,1,89,3,8,15,7,2,2,0,8,5,39
8,248,487,118,369,10,359,3,116,74,19,2,1,3,36,7,98
8,249,181,29,152,8,144,0,47,41,10,2,1,0,8,1,34
8,250,131,13,118,1,117,0,25,57,1,2,3,0,17,1,11
8,251,74,7,67,2,65,0,20,26,3,0,1,0,5,0,10
8,252,92,9,83,2,81,1,19,17,8,3,1,0,9,3,20
8,254,398,58,340,7,333,5,99,77,19,3,1,2,24,7,96
8,255,161,33,128,3,125,1,36,22,13,2,0,1,7,1,42
8,256,76,10,66,0,66,0,16,31,1,0,0,0,7,1,10
8,257,134,25,109,2,107,5,40,30,13,1,1,0,5,0,12
8,259,86,13,73,2,71,1,22,18,3,3,1,0,6,0,17
8,260,404,51,353,4,349,3,98,105,32,0,4,2,30,8,67
8,261,73,10,63,0,63,1,6,21,4,0,1,0,12,2,16
8,262,390,79,311,6,305,5,90,82,17,2,5,1,15,8,80
8,263,849,127,722,7,715,7,173,126,81,14,2,4,42,12,254
8,264,322,43,279,4,275,2,79,88,17,2,3,0,23,6,55
8,267,168,26,142,2,140,1,36,48,12,1,0,0,16,3,23
8,268,47,5,42,0,42,0,5,15,1,0,0,0,10,2,9
8,269,54,8,46,1,45,0,11,2,7,0,0,0,6,0,19
8,271,78,15,63,1,62,1,28,23,2,0,0,0,4,0,4
8,272,53,12,41,0,41,0,8,20,3,0,0,0,5,0,5
8,273,66,12,54,0,54,1,11,19,2,1,0,0,5,2,13
8,274,93,18,75,2,73,3,12,27,2,0,2,0,9,1,17
8,275,111,32,79,0,79,0,19,36,3,0,0,1,9,0,11
8,276,580,129,451,9,442,7,153,99,34,4,3,2,25,2,113
8,277,98,18,80,1,79,0,19,29,2,0,2,0,6,2,19
8,278,66,6,60,3,57,1,17,12,3,2,2,0,7,0,13
8,279,44,3,41,1,40,0,12,17,0,0,0,0,4,0,7
8,280,51,9,42,0,42,0,7,21,0,0,0,0,11,0,3
8,281,313,72,241,5,236,3,73,49,18,2,1,0,20,6,64
8,282,715,117,598,8,590,5,181,185,31,5,1,2,40,11,129
8,283,107,11,96,0,96,0,26,33,4,0,0,0,13,2,18
8,284,665,93,572,15,557,4,156,124,61,5,5,2,31,6,163
8,286,94,10,84,1,83,0,15,40,5,1,2,0,11,1,8
8,287,106,9,97,0,97,0,16,43,2,0,0,0,15,2,19
8,288,91,15,76,1,75,2,25,23,5,2,1,0,4,3,10
8,289,389,73,316,6,310,5,86,58,38,8,2,0,29,12,72
8,291,94,20,74,1,73,5,11,25,6,0,1,0,15,3,7
8,293,128,20,108,2,106,2,28,36,8,1,0,0,9,3,19
8,294,107,16,91,2,89,2,26,25,6,0,0,0,4,1,25
8,295,148,23,125,0,125,2,35,49,9,1,0,0,3,2,24
8,296,97,8,89,2,87,0,27,31,3,0,0,0,11,4,11
8,297,204,47,157,1,156,3,47,30,17,1,3,0,16,4,35
8,298,1256,199,1057,15,1042,14,211,271,95,12,10,3,83,17,326
8,300,21,3,18,0,18,1,4,7,4,0,0,0,2,0,0
8,301,60,12,48,2,46,1,9,15,5,1,0,0,2,1,12
8,302,1713,319,1394,29,1365,22,334,244,211,10,16,5,61,14,448
8,303,266,38,228,6,222,2,58,84,16,3,0,0,20,7,32
8,304,74,22,52,0,52,1,15,14,3,0,2,0,4,2,11
8,305,177,28,149,2,147,1,41,49,6,4,0,0,13,2,31
8,306,48,12,36,0,36,0,7,13,3,0,0,0,4,2,7
8,307,75,12,63,1,62,1,15,24,4,0,1,0,1,2,14
8,308,58,9,49,1,48,1,10,23,0,0,0,1,3,4,6
8,309,40,2,38,2,36,0,6,11,0,0,0,1,11,1,6
8,310,63,11,52,0,52,1,16,12,1,3,1,0,3,1,14
8,311,1605,357,1248,26,1222,7,259,289,95,19,20,0,112,38,383
8,312,121,14,107,5,102,0,23,40,6,1,1,0,11,0,20
8,313,117,22,95,1,94,2,17,31,5,0,0,0,18,0,21
8,314,495,68,427,2,425,2,95,139,28,3,1,0,49,7,101
8,315,47,6,41,1,40,0,9,15,1,0,1,0,11,0,3
8,316,842,107,735,11,724,11,175,122,80,12,5,5,37,16,261
8,317,82,17,65,1,64,1,19,19,8,1,2,0,5,2,7
8,318,251,60,191,4,187,1,46,37,36,1,0,0,15,3,48
8,319,253,29,224,4,220,2,64,51,14,2,1,1,24,3,58
8,320,392,74,318,9,309,3,71,133,19,3,0,0,42,5,33
8,321,149,25,124,1,123,3,31,41,10,0,0,0,11,1,26
8,322,319,56,263,9,254,4,67,78,18,3,3,0,10,10,61
8,323,139,19,120,4,116,4,41,24,7,0,2,0,16,0,22
8,324,104,21,83,0,83,4,20,17,10,2,0,0,11,0,19
8,325,29,1,28,0,28,0,12,7,4,1,0,0,2,1,1
8,326,117,14,103,3,100,2,18,28,11,5,2,0,10,2,22
8,327,1653,256,1397,28,1369,14,351,203,192,17,15,2,75,24,476
8,328,4411,1134,3277,52,3225,30,810,461,411,47,17,6,159,35,1249
8,329,375,59,316,8,308,5,93,79,17,2,2,3,47,11,49
8,330,449,54,395,5,390,6,92,107,45,10,8,1,31,5,85
8,331,517,82,435,12,423,7,94,86,42,9,1,0,35,10,139
8,332,38,7,31,2,29,0,3,9,5,2,0,0,8,1,1
8,333,168,18,150,2,148,1,53,34,6,2,1,1,23,2,25
8,334,34,6,28,1,27,2,1,10,2,0,1,0,4,2,5
8,335,79,10,69,0,69,5,12,8,9,0,0,0,16,1,18
8,336,161,34,127,0,127,3,22,32,18,2,1,0,8,1,40
8,338,147,23,124,3,121,1,28,63,1,1,0,0,7,4,16
8,339,218,27,191,1,190,8,44,63,14,2,1,0,31,2,25
8,340,126,22,104,0,104,3,30,32,1,0,4,0,8,3,23
8,341,547,67,480,9,471,6,160,105,36,3,2,1,37,11,110
8,342,232,36,196,3,193,5,45,49,12,1,0,0,18,4,59
8,343,884,151,733,16,717,6,196,137,89,10,9,1,51,13,205
8,344,101,22,79,3,76,0,32,27,3,1,0,0,3,3,7
8,346,1128,189,939,15,924,10,194,273,80,4,5,1,88,25,244
8,347,204,43,161,4,157,1,44,72,12,0,1,0,12,1,14
8,348,89,10,79,1,78,0,17,39,3,0,1,0,10,0,8
8,349,426,89,337,4,333,2,81,61,33,5,3,0,24,7,117
8,350,174,34,140,2,138,0,25,42,14,3,0,0,9,8,37
8,351,58,6,52,0,52,0,5,20,6,0,3,0,2,1,15
8,352,189,39,150,0,150,2,45,42,9,4,0,0,8,2,38
8,353,505,96,409,9,400,0,91,81,46,5,1,3,34,7,132
8,354,637,79,558,8,550,4,139,115,56,7,6,2,50,12,159
8,355,253,61,192,1,191,1,43,59,8,6,1,3,15,9,46
8,356,104,14,90,1,89,1,31,29,2,0,0,1,9,2,14
8,357,609,112,497,7,490,3,147,107,55,9,0,1,48,13,107
8,358,186,24,162,4,158,1,45,48,9,0,0,0,18,3,34
8,360,159,16,143,0,143,1,25,49,7,2,1,0,4,7,47
8,361,1215,159,1056,15,1041,9,331,296,66,14,7,0,53,16,249
8,362,5100,1274,3826,79,3747,40,814,1095,310,43,15,14,332,61,1023
8,363,5111,1516,3595,69,3526,36,741,578,463,50,19,1,144,59,1435
8,364,96,6,90,0,90,2,30,15,10,2,2,0,10,1,18
8,365,936,192,744,8,736,9,265,131,60,7,8,2,49,12,193
8,366,529,109,420,3,417,5,122,108,39,2,2,0,25,7,107
8,367,1680,408,1272,23,1249,9,257,318,120,28,10,1,56,36,414
8,368,184,24,160,4,156,2,37,50,10,2,2,0,16,6,31
8,369,115,19,96,1,95,0,33,35,4,0,0,0,8,1,14
8,370,378,76,302,9,293,5,108,58,23,3,3,0,24,4,65
8,371,124,29,95,5,90,1,15,29,9,0,1,1,10,5,19
8,372,56,9,47,0,47,0,10,22,3,0,0,0,1,1,10
8,373,251,40,211,3,208,2,88,41,8,3,4,1,16,9,36
8,374,81,6,75,0,75,1,15,28,5,1,1,1,10,0,13
8,375,136,28,108,1,107,1,31,30,6,2,1,1,8,1,26
8,376,168,24,144,0,144,2,26,42,9,2,1,1,21,2,38
8,377,113,7,106,1,105,2,21,36,9,0,1,0,7,1,28
8,378,86,12,74,0,74,0,25,32,2,1,0,0,7,2,5
8,379,183,17,166,2,164,1,46,71,5,1,0,1,19,3,17
8,380,156,22,134,1,133,0,34,58,7,3,0,0,12,2,17
8,381,512,88,424,4,420,2,147,109,27,11,6,2,11,9,96
8,382,114,18,96,0,96,2,31,31,5,1,2,1,2,2,19
8,383,100,23,77,0,77,1,23,21,5,1,2,0,8,3,13
8,384,137,30,107,0,107,0,19,30,12,2,1,2,20,3,18
8,385,769,117,652,13,639,9,122,192,51,3,2,2,65,4,189
8,386,191,31,160,1,159,2,34,65,7,1,0,0,15,4,31
8,387,136,25,111,1,110,4,42,25,9,1,1,0,9,1,18
8,388,303,22,281,3,278,4,41,60,33,2,3,0,31,5,99
8,389,282,55,227,5,222,3,77,57,22,3,1,1,13,7,38
8,390,64,10,54,0,54,0,15,14,7,0,0,0,4,2,12
8,391,710,144,566,10,556,4,148,99,72,4,2,1,24,9,193
8,392,170,22,148,1,147,1,41,45,12,3,2,0,9,8,26
8,393,52,10,42,0,42,0,14,20,3,0,0,0,3,1,1
8,394,82,20,62,3,59,1,10,24,2,1,0,0,7,2,12
8,395,123,16,107,0,107,2,22,28,8,0,0,1,10,3,33
8,396,128,24,104,1,103,1,23,41,9,2,1,1,8,0,17
8,397,36,2,34,0,34,0,8,11,0,1,0,0,6,0,8
8,398,83,9,74,2,72,0,19,25,3,1,2,0,8,1,13
8,399,80,14,66,2,64,1,16,24,5,2,0,0,7,0,9
8,400,354,38,316,5,311,6,77,62,35,1,3,0,31,5,91
8,401,163,22,141,3,138,0,48,54,1,2,3,2,7,4,17
8,402,501,70,431,6,425,3,144,119,32,4,4,0,44,13,62
8,403,1267,257,1010,19,991,14,283,224,92,20,9,2,79,15,253
8,404,136,20,116,4,112,6,36,24,8,2,2,0,9,0,25
8,405,200,22,178,2,176,1,62,38,13,0,1,2,16,4,39
8,406,291,32,259,5,254,4,76,54,27,1,4,1,19,9,59
8,407,60,7,53,1,52,0,28,14,1,0,1,0,5,0,3
8,408,371,48,323,3,320,2,96,77,22,5,4,3,18,2,91
8,409,10783,2872,7911,115,7796,87,1587,1753,773,99,58,18,478,106,2837
8,410,178,18,160,1,159,0,18,88,3,2,1,0,27,2,18
8,411,87,10,77,2,75,1,29,20,2,2,0,0,5,1,15
8,412,118,19,99,1,98,0,27,31,7,2,1,0,11,1,18
8,413,209,36,173,3,170,2,52,50,17,0,0,0,9,3,37
8,415,255,54,201,4,197,3,60,61,8,5,3,2,7,2,46
8,416,126,20,106,1,105,1,32,29,4,2,1,0,11,2,23
8,417,184,32,152,1,151,1,35,44,11,1,1,0,6,10,42
8,418,203,31,172,5,167,0,34,58,14,2,0,0,15,1,43
8,419,984,147,837,21,816,9,230,167,81,20,8,3,62,16,220
8,420,982,252,730,15,715,13,220,142,77,11,9,0,42,9,192
8,421,74,13,61,0,61,0,17,28,1,0,0,0,9,2,4
8,422,112,16,96,0,96,1,21,32,5,0,2,0,10,6,19
8,424,108,15,93,1,92,0,24,37,5,3,2,0,2,2,17
8,425,46,12,34,1,33,3,6,8,2,0,0,0,5,1,8
8,426,73,8,65,1,64,0,20,19,6,1,0,0,8,3,7
8,427,185,20,165,1,164,1,25,66,6,4,0,0,24,8,30
8,428,138,10,128,2,126,2,29,34,10,0,0,1,19,4,27
8,429,398,46,352,7,345,7,130,77,27,1,1,1,11,7,83
8,430,36,5,31,0,31,0,9,6,1,0,0,0,5,6,4
8,431,87,7,80,2,78,0,19,29,4,5,0,0,9,4,8
8,432,84,11,73,0,73,2,13,28,3,0,0,1,5,1,20
8,433,61,8,53,2,51,3,8,14,1,0,1,1,12,2,9
8,434,47,7,40,2,38,1,10,17,3,0,1,0,4,0,2
8,435,730,104,626,6,620,4,129,206,35,6,8,3,75,12,142
8,436,250,67,183,2,181,2,55,37,17,0,3,1,19,2,45
8,437,173,27,146,2,144,7,37,67,5,0,0,0,10,2,16
8,438,88,11,77,1,76,0,13,35,2,1,1,0,7,1,16
8,439,124,19,105,0,105,0,23,37,9,2,1,0,11,4,18
8,440,113,28,85,0,85,0,32,18,8,2,1,0,5,1,18
8,441,103,26,77,2,75,1,19,26,1,5,0,0,7,2,14
8,443,98,10,88,0,88,0,28,25,9,0,2,1,5,0,18
8,444,77,8,69,0,69,0,17,25,4,0,0,0,11,2,10
8,445,309,53,256,1,255,1,83,66,17,2,3,0,22,3,58
8,446,75,11,64,1,63,1,9,38,2,1,0,0,6,0,6
8,448,861,155,706,13,693,8,171,186,62,8,5,2,30,14,207
8,449,444,68,376,5,371,11,109,101,24,3,8,1,34,8,72
8,450,153,23,130,0,130,1,30,52,7,2,1,1,8,5,23
8,451,243,39,204,5,199,1,55,89,4,1,0,0,13,5,31
8,452,165,23,142,1,141,2,31,50,16,2,1,0,8,3,28
8,453,85,18,67,2,65,4,27,16,1,1,0,0,3,1,12
8,454,80,23,57,1,56,3,14,20,6,0,0,0,5,0,8
8,455,59,11,48,1,47,1,17,8,3,3,2,0,9,1,3
8,456,157,16,141,1,140,0,43,29,30,2,0,0,2,1,33
8,457,830,150,680,15,665,5,182,154,57,9,2,2,49,15,190
8,458,157,17,140,0,140,2,43,30,6,2,4,2,18,3,30
8,459,89,17,72,1,71,1,27,14,7,1,0,1,4,2,14
8,460,133,20,113,1,112,0,50,17,8,1,1,0,12,4,19
8,461,167,19,148,0,148,1,47,27,4,3,4,0,9,1,52
8,462,96,9,87,0,87,2,35,23,4,2,0,0,4,1,16
8,463,52,9,43,1,42,0,8,12,0,3,0,1,2,2,14
8,464,61,7,54,0,54,0,22,14,4,0,1,0,5,1,7
8,465,46,5,41,2,39,0,10,20,1,0,0,0,1,1,6
8,466,76,8,68,0,68,2,16,17,3,1,1,0,6,0,22
8,467,99,17,82,1,81,3,26,18,2,2,0,0,7,1,22
8,468,150,20,130,2,128,1,40,40,11,2,0,0,12,0,22
8,469,359,68,291,3,288,3,88,77,17,3,1,3,26,7,63
8,470,82,12,70,0,70,0,22,26,3,2,0,0,1,3,13
8,471,28,2,26,2,24,0,6,8,3,0,0,0,2,2,3
8,472,210,38,172,4,168,2,36,56,12,7,5,0,14,3,33
8,473,196,28,168,4,164,2,55,51,8,2,2,0,18,5,21
8,475,242,48,194,2,192,1,47,44,21,1,4,0,19,3,52
8,476,282,43,239,4,235,2,65,80,17,0,1,1,21,3,45
8,477,72,3,69,2,67,3,10,19,5,0,0,2,10,1,17
8,478,201,27,174,3,171,3,59,62,8,5,0,0,9,4,21
8,479,152,31,121,0,121,3,43,30,10,2,1,1,8,1,22
8,480,2563,485,2078,30,2048,17,489,410,196,32,23,2,140,31,708
8,481,217,48,169,2,167,2,43,29,22,2,0,0,18,3,48
8,482,75,5,70,1,69,0,15,25,12,2,0,0,2,1,12
8,483,358,41,317,4,313,1,94,84,33,0,0,0,24,3,74
8,484,79,7,72,2,70,2,10,40,3,0,0,0,3,0,12
8,485,153,23,130,6,124,2,22,37,10,2,0,0,19,1,31
8,486,989,228,761,13,748,4,202,131,113,11,9,0,39,12,227
8,487,1342,208,1134,14,1120,3,252,266,129,12,6,3,89,25,335
8,488,2095,515,1580,21,1559,15,392,317,190,20,19,1,108,25,472
8,489,208,33,175,0,175,3,42,45,15,3,0,0,20,3,44
8,490,2703,572,2131,36,2095,30,476,496,178,35,17,1,185,30,647
8,491,2455,517,1938,15,1923,20,534,344,224,31,24,4,95,25,622
8,492,171,19,152,0,152,1,44,37,8,6,5,0,12,3,36
8,493,270,44,226,7,219,3,75,71,5,2,1,0,17,5,40
8,494,398,65,333,5,328,9,85,81,36,7,1,0,22,5,82
8,496,104,15,89,2,87,0,24,21,6,0,1,0,15,7,13
8,497,905,135,770,10,760,9,183,219,52,6,7,2,67,15,200
8,498,285,38,247,3,244,5,53,69,21,1,1,1,29,3,61
8,499,222,32,190,1,189,2,73,48,15,1,2,0,9,2,37
8,500,56,6,50,2,48,2,4,15,6,6,0,0,7,1,7
8,501,25,4,21,0,21,1,7,9,1,0,0,0,2,0,1
8,502,84,11,73,0,73,1,23,20,2,4,0,0,6,1,16
8,503,109,21,88,0,88,0,28,21,8,0,2,0,10,0,19
9,1,48,5,43,1,42,0,1,3,26,2,0,0,3,0,7
9,2,419,55,364,10,354,3,71,71,53,7,1,1,24,2,121
9,3,332,45,287,5,282,2,75,56,37,2,6,1,7,4,92
9,4,125,12,113,4,109,0,17,10,22,3,0,0,8,1,48
9,5,174,43,131,1,130,8,18,32,26,3,1,0,9,4,29
9,6,46,7,39,0,39,0,3,7,9,0,0,0,3,0,17
9,7,61,10,51,0,51,2,4,27,8,0,0,0,1,0,9
9,8,152,34,118,0,118,4,24,14,17,0,0,0,2,3,54
9,9,180,21,159,3,156,26,12,8,45,4,1,1,12,2,45
9,11,88,20,68,1,67,9,12,15,13,1,0,1,0,1,15
9,12,26,4,22,1,21,0,1,4,6,0,0,1,0,0,9
9,13,53,1,52,1,51,4,1,11,13,1,0,2,4,0,15
9,14,185,31,154,1,153,3,22,36,22,3,1,1,10,5,50
9,15,549,53,496,7,489,11,73,71,93,13,2,1,29,6,190
9,16,161,9,152,2,150,5,31,10,26,1,0,1,10,0,66
9,17,114,18,96,4,92,1,10,9,22,0,3,0,10,0,37
9,18,72,7,65,2,63,6,8,10,19,0,0,0,3,3,14
9,19,430,57,373,4,369,26,65,72,83,5,2,0,18,1,97
9,20,52,2,50,0,50,0,7,8,8,0,0,0,1,1,25
9,21,88,4,84,3,81,1,16,10,19,1,1,0,5,2,26
9,22,192,18,174,8,166,8,25,32,30,3,1,1,13,8,45
9,23,116,16,100,2,98,5,12,8,15,1,0,0,9,1,47
9,24,211,22,189,0,189,0,31,29,31,0,3,1,12,3,79
9,25,73,14,59,0,59,0,10,8,10,0,0,0,7,0,24
9,26,120,20,100,1,99,5,24,26,17,0,0,0,7,2,18
9,27,72,19,53,1,52,6,5,4,14,1,1,1,7,0,13
9,28,36,8,28,3,25,0,5,3,4,1,0,0,1,0,11
9,29,190,37,153,2,151,3,15,52,26,2,0,0,8,3,42
9,30,541,78,463,4,459,12,45,34,118,6,2,1,23,7,211
9,31,44,7,37,0,37,2,5,8,6,0,0,0,3,0,13
9,32,1042,178,864,10,854,16,136,220,121,19,5,1,58,15,263
9,33,46,12,34,1,33,1,5,6,8,0,0,0,4,0,9
9,34,22,3,19,3,16,0,1,2,5,0,0,0,1,0,7
9,35,203,31,172,1,171,5,25,29,24,1,0,0,14,1,72
9,37,43,3,40,1,39,7,2,5,9,0,0,0,2,0,14
9,38,286,35,251,4,247,8,35,40,51,1,1,3,22,4,82
9,39,249,36,213,4,209,2,42,35,39,10,0,2,21,2,56
9,40,194,21,173,6,167,0,42,32,17,0,1,0,16,0,59
9,41,184,28,156,4,152,7,35,20,26,3,1,1,7,0,52
9,42,737,107,630,16,614,40,73,118,104,9,3,2,64,6,195
9,43,540,84,456,10,446,10,75,51,126,9,2,3,35,7,128
9,44,143,17,126,2,124,9,15,23,25,3,0,0,8,1,40
9,45,162,17,145,0,145,7,25,22,34,6,1,0,2,6,42
9,46,64,10,54,2,52,0,4,3,17,3,0,0,5,1,19
9,47,894,133,761,21,740,16,200,165,84,5,1,0,33,19,217
9,48,67,3,64,2,62,3,6,29,13,1,0,0,0,2,8
9,49,153,16,137,0,137,3,14,13,23,4,0,0,11,1,68
9,50,296,30,266,8,258,8,51,49,28,6,1,1,17,3,94
9,51,138,21,117,1,116,3,30,17,27,3,0,0,4,3,29
9,52,126,15,111,2,109,2,18,32,22,4,0,1,9,1,20
9,53,24,5,19,0,19,2,0,5,3,1,0,0,0,0,8
9,54,289,36,253,6,247,11,31,37,39,6,2,0,27,0,94
9,55,126,16,110,2,108,0,27,14,23,2,0,1,11,0,30
9,56,261,28,233,4,229,7,32,47,60,1,0,0,16,4,62
9,57,273,48,225,1,224,21,22,33,68,7,5,1,6,1,60
9,58,188,49,139,0,139,0,27,20,23,2,0,0,9,1,57
9,59,139,25,114,2,112,9,10,17,30,1,0,1,7,1,36
9,60,592,72,520,9,511,11,91,70,63,8,3,0,23,7,235
9,61,471,85,386,7,379,11,77,75,72,4,0,2,29,6,103
9,62,161,27,134,0,134,3,19,14,24,2,2,0,12,0,58
9,63,144,26,118,2,116,15,8,12,29,8,0,1,2,1,40
9,64,42,3,39,1,38,1,2,1,11,2,0,0,0,0,21
9,65,294,75,219,2,217,18,25,36,44,4,2,0,14,4,70
9,66,590,121,469,7,462,21,55,70,112,14,6,1,28,3,152
9,67,158,12,146,2,144,2,40,20,31,1,2,0,15,1,32
9,68,43,4,39,0,39,7,2,2,4,0,1,0,3,0,20
9,69,38,10,28,0,28,0,1,11,8,0,0,0,0,0,8
9,70,330,50,280,5,275,3,31,54,51,3,0,2,24,5,102
9,71,221,37,184,3,181,5,15,30,43,1,1,1,14,3,68
9,72,30,2,28,0,28,0,3,4,8,0,0,0,2,1,10
9,73,155,23,132,4,128,13,16,16,24,2,0,0,6,7,44
9,74,118,22,96,3,93,3,20,24,16,2,0,1,9,2,16
9,75,258,38,220,3,217,9,39,42,46,4,0,0,6,3,68
9,76,145,16,129,6,123,3,33,21,20,1,1,0,11,4,29
9,77,191,41,150,4,146,3,21,16,29,1,0,0,10,3,63
9,78,75,25,50,0,50,3,4,6,10,0,0,0,5,2,20
9,79,515,58,457,9,448,42,69,59,84,4,7,1,26,3,153
9,80,132,18,114,3,111,2,13,25,18,1,0,1,9,3,39
9,81,154,14,140,3,137,1,30,35,17,3,1,0,14,1,35
9,82,355,65,290,10,280,4,30,50,46,5,5,0,22,6,112
9,83,26,3,23,0,23,1,2,0,4,0,0,0,2,0,14
9,84,80,12,68,1,67,8,6,6,17,0,0,0,5,0,25
9,85,346,66,280,5,275,12,31,41,58,3,5,0,21,4,100
9,86,285,42,243,1,242,4,64,32,39,6,1,0,18,6,72
9,87,75,15,60,1,59,0,7,8,12,2,0,0,6,0,24
9,88,18,2,16,0,16,2,2,1,0,0,0,0,0,1,10
9,89,45,2,43,0,43,4,4,10,7,2,0,0,1,0,15
9,90,39,6,33,0,33,1,6,5,10,0,0,0,0,0,11
9,91,184,29,155,1,154,7,28,23,26,1,0,2,14,3,50
9,92,77,15,62,1,61,2,11,16,9,1,0,0,4,0,18
9,93,112,21,91,0,91,6,27,11,9,1,0,0,8,0,29
9,94,143,17,126,0,126,5,23,18,23,0,0,0,15,6,36
9,95,117,11,106,5,101,6,14,21,16,1,1,0,5,3,34
9,96,51,7,44,2,42,0,9,13,4,1,1,0,1,0,13
9,97,71,10,61,1,60,6,10,4,14,1,0,1,11,0,13
9,98,81,13,68,0,68,7,16,10,10,0,0,0,11,1,13
9,99,294,35,259,10,249,4,35,52,35,5,1,1,28,4,84
9,100,130,32,98,1,97,6,9,26,15,3,1,1,3,3,30
9,101,179,24,155,0,155,6,35,22,20,1,2,0,7,0,62
9,102,149,28,121,3,118,2,24,23,15,5,1,0,7,3,38
9,103,497,57,440,3,437,18,58,70,86,7,2,0,31,5,160
9,104,552,76,476,12,464,10,75,82,95,7,1,2,45,15,132
9,105,525,70,455,10,445,16,51,57,99,3,1,1,21,10,186
9,106,296,43,253,4,249,4,61,41,33,2,0,0,20,5,83
9,107,478,49,429,7,422,22,36,58,126,5,2,0,20,9,144
9,108,158,32,126,3,123,3,9,12,24,5,1,1,6,0,62
9,109,110,13,97,2,95,3,30,23,6,1,0,0,2,2,28
9,110,93,12,81,2,79,0,13,18,19,0,0,1,5,5,18
9,111,245,45,200,3,197,6,26,18,40,5,3,1,17,0,81
9,113,418,57,361,5,356,18,43,46,63,2,0,0,15,3,166
9,114,116,14,102,2,100,3,20,17,20,4,0,0,3,1,32
9,115,129,18,111,4,107,0,21,20,15,1,2,0,4,4,40
9,116,298,40,258,3,255,5,54,56,37,5,0,0,18,1,79
9,117,82,10,72,2,70,1,8,22,4,2,0,0,10,1,22
9,118,136,31,105,2,103,18,10,4,29,2,0,0,2,0,38
9,119,447,63,384,8,376,8,53,44,64,11,3,1,18,3,171
9,120,233,30,203,3,200,14,22,38,38,1,6,0,9,1,71
9,121,590,92,498,6,492,8,71,69,79,6,1,0,38,5,215
9,122,6616,1130,5486,79,5407,164,646,1002,907,64,28,10,379,74,2133
9,123,101,9,92,2,90,2,9,15,23,0,0,0,5,0,36
9,124,730,131,599,15,584,11,106,100,92,6,3,2,34,17,213
9,125,397,80,317,6,311,14,83,61,48,3,1,0,20,5,76
9,126,93,18,75,1,74,1,10,8,12,1,0,0,3,5,34
9,127,92,16,76,6,70,8,6,9,16,1,2,0,5,0,23
9,128,240,40,200,4,196,5,33,48,21,3,3,1,20,1,61
9,129,129,24,105,2,103,7,19,20,9,2,1,1,5,3,36
9,130,547,76,471,3,468,25,66,70,73,7,2,0,36,8,181
9,131,144,27,117,5,112,2,23,15,9,1,2,0,11,4,45
9,132,178,39,139,4,135,6,30,19,30,1,0,0,8,2,39
9,133,48,10,38,1,37,0,9,5,2,0,0,0,1,1,19
9,134,50,2,48,1,47,1,5,6,7,0,0,0,2,0,26
9,135,87,14,73,0,73,3,5,6,17,0,1,0,6,1,34
9,136,111,12,99,4,95,4,9,14,22,3,0,1,6,0,36
9,137,118,18,100,1,99,1,15,22,24,2,0,0,7,1,27
9,138,163,12,151,3,148,7,16,23,31,3,1,0,9,0,58
9,139,62,12,50,3,47,1,15,7,4,0,0,0,2,0,18
9,140,92,5,87,0,87,6,4,24,16,0,1,0,7,0,29
9,141,65,6,59,0,59,0,11,10,17,1,0,0,0,0,20
9,142,100,18,82,3,79,2,15,11,17,2,1,1,4,1,25
9,143,28,1,27,0,27,3,4,2,6,0,0,0,3,0,9
9,145,199,34,165,2,163,6,36,22,26,0,1,0,6,7,59
9,146,37,8,29,1,28,0,6,8,2,0,0,0,1,0,11
9,147,110,13,97,2,95,1,13,18,22,0,0,0,6,3,32
9,148,106,19,87,0,87,11,11,16,9,2,0,0,4,1,33
9,149,181,29,152,3,149,4,26,19,27,3,0,0,4,0,66
9,150,162,29,133,7,126,5,16,35,13,7,0,1,13,3,33
9,151,53,4,49,1,48,2,8,9,9,0,0,1,3,2,14
9,152,47,7,40,1,39,0,6,8,6,1,0,0,1,1,16
9,153,95,22,73,0,73,8,8,18,8,1,0,0,9,3,18
9,154,51,10,41,2,39,4,2,6,10,1,0,0,5,0,11
9,155,56,9,47,1,46,1,5,6,11,0,0,0,3,2,18
9,156,34,5,29,0,29,1,6,2,6,0,0,2,3,0,9
9,157,1965,392,1573,23,1550,19,293,314,329,26,10,4,65,26,464
9,158,201,37,164,9,155,9,25,34,14,2,0,0,14,2,55
9,159,70,9,61,1,60,0,9,4,12,1,0,0,6,1,27
9,160,4868,1077,3791,88,3703,68,788,707,598,47,16,9,179,41,1250
9,161,430,68,362,8,354,8,77,65,81,10,3,1,25,5,79
9,162,59,7,52,0,52,0,5,6,9,0,0,0,1,0,31
9,163,70,9,61,0,61,0,23,21,6,0,0,0,4,1,6
9,164,428,57,371,15,356,12,32,64,66,3,2,0,38,7,132
9,165,201,22,179,3,176,6,39,37,22,0,1,0,6,1,64
9,166,87,11,76,4,72,10,6,11,18,1,0,0,5,2,19
9,167,1663,209,1454,39,1415,31,221,308,244,8,16,3,108,16,460
9,168,149,20,129,1,128,6,28,25,21,2,2,0,5,0,39
9,169,91,9,82,0,82,3,11,29,14,2,0,0,5,0,18
9,170,170,31,139,4,135,4,18,21,25,0,0,0,7,2,58
9,171,61,13,48,2,46,0,3,6,6,0,1,0,4,2,24
9,172,31,5,26,2,24,3,0,7,7,0,0,0,2,0,5
9,173,179,21,158,5,153,9,18,10,35,0,0,0,8,0,73
9,174,199,17,182,5,177,7,27,15,46,2,1,0,14,2,63
9,175,55,4,51,0,51,1,5,2,16,1,1,0,5,4,16
9,176,409,66,343,6,337,2,81,46,53,7,6,0,10,4,128
9,177,191,26,165,3,162,7,41,28,30,4,1,2,8,4,37
9,178,46,7,39,0,39,3,7,19,2,1,1,0,5,0,1
9,179,47,8,39,0,39,0,4,4,5,4,0,0,4,0,18
9,180,108,14,94,0,94,5,20,16,15,1,0,0,5,2,30
9,181,988,191,797,13,784,31,81,127,147,17,4,0,53,12,312
9,182,630,137,493,10,483,29,63,66,155,10,3,1,33,11,112
9,183,78,5,73,2,71,3,9,18,17,0,1,0,7,3,13
9,184,40,7,33,1,32,0,4,8,2,0,0,0,5,0,13
9,185,2547,457,2090,36,2054,24,461,499,238,21,17,4,166,41,583
9,186,69,12,57,1,56,9,5,9,13,2,1,0,3,1,13
9,187,311,43,268,3,265,6,39,53,54,2,0,1,21,2,87
9,188,876,114,762,11,751,18,91,79,158,12,9,2,37,7,338
9,189,163,32,131,3,128,6,34,8,31,0,0,0,9,5,35
9,190,108,21,87,5,82,0,24,11,23,0,0,1,7,1,15
9,192,148,32,116,0,116,5,6,28,16,4,0,0,8,2,47
9,193,61,10,51,2,49,1,2,7,2,0,0,1,0,0,36
9,194,2380,368,2012,37,1975,52,296,442,290,21,10,2,155,39,668
9,195,20,5,15,0,15,0,6,4,0,0,0,0,0,1,4
9,196,45,9,36,0,36,10,0,2,9,4,0,0,3,0,8
9,197,42,5,37,1,36,1,2,11,8,0,0,0,2,2,10
9,198,174,19,155,2,153,7,23,52,19,1,1,0,11,3,36
9,199,536,77,459,16,443,8,103,113,56,7,0,1,39,7,109
9,200,96,19,77,3,74,9,13,20,14,2,0,0,6,0,10
9,201,68,6,62,0,62,1,12,4,10,0,0,0,3,1,31
9,202,249,35,214,4,210,4,19,24,69,2,1,0,12,1,78
9,203,140,23,117,3,114,5,8,24,25,1,1,1,11,2,36
9,204,230,46,184,3,181,3,30,37,39,2,1,0,18,4,47
9,205,60,10,50,0,50,7,7,4,15,0,0,0,3,2,12
9,206,586,111,475,8,467,7,112,87,65,7,5,0,25,5,154
9,207,1094,150,944,23,921,14,149,188,171,16,3,1,70,11,298
9,208,126,16,110,4,106,6,13,25,11,3,0,0,15,2,31
9,209,841,127,714,17,697,22,112,129,101,14,9,2,48,19,241
9,210,315,43,272,4,268,9,33,32,38,4,7,1,26,3,115
9,211,128,19,109,5,104,2,13,22,17,1,0,0,12,2,35
9,212,75,6,69,2,67,7,5,12,12,2,0,0,4,0,25
9,213,170,21,149,2,147,4,28,27,20,0,0,0,9,0,59
9,214,643,117,526,3,523,23,79,82,88,12,5,1,40,15,178
9,215,119,14,105,1,104,2,29,22,12,0,0,0,9,3,27
9,216,46,8,38,2,36,10,3,2,2,2,0,0,4,0,13
9,217,172,23,149,4,145,3,27,13,19,4,1,1,9,2,66
9,218,75,10,65,0,65,1,10,11,10,1,0,0,1,2,29
9,219,158,29,129,0,129,4,14,23,27,2,0,0,7,2,50
9,220,161,15,146,7,139,2,13,13,22,3,1,0,8,0,77
9,221,182,27,155,3,152,2,27,27,21,2,3,1,8,1,60
9,222,31,4,27,0,27,1,2,4,5,0,0,0,2,0,13
9,223,454,63,391,2,389,14,65,75,65,6,0,3,34,6,121
9,224,347,38,309,3,306,14,53,42,85,6,1,1,14,3,87
9,225,9467,1767,7700,146,7554,144,1451,1715,1064,86,22,25,536,109,2402
9,226,43,5,38,0,38,2,6,6,1,0,1,0,4,0,18
9,227,176,22,154,5,149,0,34,34,24,0,1,0,12,1,43
9,228,198,30,168,2,166,3,43,17,32,3,2,0,6,2,58
9,229,387,40,347,11,336,5,72,56,52,10,1,0,33,2,105
9,230,59,6,53,1,52,0,10,20,7,1,0,0,1,1,12
9,231,194,42,152,3,149,10,19,26,31,6,2,0,5,0,50
9,232,72,15,57,1,56,2,6,8,8,0,1,0,3,1,27
9,233,38,5,33,0,33,0,9,11,0,1,1,0,2,0,9
9,234,101,6,95,1,94,3,7,9,16,0,0,1,5,1,52
9,235,627,99,528,8,520,10,97,122,77,11,4,1,31,6,161
9,236,284,34,250,6,244,4,37,39,50,4,2,3,13,4,88
9,237,41,7,34,0,34,1,4,10,7,2,0,0,1,0,9
9,238,508,55,453,12,441,2,107,90,44,4,2,2,32,11,147
9,239,127,24,103,3,100,2,20,7,24,1,0,0,4,0,42
9,240,241,26,215,5,210,2,35,46,17,1,1,1,17,2,88
9,241,291,29,262,2,260,12,32,45,57,2,4,0,13,5,90
9,242,39,5,34,0,34,2,6,11,2,0,0,0,3,1,9
9,243,81,12,69,1,68,1,7,21,9,2,2,0,5,1,20
9,244,442,61,381,5,376,4,82,63,54,6,2,1,22,5,137
9,245,850,117,733,11,722,18,139,133,126,9,8,1,47,15,226
9,246,449,55,394,12,382,23,42,54,69,7,0,0,29,8,150
9,247,191,39,152,3,149,7,19,24,22,2,0,0,15,2,58
9,249,157,21,136,1,135,2,27,40,18,1,3,2,9,0,33
9,250,103,18,85,2,83,1,11,16,12,1,0,2,4,1,35
9,251,150,27,123,6,117,5,10,30,25,2,3,0,8,1,33
9,252,77,6,71,1,70,1,6,9,7,1,0,1,3,1,41
9,253,292,52,240,4,236,6,39,37,40,4,0,0,23,3,84
9,254,192,26,166,2,164,3,43,28,21,3,0,0,18,2,46
9,255,44,11,33,2,31,2,1,6,3,1,0,0,7,0,11
9,256,57,11,46,1,45,0,9,15,2,1,1,0,9,0,8
9,257,542,65,477,11,466,18,74,81,115,11,6,2,25,5,129
9,258,312,22,290,7,283,2,60,44,49,5,4,0,17,7,95
9,259,110,17,93,3,90,10,21,20,15,1,1,0,2,1,19
9,260,25,2,23,0,23,0,7,9,1,0,0,0,0,0,6
9,261,4422,866,3556,74,3482,105,444,758,573,54,16,12,242,55,1223
9,262,346,38,308,9,299,2,63,59,32,3,3,0,10,5,122
9,263,33,7,26,0,26,0,5,3,6,1,1,0,1,0,9
9,264,802,89,713,14,699,12,130,114,94,11,5,1,56,10,266
9,265,2131,381,1750,35,1715,28,333,358,232,14,11,2,97,27,613
9,266,48,5,43,0,43,3,4,2,5,0,0,0,2,5,22
9,267,130,26,104,0,104,1,16,30,13,2,2,0,4,1,35
9,268,1103,190,913,13,900,28,112,175,138,10,4,3,84,18,328
9,269,290,39,251,0,251,9,20,35,44,1,1,1,13,1,126
9,270,179,20,159,7,152,7,22,37,19,2,0,1,17,7,40
9,271,55,10,45,1,44,0,16,9,5,0,0,0,1,2,11
9,272,1030,158,872,19,853,16,134,184,109,10,4,1,53,13,329
9,273,543,45,498,13,485,16,57,66,92,9,2,0,32,4,207
9,274,235,37,198,6,192,3,36,40,32,2,1,0,16,3,59
9,275,237,17,220,0,220,12,38,35,40,7,1,0,14,6,67
9,276,166,13,153,1,152,4,42,36,23,6,0,0,11,1,29
9,277,535,58,477,10,467,21,83,102,77,4,1,0,44,4,131
9,279,45,8,37,0,37,3,6,7,3,1,1,1,2,0,13
9,280,574,75,499,5,494,22,70,70,94,7,3,0,40,7,181
9,281,103,14,89,0,89,5,19,13,16,2,1,0,6,3,24
9,282,3160,488,2672,45,2627,62,497,577,335,46,12,2,167,38,891
9,283,292,35,257,3,254,4,42,58,33,4,1,1,16,9,86
9,284,144,23,121,2,119,3,38,11,25,1,2,0,9,2,28
9,285,698,113,585,4,581,34,85,80,121,9,1,3,29,6,213
9,286,41,9,32,0,32,2,2,9,6,0,1,0,3,1,8
9,287,15,0,15,1,14,1,5,0,2,1,0,0,0,0,5
9,289,991,133,858,11,847,13,148,184,135,9,5,2,54,11,286
9,290,188,32,156,2,154,1,6,19,59,0,3,0,12,1,53
9,291,136,33,103,1,102,7,14,18,14,3,0,0,4,0,42
9,292,70,20,50,1,49,4,5,11,22,0,0,0,1,0,6
9,293,617,63,554,6,548,27,70,110,123,11,0,0,20,4,183
9,294,69,8,61,0,61,15,5,7,9,0,0,0,7,0,18
9,295,144,22,122,3,119,1,27,27,15,1,0,1,8,0,39
9,296,111,27,84,0,84,0,19,15,9,4,1,0,3,3,30
9,297,31,6,25,1,24,2,4,0,5,0,0,0,0,0,13
9,298,93,23,70,1,69,0,13,4,15,0,0,0,2,1,34
9,299,345,52,293,5,288,16,46,31,75,4,0,1,16,5,94
9,300,162,24,138,3,135,10,9,29,23,3,0,1,13,1,46
9,301,361,87,274,4,270,15,31,33,56,13,3,0,14,0,105
9,302,84,13,71,2,69,0,3,12,3,1,0,0,2,0,48
9,303,328,50,278,2,276,8,46,69,50,1,0,0,17,3,82
9,304,21,3,18,3,15,4,2,2,1,1,0,0,2,1,2
9,305,311,36,275,9,266,1,50,45,42,3,0,0,20,3,102
9,306,2052,395,1657,26,1631,31,259,305,259,27,11,3,84,15,637
9,307,135,19,116,1,115,6,21,12,16,4,0,0,4,3,49
9,308,179,22,157,1,156,5,23,32,22,5,1,0,9,3,56
9,309,131,21,110,1,109,2,26,18,18,2,0,0,11,0,32
9,310,37,3,34,2,32,2,3,1,3,1,0,0,2,4,16
9,311,31,7,24,0,24,0,4,5,5,0,0,0,0,0,10
9,312,1963,233,1730,28,1702,20,377,308,263,31,3,3,105,29,563
9,313,146,23,123,5,118,6,13,14,14,2,0,1,19,2,47
9,314,185,20,165,4,161,5,28,26,27,0,3,0,14,2,56
9,315,69,6,63,0,63,0,19,12,10,0,0,0,5,3,14
9,316,76,7,69,2,67,3,22,12,7,2,0,0,6,0,15
9,317,39,8,31,0,31,2,3,6,5,1,0,0,0,0,14
9,318,113,21,92,0,92,0,22,7,14,1,1,1,4,1,41
9,319,105,13,92,1,91,5,19,14,16,2,0,0,8,1,26
9,320,34,5,29,0,29,1,7,3,6,1,0,0,1,0,10
9,321,283,36,247,9,238,7,24,50,36,2,2,0,13,8,96
9,322,376,74,302,3,299,8,63,55,43,3,0,1,11,6,109
9,323,75,9,66,2,64,2,3,7,12,2,0,0,12,1,25
9,324,2351,411,1940,29,1911,25,351,363,335,23,13,8,126,31,636
9,325,48,15,33,0,33,1,7,11,2,0,0,0,1,0,11
9,326,138,22,116,1,115,6,22,16,13,3,1,0,8,1,45
9,327,205,25,180,4,176,7,28,36,42,8,3,0,13,2,37
9,328,203,34,169,0,169,1,24,33,30,0,0,0,11,5,65
9,329,508,68,440,19,421,11,57,57,60,9,2,4,39,8,174
9,330,33,3,30,0,30,0,5,11,3,0,0,0,1,2,8
9,331,482,53,429,4,425,6,99,90,58,3,5,0,20,7,137
9,332,1777,248,1529,35,1494,29,243,265,263,24,6,4,112,24,524
9,334,358,56,302,2,300,4,50,44,63,4,2,1,22,7,103
9,335,46,8,38,2,36,3,4,4,7,0,0,0,1,0,17
9,336,894,127,767,18,749,5,170,163,111,6,7,3,41,8,235
9,338,106,10,96,3,93,2,15,35,17,0,0,0,5,1,18
9,339,540,61,479,11,468,4,137,79,64,6,1,0,32,11,134
9,340,136,13,123,1,122,3,31,9,35,1,1,0,9,0,33
9,341,92,8,84,1,83,0,15,6,19,0,0,0,10,3,30
9,342,200,21,179,4,175,6,35,33,29,4,0,0,10,2,56
10,2,207,36,171,1,170,1,44,47,30,4,0,3,5,0,36
10,3,1768,286,1482,30,1452,25,360,357,136,21,7,1,128,28,389
10,4,187,60,127,3,124,0,51,37,11,0,0,0,2,3,20
10,5,223,39,184,4,180,1,72,50,10,2,1,1,15,3,25
10,6,1887,385,1502,29,1473,15,398,430,90,23,13,2,110,33,359
10,7,105,25,80,0,80,0,15,35,5,1,1,0,6,1,16
10,8,106,18,88,4,84,0,15,35,3,2,0,0,7,3,19
10,9,79,17,62,2,60,1,14,28,5,0,0,1,4,1,6
10,10,39,4,35,0,35,0,11,12,1,0,0,0,5,0,6
10,11,192,34,158,3,155,0,46,67,4,0,0,0,12,1,25
10,12,264,56,208,0,208,2,62,67,16,0,2,1,17,2,39
10,13,117,16,101,0,101,4,30,18,4,4,1,1,1,3,35
10,14,140,26,114,5,109,0,36,29,4,0,0,0,16,1,23
10,15,208,21,187,1,186,3,63,49,15,3,2,2,23,8,18
10,17,92,16,76,1,75,0,18,26,7,3,2,0,6,0,13
10,18,668,105,563,6,557,10,145,178,71,11,3,3,35,11,90
10,19,271,36,235,7,228,1,65,92,8,1,4,1,24,2,30
10,20,339,52,287,10,277,2,58,103,27,5,8,0,14,12,48
10,21,109,21,88,1,87,0,34,34,2,0,0,1,4,5,7
10,22,175,32,143,0,143,2,43,69,1,1,1,0,7,5,14
10,23,159,28,131,2,129,4,45,35,9,0,0,0,16,3,17
10,24,125,23,102,1,101,0,41,27,4,3,1,0,8,0,17
10,25,166,24,142,1,141,1,29,66,9,0,0,2,18,1,15
10,26,28,5,23,0,23,0,9,7,2,0,0,0,1,2,2
10,27,62,11,51,2,49,0,12,21,4,1,0,0,3,4,4
10,28,126,18,108,3,105,2,27,49,5,1,2,0,6,2,11
10,29,156,22,134,2,132,0,41,54,2,2,0,1,15,4,13
10,30,843,115,728,14,714,11,194,202,50,5,6,5,51,19,171
10,31,325,57,268,7,261,2,75,62,30,6,2,0,18,11,55
10,32,293,42,251,3,248,3,69,89,6,8,0,0,20,7,46
10,33,3420,931,2489,57,2432,30,610,701,238,19,11,3,183,48,589
10,34,1926,561,1365,21,1344,17,301,397,154,16,11,2,95,20,331
10,35,632,117,515,7,508,5,162,124,60,11,5,2,23,20,96
10,37,346,54,292,1,291,11,63,82,15,3,3,2,44,7,61
10,38,126,27,99,2,97,0,28,36,3,0,0,0,8,1,21
10,39,103,13,90,6,84,1,25,38,3,0,0,0,5,2,10
10,40,139,26,113,5,108,0,40,32,4,3,0,0,5,1,23
10,41,61,9,52,1,51,0,19,17,3,0,1,0,7,2,2
10,42,221,38,183,0,183,2,54,70,10,0,0,0,14,1,32
10,43,99,15,84,1,83,0,34,26,6,1,0,0,6,0,10
10,44,33,1,32,0,32,0,16,6,5,2,0,0,0,0,3
10,45,160,26,134,4,130,2,31,57,5,1,1,1,5,2,25
10,46,84,10,74,2,72,3,19,16,5,0,1,0,12,0,16
10,47,42,7,35,0,35,0,15,14,0,0,0,0,3,0,3
10,48,160,32,128,1,127,3,37,53,9,1,0,0,5,2,17
10,49,337,55,282,5,277,3,79,88,10,2,3,3,38,10,41
10,50,174,25,149,8,141,3,31,31,14,2,7,2,7,4,40
10,51,763,90,673,9,664,11,158,172,76,8,6,3,47,9,174
10,52,180,19,161,4,157,0,50,59,7,0,3,0,16,2,20
10,53,394,45,349,6,343,2,117,106,18,7,2,0,26,8,57
10,54,102,16,86,0,86,1,22,30,8,2,1,0,4,1,17
10,55,234,34,200,4,196,3,46,72,9,1,1,1,12,10,41
10,56,160,20,140,4,136,2,35,60,2,2,1,1,17,0,16
10,57,50,9,41,3,38,0,9,13,2,1,0,1,2,2,8
10,58,218,35,183,8,175,2,30,80,11,0,0,0,24,2,26
10,59,103,29,74,5,69,1,20,22,3,0,1,0,11,3,8
10,60,1434,220,1214,20,1194,16,281,410,76,6,8,1,102,27,267
10,61,515,88,427,6,421,12,136,96,25,7,5,0,27,20,93
10,62,161,9,152,1,151,3,48,56,6,3,1,0,5,7,22
10,63,344,45,299,5,294,4,78,84,19,1,2,0,22,2,82
10,64,2038,423,1615,35,1580,15,392,491,132,16,14,5,117,38,360
10,65,71,15,56,0,56,1,17,17,4,0,0,0,6,0,11
10,66,344,45,299,3,296,6,62,115,14,3,0,1,25,10,60
10,67,1089,137,952,17,935,9,219,330,71,5,4,0,78,16,203
10,68,125,22,103,0,103,1,28,55,1,1,0,0,5,1,11
10,69,122,20,102,0,102,2,28,41,2,0,0,0,6,2,21
10,70,417,56,361,4,357,7,55,195,14,2,1,1,27,8,47
10,71,54,8,46,1,45,0,5,19,5,0,0,0,6,0,10
10,72,31,1,30,3,27,0,9,4,3,0,1,0,4,2,4
10,73,97,8,89,2,87,0,32,22,11,3,1,0,8,0,10
10,74,367,41,326,4,322,4,91,92,29,1,1,0,24,7,73
10,75,80,19,61,1,60,1,23,17,3,1,1,0,3,4,7
10,76,252,40,212,6,206,3,48,83,17,4,1,1,15,2,32
10,77,67,5,62,0,62,0,19,20,3,3,0,0,5,2,10
10,78,25,0,25,0,25,0,7,10,0,0,0,0,2,1,5
10,79,113,19,94,5,89,0,10,62,1,0,0,0,6,2,8
10,80,759,138,621,9,612,9,191,201,49,2,2,2,44,11,101
10,81,6448,1402,5046,98,4948,43,977,1020,504,59,29,12,330,79,1895
10,82,149,26,123,5,118,0,33,25,4,6,1,0,18,2,29
10,83,252,44,208,2,206,2,49,65,12,3,0,0,27,4,44
10,84,689,89,600,7,593,4,152,164,39,8,3,0,77,15,131
10,85,54,11,43,0,43,0,11,22,1,1,1,0,4,0,3
10,86,164,19,145,2,143,2,41,63,4,2,1,0,10,1,19
10,87,42,5,37,1,36,0,16,8,1,0,0,0,6,0,5
10,89,484,91,393,2,391,7,102,123,31,5,4,1,37,3,78
10,90,204,26,178,3,175,1,58,49,14,2,1,1,14,3,32
10,91,118,21,97,1,96,1,35,31,8,1,0,0,9,2,9
10,92,93,10,83,3,80,0,28,24,9,1,1,0,3,1,13
10,93,71,10,61,0,61,0,27,21,0,0,1,1,2,2,7
10,94,549,119,430,6,424,1,153,148,16,2,3,0,29,9,63
10,95,220,43,177,4,173,3,63,57,11,1,0,0,14,1,23
10,96,362,39,323,7,316,4,79,96,23,3,2,1,32,3,73
10,97,150,10,140,3,137,1,30,71,6,4,0,0,9,4,12
10,98,288,57,231,3,228,1,58,94,15,3,0,0,15,10,32
10,99,390,62,328,5,323,10,85,104,26,3,1,1,23,11,59
10,100,761,84,677,30,647,11,224,180,51,2,4,0,45,9,121
10,101,123,17,106,1,105,0,40,41,3,0,0,0,7,3,11
10,102,179,35,144,7,137,1,45,60,4,1,0,2,8,5,11
10,103,144,25,119,5,114,0,25,57,5,2,0,0,7,7,11
10,104,250,57,193,4,189,2,59,50,19,3,2,3,21,4,26
10,105,23,4,19,1,18,0,8,7,1,0,0,0,0,1,1
10,106,80,10,70,0,70,1,12,35,2,0,0,0,5,0,15
10,107,94,10,84,0,84,2,18,27,5,0,0,0,7,0,25
10,108,63,15,48,0,48,0,19,12,1,0,3,0,3,1,9
10,109,218,39,179,3,176,6,57,37,7,2,2,0,20,4,41
10,110,393,47,346,3,343,10,101,73,32,2,3,1,33,12,76
10,111,109,18,91,3,88,4,23,27,9,0,1,0,5,3,16
10,112,144,25,119,1,118,0,18,37,13,3,1,1,11,4,30
10,113,184,35,149,4,145,6,46,42,14,1,1,0,10,2,23
10,114,553,68,485,10,475,5,152,113,62,7,1,2,20,11,102
10,115,1316,132,1184,20,1164,18,284,390,64,4,2,2,108,35,257
10,116,265,44,221,2,219,5,51,73,7,5,1,0,19,8,50
10,117,95,12,83,3,80,0,32,18,2,1,1,0,12,0,14
10,118,78,12,66,2,64,0,24,27,1,0,0,0,3,2,7
10,119,203,28,175,3,172,1,31,54,20,1,0,0,14,1,50
10,120,152,22,130,1,129,0,38,35,10,1,0,0,5,1,39
10,121,284,42,242,4,238,2,65,111,8,2,0,1,16,2,31
10,122,195,49,146,1,145,1,46,44,19,0,0,1,16,1,17
10,123,661,115,546,8,538,10,174,160,27,7,5,1,44,11,99
10,124,184,30,154,2,152,2,33,51,9,1,0,3,22,4,27
10,125,207,20,187,1,186,1,61,64,7,1,0,0,26,6,20
10,126,111,23,88,3,85,1,27,35,7,1,1,0,3,1,9
10,127,53,5,48,0,48,1,13,17,1,1,0,0,3,6,6
10,128,91,19,72,0,72,2,12,23,6,0,0,0,5,1,23
10,129,228,27,201,5,196,8,39,63,17,3,1,0,22,3,40
10,130,81,8,73,1,72,1,15,34,5,0,0,2,6,1,8
10,131,240,30,210,6,204,5,82,46,21,1,0,0,18,1,30
10,132,188,21,167,4,163,1,51,60,3,1,1,0,19,6,21
10,133,196,21,175,2,173,1,39,43,15,1,2,1,18,8,45
10,134,66,10,56,0,56,1,7,29,2,1,0,0,8,1,7
10,135,110,21,89,3,86,1,12,34,4,2,2,0,7,2,22
10,136,95,8,87,1,86,2,18,38,3,0,1,0,6,1,17
10,137,56,2,54,3,51,0,8,23,3,1,0,0,6,0,10
10,138,102,6,96,1,95,1,28,29,4,0,0,0,6,5,22
10,139,140,18,122,2,120,0,47,22,14,1,0,1,12,2,21
10,140,754,128,626,10,616,8,185,169,32,10,7,4,46,19,136
10,141,581,126,455,9,446,8,92,160,37,3,2,0,52,7,85
10,142,1348,282,1066,20,1046,14,291,261,108,10,10,2,68,16,266
10,143,188,18,170,5,165,0,32,51,24,2,3,0,21,2,30
10,144,123,16,107,3,104,2,38,24,9,0,2,0,6,4,19
10,145,179,25,154,6,148,5,34,58,6,0,0,2,13,7,23
10,146,71,10,61,0,61,2,16,28,2,0,0,0,0,1,12
10,147,116,20,96,4,92,1,23,30,8,2,0,0,6,3,19
10,148,326,44,282,5,277,6,84,89,29,2,1,1,18,11,36
10,149,226,20,206,4,202,1,41,68,9,1,2,0,25,10,45
10,150,234,40,194,4,190,1,58,61,15,1,0,1,12,2,39
10,151,600,92,508,11,497,6,151,140,34,6,7,3,41,13,96
10,153,438,83,355,3,352,7,125,101,26,5,3,2,25,4,54
10,154,78,8,70,2,68,0,17,43,2,0,0,0,1,1,4
10,155,155,15,140,1,139,3,28,95,1,0,0,0,5,2,5
10,156,453,67,386,6,380,5,102,107,32,4,6,1,31,5,87
10,157,177,24,153,4,149,2,48,51,9,2,0,0,15,1,21
10,158,370,50,320,8,312,7,75,104,24,0,1,0,42,6,53
10,159,66,11,55,1,54,1,19,19,3,0,0,0,4,0,8
10,160,44,3,41,1,40,0,9,17,4,0,0,0,3,4,3
10,161,41,6,35,0,35,0,8,21,2,0,0,0,2,1,1
10,162,198,17,181,0,181,2,64,45,15,3,1,1,9,1,40
10,163,69,11,58,1,57,0,13,30,1,0,0,0,3,2,8
10,164,535,85,450,4,446,4,177,99,49,3,2,2,18,16,76
10,165,283,52,231,3,228,7,56,79,17,0,0,1,23,2,43
10,166,304,47,257,8,249,4,75,86,16,3,1,0,10,3,51
10,167,77,29,48,1,47,0,19,15,0,0,0,1,7,1,4
10,168,59,9,50,1,49,0,15,25,3,1,0,0,1,0,4
10,169,169,28,141,0,141,3,29,43,18,0,0,0,13,4,31
10,170,375,68,307,4,303,3,124,100,9,1,1,0,19,8,38
10,171,197,26,171,2,169,1,68,38,14,0,2,0,16,2,28
10,172,155,17,138,4,134,0,42,50,3,2,0,0,20,5,12
10,173,393,46,347,9,338,9,90,93,20,4,1,0,38,12,71
10,174,129,13,116,5,111,0,30,50,5,3,0,1,6,1,15
10,175,137,26,111,1,110,1,33,37,2,0,3,0,15,2,17
10,176,138,19,119,5,114,1,36,30,12,0,1,1,13,3,17
10,177,131,14,117,0,117,1,17,50,7,0,1,0,9,4,28
10,178,223,23,200,4,196,2,64,58,12,1,2,1,21,4,31
10,179,338,55,283,8,275,2,91,48,30,5,6,0,14,6,73
10,180,82,8,74,0,74,1,23,23,3,0,1,0,11,1,11
10,181,252,54,198,7,191,1,43,82,13,0,1,0,17,4,30
10,182,123,17,106,0,106,5,17,28,15,0,2,2,6,1,30
10,183,35,4,31,1,30,0,2,18,1,0,0,0,2,2,5
10,184,111,17,94,0,94,1,28,32,5,3,1,0,5,5,14
10,185,161,30,131,2,129,3,31,58,6,2,0,0,11,3,15
10,186,392,48,344,2,342,5,63,150,11,4,1,0,29,17,62
10,187,437,85,352,8,344,5,88,128,22,2,1,1,34,10,53
10,188,198,37,161,2,159,6,57,38,8,3,1,2,15,1,28
10,189,46,4,42,0,42,0,12,13,2,1,1,0,3,1,9
10,190,370,32,338,6,332,3,85,126,15,1,4,2,30,10,56
10,191,585,72,513,7,506,9,114,168,39,4,7,0,54,13,98
10,192,97,21,76,1,75,1,23,28,8,0,1,1,5,2,6
10,193,233,34,199,3,196,0,55,64,15,1,2,0,17,4,38
10,194,94,15,79,2,77,1,22,27,5,0,2,1,8,2,9
10,195,220,53,167,3,164,0,38,58,9,7,4,1,17,3,27
10,196,170,25,145,2,143,2,40,47,8,0,0,0,15,5,26
10,197,147,26,121,5,116,1,39,49,2,2,2,0,9,0,12
10,198,94,13,81,0,81,1,17,11,11,3,0,0,7,0,31
10,199,300,61,239,6,233,1,49,110,15,1,0,0,12,8,37
10,200,72,11,61,1,60,3,20,23,1,0,0,0,5,1,7
10,201,55,11,44,0,44,0,20,13,2,0,0,1,5,0,3
10,202,109,11,98,2,96,3,41,24,8,2,0,1,4,0,13
10,203,320,48,272,5,267,2,71,78,25,1,1,0,18,7,64
10,204,86,8,78,1,77,2,25,14,8,0,2,0,11,1,14
10,205,67,6,61,0,61,0,16,34,2,0,1,0,3,1,4
10,206,116,17,99,1,98,0,26,43,5,0,0,1,11,4,8
10,207,107,22,85,3,82,1,22,25,2,1,0,0,11,5,15
10,208,214,31,183,5,178,3,40,70,19,3,0,0,14,1,28
10,209,1287,200,1087,22,1065,13,313,315,82,10,6,2,101,22,201
10,210,322,44,278,5,273,3,61,87,12,2,2,1,36,6,63
10,211,688,98,590,7,583,2,135,179,50,7,3,2,59,13,133
10,212,85,12,73,0,73,4,22,15,10,0,1,2,7,1,11
10,213,131,19,112,4,108,3,28,48,6,0,0,0,8,0,15
10,214,61,13,48,0,48,1,12,12,4,0,0,0,6,2,11
10,215,198,24,174,2,172,0,53,61,12,2,5,1,11,4,23
10,216,900,179,721,11,710,10,242,260,35,5,3,0,51,15,89
10,217,36,4,32,4,28,0,14,8,1,1,0,0,1,0,3
10,218,157,19,138,3,135,1,36,45,15,3,0,0,14,1,20
10,219,51,14,37,1,36,1,3,19,6,0,2,0,3,0,2
10,220,1178,225,953,20,933,4,246,263,82,11,6,0,68,26,227
10,221,132,24,108,4,104,0,30,28,7,0,0,0,10,3,26
10,222,373,60,313,2,311,6,80,67,35,3,1,0,32,17,70
10,223,469,83,386,7,379,4,135,92,37,4,2,1,27,13,64
10,224,1116,192,924,17,907,4,285,240,84,10,6,2,65,22,189
10,225,214,32,182,1,181,3,52,60,13,1,1,0,15,7,29
10,226,74,9,65,3,62,0,22,25,4,2,0,0,4,1,4
10,227,258,44,214,6,208,5,68,49,15,4,3,2,16,3,43
10,228,178,30,148,3,145,3,49,46,13,5,1,1,8,3,16
10,229,83,17,66,0,66,1,21,27,4,0,0,0,1,2,10
10,230,525,60,465,9,456,7,149,137,24,2,5,1,36,7,88
10,231,402,73,329,5,324,2,96,96,16,3,0,1,34,13,63
10,232,256,46,210,0,210,6,57,85,16,3,0,0,7,6,30
10,233,929,127,802,13,789,4,225,198,65,5,2,1,63,28,198
10,234,195,32,163,5,158,2,57,34,12,4,0,1,17,4,27
10,235,42,5,37,0,37,0,11,14,0,0,0,0,6,0,6
10,236,51,9,42,4,38,0,16,12,2,2,0,1,4,0,1
10,237,428,46,382,8,374,4,65,157,27,8,2,1,47,14,49
10,238,292,35,257,7,250,4,80,67,20,2,4,1,21,5,46
10,239,421,50,371,3,368,6,106,96,30,3,2,1,36,1,87
10,240,327,47,280,3,277,8,57,72,16,4,1,2,36,5,76
10,241,37,4,33,1,32,0,8,15,0,2,0,0,2,4,1
10,242,161,33,128,2,126,4,26,66,5,1,0,0,13,2,9
10,243,73,10,63,2,61,0,14,24,6,0,0,0,6,1,10
10,245,575,81,494,3,491,7,184,130,37,10,4,0,29,4,86
10,246,204,44,160,4,156,4,52,47,8,2,4,0,4,4,31
10,247,122,24,98,0,98,2,35,21,4,1,0,0,13,1,21
10,248,332,36,296,4,292,4,59,139,9,7,1,3,33,6,31
10,249,341,48,293,3,290,3,80,77,19,2,2,1,26,6,74
10,250,186,23,163,2,161,4,53,41,12,1,0,0,13,9,28
10,251,215,31,184,5,179,6,48,45,13,2,2,2,15,2,44
10,252,53,5,48,1,47,0,6,26,1,0,1,0,5,3,5
10,253,125,14,111,3,108,4,27,17,6,1,1,1,15,4,32
10,254,256,27,229,2,227,1,83,67,17,6,2,2,17,1,31
10,255,227,21,206,0,206,3,48,75,15,1,1,1,23,9,30
10,256,278,37,241,5,236,7,72,69,10,2,0,0,19,4,53
10,257,32,5,27,1,26,2,6,7,2,2,0,0,4,2,1
10,258,243,28,215,3,212,5,80,56,5,2,2,0,20,11,31
10,259,261,33,228,6,222,0,81,60,12,1,0,0,20,6,42
10,260,401,43,358,1,357,10,91,124,18,4,2,1,37,8,62
10,261,709,124,585,6,579,8,132,166,51,9,4,7,34,20,148
10,262,325,34,291,9,282,1,80,122,5,2,1,1,22,8,40
10,263,301,43,258,2,256,3,58,67,28,4,2,2,17,6,69
10,264,111,25,86,3,83,2,22,44,1,0,0,0,6,0,8
10,265,2095,438,1657,28,1629,22,354,392,146,17,12,6,116,23,541
10,266,49,6,43,1,42,2,9,5,13,0,2,1,2,0,8
10,267,253,52,201,2,199,0,71,80,5,0,1,0,10,6,26
10,268,3558,776,2782,54,2728,31,695,783,237,27,15,7,241,59,633
10,269,120,21,99,0,99,0,25,44,5,3,1,0,6,4,11
10,270,205,39,166,2,164,0,33,66,9,1,4,0,21,4,26
10,271,473,65,408,6,402,8,110,125,36,7,4,2,40,7,63
10,272,155,26,129,1,128,2,43,55,5,2,0,0,5,4,12
10,273,29,3,26,2,24,0,9,9,2,0,0,0,1,1,2
10,274,233,35,198,3,195,2,56,53,17,1,1,0,19,11,35
10,275,425,64,361,6,355,3,99,105,38,5,5,1,26,8,65
10,276,249,38,211,6,205,1,59,51,22,1,1,0,25,4,41
10,277,505,91,414,4,410,10,89,147,29,5,3,6,35,19,67
10,278,114,22,92,1,91,1,28,38,7,2,0,0,7,0,8
10,279,75,14,61,2,59,1,15,30,2,1,0,0,1,3,6
10,280,563,97,466,7,459,4,122,127,34,2,0,2,33,6,129
10,281,242,38,204,9,195,1,64,52,15,1,1,1,20,6,34
10,282,882,137,745,14,731,1,239,230,34,4,1,1,77,25,119
10,283,115,12,103,4,99,2,27,34,6,0,1,0,12,2,15
10,284,98,16,82,3,79,3,19,21,1,0,0,0,11,2,22
10,285,79,10,69,0,69,0,16,24,6,2,3,0,6,0,12
10,286,204,37,167,1,166,0,34,68,12,3,0,0,20,1,28
10,287,943,147,796,19,777,5,272,233,53,5,3,2,63,11,130
10,288,228,44,184,2,182,0,71,51,6,0,1,4,8,6,35
10,289,651,89,562,7,555,3,172,168,53,5,8,1,40,12,93
10,290,168,29,139,3,136,0,31,54,9,0,0,0,8,1,33
10,291,117,19,98,1,97,1,26,41,6,1,0,0,11,1,10
10,293,117,8,109,1,108,1,42,41,1,1,0,0,11,4,7
10,294,47,3,44,0,44,1,25,0,6,2,1,0,2,3,4
10,295,214,22,192,4,188,3,67,69,8,2,3,0,20,1,15
10,296,163,27,136,4,132,0,37,71,5,0,0,0,12,2,5
10,297,2785,541,2244,41,2203,31,458,659,173,16,15,3,246,53,549
10,298,719,172,547,547,0,0,0,0,0,0,0,0,0,0,0
10,299,438,68,370,8,362,5,108,93,22,6,6,0,42,16,64
10,300,208,46,162,5,157,2,42,54,13,7,0,0,10,4,25
10,301,131,19,112,1,111,0,39,33,3,2,1,0,3,3,27
10,302,65,7,58,2,56,2,18,22,6,0,0,0,2,0,6
10,303,71,14,57,2,55,2,15,15,2,1,1,0,7,0,12
10,304,162,24,138,6,132,0,33,42,9,2,1,3,15,1,26
10,305,82,15,67,1,66,0,19,13,2,2,1,0,7,1,21
10,306,224,34,190,4,186,3,32,73,21,2,2,0,14,6,33
10,307,276,35,241,3,238,8,55,86,9,0,0,0,23,4,53
10,308,189,41,148,2,146,1,36,68,13,1,0,0,10,1,16
10,309,95,5,90,1,89,0,20,35,5,0,0,0,10,4,15
10,310,172,39,133,3,130,4,27,50,7,2,0,0,12,6,22
10,312,126,12,114,5,109,3,22,36,5,2,4,0,11,2,24
10,313,315,39,276,2,274,2,99,81,17,4,4,0,16,2,49
10,314,254,41,213,4,209,1,61,81,4,1,0,0,21,5,35
10,315,34,5,29,0,29,0,16,9,1,0,0,0,2,0,1
10,316,173,25,148,9,139,0,38,48,9,1,0,0,13,2,28
10,317,955,168,787,17,770,5,221,342,27,3,4,1,43,25,99
10,318,129,14,115,0,115,1,33,40,11,1,1,0,13,1,14
10,319,279,48,231,2,229,3,71,73,19,1,0,1,11,5,45
10,320,174,25,149,1,148,2,41,45,2,1,2,0,16,5,34
10,321,2453,380,2073,41,2032,38,391,668,128,19,10,7,225,59,487
10,323,8806,2313,6493,109,6384,87,1575,1273,959,55,39,18,406,105,1867
10,324,119,8,111,0,111,0,26,39,7,4,0,0,12,0,23
10,325,2256,407,1849,34,1815,17,434,609,118,9,16,6,167,34,405
10,326,174,32,142,2,140,7,36,49,9,2,1,0,11,3,22
10,327,105,18,87,0,87,1,24,30,4,1,0,1,7,5,14
10,328,293,52,241,6,235,1,65,80,18,3,2,0,14,17,35
10,329,464,87,377,6,371,2,104,121,30,7,2,2,30,6,67
10,330,111,17,94,1,93,1,28,48,2,0,0,0,4,1,9
10,331,377,69,308,4,304,3,82,120,14,1,3,1,22,5,53
10,332,329,31,298,6,292,6,70,92,21,2,0,2,21,3,75
10,333,7959,1692,6267,91,6176,101,1224,1889,488,59,24,11,593,105,1682
10,334,404,51,353,4,349,3,131,77,31,2,3,1,26,15,60
10,335,175,27,148,1,147,0,34,69,2,0,2,0,0,5,35
10,336,331,44,287,5,282,2,78,91,11,3,3,0,22,8,64
10,337,35,4,31,2,29,1,7,11,2,0,0,0,5,2,1
10,338,105,14,91,4,87,1,25,26,7,0,0,0,8,2,18
10,339,190,28,162,2,160,0,43,47,12,1,2,0,12,3,40
10,340,1822,395,1427,19,1408,17,321,460,109,22,8,3,122,29,317
10,341,271,51,220,3,217,4,56,72,22,3,0,1,18,8,33
10,342,290,55,235,4,231,2,74,59,15,3,3,0,14,7,54
10,343,4933,988,3945,59,3886,67,815,1218,326,43,19,5,344,77,972
10,344,562,53,509,9,500,4,103,176,41,5,5,1,55,10,100
10,345,319,33,286,9,277,5,91,77,25,1,1,1,24,11,41
10,346,61,8,53,0,53,0,14,19,5,2,0,0,7,1,5
10,347,159,19,140,1,139,1,45,45,12,1,1,0,13,1,20
10,348,164,23,141,1,140,2,42,49,12,3,1,1,9,9,12
10,349,2200,288,1912,37,1875,24,515,532,122,17,6,4,197,49,409
10,350,501,86,415,10,405,5,99,125,42,4,3,3,25,9,90
10,351,288,49,239,5,234,10,51,74,19,2,0,0,21,3,54
10,352,1123,147,976,14,962,17,250,271,76,9,8,2,99,27,203
10,353,688,109,579,7,572,1,218,137,26,10,3,2,42,5,128
10,354,106,12,94,1,93,0,35,31,2,1,0,0,8,5,11
10,355,71,8,63,0,63,1,12,26,4,3,1,0,7,2,7
10,356,162,14,148,4,144,2,62,41,5,0,2,0,10,4,18
10,357,2097,363,1734,24,1710,22,367,538,124,21,5,2,164,28,439
10,358,758,132,626,12,614,6,155,237,33,3,4,1,39,9,127
10,359,399,64,335,1,334,5,106,93,19,3,1,1,18,12,76
10,360,590,71,519,7,512,10,120,157,31,7,2,0,56,16,113
10,361,133,15,118,3,115,1,52,39,2,2,0,0,3,4,12
10,362,7482,1725,5757,120,5637,116,1110,1526,519,51,31,14,522,115,1633
10,363,416,50,366,4,362,5,95,123,23,3,3,0,29,5,76
10,364,76,7,69,4,65,0,13,33,0,0,0,0,11,1,7
10,365,114,18,96,0,96,0,28,37,7,2,2,0,10,1,9
10,366,78,21,57,1,56,0,12,33,0,0,0,0,5,3,3
10,367,429,85,344,6,338,6,127,98,17,0,1,2,26,7,54
10,368,733,94,639,11,628,10,207,194,37,6,5,3,34,20,112
10,369,177,42,135,3,132,0,44,44,10,0,0,1,11,4,18
10,370,174,31,143,4,139,2,56,23,13,0,1,0,4,4,36
10,371,245,22,223,4,219,7,52,67,9,11,2,1,19,6,45
10,372,228,24,204,7,197,2,46,68,17,2,2,1,19,5,35
10,373,338,49,289,7,282,8,69,79,25,1,1,0,33,5,61
10,374,115,10,105,2,103,0,25,53,5,0,0,0,8,0,12
10,375,236,17,219,5,214,2,56,77,8,0,1,0,23,5,42
10,376,122,19,103,3,100,2,28,36,2,1,0,2,7,5,17
10,377,115,8,107,4,103,0,23,47,5,1,0,0,15,0,12
10,378,72,20,52,1,51,0,16,23,4,0,1,0,1,0,6
10,379,337,32,305,6,299,0,67,121,19,3,2,0,23,12,52
10,380,54,7,47,0,47,0,15,12,0,0,0,0,5,2,13
10,381,716,84,632,9,623,9,130,231,33,2,1,0,53,17,147
10,382,699,144,555,14,541,1,149,182,44,4,1,0,39,9,112
10,383,129,22,107,4,103,0,25,26,14,1,0,0,10,3,24
10,384,194,24,170,4,166,2,48,44,22,1,1,2,11,2,33
10,386,175,37,138,0,138,0,46,39,13,4,2,0,23,1,10
10,387,30546,7168,23378,366,23012,462,4496,6672,2070,213,142,57,1939,426,6535
10,388,51,6,45,0,45,0,12,11,7,0,0,0,5,1,9
10,389,110,13,97,1,96,0,34,32,3,0,0,0,12,4,11
10,390,134,20,114,5,109,0,18,62,6,2,0,2,6,5,8
10,391,244,28,216,5,211,2,52,76,7,4,0,1,30,2,37
10,392,313,39,274,5,269,4,78,72,21,2,3,1,11,6,71
10,393,155,38,117,1,116,1,29,31,11,2,2,0,7,3,30
10,394,106,8,98,1,97,2,22,35,10,3,0,0,13,0,12
10,395,254,51,203,5,198,4,56,51,22,5,3,0,10,5,42
10,396,401,40,361,4,357,6,92,111,30,2,1,1,36,13,65
10,397,115,16,99,1,98,0,20,40,8,1,1,0,4,4,20
10,398,62,8,54,2,52,3,7,25,3,0,0,0,8,2,4
10,399,472,67,405,5,400,1,128,125,21,1,2,0,23,11,88
10,400,122,18,104,1,103,4,27,39,7,1,2,0,9,0,14
10,401,1508,305,1203,21,1182,10,337,319,83,30,10,2,103,17,271
10,402,196,27,169,1,168,3,38,38,18,1,0,0,25,5,40
10,403,75,16,59,0,59,0,26,21,1,0,0,0,8,1,2
10,404,110,19,91,4,87,2,15,28,10,1,2,0,4,0,25
10,405,38,9,29,0,29,1,14,8,0,0,0,0,1,2,3
10,406,1422,240,1182,27,1155,14,297,364,69,12,4,2,127,24,242
10,408,101,19,82,3,79,1,19,23,7,1,0,1,7,3,17
10,409,409,51,358,7,351,9,103,97,20,7,0,0,39,10,66
10,410,114,25,89,5,84,4,19,24,5,1,0,0,11,1,19
10,411,13,0,13,0,13,0,5,0,1,0,0,0,6,1,0
10,412,651,81,570,13,557,7,113,196,30,5,2,1,56,6,141
10,414,91,10,81,0,81,0,22,37,3,0,0,0,6,1,12
10,415,377,75,302,5,297,4,84,80,30,3,2,0,22,10,62
10,416,177,15,162,1,161,2,53,62,8,2,0,0,9,0,25
10,417,201,31,170,2,168,2,41,38,26,2,1,1,15,4,38
10,418,140,24,116,3,113,2,27,48,6,0,0,0,10,4,16
10,419,556,95,461,11,450,3,139,148,20,9,2,2,32,15,80
10,420,1562,271,1291,20,1271,24,358,396,117,12,6,2,76,32,248
10,421,105,13,92,1,91,3,14,25,8,0,0,0,9,6,26
10,422,170,38,132,4,128,0,34,48,9,1,2,0,8,2,24
10,423,325,37,288,9,279,2,87,78,15,2,2,2,20,3,68
10,424,67,11,56,0,56,0,18,15,3,0,0,0,2,3,15
10,425,211,27,184,3,181,2,52,66,16,0,3,0,14,5,23
10,426,713,132,581,9,572,4,209,123,51,12,8,1,27,14,123
10,427,238,33,205,3,202,6,45,96,12,1,1,0,11,3,27
10,428,104,11,93,0,93,0,35,38,2,0,1,0,8,0,9
10,429,183,29,154,4,150,1,53,24,10,2,2,0,14,1,43
10,430,74,22,52,0,52,0,18,18,4,0,0,0,3,0,9
10,431,76,23,53,1,52,0,13,22,1,0,0,0,5,5,6
10,432,55,6,49,0,49,0,11,26,3,0,0,0,0,1,8
10,433,180,28,152,4,148,0,44,53,5,1,1,0,13,6,25
10,434,48,0,48,3,45,0,18,18,1,1,0,0,3,1,3
10,435,146,19,127,3,124,0,42,37,11,0,1,0,5,2,26
10,436,148,23,125,3,122,1,43,46,1,2,1,2,3,4,19
10,437,450,60,390,13,377,5,132,99,32,4,3,3,25,5,69
10,438,236,56,180,5,175,2,45,77,4,1,1,0,12,7,26
10,439,93,9,84,2,82,2,17,31,4,4,0,0,8,6,10
10,440,158,39,119,7,112,1,29,47,6,0,0,0,8,5,16
10,441,194,31,163,3,160,1,44,39,21,2,0,0,12,3,38
10,442,396,55,341,8,333,5,123,83,18,3,3,4,27,9,58
10,443,39,3,36,1,35,0,8,17,0,0,0,0,3,2,5
10,444,164,15,149,1,148,0,41,63,11,0,0,1,15,4,13
10,445,58,5,53,1,52,2,4,25,3,0,0,0,12,0,6
11,1,393,53,340,11,329,7,66,93,31,5,3,0,18,5,101
11,2,106,19,87,2,85,4,7,30,10,2,2,2,8,3,17
11,3,153,30,123,0,123,3,29,27,12,3,0,0,15,3,31
11,4,202,39,163,3,160,3,21,41,17,3,0,2,17,5,51
11,5,861,77,784,14,770,22,194,129,83,17,0,2,43,13,267
11,6,72,5,67,1,66,1,5,3,14,1,0,0,2,0,40
11,7,84,11,73,0,73,5,10,10,20,0,1,0,1,1,25
11,8,339,50,289,4,285,7,43,77,64,8,2,1,15,2,66
11,9,1086,170,916,17,899,15,200,187,94,10,3,4,37,6,343
11,10,252,59,193,4,189,9,44,31,28,4,0,0,7,2,64
11,11,361,50,311,3,308,7,58,62,49,5,1,1,29,2,94
11,12,1485,264,1221,22,1199,25,344,193,187,27,11,3,76,13,320
11,13,277,45,232,4,228,12,54,31,43,6,2,1,13,3,63
11,14,1128,124,1004,20,984,15,225,253,100,11,4,1,78,14,283
11,15,156,36,120,1,119,4,21,43,11,1,0,0,7,2,30
11,16,82,14,68,1,67,0,13,18,11,0,0,0,5,0,20
11,17,87,5,82,0,82,3,22,17,4,0,0,0,8,2,26
11,18,860,98,762,11,751,14,179,140,88,15,5,2,40,11,257
11,19,64,9,55,3,52,2,10,8,6,0,0,0,3,1,22
11,20,31,6,25,1,24,3,3,1,4,0,0,0,2,0,11
11,21,474,109,365,10,355,3,48,55,64,3,2,1,19,5,155
11,22,877,112,765,20,745,9,181,185,77,11,10,2,37,15,218
11,23,519,59,460,12,448,5,120,78,56,4,1,0,31,5,148
11,24,653,78,575,18,557,17,107,115,111,4,2,1,25,7,168
11,25,185,19,166,4,162,1,52,36,14,0,1,0,16,1,41
11,26,105,4,101,3,98,2,15,29,19,2,1,1,7,1,21
11,27,508,51,457,5,452,4,99,89,56,3,1,0,35,5,160
11,28,381,55,326,5,321,13,70,118,33,4,1,2,14,3,63
11,29,53,10,43,1,42,2,6,8,6,1,0,0,4,0,15
11,30,92,12,80,0,80,1,7,29,8,1,0,0,4,0,30
11,31,37,6,31,0,31,0,8,6,3,0,0,0,5,0,9
11,32,147,18,129,1,128,1,27,29,23,0,0,1,2,3,42
11,33,1010,158,852,23,829,17,183,188,111,10,5,3,64,12,236
11,34,655,82,573,11,562,7,119,111,70,4,2,3,30,5,211
11,35,229,44,185,4,181,7,50,40,20,6,1,0,15,3,39
11,36,173,31,142,2,140,11,35,23,23,0,2,1,7,2,36
11,37,549,144,405,4,401,2,132,62,28,3,0,1,17,3,153
11,38,59,22,37,1,36,1,2,4,7,1,0,1,1,0,19
11,39,35,2,33,0,33,4,5,4,6,1,0,0,2,0,11
11,40,1017,117,900,28,872,18,231,142,134,8,7,0,61,9,262
11,41,862,137,725,12,713,18,142,140,103,7,2,4,41,8,248
11,42,143,18,125,4,121,1,26,18,19,1,1,0,6,1,48
11,43,199,32,167,2,165,3,33,23,22,0,0,0,9,1,74
11,44,84,10,74,4,70,3,9,12,12,0,0,1,4,2,27
11,45,106,9,97,0,97,5,20,17,19,3,0,0,9,2,22
11,46,38,6,32,3,29,1,1,7,7,0,0,0,5,0,8
11,47,59,16,43,0,43,0,7,11,9,2,0,0,2,0,12
11,48,546,91,455,7,448,7,108,52,74,9,2,0,30,5,161
11,49,2374,316,2058,47,2011,26,445,478,194,30,10,6,96,31,695
11,50,200,31,169,1,168,13,24,36,22,8,0,0,23,2,40
11,51,131,26,105,3,102,4,17,12,18,1,0,0,9,3,38
11,52,271,34,237,1,236,11,51,56,30,0,2,0,19,5,62
11,53,194,45,149,4,145,5,36,18,18,0,1,0,9,4,54
11,54,194,20,174,2,172,4,44,48,11,2,0,1,18,4,40
11,55,201,36,165,2,163,19,23,19,41,5,0,0,12,3,41
11,56,132,26,106,1,105,2,6,24,30,2,1,0,9,2,29
11,57,20,3,17,0,17,0,5,7,1,0,0,0,1,0,3
11,58,204,34,170,1,169,1,33,46,13,3,0,0,8,0,65
11,59,91,14,77,6,71,1,16,16,2,1,1,1,4,0,29
11,60,36,3,33,0,33,1,2,2,11,2,0,0,0,0,15
11,61,202,23,179,9,170,2,38,31,15,0,0,0,6,4,74
11,62,51,13,38,1,37,4,1,6,5,0,0,0,6,0,15
11,63,492,87,405,2,403,7,98,91,75,11,3,1,23,7,87
11,64,219,13,206,2,204,2,44,13,79,0,1,0,11,3,51
11,65,65,16,49,0,49,8,7,6,12,0,0,0,3,5,8
11,66,115,36,79,2,77,1,14,39,5,0,0,1,6,1,10
11,67,1054,156,898,17,881,14,223,171,118,18,3,3,49,12,270
11,68,1110,162,948,11,937,16,218,162,149,16,6,2,46,20,302
11,69,31090,6369,24721,470,24251,500,5463,5582,2885,240,95,37,1444,327,7678
11,70,211,21,190,3,187,8,44,43,15,0,1,2,15,3,56
11,71,167,27,140,0,140,3,42,20,5,0,0,0,2,2,66
11,72,132,16,116,0,116,1,17,24,13,3,0,0,2,5,51
11,73,49,7,42,1,41,6,4,5,7,1,0,0,3,0,15
11,74,183,10,173,4,169,8,33,33,29,4,0,1,22,1,38
11,75,125,16,109,1,108,13,22,10,30,0,1,0,5,3,24
11,76,7252,1470,5782,115,5667,97,1112,1459,604,52,30,10,395,111,1797
11,77,374,58,316,7,309,2,99,36,37,5,3,1,16,13,97
11,78,168,28,140,2,138,13,25,34,13,4,1,0,5,5,38
11,79,134,11,123,3,120,2,20,33,15,4,0,0,9,5,32
11,80,112,8,104,3,101,1,17,19,20,2,1,0,3,2,36
11,81,1165,184,981,21,960,28,197,185,125,12,4,2,60,19,328
11,82,12,4,8,0,8,2,0,0,0,0,0,0,0,0,6
11,83,44,13,31,1,30,2,5,4,5,0,0,0,2,0,12
11,84,644,70,574,11,563,5,174,111,52,7,2,1,37,7,167
11,85,705,118,587,9,578,18,170,102,81,3,5,0,45,10,144
11,86,567,53,514,11,503,7,137,115,52,12,3,0,37,6,134
11,87,73,12,61,0,61,3,7,22,7,2,0,0,2,0,18
11,88,1264,164,1100,28,1072,13,241,254,142,12,5,2,61,15,327
11,89,259,32,227,1,226,9,41,33,57,5,0,1,9,4,67
11,90,444,59,385,9,376,14,76,82,42,3,1,0,20,9,129
11,91,851,141,710,17,693,20,92,142,108,9,8,0,35,7,272
11,92,90,11,79,3,76,0,9,15,7,2,0,1,6,4,32
11,93,31,4,27,0,27,0,0,1,2,0,0,0,0,0,24
11,94,25,6,19,0,19,4,5,1,6,0,0,0,1,0,2
11,95,211,27,184,5,179,1,66,24,12,3,0,1,13,2,57
11,96,62,11,51,1,50,3,3,12,7,0,0,0,2,0,23
11,97,53,7,46,0,46,0,7,9,5,2,0,0,8,1,14
11,98,618,67,551,10,541,4,170,82,70,2,2,1,37,6,167
11,99,1665,206,1459,28,1431,35,364,291,206,22,10,4,73,22,404
11,100,35,10,25,1,24,0,7,4,2,0,0,0,0,0,11
11,101,53,8,45,2,43,0,3,18,2,0,1,0,0,2,17
11,102,468,58,410,5,405,6,94,66,73,6,2,0,18,4,136
11,103,939,159,780,27,753,8,157,129,90,7,3,2,46,16,295
11,104,58,8,50,0,50,2,9,9,9,1,0,0,1,2,17
11,105,478,42,436,11,425,6,90,70,65,4,1,0,24,7,158
11,106,4432,684,3748,75,3673,44,852,636,769,42,23,13,179,53,1062
11,107,41,6,35,1,34,5,4,6,6,2,1,0,1,0,9
11,108,36,5,31,0,31,0,2,7,8,0,0,0,7,0,7
11,109,49,4,45,0,45,0,8,9,4,1,0,1,3,1,18
11,110,90,16,74,2,72,1,21,21,10,0,0,0,5,2,12
11,111,387,32,355,7,348,2,115,68,39,1,1,1,22,5,94
11,112,59,9,50,1,49,3,9,8,15,2,0,0,3,1,8
11,113,106,10,96,1,95,5,16,30,12,0,1,1,3,0,27
11,114,33,4,29,1,28,1,9,5,1,0,0,0,1,0,11
11,115,553,59,494,10,484,14,124,79,60,6,1,3,30,5,162
11,116,3373,615,2758,58,2700,43,702,543,395,31,13,7,149,41,776
11,117,111,23,88,0,88,6,16,16,14,1,2,1,3,5,24
11,118,47,15,32,0,32,1,3,2,19,0,0,0,0,0,7
11,119,224,23,201,1,200,2,35,52,32,3,1,0,16,3,56
11,120,409,45,364,9,355,2,64,85,37,4,2,2,30,8,121
11,121,78,11,67,0,67,5,14,14,4,0,0,0,8,2,20
11,122,514,60,454,7,447,5,77,76,74,5,5,0,23,5,177
11,123,129,8,121,2,119,6,14,25,29,4,0,0,12,2,27
11,124,506,72,434,7,427,12,66,74,54,3,3,1,17,7,190
11,125,162,23,139,3,136,3,26,34,21,1,1,2,5,1,42
11,126,287,34,253,5,248,3,78,60,22,1,4,1,11,4,64
11,127,110,27,83,1,82,2,9,10,18,5,1,0,4,0,33
11,128,117,20,97,5,92,1,15,31,15,4,0,0,5,5,16
11,129,1442,270,1172,20,1152,23,252,227,217,24,10,4,67,14,314
11,130,218,36,182,6,176,9,40,46,15,3,1,0,8,6,48
11,131,245,49,196,5,191,13,43,22,52,4,2,0,9,2,44
11,132,956,136,820,17,803,13,174,157,149,4,2,0,53,14,237
11,133,38,7,31,1,30,1,3,13,3,0,0,0,8,0,2
11,134,40,2,38,0,38,3,1,13,5,0,0,0,10,1,5
11,135,25,6,19,1,18,0,4,1,1,0,0,0,1,0,11
11,136,541,60,481,16,465,9,122,93,62,7,3,1,34,6,128
11,137,126,24,102,3,99,1,24,19,10,1,0,0,5,3,36
11,138,417,51,366,9,357,8,83,63,45,9,2,2,40,4,101
11,139,74,12,62,1,61,3,10,13,12,3,0,0,3,1,16
11,140,913,126,787,16,771,12,186,125,149,17,4,2,41,6,229
11,141,76,10,66,2,64,9,8,12,10,0,0,0,3,0,22
11,142,129,30,99,4,95,12,4,14,26,3,0,0,1,2,33
11,143,82,21,61,0,61,5,17,8,12,0,0,0,2,0,17
11,144,718,144,574,7,567,21,119,118,57,5,2,2,43,18,182
11,145,3176,520,2656,50,2606,34,736,654,292,29,11,5,147,20,678
11,146,218,33,185,3,182,3,44,18,22,2,0,0,11,6,76
11,147,20,5,15,1,14,0,5,2,3,0,0,0,0,1,3
11,148,362,48,314,8,306,2,84,46,29,7,2,2,27,8,99
11,149,72,10,62,2,60,5,12,27,2,0,0,0,5,0,9
11,150,313,49,264,5,259,10,57,64,50,4,1,0,14,6,53
11,151,289,35,254,10,244,8,74,38,16,4,2,1,15,1,85
11,152,118,16,102,1,101,2,12,29,20,4,0,0,8,0,26
11,153,155,20,135,4,131,5,42,27,12,2,2,0,7,3,31
11,154,56,12,44,1,43,1,9,8,2,0,0,0,3,0,20
11,155,60,11,49,1,48,2,6,7,16,0,0,0,2,2,13
11,156,84,10,74,3,71,3,10,16,12,0,0,0,8,1,21
11,157,184,21,163,3,160,1,31,14,35,4,0,1,14,4,56
11,158,196,32,164,5,159,4,44,30,17,6,0,2,14,4,38
11,159,124,17,107,1,106,5,20,18,23,0,1,1,8,2,28
11,160,26,6,20,2,18,1,1,0,7,1,0,0,0,0,8
11,161,74,3,71,1,70,0,12,19,9,0,0,0,7,2,21
11,162,54,5,49,0,49,4,3,17,7,2,0,0,4,0,12
11,163,43,7,36,0,36,1,13,12,1,1,0,0,5,0,3
11,164,981,101,880,20,860,11,216,181,118,15,6,5,67,16,225
11,165,278,60,218,8,210,8,44,49,23,3,0,0,15,2,66
11,166,58,10,48,1,47,0,8,11,9,0,1,0,2,2,14
11,167,73,7,66,1,65,0,16,7,10,3,1,0,2,0,26
11,168,101,21,80,0,80,1,10,9,28,3,1,0,6,1,21
11,169,85,7,78,0,78,13,7,3,15,3,1,1,7,0,28
11,170,4446,708,3738,54,3684,80,984,887,504,53,19,15,187,46,909
11,171,36,3,33,0,33,0,6,10,2,0,0,0,1,0,14
11,172,468,70,398,10,388,4,97,84,50,6,3,0,22,6,116
11,173,103,28,75,2,73,1,22,17,7,2,0,1,3,0,20
11,174,56,9,47,0,47,0,8,9,8,1,0,0,2,0,19
11,175,357,43,314,8,306,7,56,75,42,3,3,0,24,9,87
11,176,52,8,44,0,44,2,8,8,6,1,0,0,4,1,14
11,177,38,5,33,1,32,2,7,3,10,1,0,0,1,2,6
11,178,746,98,648,13,635,8,126,135,55,13,6,2,48,14,228
11,179,77,12,65,4,61,3,16,6,11,0,0,0,1,0,24
11,180,80,10,70,2,68,5,9,3,9,0,0,1,3,3,35
11,181,307,32,275,3,272,15,69,54,41,10,0,0,29,5,49
11,182,127,19,108,3,105,1,25,29,11,1,0,1,7,3,27
11,183,210,28,182,1,181,9,20,34,31,5,1,0,18,1,62
11,184,80,16,64,0,64,6,21,8,2,1,1,0,5,0,20
11,185,457,79,378,10,368,21,55,68,55,5,0,1,14,3,146
11,186,42,4,38,3,35,3,0,3,14,4,0,0,2,0,9
11,187,53,14,39,0,39,1,9,3,7,1,0,0,2,0,16
11,188,1210,202,1008,21,987,15,277,272,98,15,3,2,58,18,229
11,189,96,13,83,2,81,1,15,11,2,0,1,0,7,2,42
11,190,811,137,674,17,657,7,133,113,79,10,4,1,38,7,265
11,191,92,16,76,0,76,1,10,16,21,1,0,1,9,1,16
11,192,522,60,462,8,454,4,104,94,41,8,4,5,34,6,154
11,193,172,20,152,1,151,1,33,25,22,7,0,0,9,4,50
11,194,109,13,96,0,96,0,14,14,33,3,2,1,5,1,23
11,195,277,44,233,4,229,6,60,40,26,2,3,1,22,6,63
11,196,135,4,131,3,128,5,24,23,10,6,1,0,9,3,47
11,197,495,53,442,7,435,1,102,61,69,9,1,2,39,9,142
11,198,841,129,712,10,702,18,136,120,98,1,2,0,52,11,264
11,199,999,128,871,10,861,15,238,215,91,11,6,3,58,8,216
11,200,129,25,104,1,103,3,21,20,25,0,0,0,6,0,28
11,201,551,58,493,5,488,11,100,70,68,10,1,0,22,10,196
11,202,4106,725,3381,54,3327,80,795,987,341,30,13,8,225,42,806
11,203,6998,1345,5653,135,5518,76,1408,1071,678,58,28,6,225,79,1889
11,204,38,6,32,1,31,0,8,8,1,1,0,0,2,0,11
11,205,106,12,94,1,93,2,29,21,14,3,0,0,8,0,16
11,206,6699,1207,5492,110,5382,107,1075,1254,662,62,30,17,291,72,1812
11,207,187,26,161,6,155,5,27,35,14,0,0,1,11,2,60
11,208,87,14,73,1,72,3,16,26,6,1,0,0,4,1,15
11,209,175,18,157,3,154,13,28,14,21,2,1,0,16,9,50
11,210,817,95,722,16,706,9,233,142,86,10,2,2,37,9,176
11,211,405,39,366,7,359,7,68,68,75,5,0,1,20,7,108
11,212,356,43,313,4,309,6,81,46,34,5,3,0,23,6,105
11,213,46,3,43,0,43,1,3,13,6,2,0,0,4,0,14
11,214,301,38,263,3,260,0,84,65,19,6,0,1,24,0,61
11,215,637,66,571,9,562,11,131,105,79,4,4,0,31,8,189
11,216,270,27,243,4,239,6,45,50,24,2,2,0,20,8,82
11,217,943,125,818,15,803,12,201,133,131,16,5,2,49,5,249
11,218,59,7,52,1,51,0,7,17,8,1,0,0,3,0,15
11,219,43,7,36,0,36,0,9,2,9,2,1,0,1,0,12
11,220,515,62,453,11,442,7,116,75,70,7,2,0,25,4,136
11,221,190,31,159,3,156,3,33,35,20,2,0,0,8,1,54
11,222,145,18,127,4,123,5,14,10,9,1,3,0,10,5,66
11,223,22,5,17,0,17,0,2,12,1,0,0,0,0,0,2
11,224,29,3,26,0,26,3,4,2,6,0,0,0,2,0,9
11,225,652,79,573,17,556,13,122,115,62,4,3,1,31,10,195
11,226,63,8,55,3,52,1,6,18,5,0,0,0,9,0,13
11,227,29,4,25,1,24,2,1,0,13,0,0,1,0,0,7
11,228,142,11,131,3,128,1,31,20,11,2,1,0,8,0,54
11,229,57,17,40,0,40,0,4,4,3,1,0,0,1,0,27
11,230,47,7,40,0,40,0,20,10,1,0,1,0,2,0,6
11,231,62,5,57,2,55,3,10,6,7,0,0,0,3,2,24
11,232,57,11,46,2,44,3,5,6,7,2,0,1,5,0,15
11,233,562,55,507,8,499,14,108,76,67,12,6,0,33,8,175
11,234,153,20,133,1,132,4,14,21,21,4,1,0,15,3,49
11,235,69,5,64,0,64,0,11,14,8,0,1,0,3,1,26
11,236,189,19,170,9,161,5,31,34,25,1,0,0,21,5,39
11,238,78,3,75,2,73,1,12,14,11,0,0,1,10,4,20
11,239,76,15,61,3,58,0,11,5,13,3,0,0,6,3,17
11,240,440,92,348,5,343,11,67,55,82,5,3,0,20,3,97
11,241,215,36,179,2,177,4,63,29,23,1,0,0,4,0,53
11,242,142,29,113,2,111,6,24,17,15,3,1,0,6,4,35
11,243,339,42,297,7,290,7,58,80,29,5,0,1,33,6,71
11,244,102,18,84,2,82,0,25,22,13,0,0,0,0,0,22
11,245,41,9,32,1,31,6,1,3,9,2,0,0,0,0,10
11,246,53,10,43,2,41,2,11,8,1,0,0,0,4,0,15
11,247,36,3,33,0,33,2,5,8,4,0,0,0,6,0,8
11,248,57,11,46,2,44,0,11,11,13,1,0,0,1,0,7
11,249,76,12,64,1,63,1,8,9,10,0,2,1,0,0,32
11,250,38,12,26,2,24,2,0,4,6,0,0,0,0,0,12
11,251,461,73,388,7,381,15,54,55,91,2,3,1,19,3,138
11,252,253,27,226,4,222,6,44,49,51,3,4,1,12,4,48
11,253,704,102,602,5,597,37,99,179,65,12,3,1,44,11,146
11,254,1327,193,1134,15,1119,21,263,263,130,11,11,5,88,15,312
11,255,1025,140,885,24,861,5,244,116,120,5,2,0,48,18,303
11,256,357,46,311,6,305,7,43,42,59,7,1,0,19,3,124
11,257,154,19,135,6,129,6,32,22,12,1,0,0,9,1,46
11,258,1308,125,1183,19,1164,20,276,210,232,11,13,2,64,13,323
11,259,704,68,636,10,626,11,159,131,75,12,1,0,27,13,197
11,260,89,14,75,2,73,0,14,10,27,0,1,0,0,0,21
11,261,544,105,439,9,430,11,107,65,80,7,1,0,27,6,126
11,262,37249,8077,29172,566,28606,561,6329,7112,3658,305,141,50,1793,403,8254
11,263,200,35,165,5,160,4,37,33,34,3,0,1,10,6,32
11,264,963,112,851,23,828,15,204,145,136,13,5,1,41,13,255
11,265,71,21,50,1,49,0,9,12,4,1,0,0,3,0,20
11,266,4574,782,3792,72,3720,41,1384,859,324,49,22,4,141,59,837
11,267,929,144,785,17,768,13,166,196,121,6,3,1,35,10,217
11,268,91,14,77,1,76,1,15,20,16,1,0,0,8,1,14
11,269,1653,252,1401,21,1380,21,317,321,216,26,13,3,103,34,326
11,270,138,42,96,1,95,1,12,17,11,0,0,1,9,4,40
11,271,31,3,28,0,28,0,7,11,3,1,0,0,1,0,5
11,272,1680,168,1512,20,1492,22,363,344,150,20,6,3,106,24,454
11,273,499,85,414,8,406,9,94,70,59,7,5,2,24,9,127
11,274,254,52,202,2,200,6,45,65,16,4,1,0,13,2,48
11,275,153,17,136,3,133,3,22,18,23,3,0,1,11,3,49
11,276,366,55,311,9,302,4,51,38,95,7,4,2,15,3,83
11,277,23,2,21,0,21,2,3,2,2,0,0,0,0,1,11
11,278,57,4,53,2,51,9,7,10,5,1,1,0,4,0,14
11,279,1756,226,1530,22,1508,23,408,357,155,17,7,4,78,23,436
11,280,701,102,599,12,587,5,137,115,77,10,3,2,19,6,213
11,281,821,116,705,13,692,4,180,179,91,12,4,0,36,17,169
11,282,52,14,38,1,37,1,8,4,6,1,1,0,0,1,15
11,283,45,6,39,1,38,3,5,10,6,0,0,0,3,0,11
11,284,320,41,279,7,272,4,72,62,24,7,2,0,22,1,78
11,285,900,114,786,10,776,32,176,183,98,12,3,5,67,12,188
11,286,844,174,670,10,660,13,155,108,84,5,4,3,35,6,247
11,287,58,7,51,0,51,9,10,8,17,0,0,0,1,0,6
11,288,974,129,845,26,819,12,273,162,76,9,1,0,47,9,230
11,289,783,95,688,10,678,12,162,115,107,6,5,0,30,8,233
11,290,90,18,72,2,70,1,10,20,12,3,0,0,3,7,14
11,291,90,9,81,5,76,1,4,30,6,1,1,0,1,1,31
11,292,129,10,119,5,114,1,27,21,15,2,0,0,11,1,36
11,293,615,96,519,8,511,12,129,128,35,3,8,3,27,8,158
11,294,39,4,35,0,35,0,9,6,9,0,0,0,0,1,10
11,295,926,134,792,14,778,12,182,158,115,13,3,3,30,18,244
11,296,350,43,307,3,304,1,71,43,38,4,0,0,27,5,115
11,297,148,16,132,2,130,4,38,20,25,1,0,0,7,0,35
11,298,144,14,130,1,129,8,29,12,21,0,2,0,12,2,43
11,299,409,43,366,9,357,11,91,78,25,5,1,1,20,5,120
11,300,123,11,112,1,111,4,26,23,9,0,0,0,14,3,32
11,301,750,112,638,14,624,27,158,91,132,5,1,0,20,4,186
11,302,226,25,201,5,196,7,42,29,29,1,2,0,7,4,75
11,303,380,57,323,7,316,13,47,66,42,4,1,0,17,3,123
11,304,2535,495,2040,53,1987,33,420,489,263,41,7,1,99,34,600
11,305,61,13,48,2,46,2,3,3,8,1,0,0,2,0,27
11,306,43,8,35,1,34,3,0,2,19,1,0,0,1,0,8
11,307,218,47,171,6,165,1,38,23,21,2,2,0,23,1,54
11,308,259,34,225,7,218,4,51,33,28,5,2,1,17,0,77
11,309,74,15,59,1,58,2,8,14,11,0,1,0,2,0,20
11,310,129,12,117,3,114,9,18,25,21,1,0,0,4,1,35
11,311,210,29,181,4,177,10,31,29,35,3,1,0,14,6,48
11,312,78,11,67,1,66,2,13,5,10,1,3,1,6,1,24
11,313,221,24,197,7,190,0,34,55,25,4,0,0,12,7,53
11,314,67,18,49,1,48,1,9,9,7,0,0,0,3,0,19
11,315,1534,277,1257,30,1227,23,312,334,98,7,9,2,60,8,374
11,316,177,57,120,5,115,4,10,33,13,0,1,0,16,2,36
11,317,130,25,105,1,104,10,13,5,24,0,2,0,6,2,42
11,318,105,24,81,0,81,3,29,16,8,3,0,0,7,0,15
11,319,68,8,60,2,58,3,8,6,15,1,1,0,3,0,21
11,320,275,42,233,2,231,7,45,36,34,1,1,1,14,4,88
11,321,137,27,110,0,110,1,28,20,13,1,0,0,10,2,35
11,322,790,114,676,13,663,10,163,157,96,13,1,2,41,7,173
11,323,166,17,149,4,145,7,20,14,23,2,0,1,8,2,68
11,324,358,58,300,3,297,4,89,61,35,1,2,0,19,4,82
11,325,286,31,255,1,254,6,57,53,31,5,2,0,16,2,82
11,326,77,14,63,2,61,4,12,4,12,0,0,0,1,2,26
11,327,372,40,332,11,321,7,67,56,78,3,1,0,21,8,80
11,328,213,15,198,4,194,5,27,34,30,2,1,0,6,5,84
11,329,172,35,137,2,135,15,27,18,30,1,0,0,9,2,33
11,330,281,28,253,8,245,6,54,58,36,5,2,1,10,5,68
11,331,61,2,59,2,57,3,8,29,3,1,0,0,4,0,9
11,332,959,164,795,17,778,11,197,157,114,7,7,2,36,15,232
11,333,68,8,60,1,59,7,12,10,5,5,0,1,2,1,16
11,334,97,11,86,0,86,2,20,12,7,1,0,1,6,4,33
11,335,58,10,48,0,48,1,8,11,2,0,1,0,5,1,19
11,336,338,45,293,10,283,8,58,50,47,2,1,2,19,7,89
11,337,288,25,263,5,258,6,62,56,43,4,1,0,16,3,67
11,338,29,1,28,3,25,2,2,6,1,1,0,0,1,1,11
11,339,392,78,314,8,306,10,70,58,29,7,0,0,30,5,97
11,340,351,21,330,10,320,6,80,86,36,2,3,0,13,7,87
11,341,116,26,90,0,90,2,21,17,16,2,0,0,7,1,24
11,342,165,22,143,2,141,4,46,22,15,1,2,0,7,2,42
11,343,63,5,58,2,56,3,10,6,6,3,1,1,6,1,19
11,344,566,68,498,6,492,12,90,101,60,6,1,1,32,9,180
11,345,238,37,201,4,197,7,44,42,50,0,0,0,10,2,42
11,346,85,17,68,1,67,10,8,10,15,0,0,0,3,1,20
11,347,116,19,97,0,97,6,14,18,16,6,1,0,2,0,34
11,348,65,15,50,0,50,4,7,2,8,1,1,0,3,1,23
11,350,50,2,48,0,48,2,2,2,10,2,0,0,10,1,19
11,351,580,88,492,8,484,11,92,94,79,6,5,1,21,10,165
11,352,59,13,46,2,44,3,10,2,11,1,0,0,2,0,15
11,353,1138,153,985,24,961,6,254,179,130,18,7,4,45,20,298
11,354,24,1,23,0,23,0,2,0,2,0,0,0,1,0,18
11,355,258,46,212,3,209,2,58,56,23,3,2,1,3,2,59
11,356,769,69,700,15,685,14,178,150,83,3,2,1,53,10,191
11,357,184,23,161,10,151,2,24,31,30,1,1,1,11,4,46
11,358,35,17,18,0,18,0,3,0,7,0,0,1,0,0,7
11,359,319,37,282,2,280,13,51,74,31,3,0,1,28,5,74
11,360,1245,131,1114,16,1098,21,265,212,190,8,2,0,78,17,305
11,361,634,83,551,14,537,7,112,107,56,10,5,0,65,9,166
11,362,151,18,133,2,131,5,35,24,14,1,0,2,10,1,39
11,363,162,15,147,4,143,7,14,16,49,2,1,0,7,0,47
11,364,161,26,135,1,134,1,24,39,14,5,0,0,12,3,36
11,365,36,2,34,0,34,2,4,10,4,0,0,0,2,0,12
11,366,422,55,367,4,363,5,63,76,47,9,4,2,32,7,118
11,367,667,106,561,13,548,26,128,125,64,6,4,1,48,9,137
11,368,104,8,96,5,91,4,30,13,7,0,1,0,13,0,23
11,369,1833,206,1627,33,1594,39,403,340,193,17,8,5,99,22,468
11,370,2213,293,1920,28,1892,33,486,395,243,21,9,3,111,25,566
11,371,478,50,428,8,420,13,67,98,58,6,1,1,36,8,132
11,372,303,57,246,1,245,7,64,39,21,3,0,0,8,2,101
11,373,75,12,63,1,62,4,7,3,15,2,2,0,3,0,26
11,374,31,6,25,3,22,4,0,1,5,2,0,0,2,0,8
11,375,23,1,22,1,21,0,0,8,5,1,0,0,2,0,5
11,376,74,8,66,3,63,1,16,12,12,2,0,0,5,2,13
11,377,38,3,35,1,34,2,3,7,5,0,0,1,3,0,13
11,378,205,28,177,4,173,5,27,19,25,1,1,0,10,2,83
11,379,4176,713,3463,64,3399,48,1000,717,382,55,19,10,218,54,896
11,380,129,11,118,2,116,3,30,26,24,3,1,1,10,1,17
11,381,63,12,51,0,51,8,8,5,19,0,1,0,2,0,8
11,382,237,26,211,2,209,3,51,61,11,0,1,0,16,4,62
11,383,251,20,231,5,226,3,64,66,30,2,1,0,14,4,42
11,384,102,12,90,2,88,8,20,11,23,5,1,0,3,3,14
11,385,180,17,163,4,159,4,26,40,16,5,2,2,7,2,55
11,386,322,34,288,4,284,3,48,59,46,3,2,0,37,1,85
11,387,55,6,49,1,48,2,5,9,9,0,0,0,3,2,18
11,388,65,12,53,1,52,5,1,5,11,5,0,1,3,3,18
11,389,30,5,25,3,22,0,2,6,2,0,0,0,1,0,11
11,390,437,67,370,9,361,6,91,61,48,3,2,0,9,2,139
11,391,28,5,23,0,23,1,2,1,2,0,0,0,2,0,15
11,392,217,30,187,2,185,2,30,26,41,5,0,0,3,3,75
11,393,342,32,310,5,305,8,83,56,20,1,2,0,20,3,112
11,394,96,12,84,1,83,1,19,23,7,0,0,1,5,2,25
11,395,31,2,29,1,28,2,1,3,6,1,1,0,0,0,14
11,396,389,35,354,4,350,12,72,78,64,8,2,2,28,4,80
11,397,4129,687,3442,59,3383,29,935,667,405,34,14,5,133,28,1133
11,398,179,21,158,1,157,9,36,39,16,3,1,0,5,5,43
11,399,101,18,83,2,81,6,29,10,7,1,2,1,8,1,16
11,400,78,15,63,0,63,5,11,12,16,1,2,1,5,1,9
11,401,705,109,596,12,584,13,75,107,125,9,8,3,34,4,206
11,402,27,0,27,0,27,2,4,0,3,0,0,0,2,0,16
11,404,713,92,621,9,612,18,124,120,76,12,3,0,36,9,214
11,405,393,38,355,6,349,9,51,70,50,1,2,0,25,5,136
11,406,46,12,34,0,34,3,8,14,3,1,0,0,1,0,4
11,407,224,22,202,3,199,8,30,48,24,2,0,1,26,3,57
11,408,323,34,289,6,283,9,61,58,42,6,2,2,14,5,84
11,409,90,6,84,4,80,2,7,22,21,0,2,0,4,2,20
11,410,716,103,613,7,606,10,153,118,77,8,3,0,20,4,213
11,411,121,20,101,0,101,3,29,17,10,0,0,0,5,0,37
11,412,60,4,56,0,56,0,16,6,8,1,0,0,1,0,24
11,413,367,46,321,9,312,18,61,73,59,8,0,0,17,5,71
11,414,29,9,20,1,19,2,0,0,6,0,1,0,0,1,9
11,415,90,14,76,1,75,2,19,20,6,1,0,0,7,0,20
11,416,159,17,142,7,135,3,27,25,17,1,0,1,7,1,53
11,417,82,16,66,1,65,11,14,7,10,1,0,0,5,0,17
11,418,788,115,673,16,657,13,168,139,78,3,9,1,46,15,185
11,419,48,6,42,0,42,1,10,8,9,3,0,0,5,1,5
11,420,101,13,88,1,87,2,9,11,12,1,0,0,17,0,35
11,421,355,42,313,7,306,5,96,44,44,4,1,0,17,2,93
11,422,263,16,247,3,244,1,57,67,23,3,1,0,10,3,79
11,423,126,12,114,1,113,6,28,19,13,2,0,0,9,0,36
11,424,85,16,69,0,69,2,12,14,13,1,0,0,6,1,20
11,425,1208,161,1047,25,1022,20,249,177,101,13,7,2,65,13,375
11,426,747,72,675,16,659,14,200,138,77,7,9,2,34,7,171
11,427,252,28,224,4,220,11,38,35,31,5,0,1,14,1,84
11,428,218,25,193,4,189,2,50,36,27,2,2,0,14,3,53
11,429,2774,319,2455,39,2416,32,571,598,241,20,11,3,184,28,728
11,430,924,111,813,16,797,14,174,185,88,12,4,0,57,20,243
11,431,217,34,183,5,178,4,31,42,33,3,1,0,12,5,47
11,432,154,17,137,1,136,1,36,27,18,1,1,0,12,5,35
11,433,723,133,590,17,573,7,110,123,89,3,2,1,46,15,177
11,434,784,116,668,16,652,5,152,147,61,12,5,0,42,12,216
11,435,168,25,143,3,140,7,14,19,28,3,0,1,7,5,56
11,436,305,52,253,3,250,9,68,43,28,1,0,3,11,3,84
11,437,596,54,542,8,534,6,186,108,52,7,0,2,29,9,135
11,438,262,35,227,6,221,0,62,40,25,2,3,0,15,5,69
11,439,292,27,265,3,262,6,60,45,37,4,1,0,21,2,86
11,440,41,5,36,1,35,1,1,0,20,0,0,0,0,0,13
11,441,1926,208,1718,38,1680,29,471,354,226,22,11,3,101,32,431
12,1,906,105,801,21,780,10,126,159,100,10,4,1,122,12,236
12,2,675,112,563,13,550,19,99,108,71,11,3,2,59,11,167
12,3,300,34,266,6,260,4,58,62,19,3,2,0,25,5,82
12,4,383,41,342,10,332,4,35,95,38,3,1,2,50,8,96
12,5,78,12,66,0,66,1,6,31,1,0,3,0,11,2,11
12,6,348,68,280,4,276,9,44,103,16,2,0,1,45,8,48
12,7,150,18,132,1,131,9,10,28,25,3,1,0,11,3,41
12,8,566,69,497,12,485,11,43,117,74,6,1,0,89,8,136
12,9,72,12,60,2,58,1,20,20,8,0,0,0,3,1,5
12,10,112,19,93,5,88,1,23,29,3,2,0,0,12,0,18
12,11,726,95,631,21,610,13,66,196,65,4,3,0,117,3,143
12,12,501,75,426,13,413,7,86,75,67,5,4,0,50,9,110
12,13,3238,581,2657,40,2617,21,343,322,607,38,7,3,186,40,1050
12,14,201,35,166,2,164,1,33,54,8,5,1,0,40,3,19
12,15,221,38,183,2,181,4,25,63,19,2,2,0,19,0,47
12,16,724,93,631,7,624,17,66,125,92,5,3,3,86,10,217
12,17,210,54,156,3,153,4,35,40,13,7,0,0,33,0,21
12,18,142,14,128,2,126,7,16,24,12,5,2,1,17,1,41
12,19,83,16,67,0,67,4,11,21,8,1,0,0,8,1,13
12,20,440,46,394,9,385,9,54,61,52,4,0,1,53,11,140
12,21,747,109,638,12,626,12,77,173,57,11,5,2,109,7,173
12,22,106,21,85,1,84,2,25,14,12,4,1,0,14,2,10
12,23,115,16,99,0,99,1,12,42,5,4,1,0,9,1,24
12,24,218,24,194,7,187,9,18,38,19,1,1,0,37,4,60
12,25,796,128,668,16,652,24,98,170,63,9,4,0,105,11,168
12,26,843,121,722,17,705,10,118,183,72,8,4,0,99,5,206
12,27,219,41,178,10,168,4,21,49,28,3,0,0,22,4,37
12,28,413,62,351,4,347,2,63,42,74,6,4,2,13,3,138
12,29,157,24,133,5,128,6,17,35,14,4,1,0,22,3,26
12,30,349,44,305,8,297,4,53,56,45,3,1,3,22,4,106
12,31,249,14,235,4,231,3,15,54,38,1,1,3,29,5,82
12,32,445,41,404,4,400,6,64,113,31,3,3,1,57,6,116
12,33,2065,233,1832,37,1795,36,268,509,190,23,11,5,250,40,463
12,34,254,32,222,11,211,3,24,43,27,2,0,1,26,5,80
12,35,157,28,129,2,127,2,20,36,13,1,0,0,18,2,35
12,36,608,109,499,6,493,5,63,203,53,5,2,0,44,10,108
12,37,540,98,442,18,424,15,53,98,57,9,1,1,88,8,94
12,38,148,31,117,10,107,7,20,30,12,1,0,0,13,1,23
12,39,319,67,252,10,242,6,33,71,24,5,4,1,29,0,69
12,40,166,16,150,5,145,3,29,41,14,4,0,1,18,1,34
12,41,229,29,200,3,197,2,18,42,25,1,4,1,34,1,69
12,42,191,21,170,11,159,7,15,39,16,5,1,2,16,7,51
12,43,1473,126,1347,42,1305,29,181,358,138,20,1,1,179,29,369
12,44,846,115,731,13,718,19,101,209,97,12,5,3,86,6,180
12,45,325,35,290,5,285,9,42,61,37,3,2,1,44,5,81
12,46,527,73,454,14,440,12,56,106,42,7,0,0,70,7,140
12,47,385,49,336,7,329,9,45,92,39,2,2,1,36,5,98
12,48,362,53,309,12,297,3,64,101,26,4,3,0,34,4,58
12,49,384,45,339,2,337,11,56,112,24,5,2,1,64,3,59
12,50,379,41,338,9,329,1,66,109,23,3,3,1,47,8,68
12,51,331,61,270,2,268,2,43,112,8,3,0,1,53,5,41
12,52,3426,555,2871,72,2799,49,321,543,447,31,17,8,237,63,1083
12,53,244,31,213,1,212,4,43,50,25,5,2,0,26,3,54
12,54,303,43,260,7,253,7,16,48,25,2,2,0,47,5,101
12,55,88,23,65,2,63,1,9,24,3,1,0,0,14,1,10
12,56,2191,239,1952,64,1888,32,235,461,194,25,14,8,245,32,642
12,57,770,91,679,26,653,18,90,188,42,14,2,1,95,14,189
12,58,129,17,112,6,106,5,15,38,4,0,0,0,22,1,21
12,59,486,81,405,11,394,9,43,113,44,1,2,1,72,9,100
12,60,128,20,108,2,106,4,12,24,12,0,0,0,26,0,28
12,61,462,58,404,11,393,6,78,138,32,4,1,1,39,6,88
12,62,300,25,275,6,269,8,54,74,28,3,3,0,33,5,61
12,63,710,88,622,20,602,17,152,161,62,10,3,3,76,10,108
12,64,256,49,207,9,198,4,35,84,8,0,1,0,38,4,24
12,65,482,81,401,10,391,6,47,82,33,2,0,1,63,3,154
12,66,901,118,783,21,762,23,60,175,103,13,5,1,87,7,288
12,67,92,24,68,3,65,2,15,19,8,0,0,0,10,1,10
12,68,847,113,734,23,711,13,94,209,66,4,3,1,120,22,179
12,69,250,32,218,7,211,14,21,41,33,7,0,1,41,3,50
12,70,482,60,422,15,407,25,53,83,64,7,5,1,37,5,127
12,71,343,58,285,10,275,5,42,53,30,5,1,0,54,3,82
12,72,236,25,211,3,208,8,35,35,41,1,1,1,24,3,59
12,73,431,55,376,12,364,6,53,101,44,6,1,1,54,6,92
12,74,271,36,235,7,228,4,30,85,16,2,1,0,43,4,43
12,75,107,15,92,0,92,4,9,15,12,4,0,2,13,1,32
12,76,325,60,265,6,259,13,31,76,24,5,3,0,45,5,57
12,77,361,54,307,7,300,15,48,79,30,3,2,0,48,6,69
12,78,149,26,123,4,119,4,14,35,16,5,0,0,21,6,18
12,79,436,60,376,9,367,11,61,97,42,2,1,1,81,10,61
12,80,395,69,326,8,318,10,49,84,27,4,4,0,36,3,101
12,81,233,38,195,4,191,1,41,66,11,1,0,0,23,5,43
12,82,214,33,181,0,181,18,29,46,29,5,3,0,7,1,43
12,83,1331,231,1100,19,1081,18,120,160,261,11,6,5,58,12,430
12,84,1262,165,1097,24,1073,14,186,210,167,19,6,1,116,26,328
12,85,265,22,243,3,240,3,19,79,23,6,3,0,32,4,71
12,86,290,45,245,7,238,7,47,54,46,3,0,0,30,3,48
12,87,323,40,283,8,275,5,50,100,18,2,1,1,49,3,46
12,88,220,21,199,2,197,4,40,93,8,0,0,0,21,3,28
12,89,4290,865,3425,59,3366,51,440,560,671,44,18,4,218,33,1327
12,90,1565,161,1404,33,1371,27,145,333,150,9,5,6,261,15,420
12,91,375,32,343,19,324,5,41,117,23,3,3,1,51,4,76
12,92,492,58,434,13,421,7,77,149,18,3,0,1,70,12,84
12,93,154,19,135,2,133,2,15,54,14,3,0,1,17,3,24
12,94,924,146,778,14,764,13,103,253,80,6,4,2,80,17,206
12,95,195,25,170,5,165,4,10,46,25,4,0,0,19,4,53
12,96,3428,542,2886,58,2828,49,416,987,223,36,13,4,395,56,649
12,97,229,28,201,6,195,10,26,49,20,4,2,0,43,0,41
12,98,518,91,427,14,413,8,52,179,32,6,2,2,54,3,75
12,99,270,42,228,6,222,3,42,55,28,2,1,0,23,3,65
12,100,1987,290,1697,28,1669,22,196,230,431,19,14,3,116,11,627
12,101,732,67,665,15,650,15,87,128,94,7,4,1,63,10,241
12,102,1809,166,1643,38,1605,36,264,401,177,15,11,6,209,41,445
12,103,298,50,248,17,231,3,31,105,21,2,0,0,30,4,35
12,104,306,32,274,10,264,6,39,44,46,5,0,1,34,7,82
12,105,927,109,818,22,796,25,102,183,74,7,7,2,135,14,247
12,106,427,59,368,7,361,7,44,172,25,2,0,0,41,8,62
12,107,279,36,243,6,237,9,33,65,35,0,1,0,35,3,56
12,108,317,44,273,3,270,6,35,64,35,1,0,1,35,11,82
12,109,102,13,89,1,88,3,22,17,13,2,0,0,15,1,15
12,110,353,56,297,6,291,8,37,103,30,5,0,2,29,3,74
12,111,416,56,360,7,353,5,43,69,39,7,1,2,51,6,130
12,112,187,30,157,6,151,2,31,44,11,1,1,0,23,5,33
12,113,345,53,292,12,280,6,39,96,22,4,1,0,59,7,46
12,114,354,50,304,10,294,6,48,67,35,4,4,0,52,6,72
12,115,246,28,218,5,213,8,48,53,28,4,1,0,23,5,43
12,116,231,25,206,4,202,0,35,92,9,3,1,0,38,6,18
12,117,188,29,159,5,154,1,43,71,7,1,2,0,12,6,11
12,118,466,69,397,8,389,3,68,157,29,3,0,0,53,6,70
12,119,930,108,822,20,802,9,115,374,51,9,7,2,119,11,105
12,120,1205,123,1082,31,1051,15,172,349,102,26,6,2,109,24,246
12,121,580,100,480,6,474,9,69,115,46,2,3,2,78,8,142
12,122,115,11,104,5,99,4,21,20,7,2,1,0,19,2,23
12,123,655,71,584,15,569,15,116,122,73,4,3,1,42,5,188
12,124,289,42,247,5,242,8,31,92,10,1,2,0,58,8,32
12,125,327,65,262,4,258,5,43,54,28,3,1,0,39,8,77
12,126,232,38,194,3,191,2,33,51,15,4,0,2,36,3,45
12,127,690,122,568,20,548,15,89,121,61,8,5,4,84,14,147
12,128,233,42,191,4,187,4,25,37,22,0,1,0,37,3,58
12,129,373,39,334,17,317,4,67,113,18,4,0,0,47,8,56
12,130,965,146,819,15,804,19,85,170,131,11,3,1,78,11,295
12,131,1183,95,1088,22,1066,18,142,293,105,7,5,2,129,24,341
12,133,4247,440,3807,101,3706,53,528,972,356,24,9,10,551,52,1151
12,134,291,32,259,6,253,8,34,35,34,1,5,0,32,8,96
12,135,347,61,286,10,276,12,29,58,25,2,1,0,47,6,96
12,136,792,97,695,19,676,10,111,141,91,16,4,1,105,10,187
12,137,514,56,458,11,447,9,72,105,52,6,1,0,53,13,136
12,138,1266,151,1115,18,1097,26,114,290,145,23,11,7,114,18,349
12,139,133,21,112,5,107,5,24,36,14,0,0,0,7,3,18
12,140,780,83,697,21,676,13,81,149,83,8,3,3,82,10,244
12,141,224,34,190,6,184,12,21,34,30,3,1,0,27,2,54
12,142,469,58,411,19,392,1,41,112,38,6,4,1,66,4,119
12,143,101,21,80,3,77,1,10,14,13,2,0,0,10,2,25
12,144,155,24,131,6,125,1,14,18,17,0,0,0,16,1,58
12,145,16634,3056,13578,309,13269,427,2216,2943,1922,221,88,35,1253,192,3972
12,146,1653,232,1421,28,1393,29,171,311,192,16,5,4,193,28,444
12,147,154,30,124,1,123,6,35,23,6,1,5,1,23,0,23
12,148,1097,146,951,39,912,21,101,207,101,11,8,3,140,10,310
12,149,140,24,116,4,112,4,17,21,18,3,2,1,16,2,28
12,150,452,56,396,8,388,8,49,76,52,9,8,2,39,7,138
12,151,216,31,185,7,178,0,28,65,20,3,1,0,12,3,46
12,152,128,17,111,4,107,0,20,62,5,0,0,1,9,3,7
12,153,374,44,330,11,319,8,48,49,61,4,1,0,40,4,104
12,154,557,87,470,20,450,14,73,88,93,1,5,1,60,7,108
12,155,287,52,235,3,232,8,43,60,36,2,2,0,25,3,53
12,156,487,75,412,6,406,2,71,182,14,4,3,1,66,10,53
12,157,1219,127,1092,16,1076,31,154,236,183,13,3,1,136,16,303
12,158,217,22,195,6,189,9,18,33,30,10,0,2,27,6,54
12,159,515,64,451,19,432,10,59,89,57,4,0,4,59,10,140
12,160,295,43,252,5,247,9,42,61,31,6,0,1,20,4,73
12,161,454,65,389,10,379,12,39,113,35,3,0,1,59,5,112
12,162,927,123,804,23,781,22,93,210,97,11,3,5,121,15,204
12,163,185,50,135,1,134,5,22,37,22,1,0,0,24,3,20
12,164,554,83,471,17,454,6,40,205,33,5,1,0,40,5,119
12,165,299,35,264,3,261,8,46,51,49,5,1,0,27,6,68
12,166,109,17,92,3,89,2,6,50,13,0,0,1,8,1,8
12,167,658,95,563,13,550,25,51,138,98,8,1,2,92,10,125
12,168,796,119,677,16,661,28,98,146,141,6,4,0,65,10,163
12,169,1615,220,1395,42,1353,18,158,394,140,26,5,2,179,13,418
12,170,295,23,272,13,259,3,27,51,30,5,1,1,39,6,96
12,171,425,54,371,12,359,7,50,76,48,9,0,0,61,5,103
12,172,486,79,407,9,398,3,59,178,16,4,3,0,61,6,68
12,173,150,16,134,4,130,2,12,30,7,2,1,0,32,7,37
12,174,2366,295,2071,38,2033,39,246,507,209,21,12,2,256,43,698
12,175,125,19,106,3,103,2,9,37,7,1,1,0,21,3,22
12,176,7633,1112,6521,130,6391,136,815,1510,801,85,32,16,786,87,2123
12,177,284,39,245,3,242,3,56,80,24,4,1,0,19,5,50
12,178,293,22,271,8,263,8,55,45,39,3,1,0,38,7,67
12,179,100,19,81,5,76,3,15,36,5,1,0,0,7,2,7
12,180,114,26,88,1,87,6,12,29,11,0,0,0,6,2,21
12,181,220,24,196,5,191,8,27,41,16,1,0,0,22,6,70
12,182,228,24,204,8,196,5,30,65,15,3,1,1,17,3,56
12,183,225,35,190,6,184,6,25,48,20,4,1,0,25,1,54
12,184,147,23,124,1,123,2,19,49,10,1,0,2,18,2,20
12,185,1213,157,1056,37,1019,14,170,347,86,16,5,5,142,10,224
12,186,205,24,181,7,174,7,26,39,15,7,0,0,30,1,49
12,187,327,56,271,10,261,5,33,110,21,4,0,0,43,7,38
12,188,281,37,244,4,240,1,42,92,10,2,2,1,45,0,45
12,189,333,46,287,14,273,13,34,87,30,1,1,1,41,0,65
12,190,272,43,229,5,224,5,39,27,25,7,3,3,37,8,70
12,191,289,44,245,10,235,0,33,60,24,4,1,1,30,6,76
12,192,217,33,184,2,182,4,15,40,21,5,2,1,40,3,51
12,193,239,33,206,2,204,4,27,70,33,4,1,0,27,4,34
12,194,694,103,591,25,566,12,73,96,51,10,3,1,104,6,210
12,195,242,19,223,6,217,5,24,60,21,5,2,2,39,7,52
12,196,395,50,345,12,333,7,50,71,45,10,3,2,35,3,107
12,197,1711,234,1477,41,1436,30,215,427,145,22,7,1,193,21,375
12,198,1645,249,1396,28,1368,33,179,358,129,17,5,5,189,26,427
12,199,1386,143,1243,33,1210,36,170,340,79,10,6,6,182,26,355
12,200,821,90,731,11,720,14,115,158,103,10,3,4,88,19,206
12,201,834,105,729,20,709,29,86,195,86,4,4,2,120,15,168
12,202,14535,2569,11966,224,11742,344,1275,3136,1356,112,46,23,1468,187,3795
12,203,578,78,500,14,486,5,91,114,73,9,4,2,61,5,122
12,204,214,39,175,5,170,15,25,28,36,5,1,0,8,1,51
12,205,667,92,575,12,563,30,67,94,88,8,5,0,56,5,210
12,206,453,50,403,14,389,4,40,87,55,3,5,1,61,5,128
12,207,337,49,288,7,281,3,24,112,17,2,1,0,45,8,69
12,208,5836,862,4974,130,4844,146,716,1079,744,84,30,14,470,85,1476
12,209,676,140,536,6,530,6,69,218,29,5,1,1,80,10,111
12,210,349,46,303,17,286,9,28,58,53,5,2,0,44,5,82
12,211,173,28,145,2,143,0,25,48,14,0,1,0,21,9,25
12,212,107,22,85,0,85,1,17,11,24,3,0,0,5,0,24
12,213,457,52,405,14,391,17,67,90,62,6,8,1,38,10,92
12,214,427,65,362,7,355,9,59,123,26,7,1,3,65,7,55
12,215,907,108,799,30,769,25,92,168,125,16,2,1,117,7,216
12,216,1114,146,968,17,951,23,125,346,99,9,5,2,100,22,220
12,217,558,69,489,21,468,23,56,94,59,7,0,0,45,8,176
12,218,716,98,618,23,595,17,84,185,54,6,4,2,86,7,150
12,219,325,45,280,11,269,5,58,96,31,4,1,1,25,7,41
12,220,258,32,226,5,221,7,29,48,46,2,1,0,24,4,60
12,221,361,43,318,4,314,6,49,115,23,2,0,1,46,9,63
12,222,206,30,176,8,168,5,29,35,25,1,0,1,21,6,45
12,223,821,131,690,16,674,5,127,273,42,5,7,2,80,14,119
12,224,1561,258,1303,32,1271,14,218,440,109,14,1,3,165,16,291
12,225,1202,156,1046,21,1025,25,188,196,157,13,5,2,110,32,297
12,226,433,75,358,9,349,7,61,112,33,6,4,0,43,12,71
12,227,148,16,132,4,128,2,19,31,10,0,0,0,27,1,38
12,228,298,48,250,10,240,14,41,51,39,5,0,0,36,3,51
12,229,187,15,172,5,167,4,36,25,29,6,1,1,22,2,41
12,230,336,45,291,10,281,3,41,94,11,6,0,0,48,2,76
12,231,619,80,539,9,530,18,131,161,53,7,3,0,31,9,117
12,232,268,39,229,2,227,6,33,52,34,5,1,0,35,5,56
12,233,232,32,200,7,193,2,42,45,13,6,0,0,34,4,47
12,234,413,49,364,9,355,7,52,76,39,3,2,0,54,10,112
12,235,208,33,175,1,174,4,17,44,14,0,0,0,23,1,71
12,236,163,17,146,4,142,3,35,47,8,4,2,1,19,3,20
12,237,508,80,428,15,413,9,48,101,75,4,2,0,41,5,128
12,238,279,30,249,7,242,14,35,50,34,4,1,0,45,10,49
12,239,216,23,193,5,188,4,31,58,18,5,1,1,34,1,35
12,240,382,66,316,8,308,7,34,74,44,4,1,2,41,6,95
12,241,1418,136,1282,35,1247,27,158,329,119,13,4,4,202,23,368
12,242,259,33,226,3,223,0,23,59,33,3,1,0,12,4,88
12,243,623,81,542,15,527,11,91,122,54,10,4,0,51,6,178
12,244,610,66,544,7,537,10,97,120,98,3,4,0,55,16,134
12,245,380,38,342,6,336,4,44,64,43,6,0,1,57,10,107
12,246,468,83,385,15,370,6,63,109,35,5,1,1,36,10,104
12,247,303,30,273,4,269,8,45,120,19,3,2,0,32,4,36
12,248,392,50,342,5,337,4,50,100,42,4,1,2,31,12,91
12,249,226,35,191,7,184,13,14,40,31,3,1,0,35,1,46
12,250,217,44,173,3,170,2,26,70,19,0,0,0,22,4,27
12,251,323,46,277,9,268,8,45,48,44,4,1,3,30,2,83
12,252,383,48,335,13,322,16,31,56,43,4,3,1,47,8,113
12,253,924,112,812,20,792,8,108,310,44,11,6,2,118,14,171
12,254,1808,237,1571,47,1524,61,157,382,191,20,10,4,222,20,457
12,255,596,71,525,9,516,10,83,152,68,6,3,1,59,6,128
12,256,334,52,282,8,274,10,51,50,34,5,2,2,29,5,86
12,257,571,60,511,8,503,16,51,100,90,7,2,2,60,8,167
12,258,949,155,794,14,780,15,114,178,82,12,2,1,98,16,262
12,259,527,75,452,14,438,16,67,93,44,7,0,2,78,12,119
12,260,187,33,154,2,152,5,26,25,24,3,1,1,9,3,55
12,261,140,20,120,1,119,5,12,33,6,0,0,1,20,3,39
12,262,684,120,564,10,554,6,65,152,77,7,0,2,78,6,161
12,263,513,63,450,8,442,6,40,102,64,11,1,3,43,10,162
12,264,2476,244,2232,61,2171,45,267,532,276,22,6,4,279,42,698
12,265,367,53,314,6,308,4,49,128,13,2,0,1,60,3,48
12,266,468,63,405,8,397,6,66,128,38,2,5,1,74,10,67
12,267,640,103,537,12,525,3,90,165,47,8,4,3,95,14,96
12,268,416,69,347,6,341,5,49,107,18,1,3,2,57,6,93
12,269,127,18,109,1,108,0,17,27,9,4,1,1,15,3,31
12,270,1946,277,1669,30,1639,38,267,401,182,24,13,4,216,26,468
12,271,320,32,288,6,282,2,46,97,31,4,2,0,35,7,58
12,272,391,42,349,12,337,6,43,83,49,7,1,1,32,8,107
12,273,236,25,211,5,206,3,39,77,10,2,4,1,24,8,38
12,274,117,8,109,1,108,2,8,31,14,0,1,0,27,0,25
12,275,58,12,46,2,44,2,6,7,4,1,1,0,5,1,17
12,276,346,56,290,3,287,2,46,62,34,3,1,0,43,4,92
12,277,417,60,357,6,351,1,42,184,30,3,2,0,25,9,55
12,278,173,27,146,9,137,6,28,29,17,3,2,0,16,2,34
12,279,156,25,131,1,130,1,27,51,8,0,0,1,26,2,14
12,280,400,54,346,12,334,6,39,161,20,3,4,0,50,5,46
12,281,599,78,521,14,507,7,69,97,53,13,5,0,47,10,206
12,282,327,46,281,11,270,5,54,39,34,7,4,0,27,4,96
12,283,459,59,400,9,391,10,65,114,27,3,4,0,59,11,98
12,284,312,49,263,6,257,10,39,77,27,4,3,1,26,4,66
12,285,358,36,322,16,306,10,57,60,36,9,1,1,56,7,69
12,286,950,100,850,19,831,20,115,217,110,12,2,3,102,14,236
12,287,498,61,437,14,423,8,63,99,50,5,1,2,43,6,146
12,288,1176,131,1045,21,1024,24,129,187,155,17,5,2,132,10,363
12,289,197,19,178,5,173,1,28,41,22,2,1,0,20,2,56
12,290,398,53,345,10,335,7,50,71,31,4,5,0,61,9,97
12,291,320,50,270,6,264,11,56,56,40,2,0,0,27,7,65
12,292,384,57,327,6,321,6,53,84,54,5,2,0,35,5,77
12,293,149,13,136,2,134,3,18,19,16,2,1,0,13,0,62
12,294,538,68,470,12,458,15,78,160,25,2,3,0,82,14,79
12,295,88,6,82,0,82,3,13,12,13,0,0,0,8,5,28
12,296,440,76,364,13,351,16,52,70,61,9,3,0,29,1,110
12,297,443,67,376,12,364,15,63,96,26,3,3,1,71,9,77
12,298,339,52,287,10,277,6,41,72,35,4,3,0,37,6,73
12,299,624,90,534,18,516,6,80,170,44,12,2,0,83,4,115
12,300,9144,2028,7116,195,6921,151,861,1561,814,96,38,16,677,104,2603
12,301,1645,237,1408,36,1372,23,191,323,114,18,7,1,162,12,521
12,303,240,22,218,1,217,10,30,73,17,1,3,0,24,6,53
12,304,97,10,87,1,86,1,11,37,5,0,1,1,12,1,17
12,305,1021,152,869,19,850,17,93,93,205,13,6,3,61,14,345
12,307,300,38,262,7,255,2,47,100,21,5,1,0,37,10,32
13,1,90437,18645,71792,968,70824,2219,10305,23240,7943,433,188,187,6396,952,18961
13,2,16629,2479,14150,277,13873,252,3782,4225,1601,97,45,25,909,187,2750
13,3,1838,257,1581,36,1545,36,383,418,147,24,5,7,144,37,344
13,4,37292,7332,29960,530,29430,600,7385,6776,4520,310,132,52,1572,327,7756
13,5,32051,6003,26048,456,25592,533,6180,6526,4779,193,88,46,1491,367,5389
13,6,1215,161,1054,19,1035,34,302,258,142,12,1,3,60,19,204
13,7,8589,1279,7310,106,7204,166,1912,2064,938,50,32,20,488,113,1421
13,8,415,46,369,5,364,15,58,125,43,3,2,1,29,5,83
13,9,651,67,584,7,577,14,128,215,44,5,3,4,59,10,95
13,10,3086,474,2612,56,2556,69,745,796,223,20,7,2,163,40,491
13,11,391,50,341,2,339,13,61,147,10,1,4,1,19,6,77
13,12,449,69,380,3,377,14,46,129,24,4,2,2,51,3,102
13,13,1359,149,1210,26,1184,39,219,343,198,7,1,3,107,34,233
13,14,9072,1809,7263,122,7141,67,2075,1219,1161,62,37,12,265,83,2160
13,15,11134,1871,9263,135,9128,239,1743,3209,806,52,26,21,868,146,2018
13,16,4263,570,3693,50,3643,95,953,947,551,34,13,9,267,62,712
13,17,1278,168,1110,16,1094,45,364,319,84,4,4,1,86,17,170
13,18,3238,714,2524,62,2462,39,780,674,274,22,10,3,147,49,464
13,19,7719,1433,6286,78,6208,129,1176,2407,600,29,16,13,589,81,1168
13,20,1780,314,1466,20,1446,28,344,309,229,20,5,4,116,29,362
13,21,5502,890,4612,63,4549,90,979,2125,299,24,7,11,261,66,687
13,22,6510,1099,5411,62,5349,121,826,2730,376,32,10,7,324,57,866
13,23,3500,556,2944,51,2893,74,677,1045,261,22,13,10,215,41,535
13,24,1766,309,1457,36,1421,29,343,397,172,20,3,1,114,22,320
13,25,1804,308,1496,20,1476,65,242,507,143,10,1,2,144,23,339
13,26,9667,1690,7977,155,7822,126,2430,1997,777,72,42,15,396,108,1859
13,27,10208,1722,8486,146,8340,143,2490,2508,758,74,39,15,515,125,1673
13,28,27383,5270,22113,355,21758,491,5113,6364,2877,199,65,41,1307,318,4983
13,29,1123,197,926,10,916,32,222,312,82,10,4,3,87,15,149
13,30,3527,498,3029,50,2979,57,852,746,396,22,9,9,172,57,659
13,31,2587,387,2200,47,2153,37,592,594,239,11,14,6,165,33,462
13,32,6401,1191,5210,79,5131,157,770,1964,450,28,19,12,550,72,1109
13,33,4225,653,3572,61,3511,66,979,1015,438,20,14,8,245,58,668
13,34,1566,220,1346,22,1324,35,305,507,94,11,6,4,73,15,274
13,35,5516,1113,4403,77,4326,88,1236,1253,460,46,10,11,367,85,770
13,36,3357,650,2707,53,2654,49,775,909,238,26,10,9,162,50,426
13,37,5690,1008,4682,75,4607,79,1262,1234,489,33,16,12,376,77,1029
13,38,3144,398,2746,38,2708,44,616,839,359,18,13,9,195,44,571
13,39,12027,2501,9526,176,9350,106,2800,1766,1493,137,50,23,437,118,2420
13,40,6907,1054,5853,103,5750,163,1127,1536,830,49,16,24,507,101,1397
13,41,15857,3512,12345,201,12144,201,3155,2461,2405,119,68,24,645,172,2894
13,42,5309,858,4451,72,4379,152,864,1676,371,29,8,15,359,61,844
13,43,7517,1559,5958,110,5848,69,1986,1432,703,51,10,3,310,91,1193
13,44,3725,548,3177,58,3119,76,755,951,319,24,7,10,276,57,644
13,45,3334,698,2636,26,2610,37,870,765,220,12,10,9,189,52,446
13,46,3250,542,2708,47,2661,71,664,551,412,30,11,6,198,36,682
13,47,30054,5626,24428,474,23954,449,6547,5107,3396,338,109,66,1525,356,6061
13,48,3561,691,2870,53,2817,62,711,723,345,23,7,6,229,57,654
13,49,1481,194,1287,25,1262,26,354,349,114,13,4,4,101,33,264
13,50,7159,1203,5956,110,5846,179,1158,1773,683,47,19,13,549,122,1303
13,51,6569,1277,5292,89,5203,98,1481,1620,455,36,16,11,408,109,969
13,52,1732,250,1482,29,1453,28,441,501,108,17,1,6,91,27,233
13,53,4663,950,3713,66,3647,69,1011,989,463,31,16,7,277,78,706
13,54,22090,4412,17678,426,17252,185,6011,4389,1750,130,49,37,879,226,3596
13,55,484206,105301,378905,5201,373704,8026,79292,100637,51700,2606,1167,679,20619,4160,104818
13,56,33424,5766,27658,509,27149,480,6627,5704,5906,261,150,72,1425,354,6170
13,57,383,43,340,6,334,1,95,78,35,4,3,0,40,6,72
13,58,1775,259,1516,26,1490,33,291,640,130,16,2,1,119,14,244
13,59,2792,536,2256,25,2231,61,515,606,266,21,9,11,207,34,501
13,60,4108,608,3500,69,3431,84,962,988,399,27,10,9,235,23,694
13,61,207,16,191,6,185,0,66,67,11,3,0,0,13,2,23
13,62,3722,571,3151,46,3105,83,737,792,458,32,5,10,241,67,680
13,63,16018,3435,12583,275,12308,160,3835,2306,1973,143,63,23,600,163,3042
13,64,1969,331,1638,27,1611,35,478,540,144,13,5,5,102,42,247
13,65,2556,347,2209,34,2175,41,643,582,213,36,7,7,146,61,439
13,66,4217,677,3540,61,3479,55,998,933,511,35,19,6,209,69,644
13,67,1996,388,1608,21,1587,21,469,415,181,15,7,7,99,22,351
13,68,1189,175,1014,15,999,28,181,379,108,9,0,1,97,13,183
13,69,8128,1504,6624,124,6500,175,1305,2164,583,50,25,17,629,99,1453
13,70,4809,806,4003,62,3941,53,1102,987,705,48,15,6,208,42,775
13,71,17302,3634,13668,234,13434,189,4288,3691,1571,79,33,26,694,191,2672
13,72,2516,409,2107,29,2078,72,367,649,241,21,6,5,172,45,500
13,73,4455,682,3773,75,3698,65,1115,859,497,31,9,10,272,52,788
13,74,3296,556,2740,40,2700,54,610,729,340,23,22,11,179,59,673
13,75,9041,1721,7320,111,7209,120,2044,2467,635,35,17,18,500,75,1298
13,76,2137,322,1815,32,1783,38,594,461,172,18,14,2,103,28,353
13,77,11573,2529,9044,119,8925,86,1962,1170,3255,82,48,17,270,73,1962
13,78,6309,1032,5277,110,5167,44,1521,680,1640,59,34,15,150,55,969
13,79,1152,149,1003,12,991,18,222,300,117,6,3,2,90,12,221
13,80,4118,723,3395,77,3318,86,710,941,343,24,15,11,234,45,909
13,81,9236,1916,7320,119,7201,86,2286,1830,885,60,41,13,435,135,1430
13,82,3658,562,3096,34,3062,99,557,987,299,35,6,12,270,51,746
13,83,3150,411,2739,60,2679,46,780,897,190,17,7,3,209,56,474
13,84,3453,580,2873,42,2831,65,627,660,372,29,18,6,229,35,790
13,85,4110,670,3440,56,3384,81,775,987,461,20,11,5,266,48,730
13,86,6556,1043,5513,108,5405,119,1210,1646,826,45,23,11,395,66,1064
13,87,3405,460,2945,60,2885,95,577,641,396,21,6,9,238,39,863
13,88,3944,554,3390,65,3325,47,837,639,1083,21,13,4,161,47,473
13,89,2311,417,1894,41,1853,38,595,546,157,13,10,2,85,39,368
13,90,135,30,105,0,105,4,12,48,9,0,0,0,12,1,19
13,91,4438,761,3677,77,3600,78,682,1216,339,24,12,13,333,60,843
13,92,5726,972,4754,74,4680,95,1321,1107,728,60,12,15,318,92,932
13,93,259,24,235,6,229,10,58,71,31,2,1,0,15,1,40
13,94,1805,230,1575,22,1553,37,379,549,171,12,4,5,116,28,252
13,95,938,158,780,10,770,33,69,372,57,4,1,2,96,12,124
13,96,2676,374,2302,34,2268,53,621,998,132,22,10,5,90,31,306
13,97,8625,1147,7478,135,7343,122,1921,1806,798,76,38,17,534,137,1894
13,98,4758,789,3969,64,3905,91,951,1028,596,32,24,12,288,44,839
13,99,687,114,573,12,561,6,195,129,63,5,4,5,27,11,116
13,100,8267,1408,6859,116,6743,164,1531,2306,780,55,22,24,427,89,1345
13,101,2353,371,1982,38,1944,50,467,444,306,22,8,9,145,37,456
13,102,4749,926,3823,65,3758,45,1358,986,375,35,14,6,164,41,734
13,103,28870,5527,23343,416,22927,457,5581,6840,2189,207,99,58,1805,405,5286
13,104,6641,1105,5536,75,5461,83,1320,1989,472,43,8,6,350,82,1108
13,105,4595,670,3925,80,3845,84,1160,1061,373,33,11,11,235,71,806
13,106,8078,1622,6456,99,6357,88,1877,1363,1260,42,20,7,241,77,1382
13,107,4408,694,3714,72,3642,92,811,1027,459,21,14,4,279,43,892
13,108,9419,2229,7190,138,7052,109,2371,1742,720,81,21,23,396,128,1461
13,109,1953,406,1547,17,1530,65,188,559,148,9,3,10,158,33,357
13,110,7954,1311,6643,130,6513,197,1604,1805,857,69,41,17,455,128,1340
13,111,706,105,601,7,594,28,79,200,106,2,1,2,41,6,129
13,112,6833,1082,5751,84,5667,116,1247,1688,578,43,19,6,491,93,1386
13,113,6823,1070,5753,89,5664,174,919,1850,546,35,9,14,556,94,1467
13,114,4272,655,3617,50,3567,92,507,1511,285,24,7,14,377,60,690
13,115,1157,171,986,16,970,28,234,278,120,11,2,1,88,25,183
13,116,584,66,518,12,506,11,156,155,51,4,2,1,41,11,74
13,117,24337,5068,19269,317,18952,266,5170,4219,2553,177,87,48,1068,291,5073
13,118,2534,311,2223,21,2202,43,477,711,195,15,2,1,201,32,525
13,119,5368,979,4389,65,4324,72,1224,1538,327,24,5,12,320,73,729
14,1,901,107,794,11,783,13,171,230,60,8,2,4,95,38,162
14,2,119,16,103,0,103,0,16,27,18,1,4,1,8,2,26
14,3,218,18,200,2,198,6,29,47,10,3,0,0,39,2,62
14,4,146,17,129,3,126,0,26,34,13,1,1,0,17,9,25
14,5,514,60,454,5,449,11,88,105,54,8,3,1,39,12,128
14,6,742,75,667,15,652,20,76,184,49,14,6,2,108,12,181
14,7,165,16,149,1,148,1,46,29,10,3,3,0,19,3,34
14,8,233,32,201,7,194,11,13,60,28,0,0,0,26,2,54
14,9,980,93,887,15,872,31,139,177,128,7,7,6,99,20,258
14,11,792,126,666,13,653,13,141,140,75,11,5,2,71,16,179
14,12,106,7,99,0,99,0,20,33,14,1,0,0,7,1,23
14,13,23,1,22,0,22,1,0,10,2,0,0,0,3,0,6
14,14,602,58,544,9,535,13,48,176,56,6,1,1,78,6,150
14,15,565,78,487,10,477,16,38,151,49,4,4,1,77,13,124
14,16,379,58,321,2,319,2,93,104,23,6,3,1,28,13,46
14,19,192,20,172,1,171,0,24,43,22,2,2,0,21,5,52
14,20,2625,446,2179,40,2139,28,376,517,233,21,15,3,231,42,673
14,21,486,68,418,6,412,5,64,156,48,5,3,1,33,7,90
14,22,530,80,450,5,445,22,95,140,38,6,0,4,37,11,92
14,23,45,5,40,0,40,1,7,21,1,0,0,0,7,0,3
14,24,314,23,291,3,288,3,52,117,27,5,0,1,30,5,48
14,25,250,27,223,1,222,4,42,56,36,1,0,1,26,6,50
14,26,781,98,683,9,674,15,131,156,61,8,9,4,73,18,199
14,27,2092,438,1654,26,1628,25,361,358,132,26,12,7,157,46,504
14,28,248,43,205,2,203,8,50,58,9,3,0,0,29,6,40
14,29,41,12,29,0,29,1,8,13,0,0,0,0,5,0,2
14,30,1151,102,1049,12,1037,40,98,268,86,5,1,1,159,28,351
14,31,61,10,51,0,51,1,14,13,2,0,0,0,7,0,14
14,32,267,38,229,5,224,3,39,108,11,1,0,0,19,3,40
14,33,187,21,166,6,160,4,41,52,12,6,0,0,17,3,25
14,34,377,39,338,5,333,9,53,86,38,1,5,3,37,4,97
14,35,675,142,533,16,517,16,111,122,42,6,7,0,51,21,141
14,36,114,14,100,1,99,0,14,36,12,1,0,0,16,1,19
14,37,339,46,293,4,289,9,63,52,37,3,5,0,32,7,81
14,38,496,73,423,9,414,5,64,85,41,6,3,1,39,8,162
14,39,534,54,480,12,468,8,104,81,61,10,2,4,46,9,143
14,40,157,11,146,1,145,8,24,30,16,2,0,1,10,2,52
14,41,124,13,111,3,108,1,16,40,11,1,0,0,20,2,17
14,42,662,102,560,13,547,8,75,151,54,5,3,1,69,12,169
14,43,76,6,70,3,67,0,14,18,7,2,1,0,7,2,16
14,44,799,109,690,14,676,12,101,165,66,6,6,3,66,17,234
14,45,224,44,180,3,177,3,34,72,14,4,1,0,19,1,29
14,46,1277,181,1096,20,1076,16,174,268,108,22,8,5,91,22,362
14,47,9391,1816,7575,125,7450,168,1016,2057,772,118,46,15,865,162,2231
14,49,113,12,101,1,100,3,8,46,9,0,2,1,12,2,17
14,50,135,30,105,0,105,4,18,35,10,2,1,0,5,5,25
14,52,137,23,114,3,111,2,25,29,7,3,1,0,7,5,32
14,53,126,19,107,1,106,0,29,31,4,1,0,0,8,6,27
14,54,165,30,135,0,135,3,31,46,16,0,1,0,14,7,17
14,55,360,40,320,9,311,4,53,134,41,3,1,0,26,8,41
14,56,200,27,173,5,168,7,36,25,24,5,2,0,13,3,53
14,57,1143,132,1011,15,996,12,171,179,139,16,9,2,91,17,360
14,58,103,13,90,1,89,2,26,37,2,0,0,0,8,2,12
14,59,419,64,355,5,350,3,37,223,12,5,0,0,21,4,45
14,60,1579,154,1425,26,1399,29,150,339,164,17,11,3,193,20,473
14,61,818,142,676,6,670,8,127,167,60,10,3,2,78,16,199
14,62,274,25,249,1,248,5,53,77,26,2,0,0,24,3,58
14,63,159,22,137,0,137,2,40,39,13,0,0,0,9,7,27
14,64,199,31,168,5,163,3,41,32,21,7,0,2,20,2,35
14,65,411,61,350,3,347,10,95,85,30,5,3,1,32,10,76
14,66,1894,359,1535,22,1513,54,258,419,163,17,9,1,130,29,433
14,68,2062,258,1804,23,1781,53,168,619,125,10,1,7,215,31,552
14,69,950,130,820,15,805,15,180,200,85,12,5,0,59,17,232
14,70,200,28,172,3,169,6,36,58,9,6,1,0,21,7,25
14,73,168,40,128,1,127,1,45,30,13,1,1,0,8,5,23
14,74,248,24,224,2,222,2,45,44,23,3,3,1,28,10,63
14,75,139,18,121,0,121,1,15,40,12,1,0,1,15,0,36
14,76,4126,740,3386,54,3332,67,516,559,519,52,17,5,307,65,1225
14,77,540,96,444,11,433,7,64,182,38,9,4,3,38,12,76
14,78,287,31,256,5,251,8,57,50,30,1,0,1,31,4,69
14,79,1276,196,1080,18,1062,15,149,515,56,10,1,1,87,23,205
14,80,101,22,79,0,79,3,23,16,7,0,0,0,7,2,21
14,81,174,31,143,2,141,7,29,54,11,0,2,1,9,2,26
14,82,150,24,126,0,126,2,38,33,8,6,2,0,14,2,21
14,83,551,68,483,13,470,5,94,172,46,2,2,1,39,8,101
14,84,290,31,259,5,254,3,61,66,27,1,2,2,16,6,70
14,85,656,86,570,10,560,9,115,201,49,7,5,0,63,8,103
14,86,297,32,265,5,260,1,47,138,20,3,0,0,26,1,24
14,87,99,18,81,2,79,0,11,24,4,4,1,0,9,3,23
14,88,336,62,274,5,269,4,57,38,31,7,8,0,25,7,92
14,89,266,27,239,7,232,5,38,50,27,2,3,1,22,11,73
14,90,372,49,323,6,317,12,73,64,30,1,2,0,30,7,98
14,91,162,31,131,2,129,3,25,56,8,1,1,0,21,7,7
14,92,1012,142,870,18,852,5,168,160,97,21,8,4,91,20,278
14,93,162,28,134,1,133,3,23,52,9,4,2,0,19,2,19
14,96,177,16,161,5,156,6,50,35,19,3,0,0,11,4,28
14,97,209,18,191,5,186,3,38,26,20,6,4,1,23,4,61
14,98,1890,219,1671,28,1643,41,246,391,143,22,16,6,193,45,540
14,99,255,45,210,2,208,1,57,50,14,2,3,0,25,5,51
14,100,1159,109,1050,21,1029,11,159,210,143,19,14,3,79,22,369
14,101,3132,377,2755,44,2711,72,249,766,272,29,11,5,388,44,875
14,102,768,90,678,8,670,8,121,281,39,8,4,4,58,19,128
14,103,280,33,247,6,241,6,58,56,28,2,1,0,27,8,55
14,104,134,20,114,1,113,3,24,48,5,2,0,1,13,0,17
14,105,105,16,89,1,88,1,25,34,7,3,2,0,5,1,10
14,106,504,57,447,9,438,15,65,92,61,8,2,8,42,8,137
14,107,116,20,96,0,96,0,36,33,6,1,0,0,9,0,11
14,109,309,32,277,5,272,6,48,73,25,5,0,0,22,7,86
14,110,114,22,92,2,90,0,17,45,4,0,0,0,9,2,13
14,111,278,29,249,5,244,5,58,58,27,0,2,1,38,3,52
14,113,281,50,231,7,224,2,43,54,22,4,1,1,28,9,60
14,115,103,13,90,1,89,4,18,35,5,2,1,0,8,0,16
14,116,88,9,79,1,78,3,10,17,9,1,0,0,7,1,30
14,117,3282,688,2594,35,2559,36,420,1035,205,26,14,7,178,32,606
14,118,60499,11816,48683,682,48001,1715,4527,11980,5949,639,237,115,5252,708,16879
14,119,1060,140,920,20,900,6,177,150,111,6,10,1,71,17,351
14,120,974,140,834,23,811,20,175,247,58,13,2,1,91,21,183
14,121,220,53,167,3,164,5,46,40,17,2,3,0,14,0,37
14,122,92,26,66,0,66,1,11,17,7,1,3,0,12,1,13
14,123,1503,215,1288,23,1265,39,125,324,137,6,6,0,187,26,415
14,124,475,93,382,6,376,3,101,125,27,3,2,1,28,12,74
14,125,1177,140,1037,10,1027,23,79,327,91,3,0,2,131,19,352
14,126,966,186,780,6,774,25,132,262,86,15,1,0,76,20,157
14,127,327,46,281,7,274,1,59,55,37,3,3,0,40,4,72
14,128,95,17,78,2,76,2,16,29,5,3,0,3,5,2,11
14,129,406,63,343,9,334,7,75,107,22,7,4,0,39,11,62
14,130,139,20,119,2,117,0,23,17,9,4,1,0,17,1,45
14,131,180,29,151,2,149,1,31,77,9,0,2,0,15,1,13
14,132,167,19,148,0,148,0,31,55,14,0,3,0,13,5,27
14,134,144,16,128,5,123,0,18,45,10,0,3,1,21,0,25
14,135,223,20,203,2,201,2,31,45,39,3,1,1,25,3,51
14,136,61,10,51,1,50,0,12,20,2,3,0,0,5,1,7
14,137,1718,232,1486,30,1456,31,256,364,151,26,8,7,145,28,440
14,138,225,57,168,8,160,4,48,39,13,6,1,1,17,4,27
14,139,289,64,225,5,220,3,57,79,17,1,2,0,16,5,40
14,140,267,38,229,6,223,5,50,60,28,1,3,2,15,3,56
14,141,114,15,99,3,96,6,23,30,5,3,2,0,10,0,17
14,142,214,35,179,1,178,4,35,64,21,1,4,2,18,4,25
14,143,823,195,628,9,619,6,141,156,52,13,6,2,83,15,145
14,144,65,7,58,0,58,5,6,12,11,1,1,0,8,0,14
14,145,314,42,272,9,263,0,48,70,13,5,4,0,30,10,83
14,146,123,15,108,3,105,0,23,18,18,0,0,0,7,6,33
14,147,120,20,100,0,100,3,17,42,15,0,3,1,6,4,9
14,148,98,20,78,1,77,2,15,19,12,1,0,0,9,4,15
14,149,262,25,237,3,234,6,47,45,27,1,0,0,25,5,78
14,150,389,49,340,6,334,7,64,68,41,6,3,0,23,10,112
14,151,273,56,217,3,214,2,47,49,22,0,1,0,15,1,77
14,152,72,12,60,2,58,3,19,11,0,0,2,1,9,3,10
14,153,47,10,37,1,36,1,7,17,1,0,0,0,5,2,3
14,154,411,73,338,9,329,3,86,89,19,9,3,3,21,9,87
14,155,201,20,181,2,179,2,42,54,16,1,0,1,19,4,40
14,156,170,21,149,8,141,3,34,41,7,4,1,0,15,4,32
14,157,861,112,749,16,733,16,111,193,84,15,6,1,89,22,196
14,158,367,51,316,4,312,11,45,62,35,1,3,1,35,8,111
14,159,181,22,159,3,156,3,25,52,19,0,2,0,9,8,38
14,160,144,22,122,2,120,0,27,34,11,1,0,1,8,2,36
14,161,283,28,255,3,252,2,56,107,11,1,3,0,30,3,39
14,162,980,154,826,11,815,23,175,224,100,16,5,3,76,26,167
14,163,248,19,229,1,228,6,53,64,14,5,1,0,24,1,60
14,164,809,90,719,14,705,17,100,161,94,9,2,1,73,14,234
14,165,143,22,121,1,120,0,24,42,12,1,0,0,8,1,32
14,166,1957,241,1716,27,1689,39,250,473,146,20,15,4,191,28,523
14,167,4116,877,3239,50,3189,37,547,430,547,57,33,8,194,54,1282
14,168,163,18,145,0,145,3,31,54,12,2,0,1,12,1,29
14,169,142,21,121,2,119,3,13,20,14,0,0,0,14,1,54
14,170,336,33,303,4,299,11,18,105,28,1,0,0,38,5,93
14,171,105,13,92,2,90,1,12,20,9,2,1,0,5,1,39
14,172,377,71,306,2,304,6,44,123,30,1,2,0,19,10,69
14,173,341,38,303,3,300,8,66,70,39,1,2,1,28,4,81
14,174,3525,573,2952,46,2906,37,536,733,254,37,35,11,264,63,936
14,175,169,28,141,2,139,2,22,18,23,1,1,1,22,4,45
14,176,73,10,63,1,62,2,6,25,10,0,2,0,1,2,14
14,177,648,81,567,7,560,9,99,210,29,6,3,1,55,13,135
14,178,45,9,36,1,35,2,10,6,2,0,0,0,5,1,9
14,179,114,11,103,0,103,4,28,37,15,2,0,0,6,0,11
14,180,121,18,103,3,100,2,23,18,21,3,2,1,6,0,24
14,181,3669,567,3102,63,3039,62,501,697,330,34,21,9,290,41,1054
14,182,289,45,244,5,239,3,52,68,20,4,1,0,24,11,56
14,183,96,17,79,1,78,2,23,17,8,1,1,0,7,0,19
14,184,139,11,128,1,127,0,31,37,13,1,2,0,11,5,27
14,185,246,30,216,1,215,4,44,78,19,1,3,2,30,10,24
14,186,264,17,247,6,241,3,29,71,20,0,4,0,37,5,72
14,187,582,75,507,9,498,6,81,145,41,9,5,1,58,11,141
14,188,263,37,226,5,221,5,67,55,19,4,2,2,13,5,49
14,189,34,0,34,1,33,0,9,12,2,0,0,0,5,0,5
14,190,124,21,103,0,103,1,30,37,8,1,0,0,5,1,20
14,191,3421,516,2905,56,2849,74,410,965,241,40,19,7,245,55,793
14,192,348,59,289,4,285,5,45,92,24,5,4,1,50,5,54
14,193,589,90,499,6,493,12,105,110,69,11,3,0,55,8,120
14,194,484,76,408,4,404,9,114,105,41,7,4,0,28,9,87
14,195,183,42,141,0,141,2,40,31,13,4,0,1,20,1,29
14,196,190,14,176,2,174,0,29,57,13,2,0,0,28,3,42
14,197,987,131,856,15,841,10,83,237,75,16,4,1,93,13,309
14,198,214,28,186,1,185,7,37,51,15,6,2,0,20,4,43
14,200,1146,168,978,12,966,14,149,220,106,16,10,7,85,18,341
14,201,309,67,242,2,240,4,52,81,20,4,1,0,14,5,59
14,202,171,19,152,2,150,3,20,85,6,1,1,1,18,2,13
14,203,145,23,122,0,122,3,16,35,12,1,0,1,19,7,28
14,204,180,26,154,4,150,2,44,52,11,2,1,1,14,4,19
14,205,150,19,131,2,129,3,24,34,9,1,2,0,21,4,31
14,206,233,23,210,4,206,3,47,59,10,3,2,2,22,3,55
14,207,387,53,334,4,330,8,69,82,39,6,2,2,19,10,93
14,208,344,62,282,1,281,5,68,54,37,4,2,1,26,5,79
14,209,422,77,345,8,337,2,85,67,41,6,2,1,32,9,92
14,210,98,21,77,1,76,4,12,34,8,2,0,1,4,0,11
14,211,268,45,223,3,220,1,53,60,34,4,0,0,17,4,47
14,212,137,20,117,3,114,1,19,41,13,0,0,0,14,6,20
14,213,376,51,325,5,320,14,57,49,48,5,1,2,30,4,110
14,214,145,29,116,2,114,3,22,26,16,1,1,0,13,2,30
14,215,1468,182,1286,26,1260,21,207,220,181,18,11,3,110,21,468
14,216,149,10,139,1,138,5,23,37,9,3,1,0,17,5,38
14,217,108,15,93,0,93,1,26,20,11,5,1,1,8,2,18
14,218,254,48,206,0,206,8,47,89,9,0,1,1,15,8,28
14,219,130,22,108,3,105,2,23,24,11,1,4,0,12,0,28
14,220,3732,890,2842,34,2808,33,378,1537,141,15,6,8,186,41,463
14,221,2451,307,2144,29,2115,20,361,372,272,30,17,6,192,35,810
14,222,60,8,52,0,52,1,14,20,3,1,0,0,5,1,7
14,223,78,18,60,1,59,1,8,20,4,1,1,0,8,1,15
14,224,57,9,48,1,47,2,11,8,10,0,2,1,7,3,3
14,225,4345,805,3540,68,3472,50,573,709,894,41,18,10,202,52,923
14,226,197,26,171,2,169,3,45,34,13,3,2,0,21,6,42
14,227,199,30,169,0,169,2,24,69,20,1,2,1,23,5,22
14,228,3967,663,3304,51,3253,92,419,857,339,32,14,11,404,63,1022
14,229,1190,183,1007,14,993,19,203,313,110,13,19,3,74,23,216
14,230,105,17,88,0,88,0,13,34,5,0,1,2,12,1,20
14,231,356,60,296,7,289,6,83,78,37,5,3,1,21,10,45
14,232,138,22,116,3,113,2,17,24,19,3,0,1,7,7,33
14,235,162,14,148,2,146,3,42,48,12,2,2,0,9,4,24
14,236,294,30,264,3,261,1,65,48,16,7,1,0,28,6,89
14,237,421,64,357,5,352,5,52,91,39,6,0,3,42,5,109
14,238,111,16,95,1,94,4,15,47,5,1,1,0,6,1,14
14,239,81,18,63,0,63,2,14,22,0,0,2,0,8,10,5
14,240,374,61,313,4,309,2,61,64,50,6,4,0,38,11,73
14,241,478,58,420,6,414,13,83,106,62,2,2,0,51,5,90
14,242,1063,130,933,17,916,23,49,272,66,10,1,2,154,16,323
14,243,943,128,815,5,810,11,113,322,70,5,3,3,66,15,202
14,244,243,27,216,2,214,3,34,62,20,1,1,1,34,2,56
14,245,231,38,193,1,192,6,37,53,17,3,0,1,20,7,48
14,246,530,73,457,9,448,9,78,111,54,3,3,0,46,12,132
14,248,162,16,146,1,145,4,20,32,16,2,0,1,16,1,53
14,249,932,84,848,12,836,8,136,211,82,16,3,0,87,16,277
14,250,278,34,244,1,243,6,48,51,24,3,1,0,29,5,76
14,251,364,62,302,4,298,2,57,79,36,1,1,0,35,4,83
14,252,156,21,135,3,132,1,22,46,3,3,0,0,16,2,39
14,253,242,50,192,5,187,0,48,57,21,2,4,0,16,7,32
14,254,1027,113,914,11,903,21,100,262,71,8,1,1,118,11,310
14,255,231,19,212,5,207,0,25,55,20,8,0,0,24,1,74
14,256,239,27,212,2,210,9,33,72,22,5,0,0,18,7,44
14,257,1205,114,1091,32,1059,22,122,322,106,18,4,3,143,30,289
14,258,5547,1298,4249,63,4186,84,672,1011,386,48,41,11,398,65,1470
14,259,106,15,91,2,89,2,14,42,6,0,0,0,12,3,10
14,260,212,19,193,0,193,4,37,70,14,0,0,2,21,4,41
14,261,241,28,213,1,212,5,41,74,14,3,0,2,36,3,34
14,264,194,37,157,3,154,5,36,45,19,1,0,1,16,1,30
14,265,493,108,385,4,381,7,93,87,55,1,2,0,39,7,90
14,266,1021,147,874,9,865,25,121,225,95,13,9,3,86,25,263
14,268,396,56,340,6,334,6,63,75,41,2,2,1,30,4,110
14,269,161,25,136,2,134,2,20,60,8,1,0,0,16,2,25
14,270,329,43,286,10,276,3,60,93,21,5,2,0,24,7,61
14,271,2950,458,2492,43,2449,52,350,471,382,35,10,2,187,94,866
14,272,101,23,78,1,77,2,26,23,4,3,2,0,9,2,6
14,273,155,42,113,2,111,3,29,44,3,1,0,0,4,4,23
14,274,1545,138,1407,33,1374,29,124,409,120,9,4,3,190,40,446
14,275,344,31,313,2,311,5,61,84,27,5,0,0,34,8,87
14,276,266,40,226,6,220,1,42,52,24,6,3,0,21,1,70
14,277,1233,160,1073,16,1057,19,151,237,123,25,11,2,101,22,366
14,278,786,95,691,16,675,12,128,144,67,8,7,2,64,14,229
14,279,121,25,96,0,96,2,14,29,17,0,0,0,13,0,21
14,280,181,27,154,5,149,5,32,49,13,1,0,1,11,10,27
14,281,194,38,156,6,150,1,30,43,14,3,0,1,22,6,30
14,282,144,19,125,4,121,0,28,43,8,6,0,1,6,3,26
14,283,147,30,117,2,115,4,25,27,8,1,1,0,19,7,23
14,284,146,21,125,0,125,2,26,21,13,7,2,0,14,2,38
14,285,54,13,41,0,41,0,13,11,2,0,1,0,8,0,6
14,286,324,42,282,3,279,2,54,97,24,4,3,0,17,15,63
14,287,1320,153,1167,16,1151,14,217,267,142,13,8,0,94,26,370
14,288,652,85,567,5,562,20,48,157,51,5,1,0,63,7,210
14,289,372,41,331,6,325,6,67,76,23,3,1,4,32,2,111
14,290,568,81,487,6,481,10,78,90,59,8,3,0,48,11,174
14,291,195,21,174,0,174,3,50,51,10,1,2,0,14,4,39
14,292,215,53,162,2,160,1,44,51,12,6,1,0,13,8,24
14,293,220,26,194,0,194,2,45,72,13,1,1,0,12,2,46
14,294,596,94,502,6,496,4,79,106,60,7,3,1,54,11,171
14,296,183,40,143,2,141,0,26,46,10,1,1,0,19,2,36
14,297,292,25,267,5,262,4,38,47,49,5,3,1,47,8,60
14,298,124,22,102,2,100,2,19,41,5,2,0,0,11,0,20
14,299,525,81,444,9,435,9,88,156,33,7,5,1,42,12,82
14,300,45,2,43,0,43,0,9,7,9,1,0,0,4,3,10
14,301,3638,623,3015,41,2974,41,524,486,581,52,22,6,196,42,1024
14,302,155,7,148,2,146,6,27,74,3,3,0,0,12,0,21
14,303,748,115,633,8,625,9,138,184,60,9,6,0,65,19,135
14,304,697,102,595,10,585,9,98,218,44,6,6,0,72,13,119
14,305,575,77,498,7,491,7,78,226,33,3,3,0,37,18,86
14,306,315,51,264,3,261,2,38,103,30,3,2,0,21,4,58
14,307,137,19,118,3,115,3,16,23,14,2,0,0,14,1,42
14,308,146,26,120,1,119,2,22,51,11,1,2,2,13,1,14
14,309,596,87,509,4,505,11,101,65,62,6,7,1,40,6,206
14,310,500,57,443,3,440,4,91,112,58,3,0,0,42,5,125
14,311,706,126,580,7,573,8,94,152,60,6,2,3,41,6,201
14,312,1508,335,1173,7,1166,10,280,454,74,16,5,3,74,22,228
14,313,62,6,56,2,54,2,14,16,9,3,0,1,1,1,7
14,316,221,28,193,5,188,7,38,69,21,2,0,1,20,2,28
14,317,913,133,780,14,766,13,102,195,78,20,6,3,96,22,231
14,318,454,54,400,8,392,12,61,117,47,3,2,0,34,5,111
14,319,675,105,570,6,564,10,84,101,90,7,2,2,49,10,209
14,320,223,28,195,9,186,7,36,47,21,4,1,0,14,2,54
14,322,188,24,164,4,160,0,15,74,14,5,3,1,21,3,24
14,324,332,31,301,6,295,6,59,66,25,3,2,0,35,11,88
14,325,2390,438,1952,28,1924,53,253,563,178,25,9,5,204,36,598
14,326,656,68,588,9,579,11,87,203,43,10,1,2,79,8,135
14,327,13219,2814,10405,138,10267,298,1086,1437,1616,163,48,20,1234,128,4237
14,328,891,100,791,19,772,15,102,163,96,16,5,0,53,15,307
14,329,80,23,57,0,57,0,13,18,5,1,0,0,7,4,9
14,330,146,17,129,1,128,0,34,57,3,1,0,0,7,3,23
14,331,210,32,178,3,175,0,29,67,13,0,0,0,18,6,42
14,332,521,80,441,10,431,12,97,82,46,9,5,0,41,8,131
14,333,5621,1378,4243,70,4173,78,727,1165,432,42,32,16,342,99,1240
14,334,213,35,178,5,173,1,33,71,15,5,2,0,24,0,22
14,335,265,38,227,2,225,8,39,95,24,0,4,0,19,1,35
14,336,331,40,291,4,287,4,73,76,20,3,2,1,38,8,62
14,337,223,26,197,4,193,2,38,67,15,2,0,1,16,4,48
14,338,1753,323,1430,21,1409,17,212,572,110,10,3,1,125,16,343
14,339,234,19,215,3,212,6,22,71,19,2,2,1,24,5,60
14,341,7206,1133,6073,93,5980,129,784,1274,735,74,26,25,607,129,2197
14,342,2035,486,1549,25,1524,10,344,474,143,20,8,1,98,34,392
14,343,56,5,51,0,51,1,5,18,6,0,0,0,7,2,12
14,344,344,43,301,4,297,13,53,104,17,0,0,1,32,3,74
14,345,245,49,196,0,196,2,43,69,16,3,3,2,19,0,39
14,346,548,67,481,4,477,4,102,135,57,8,6,2,58,18,87
14,347,493,106,387,7,380,11,99,81,31,6,1,1,30,18,102
14,348,64,5,59,1,58,0,7,26,11,0,0,0,6,1,7
14,349,427,40,387,10,377,7,75,88,35,9,6,1,32,9,115
14,350,45,3,42,0,42,1,5,10,6,0,0,0,6,3,11
14,352,670,121,549,16,533,6,98,203,38,4,4,2,62,11,105
14,353,290,32,258,2,256,2,48,70,31,0,0,0,31,8,66
14,354,1456,227,1229,11,1218,35,182,294,159,15,10,5,103,31,384
14,355,520,74,446,7,439,18,60,95,54,8,2,2,48,9,143
14,356,478,44,434,4,430,6,45,151,46,4,4,3,57,3,111
14,357,250,49,201,5,196,4,52,55,16,0,0,1,19,10,39
14,358,68,5,63,1,62,6,11,23,4,0,0,0,5,4,9
14,359,131,18,113,0,113,3,39,24,8,1,1,0,10,2,25
14,360,122,8,114,1,113,2,19,32,13,0,0,1,8,2,36
14,361,131,17,114,0,114,1,25,33,12,0,1,1,16,3,22
14,362,139,26,113,1,112,1,17,42,12,0,1,0,16,5,18
14,364,343,42,301,6,295,5,53,103,27,6,1,0,36,2,62
14,365,2110,327,1783,19,1764,46,233,485,234,23,8,5,161,20,549
14,366,14166,3601,10565,204,10361,182,1769,2904,1002,143,78,18,932,225,3108
14,367,354,52,302,7,295,4,78,78,18,2,5,1,18,12,79
14,368,266,54,212,5,207,1,62,60,18,5,4,1,13,8,35
14,369,215,52,163,5,158,4,33,38,16,2,3,0,25,4,33
14,370,2121,401,1720,13,1707,25,375,434,164,23,19,6,177,53,431
14,371,1571,315,1256,34,1222,17,238,443,106,20,11,0,81,24,282
14,372,627,87,540,5,535,9,112,128,53,18,2,4,54,12,143
14,373,208,24,184,1,183,5,38,33,22,4,0,0,22,1,58
14,374,99,14,85,4,81,2,20,17,3,0,1,0,11,3,24
14,375,130,19,111,4,107,0,35,13,9,0,1,0,15,4,30
14,376,166,14,152,2,150,7,33,29,22,1,2,2,13,5,36
14,377,497,74,423,10,413,14,83,121,43,2,3,3,37,5,102
14,378,228,31,197,5,192,5,49,70,15,2,1,0,16,4,30
14,379,288,36,252,3,249,2,58,65,20,5,4,0,21,16,58
14,380,132,10,122,1,121,1,24,40,10,2,0,0,14,2,28
14,381,65,8,57,2,55,0,19,19,4,0,0,0,6,2,5
14,382,71,6,65,2,63,3,7,24,9,1,2,0,4,0,13
14,383,2036,314,1722,30,1692,58,158,407,214,17,6,1,233,29,569
14,384,2661,457,2204,37,2167,52,292,609,242,30,12,3,217,60,650
14,385,118,19,99,2,97,1,16,29,4,1,2,0,16,3,25
14,386,448,74,374,8,366,2,85,89,37,6,4,1,17,7,118
14,387,260,28,232,4,228,7,54,53,21,4,2,0,15,10,62
14,388,362,49,313,12,301,6,57,84,28,4,2,2,25,9,84
14,389,183,34,149,4,145,3,19,43,14,2,1,0,25,11,27
14,390,155,25,130,2,128,6,22,32,15,3,2,0,13,5,30
14,391,267,33,234,3,231,6,49,78,18,3,2,0,22,1,52
14,393,258,36,222,4,218,7,37,44,22,3,2,1,27,4,71
14,394,353,83,270,3,267,2,61,48,24,8,4,1,23,8,88
14,395,23,2,21,0,21,1,2,5,1,1,1,0,4,0,6
14,396,618,50,568,9,559,22,71,141,64,9,2,1,76,8,165
14,397,261,40,221,3,218,3,52,78,14,4,1,1,15,6,44
14,398,449,68,381,8,373,10,64,112,35,3,4,0,56,12,77
14,399,291,39,252,1,251,6,60,86,20,3,1,0,18,7,50
14,400,136,19,117,2,115,3,17,45,7,4,1,0,8,0,30
14,401,98,16,82,1,81,1,14,29,3,0,0,0,11,0,23
14,402,76,12,64,1,63,1,16,15,10,0,0,0,5,0,16
14,403,580,69,511,8,503,5,125,142,43,8,4,1,56,6,113
14,404,78,7,71,6,65,0,12,27,1,0,1,1,7,1,15
14,405,258,31,227,3,224,5,51,63,18,3,0,0,29,2,53
14,406,289,44,245,2,243,6,43,71,16,4,0,2,23,7,71
14,407,1685,208,1477,18,1459,38,114,559,107,12,5,3,212,28,381
14,408,1437,198,1239,22,1217,22,190,243,173,35,10,2,118,27,397
14,409,1722,250,1472,21,1451,26,225,523,114,21,3,0,154,25,360
14,410,698,86,612,9,603,15,140,131,63,12,6,2,49,8,177
14,411,166,20,146,4,142,0,30,46,11,2,2,0,9,1,41
14,412,57,9,48,1,47,3,12,10,4,1,0,0,8,1,8
14,413,229,34,195,1,194,2,50,44,22,3,3,2,17,1,50
14,414,176,19,157,1,156,2,26,66,18,0,4,1,12,1,26
14,415,35,3,32,0,32,0,3,8,5,0,0,0,12,0,4
14,416,82,7,75,0,75,3,12,21,6,2,2,0,10,6,13
14,417,733,103,630,20,610,14,125,145,49,11,4,3,63,21,175
14,418,247,51,196,6,190,8,40,60,18,3,4,4,17,4,32
14,419,262,53,209,3,206,3,57,74,12,3,0,0,21,6,30
14,420,198,25,173,5,168,2,36,51,12,1,1,0,24,6,35
14,421,439,56,383,6,377,9,80,96,42,0,1,1,29,21,98
14,422,794,114,680,6,674,10,159,223,58,12,6,2,53,9,142
14,423,216,34,182,2,180,7,41,52,21,0,0,0,18,5,36
14,424,152,32,120,4,116,3,18,37,5,3,0,0,16,7,27
14,425,146,25,121,2,119,7,20,43,8,1,1,0,12,4,23
14,426,158,14,144,4,140,3,29,59,10,1,0,0,16,4,18
14,427,220,22,198,3,195,4,35,44,25,5,0,0,18,3,61
14,429,303,72,231,5,226,4,69,68,18,7,0,0,13,7,40
14,430,144,13,131,2,129,0,21,60,7,3,1,0,11,6,20
14,431,3257,675,2582,34,2548,31,572,428,307,50,29,3,164,56,908
14,432,400,48,352,6,346,5,79,102,39,3,0,3,34,4,77
14,433,126,27,99,4,95,1,26,21,10,1,2,0,17,0,17
14,435,147,13,134,1,133,1,28,58,7,0,2,0,3,6,28
14,436,393,53,340,5,335,2,41,97,31,8,2,0,42,8,104
14,437,6952,1220,5732,103,5629,94,863,967,840,94,62,13,464,86,2146
14,438,374,72,302,13,289,8,57,67,23,7,4,1,30,4,88
14,439,91,12,79,3,76,0,25,37,0,1,1,0,2,2,8
14,440,72,16,56,0,56,5,12,17,5,4,1,0,6,1,5
14,441,184,30,154,1,153,7,32,39,17,1,1,1,22,6,27
14,442,382,53,329,8,321,3,63,63,24,9,3,1,42,8,105
14,443,253,44,209,3,206,9,63,69,14,0,3,0,17,4,27
14,444,115,20,95,3,92,0,30,21,7,0,0,0,10,3,21
14,445,83,8,75,0,75,1,22,18,6,1,0,0,9,0,18
14,446,64,11,53,3,50,3,7,17,1,2,0,0,5,1,14
14,448,47,11,36,0,36,0,3,11,2,1,0,0,7,1,11
14,449,347,38,309,7,302,2,79,72,31,5,1,0,25,10,77
14,450,169,50,119,0,119,3,39,26,14,1,0,0,8,3,25
14,452,403,62,341,1,340,2,81,99,35,6,2,1,27,8,79
14,453,261,32,229,2,227,3,54,57,16,4,1,2,29,5,56
14,454,964,119,845,10,835,23,130,190,80,8,4,7,98,18,277
14,455,194,21,173,2,171,3,35,37,27,10,2,0,21,3,33
14,456,1371,158,1213,12,1201,15,262,265,126,9,15,4,102,15,388
14,457,96,11,85,0,85,0,21,42,2,0,0,0,5,0,15
14,458,253,35,218,7,211,2,55,58,20,4,4,0,22,2,44
14,459,63,9,54,0,54,3,10,28,1,0,0,0,5,0,7
14,460,1027,147,880,22,858,10,228,277,52,8,6,3,86,19,169
14,461,274,34,240,6,234,6,38,55,29,5,2,0,20,7,72
14,462,359,79,280,2,278,4,75,69,27,2,5,1,22,2,71
14,465,368,42,326,3,323,14,44,82,33,2,3,0,43,10,92
14,466,249,37,212,4,208,2,44,80,15,2,3,0,24,9,29
14,467,216,32,184,3,181,1,34,46,10,1,2,0,29,4,54
14,468,257,38,219,5,214,3,39,65,29,3,0,0,17,3,55
14,469,86,13,73,2,71,0,16,23,6,1,0,0,5,3,17
14,471,301,50,251,7,244,6,46,97,19,0,2,0,22,12,40
14,473,99,10,89,2,87,2,19,31,9,2,0,0,9,0,15
14,474,130,24,106,0,106,2,14,49,10,0,0,0,16,2,13
14,475,810,93,717,22,695,9,122,174,70,11,4,2,79,13,211
14,476,162,30,132,2,130,7,25,25,15,4,3,1,10,6,34
14,477,232,29,203,1,202,9,49,54,11,1,4,1,15,6,52
14,478,1521,304,1217,13,1204,17,288,405,103,20,11,1,91,22,246
14,480,410,71,339,3,336,2,90,107,32,4,3,1,34,11,52
14,481,211,37,174,2,172,0,47,54,12,1,3,1,18,2,34
14,482,170,9,161,4,157,4,35,46,13,0,1,0,18,5,35
14,483,153,28,125,0,125,2,30,32,12,0,2,0,8,2,37
14,484,149,13,136,0,136,3,22,50,2,2,0,0,24,1,32
14,486,406,47,359,12,347,5,71,77,53,7,1,0,26,6,101
14,487,653,75,578,10,568,9,81,229,41,9,2,1,54,9,133
14,488,7711,1655,6056,90,5966,117,850,1917,549,71,29,9,519,97,1808
14,489,222,58,164,2,162,1,40,39,13,4,0,1,16,1,47
14,491,151,14,137,4,133,5,30,20,19,2,0,0,16,3,38
14,492,254,24,230,1,229,4,41,114,19,1,0,0,25,1,24
14,493,200,29,171,1,170,1,35,45,11,4,1,0,19,6,48
14,494,114,19,95,2,93,6,21,39,6,0,0,0,6,1,14
14,495,397,32,365,5,360,12,35,148,26,7,0,0,50,4,78
14,496,42,2,40,0,40,3,3,11,5,0,0,1,2,2,13
14,497,229,39,190,2,188,4,59,25,19,1,3,0,10,5,62
14,498,178,21,157,5,152,1,30,47,4,3,0,0,17,6,44
14,499,399,45,354,8,346,3,53,86,55,4,5,1,48,11,80
14,500,122,12,110,2,108,0,15,52,7,3,0,0,12,0,19
14,501,185,22,163,2,161,1,41,36,17,0,1,0,14,3,48
14,502,74,14,60,0,60,0,9,18,9,0,0,1,7,3,13
14,503,179,32,147,1,146,3,34,24,24,1,3,0,15,9,33
14,504,574,96,478,3,475,11,90,147,37,6,5,0,70,14,95
14,505,116,17,99,2,97,0,19,31,11,0,0,0,8,2,26
14,506,197,35,162,2,160,3,27,51,13,2,0,1,23,7,33
14,508,254,50,204,6,198,13,43,57,24,5,0,0,19,2,35
14,509,191,24,167,2,165,6,13,63,14,0,0,0,18,5,46
14,510,42,6,36,0,36,0,8,6,4,0,0,2,7,0,9
14,511,64,13,51,0,51,0,9,19,3,2,0,0,3,4,11
14,512,77,12,65,1,64,2,23,14,2,2,0,0,3,3,15
14,513,371,52,319,2,317,8,63,93,34,5,3,2,27,8,74
14,514,3110,639,2471,40,2431,44,443,842,217,28,19,2,209,63,564
14,515,1600,368,1232,12,1220,13,223,467,90,13,8,3,88,34,281
14,516,1307,206,1101,16,1085,12,230,135,182,16,9,3,89,18,391
14,517,70,4,66,0,66,0,10,25,4,0,0,0,14,2,11
14,518,46,6,40,3,37,0,8,15,0,1,0,0,11,0,2
14,519,89,6,83,1,82,2,16,17,11,2,2,0,6,3,23
14,520,615,63,552,11,541,7,123,160,52,6,5,3,56,4,125
14,521,190,28,162,3,159,0,39,64,10,1,0,0,11,2,32
14,522,310,42,268,5,263,6,64,76,21,5,1,0,22,6,62
14,523,297,34,263,4,259,2,56,66,28,2,1,0,24,9,71
14,524,257,36,221,3,218,6,34,72,16,5,0,0,25,1,59
14,525,309,35,274,6,268,6,32,79,20,0,1,1,35,4,90
14,527,247,32,215,3,212,3,44,67,19,2,1,1,35,5,35
14,528,296,74,222,2,220,2,43,106,13,8,1,1,22,3,21
14,529,166,23,143,2,141,5,22,38,18,4,1,0,8,1,44
14,530,1471,254,1217,18,1199,16,172,317,133,10,9,6,107,29,400
14,531,38,4,34,0,34,0,6,14,0,0,2,0,6,1,5
14,532,205,26,179,1,178,5,37,41,11,2,2,0,27,6,47
14,533,75,17,58,0,58,3,12,22,7,2,1,0,4,1,6
14,534,283,39,244,3,241,1,44,87,10,3,0,2,40,4,50
14,535,445,62,383,4,379,16,60,100,48,10,1,1,34,4,105
14,536,1388,255,1133,18,1115,14,230,306,110,17,4,4,76,33,321
14,538,529,46,483,7,476,6,89,86,47,8,3,0,44,16,177
14,539,77,15,62,3,59,4,13,12,9,1,0,0,7,3,10
14,540,300,42,258,0,258,1,26,136,15,1,0,0,42,3,34
14,541,115,23,92,0,92,3,20,29,6,1,0,0,7,2,24
14,542,492,77,415,2,413,13,44,125,39,4,2,2,57,6,121
14,543,1029,126,903,8,895,26,101,295,80,9,12,2,108,17,245
14,544,144,11,133,1,132,7,28,36,14,0,0,0,13,7,27
14,545,749,72,677,12,665,11,122,171,60,11,4,2,71,17,196
14,546,159,22,137,1,136,2,35,26,16,2,2,0,15,1,37
14,547,98,9,89,1,88,3,21,28,2,1,0,0,7,4,22
14,548,120,13,107,1,106,3,16,26,15,0,2,0,7,1,36
14,549,168,21,147,8,139,3,30,39,14,0,2,0,19,7,25
14,550,79,9,70,1,69,3,10,33,10,1,0,0,6,1,5
14,551,132,18,114,2,112,3,22,38,1,3,1,2,8,5,29
14,552,390,44,346,5,341,8,79,95,23,2,0,1,32,7,94
14,553,94,19,75,3,72,1,17,25,2,0,2,0,9,4,12
14,554,332,23,309,7,302,5,60,54,29,3,2,1,32,10,106
14,555,346,44,302,2,300,2,90,100,17,0,1,0,28,9,53
14,556,1336,178,1158,19,1139,29,167,250,129,19,9,4,114,18,400
14,557,938,155,783,5,778,12,110,365,52,10,2,4,70,11,142
14,558,589,80,509,7,502,14,87,145,60,5,3,1,53,9,125
14,559,194,43,151,6,145,3,17,62,11,3,2,2,20,3,22
14,562,1855,327,1528,23,1505,42,219,417,156,15,5,4,181,31,435
14,563,265,7,258,5,253,1,45,92,28,4,3,0,12,9,59
14,564,141,15,126,0,126,3,22,31,8,1,2,1,13,5,40
14,565,222,23,199,5,194,3,30,77,13,3,0,0,25,4,39
14,566,1987,252,1735,26,1709,51,167,546,166,18,6,3,234,38,480
14,568,229,28,201,2,199,4,20,47,22,3,0,0,30,1,72
14,569,194,23,171,2,169,6,17,59,13,2,0,2,22,4,44
14,570,479,65,414,5,409,13,98,110,48,4,2,2,35,8,89
14,571,239,32,207,8,199,2,50,61,15,2,4,0,20,4,41
14,572,632,84,548,9,539,6,128,133,54,7,3,1,37,15,155
14,573,68,11,57,2,55,0,14,14,4,0,0,0,8,0,15
14,574,1368,250,1118,19,1099,21,214,375,68,13,7,2,116,34,249
14,575,385,70,315,4,311,7,54,142,19,1,1,0,38,8,41
14,576,128,21,107,0,107,1,26,34,6,1,1,0,7,3,28
14,577,233,39,194,4,190,3,37,57,20,4,5,3,15,8,38
14,578,1128,204,924,10,914,10,142,349,81,14,4,0,105,13,196
14,579,553,93,460,8,452,11,100,124,54,5,2,1,57,11,87
14,580,96,8,88,0,88,5,14,36,8,2,0,0,11,0,12
14,581,225,41,184,2,182,3,55,34,15,2,1,0,12,6,54
14,582,569,84,485,10,475,9,108,130,40,3,3,0,48,6,128
14,583,138,16,122,1,121,4,29,55,8,0,1,0,8,1,15
14,584,1537,221,1316,30,1286,34,216,352,134,16,9,5,136,32,352
14,585,741,80,661,9,652,15,145,170,40,8,3,3,63,21,184
14,586,143,27,116,0,116,2,33,47,6,1,1,0,3,1,22
14,587,1729,269,1460,15,1445,31,164,283,184,23,23,5,158,32,542
14,588,206,23,183,4,179,5,42,35,14,2,0,0,23,6,52
14,589,672,69,603,9,594,13,134,99,83,6,6,4,31,6,212
14,590,106,17,89,1,88,1,14,40,1,1,1,0,8,2,20
14,591,416,78,338,4,334,13,64,115,25,7,2,1,18,10,79
14,592,1040,132,908,31,877,25,124,250,81,12,4,5,109,18,249
14,593,566,114,452,8,444,3,77,174,41,3,2,1,39,10,94
14,595,184,27,157,4,153,1,18,66,12,1,1,0,19,3,32
14,596,157,20,137,1,136,1,48,28,18,2,1,0,13,0,25
14,597,261,42,219,4,215,14,41,58,26,1,4,1,22,5,43
14,598,159,16,143,3,140,1,31,49,10,4,1,1,18,2,23
14,599,374,50,324,5,319,3,86,82,20,8,1,1,36,12,70
14,600,478,45,433,9,424,8,114,131,29,11,1,1,41,11,77
14,601,160,24,136,1,135,2,20,61,7,0,1,0,15,3,26
14,602,181,29,152,4,148,3,49,39,15,2,1,0,14,2,23
14,603,353,46,307,5,302,17,59,49,35,9,0,0,41,5,87
14,604,158,26,132,2,130,6,16,58,12,1,0,1,13,4,19
14,605,268,43,225,2,223,11,32,89,21,3,0,0,9,5,53
14,606,146,18,128,1,127,2,23,38,10,0,1,0,9,7,37
14,607,138,21,117,2,115,0,29,35,7,2,0,0,4,5,33
14,608,161,29,132,1,131,4,22,46,7,4,0,0,17,3,28
14,609,288,45,243,4,239,5,35,76,20,1,1,2,29,4,66
14,610,1344,188,1156,31,1125,18,172,318,110,8,8,8,141,14,328
14,611,406,50,356,7,349,5,59,92,36,9,3,0,42,9,94
14,613,87,18,69,2,67,2,18,21,6,1,0,0,6,0,13
14,614,629,123,506,12,494,6,144,127,51,2,2,0,48,14,100
14,615,157,20,137,0,137,5,27,42,15,2,0,1,18,1,26
14,616,319,67,252,7,245,5,63,82,14,8,3,1,13,4,52
14,618,467,76,391,6,385,6,70,99,41,4,1,0,41,5,118
14,619,74,11,63,0,63,0,15,30,2,0,0,0,7,3,6
14,620,341,61,280,7,273,3,42,124,29,1,0,1,24,4,45
14,621,411,123,288,4,284,5,90,79,25,1,2,3,22,7,50
14,622,108,16,92,0,92,3,20,27,9,2,0,0,4,2,25
14,623,1875,273,1602,27,1575,28,234,387,148,23,14,5,161,29,546
14,625,684,88,596,8,588,15,90,188,48,7,2,3,59,17,159
14,626,676,96,580,15,565,7,145,142,66,5,8,3,49,14,126
14,627,318,44,274,9,265,3,49,54,25,4,2,2,27,7,92
14,628,438,86,352,7,345,4,61,90,42,5,1,0,35,8,99
14,629,858,179,679,11,668,7,182,211,35,5,4,3,62,16,143
14,630,545,84,461,11,450,8,58,119,62,10,5,2,69,7,110
14,632,198,36,162,4,158,5,32,43,23,1,1,1,22,4,26
14,633,86,9,77,1,76,2,17,20,6,0,0,1,6,3,21
14,634,136,14,122,3,119,2,29,38,8,1,0,0,8,3,30
14,635,125,13,112,1,111,2,25,23,20,1,0,0,10,3,27
14,636,264,41,223,3,220,3,52,69,17,1,2,1,18,6,51
14,637,152,11,141,0,141,4,32,31,12,1,0,0,19,3,39
14,638,79,8,71,1,70,0,11,28,6,1,1,0,10,3,10
14,639,228,38,190,5,185,5,53,52,15,3,2,1,19,2,33
14,640,188,16,172,0,172,3,32,74,13,0,0,0,22,7,21
14,643,570,112,458,15,443,6,109,85,49,6,8,0,39,8,133
14,644,516,71,445,6,439,4,76,171,28,11,0,1,45,9,94
14,645,143,11,132,2,130,2,38,55,2,2,0,0,18,2,11
14,646,303,35,268,6,262,3,41,68,34,5,1,2,20,14,74
14,647,369,50,319,10,309,7,81,84,31,4,0,0,25,16,61
14,648,356,54,302,4,298,10,68,93,20,2,1,0,26,11,67
14,649,313,34,279,11,268,4,48,83,18,2,1,2,21,6,83
14,650,133,22,111,0,111,1,24,19,8,1,0,0,14,1,43
14,651,166,31,135,5,130,1,31,29,5,1,3,0,16,4,40
14,652,71,8,63,0,63,0,16,17,6,0,3,0,7,0,14
14,653,294,52,242,0,242,5,56,65,23,2,0,0,31,4,56
14,654,2420,684,1736,32,1704,18,360,536,133,25,21,4,129,14,464
14,655,270,55,215,5,210,2,37,46,18,6,1,0,21,9,70
14,656,778,132,646,15,631,8,145,134,78,6,6,4,53,9,188
14,657,248,31,217,5,212,2,31,74,22,1,2,0,28,3,49
14,658,964,206,758,16,742,12,103,249,70,12,5,1,86,19,185
14,659,877,118,759,12,747,8,148,168,74,13,10,0,87,18,221
14,660,84,22,62,0,62,0,17,28,0,0,0,1,6,6,4
14,661,112,14,98,2,96,2,15,36,6,1,0,0,7,1,28
14,662,186,40,146,4,142,3,28,30,13,2,1,1,18,3,43
14,663,1614,241,1373,15,1358,23,192,423,120,18,11,2,157,37,375
14,664,177,26,151,0,151,4,33,65,13,0,0,0,8,1,27
14,665,222,34,188,3,185,4,31,64,14,1,1,0,18,3,49
14,666,1322,167,1155,18,1137,19,210,257,110,9,6,2,139,26,359
14,667,173,24,149,0,149,3,37,27,14,1,2,0,20,16,29
14,668,176,24,152,4,148,2,43,39,9,7,1,0,14,11,22
14,669,145,14,131,1,130,2,22,47,14,1,1,0,11,1,31
14,670,293,40,253,2,251,9,33,82,32,1,0,0,30,4,60
14,671,294,47,247,3,244,3,42,93,20,3,2,1,29,10,41
14,672,317,69,248,5,243,0,66,68,23,3,4,0,33,10,36
14,674,70,5,65,1,64,2,12,15,11,3,1,0,5,3,12
14,675,1526,161,1365,23,1342,20,230,289,145,9,12,1,135,41,460
14,676,790,92,698,12,686,10,91,164,78,18,5,0,85,16,219
14,677,211,30,181,4,177,4,32,47,15,0,0,1,18,3,57
14,678,414,68,346,2,344,6,56,72,54,6,6,4,29,9,102
14,679,490,48,442,8,434,13,65,110,37,12,6,2,46,5,138
14,680,122,26,96,2,94,4,19,35,6,3,2,0,10,2,13
14,681,106,10,96,1,95,0,31,37,6,0,0,0,9,2,10
14,682,402,52,350,6,344,7,57,125,23,6,1,0,50,11,64
14,684,175,21,154,3,151,0,34,45,10,1,1,0,21,2,37
14,685,1135,123,1012,21,991,33,116,236,89,10,3,0,122,16,366
14,686,189,29,160,6,154,6,31,51,13,1,1,1,20,3,27
14,687,138,17,121,7,114,5,31,31,3,3,1,0,10,4,26
14,688,244,44,200,3,197,2,52,43,13,3,5,0,15,6,58
14,689,1407,241,1166,20,1146,15,193,307,107,20,11,2,120,24,347
14,690,118,16,102,1,101,3,24,20,14,3,0,0,9,1,27
14,691,96,14,82,2,80,0,11,21,7,1,0,0,14,1,25
14,692,1175,208,967,16,951,13,163,233,109,11,10,1,71,29,311
14,693,201,35,166,3,163,2,48,62,10,4,1,0,8,4,24
14,694,353,33,320,4,316,4,74,120,17,2,1,1,23,7,67
14,695,304,47,257,6,251,5,55,72,17,0,1,1,23,2,75
14,696,111,11,100,4,96,2,19,39,7,3,0,0,7,3,16
14,697,1121,187,934,16,918,13,164,323,94,17,10,2,72,14,209
14,698,230,46,184,6,178,3,39,49,22,1,3,1,20,5,35
14,699,2935,653,2282,47,2235,39,392,875,170,31,14,1,172,47,494
14,700,413,48,365,5,360,4,55,122,36,4,3,2,38,16,80
14,701,824,141,683,7,676,9,92,433,14,1,1,0,49,9,68
14,702,262,36,226,5,221,9,52,45,13,4,0,2,24,10,62
14,703,260,35,225,5,220,4,47,63,19,6,0,0,24,4,53
14,704,420,65,355,11,344,6,82,84,38,6,3,0,26,13,86
14,705,137,22,115,4,111,1,29,24,7,0,1,0,7,9,33
14,706,233,31,202,5,197,3,28,100,14,0,1,0,21,2,28
14,707,810,91,719,16,703,12,115,141,95,6,2,3,69,12,248
14,708,258,35,223,1,222,0,55,52,20,4,2,0,22,11,56
14,709,282,27,255,8,247,4,35,107,20,1,1,3,17,7,52
14,710,84,12,72,0,72,0,26,30,2,1,2,0,2,1,8
14,711,749,153,596,15,581,7,124,187,45,9,5,0,55,13,136
14,712,2587,379,2208,44,2164,35,364,575,220,29,14,6,215,46,660
14,713,279,29,250,9,241,5,42,76,45,4,0,3,21,3,42
14,714,555,81,474,11,463,12,91,126,43,10,3,1,43,6,128
14,715,4049,992,3057,46,3011,65,466,1210,235,37,13,10,197,48,730
14,716,176,26,150,5,145,2,37,40,15,2,0,1,11,7,30
14,717,459,59,400,8,392,4,83,125,26,5,5,0,51,9,84
14,718,90,7,83,4,79,0,15,29,7,0,0,0,12,0,16
14,719,379,43,336,7,329,2,45,79,37,5,6,0,41,7,107
14,720,627,87,540,10,530,3,101,111,63,14,2,0,49,11,176
14,721,366,42,324,15,309,15,59,77,27,1,2,2,36,4,86
14,722,228,34,194,5,189,6,33,63,19,0,2,0,25,11,30
14,723,233,34,199,0,199,3,49,69,13,1,0,1,17,5,41
14,724,821,114,707,8,699,14,129,285,43,7,2,1,61,20,137
14,726,1308,213,1095,26,1069,26,225,291,95,18,12,4,151,35,212
14,727,348,83,265,7,258,2,58,59,16,10,0,0,25,7,81
14,728,306,44,262,0,262,4,27,94,34,2,0,0,35,10,56
14,729,161,25,136,0,136,1,39,30,19,3,0,0,5,3,36
14,730,1180,134,1046,19,1027,15,107,330,91,13,1,2,112,22,334
14,731,210,44,166,4,162,1,31,70,9,1,0,0,16,4,30
14,732,257,17,240,1,239,11,32,57,16,6,0,0,49,6,62
14,733,226,25,201,0,201,1,28,56,30,0,0,1,27,3,55
14,734,227,16,211,5,206,5,34,53,24,7,2,0,25,6,50
14,735,635,133,502,13,489,4,110,139,45,6,8,3,41,13,120
14,737,318,33,285,5,280,2,44,100,20,3,3,0,35,3,70
14,738,2701,384,2317,36,2281,50,227,533,238,17,8,3,299,47,859
14,739,1226,147,1079,13,1066,16,211,320,75,13,2,5,100,16,308
14,740,788,170,618,9,609,9,159,186,46,18,7,1,53,9,121
14,741,74,5,69,0,69,3,9,20,7,3,1,0,6,1,19
14,742,52,12,40,1,39,0,13,15,2,0,0,0,3,2,4
14,743,109,14,95,1,94,1,19,48,4,1,1,1,7,4,8
14,744,236,27,209,10,199,1,32,66,16,2,1,0,17,8,56
14,745,253,41,212,2,210,1,36,95,13,2,1,0,18,8,36
14,746,609,79,530,15,515,10,131,114,67,16,3,0,47,19,108
14,747,492,41,451,4,447,19,57,83,48,6,0,2,64,6,162
14,748,90,21,69,1,68,3,8,27,8,3,0,0,8,2,9
14,749,333,30,303,2,301,8,65,48,45,5,3,1,29,10,87
14,750,238,46,192,0,192,3,38,65,25,0,0,2,11,6,42
14,751,211,26,185,1,184,2,37,63,23,0,1,1,13,6,38
14,752,2024,321,1703,30,1673,18,366,394,142,20,25,2,156,43,507
14,753,492,65,427,9,418,7,87,81,45,14,4,0,48,7,125
14,754,2301,443,1858,24,1834,31,356,795,92,10,7,6,143,35,359
14,755,595,93,502,5,497,26,74,196,35,7,1,2,39,7,110
14,756,154,16,138,0,138,2,37,30,12,1,2,0,15,5,34
14,757,225,30,195,0,195,2,27,43,24,5,4,2,25,2,61
14,758,583,59,524,5,519,13,44,181,53,3,0,1,81,3,140
14,759,203,23,180,5,175,3,24,60,10,1,1,0,14,2,60
14,760,543,67,476,6,470,8,95,111,54,14,5,0,54,9,120
14,761,463,68,395,8,387,3,86,98,46,6,3,5,26,6,108
14,762,8376,1704,6672,177,6495,106,904,1791,618,98,57,18,662,133,2108
14,763,140,36,104,2,102,1,23,36,7,2,0,0,13,1,19
14,764,740,107,633,11,622,12,139,136,68,12,9,2,55,7,182
15,1,816,187,629,7,622,6,108,151,65,8,6,6,78,8,186
15,2,191,34,157,0,157,1,22,60,11,4,0,0,24,4,31
15,3,601,115,486,16,470,4,82,115,35,5,2,0,41,6,180
15,4,374,51,323,11,312,4,62,78,25,1,1,2,45,7,87
15,5,270,30,240,4,236,4,47,69,19,4,0,0,24,4,65
15,6,661,120,541,8,533,7,82,178,48,5,4,1,74,6,128
15,7,106,15,91,0,91,3,12,45,7,3,0,0,13,0,8
15,8,241,33,208,4,204,9,29,47,23,4,2,1,31,3,55
15,9,232,44,188,2,186,2,28,52,11,1,1,0,17,4,70
15,10,172,23,149,4,145,1,39,18,18,1,1,1,12,5,49
15,11,181,35,146,1,145,1,19,43,14,2,0,0,21,1,44
15,12,5057,754,4303,91,4212,65,554,1041,463,51,17,9,424,69,1519
15,13,206,43,163,5,158,2,25,55,9,0,0,1,29,2,35
15,14,18647,3802,14845,312,14533,307,1615,3433,1590,168,78,35,1391,201,5715
15,15,210,47,163,4,159,1,25,49,18,2,2,0,16,7,39
15,16,490,77,413,7,406,8,83,95,38,4,2,1,42,18,115
15,17,118,13,105,1,104,1,35,32,3,1,0,0,18,3,11
15,18,125,23,102,2,100,1,15,37,5,0,0,1,11,0,30
15,19,210,22,188,6,182,7,18,32,25,1,0,0,19,4,76
15,20,95,23,72,2,70,3,4,27,7,1,2,0,14,2,10
15,21,539,86,453,17,436,4,70,125,33,4,2,0,81,6,111
15,22,179,25,154,4,150,7,16,38,12,1,0,1,30,2,43
15,24,74,11,63,3,60,1,19,12,7,0,0,0,6,0,15
15,25,250,27,223,3,220,2,31,93,6,5,1,0,16,1,65
15,26,205,32,173,2,171,8,24,68,10,4,0,0,26,1,30
15,27,382,63,319,1,318,1,49,98,20,6,3,0,41,8,92
15,28,305,37,268,6,262,2,42,79,29,1,2,0,39,3,65
15,29,479,94,385,8,377,6,70,103,27,5,4,2,45,9,106
15,30,215,25,190,7,183,1,31,42,16,5,4,0,18,9,57
15,31,215,38,177,1,176,2,36,62,9,3,2,0,21,5,36
15,32,75,14,61,0,61,0,13,14,5,4,0,0,9,2,14
15,33,247,39,208,6,202,1,38,83,8,2,0,0,29,3,38
15,34,174,24,150,3,147,3,27,32,7,3,2,0,36,2,35
15,35,421,76,345,5,340,8,42,113,23,7,8,0,45,1,93
15,36,480,103,377,6,371,4,90,97,29,3,1,0,32,12,103
15,37,957,195,762,12,750,13,108,131,67,12,4,3,48,11,353
15,38,943,187,756,10,746,17,79,178,90,15,4,0,62,10,291
15,40,135,35,100,3,97,3,20,28,6,0,1,1,17,1,20
15,41,218,31,187,2,185,1,17,74,15,2,2,0,23,5,46
15,42,301,43,258,5,253,1,68,91,16,0,1,0,31,5,40
15,43,109,20,89,3,86,2,13,24,5,0,0,0,18,1,23
15,44,126,14,112,5,107,0,13,28,7,1,0,1,19,0,38
15,45,707,111,596,11,585,5,110,236,37,3,2,0,65,5,122
15,46,211,26,185,3,182,3,35,36,20,2,1,0,11,2,72
15,47,109,10,99,3,96,0,20,34,7,2,1,1,10,0,21
15,48,41,9,32,0,32,0,6,14,6,0,0,0,3,0,3
15,49,268,52,216,4,212,4,20,108,9,1,0,2,30,4,34
15,50,231,56,175,1,174,1,19,86,10,2,0,0,18,2,36
15,51,224,53,171,4,167,2,34,58,8,3,1,0,29,2,30
15,52,189,40,149,5,144,1,24,35,18,0,1,1,17,1,46
15,53,390,75,315,11,304,1,62,51,31,4,0,1,25,5,124
15,54,814,155,659,14,645,11,88,183,58,9,4,4,78,17,193
15,55,354,43,311,6,305,4,44,97,18,4,2,1,37,6,92
15,56,543,60,483,10,473,6,52,125,52,10,3,1,30,11,183
15,57,210,36,174,3,171,2,20,51,12,1,0,1,24,1,59
15,58,147,25,122,1,121,0,24,37,13,0,0,0,8,2,37
15,59,124,13,111,0,111,4,21,36,4,0,0,0,17,2,27
15,60,50,11,39,0,39,0,7,20,1,0,1,0,5,0,5
15,61,276,43,233,4,229,7,26,96,19,2,0,0,41,1,37
15,63,357,66,291,13,278,3,49,77,27,6,3,0,19,5,89
15,64,69,16,53,2,51,0,9,20,6,0,0,0,5,2,9
15,65,75,10,65,4,61,1,4,28,1,0,0,0,11,0,16
15,66,155,35,120,4,116,0,16,26,7,1,1,0,9,4,52
15,67,51,11,40,0,40,0,2,17,3,1,2,0,5,1,9
15,68,328,75,253,3,250,0,49,82,10,8,3,2,34,6,56
15,69,287,59,228,3,225,3,46,70,27,1,1,0,32,2,43
15,70,239,49,190,1,189,2,25,58,16,7,1,0,20,5,55
15,71,66,9,57,0,57,2,3,16,3,0,0,0,16,2,15
15,72,185,37,148,0,148,2,37,32,10,0,0,1,18,3,45
15,73,96,18,78,1,77,0,11,42,1,1,0,3,12,0,7
15,74,616,88,528,16,512,8,84,166,43,11,0,3,56,2,139
15,75,69,12,57,3,54,0,12,15,5,0,0,0,11,0,11
15,76,196,40,156,1,155,5,31,34,20,2,3,1,8,2,49
15,77,56,9,47,1,46,0,10,20,1,0,0,0,11,0,4
15,78,136,19,117,1,116,2,17,48,5,5,1,0,23,3,12
15,79,363,49,314,8,306,1,64,55,29,4,4,0,34,4,111
15,80,167,40,127,4,123,5,26,38,7,1,0,0,15,4,27
15,81,112,9,103,4,99,7,14,31,8,0,0,0,14,2,23
15,82,291,52,239,3,236,2,26,94,18,0,2,0,41,8,45
15,83,1581,227,1354,23,1331,11,219,394,121,10,7,4,105,19,441
15,84,218,29,189,3,186,3,35,83,14,0,1,0,20,3,27
15,85,373,62,311,6,305,3,66,88,24,4,1,0,17,3,99
15,86,64,12,52,2,50,0,4,31,1,0,2,0,7,2,3
15,87,256,29,227,9,218,8,37,50,27,3,1,0,27,4,61
15,88,388,28,360,9,351,2,65,90,35,6,4,2,36,3,108
15,89,406,72,334,16,318,7,55,108,16,1,3,2,42,6,78
15,90,442,55,387,17,370,9,61,122,24,2,2,1,53,1,95
15,91,114,32,82,4,78,1,8,28,7,1,0,0,7,0,26
15,92,1242,185,1057,29,1028,16,155,258,108,16,8,0,94,17,356
15,93,95,15,80,0,80,1,19,37,4,0,0,0,6,2,11
15,94,644,113,531,7,524,5,48,149,73,3,3,0,37,14,192
15,95,283,45,238,1,237,3,50,70,22,3,1,0,23,4,61
15,96,251,37,214,3,211,4,35,65,23,0,1,3,24,3,53
15,97,116,20,96,1,95,2,25,30,5,1,2,0,12,3,15
15,98,112,27,85,1,84,1,17,34,3,2,1,0,14,1,11
15,99,220,34,186,0,186,1,30,62,12,4,0,1,30,3,43
15,100,97,12,85,1,84,0,13,32,6,0,1,0,17,1,14
15,101,482,81,401,5,396,7,89,115,20,6,5,1,41,3,109
15,102,116,23,93,2,91,4,15,39,8,0,0,0,12,1,12
15,103,212,35,177,3,174,3,35,57,12,3,1,1,19,4,39
15,104,305,66,239,3,236,7,49,54,7,2,1,1,38,10,67
15,105,39,5,34,1,33,1,7,14,0,0,0,0,4,2,5
15,106,162,25,137,1,136,1,23,81,6,0,0,0,10,2,13
15,107,192,43,149,2,147,2,32,46,6,3,0,1,10,7,40
15,108,415,64,351,7,344,3,50,105,33,3,0,1,43,3,103
15,110,168,38,130,3,127,0,18,42,7,2,1,0,13,2,42
15,111,204,36,168,5,163,2,22,41,14,0,0,0,19,7,58
15,112,105,16,89,2,87,3,20,37,1,3,0,0,11,4,8
15,113,250,56,194,3,191,3,36,62,20,3,0,0,33,3,31
15,114,472,107,365,10,355,7,59,116,23,7,1,1,52,8,81
15,116,186,37,149,3,146,2,20,52,3,4,0,0,26,1,38
15,117,510,59,451,11,440,9,58,158,38,8,3,1,71,8,86
15,118,596,73,523,5,518,3,75,170,52,7,6,0,68,9,128
15,119,1449,233,1216,33,1183,14,202,349,121,13,9,2,126,25,322
15,120,2837,532,2305,39,2266,23,367,613,222,36,15,4,227,39,720
15,121,84,19,65,0,65,2,15,22,3,0,1,0,11,0,11
15,122,1694,247,1447,30,1417,25,141,405,173,31,5,3,121,18,495
15,123,162,21,141,5,136,3,22,48,11,2,2,0,13,0,35
15,124,469,79,390,6,384,4,54,89,54,9,1,1,35,9,128
15,125,112,19,93,2,91,4,12,29,4,3,0,0,23,0,16
15,126,109,24,85,4,81,0,19,37,2,0,1,1,9,1,11
15,127,261,32,229,1,228,5,33,71,26,2,2,1,20,6,62
15,128,140,25,115,3,112,7,20,29,6,2,1,0,11,4,32
15,129,215,46,169,5,164,0,40,41,8,0,1,1,18,1,54
15,130,128,22,106,3,103,2,23,30,7,0,0,0,25,0,16
15,131,254,51,203,3,200,4,28,70,12,0,0,2,22,10,52
15,132,60,13,47,2,45,0,13,19,2,1,0,0,7,0,3
15,133,95,13,82,4,78,3,16,20,5,0,0,0,14,2,18
15,134,657,76,581,18,563,8,68,201,38,4,7,2,58,14,163
15,135,98,4,94,2,92,0,15,37,8,0,1,0,13,0,18
15,136,295,63,232,13,219,4,29,76,8,0,1,1,46,2,52
15,137,274,48,226,10,216,7,31,53,29,4,4,0,30,1,57
15,138,1390,182,1208,23,1185,22,185,381,79,9,6,2,121,15,365
15,139,93,20,73,1,72,1,15,34,2,0,0,1,4,1,14
15,140,1685,254,1431,35,1396,17,169,340,126,26,14,3,134,17,550
15,141,812,125,687,18,669,12,108,212,64,5,9,2,45,10,202
15,142,971,133,838,26,812,13,132,284,48,10,6,2,117,13,187
15,143,112,13,99,1,98,1,16,40,10,2,0,1,10,0,18
15,144,265,35,230,6,224,3,29,74,14,2,0,3,17,3,79
15,145,234,51,183,3,180,2,36,65,15,1,1,0,21,1,38
15,146,164,39,125,3,122,3,16,81,3,2,0,0,6,3,8
15,147,275,35,240,5,235,4,20,62,28,4,3,1,22,8,83
15,148,401,67,334,8,326,4,50,132,21,2,1,2,47,9,58
15,149,181,37,144,2,142,1,23,71,8,0,0,0,17,2,20
15,150,226,28,198,4,194,2,29,51,18,3,0,2,23,7,59
15,151,176,38,138,3,135,5,21,59,8,2,1,0,15,1,23
15,152,675,113,562,19,543,6,66,240,31,9,2,2,65,7,115
15,153,1529,274,1255,33,1222,17,185,331,113,8,11,0,118,17,422
15,154,941,132,809,10,799,14,151,235,57,15,5,4,66,14,238
15,155,98,26,72,0,72,1,17,16,4,3,0,0,6,0,25
15,156,446,60,386,17,369,5,74,106,19,7,2,0,46,7,103
15,157,258,36,222,8,214,3,26,55,24,1,5,1,19,4,76
15,158,117,32,85,1,84,0,12,24,6,0,0,0,21,1,20
15,159,280,43,237,1,236,2,34,87,19,2,1,0,35,5,51
15,160,873,119,754,14,740,12,115,164,76,10,6,1,62,16,278
15,161,112,26,86,3,83,0,11,38,6,0,0,0,14,0,14
15,162,2189,455,1734,24,1710,33,248,471,143,25,14,6,193,31,546
15,163,813,119,694,17,677,20,96,199,58,5,3,1,81,8,206
15,164,500,69,431,13,418,5,84,147,28,4,1,0,54,4,91
15,165,183,35,148,2,146,2,39,30,14,0,0,0,7,4,50
15,166,207,25,182,6,176,6,36,49,10,1,3,1,21,4,45
15,167,103,14,89,1,88,5,12,23,6,1,1,0,19,0,21
15,168,527,86,441,5,436,4,71,140,26,14,2,2,48,6,123
15,169,719,135,584,21,563,10,90,130,35,10,6,3,64,14,201
15,170,239,50,189,4,185,3,42,54,14,0,2,1,28,3,38
15,171,152,30,122,2,120,2,18,41,8,1,0,0,22,1,27
15,172,108,14,94,5,89,0,8,32,7,1,0,0,9,0,32
15,173,158,37,121,1,120,0,18,33,13,2,2,0,20,1,31
15,174,270,47,223,7,216,0,35,90,13,4,2,2,35,2,33
15,175,837,146,691,10,681,2,105,227,64,4,6,1,64,11,197
15,176,212,28,184,6,178,3,37,61,11,2,1,0,20,1,42
15,178,122,24,98,0,98,1,27,32,9,0,0,1,7,0,21
15,179,218,36,182,4,178,2,36,66,13,0,2,0,16,4,39
15,180,70,9,61,0,61,8,4,19,2,0,0,0,12,4,12
15,181,516,75,441,10,431,12,45,118,49,5,1,0,58,3,140
15,182,107,14,93,3,90,2,5,20,12,0,0,0,9,4,38
15,183,104,18,86,2,84,2,21,23,8,1,0,0,7,0,22
15,184,598,75,523,9,514,12,60,146,67,5,2,0,73,3,146
15,185,220,53,167,6,161,7,20,38,17,2,2,0,20,7,48
15,186,202,54,148,9,139,2,26,37,15,2,0,0,14,0,43
15,187,4255,723,3532,64,3468,52,525,1061,275,47,20,5,495,49,939
15,188,872,108,764,15,749,10,151,208,53,10,6,2,113,11,185
15,189,212,24,188,0,188,5,29,49,28,1,1,0,15,3,57
15,190,108,15,93,0,93,1,9,43,10,0,0,0,12,1,17
15,191,605,145,460,9,451,2,81,162,33,3,0,1,52,4,113
15,192,275,50,225,4,221,7,37,58,30,3,3,1,29,7,46
15,194,128,20,108,2,106,2,12,31,20,1,0,2,17,2,19
15,195,225,54,171,3,168,1,31,47,14,1,0,0,25,3,46
15,196,1135,143,992,32,960,10,174,268,65,14,7,2,101,25,294
15,197,79,10,69,5,64,1,7,22,2,1,0,0,19,0,12
15,198,107,20,87,3,84,3,21,35,2,0,2,0,16,0,5
15,199,69,13,56,1,55,0,12,22,3,1,0,0,5,2,10
15,200,147,27,120,1,119,3,31,29,8,4,0,0,18,4,22
15,201,230,42,188,3,185,3,34,91,4,2,1,1,20,3,26
15,202,717,123,594,25,569,8,83,168,35,6,1,0,49,13,206
15,203,155,25,130,1,129,1,17,55,5,2,1,0,19,1,28
15,204,1183,152,1031,26,1005,9,162,201,128,13,5,4,95,18,370
15,205,132,17,115,0,115,3,19,48,6,1,0,2,8,4,24
15,206,157,36,121,4,117,0,20,39,10,2,0,0,21,4,21
15,207,313,46,267,5,262,4,51,79,20,5,0,0,45,5,53
15,208,134,24,110,4,106,4,8,41,10,1,2,0,12,1,27
15,209,125,21,104,2,102,2,8,57,3,0,0,0,15,4,13
15,211,262,51,211,5,206,6,40,58,11,1,1,1,18,2,68
15,212,274,40,234,8,226,2,53,39,20,0,3,2,20,10,77
15,213,243,54,189,3,186,6,37,74,6,2,2,0,19,3,37
15,214,177,17,160,10,150,1,19,33,18,2,1,0,10,2,64
15,215,947,132,815,16,799,15,116,227,79,13,8,2,83,6,250
15,216,364,47,317,4,313,6,50,165,15,6,2,0,38,4,27
15,217,88,12,76,1,75,3,11,30,6,0,0,0,6,2,17
15,218,91,26,65,0,65,2,5,15,11,0,1,1,9,1,20
15,219,299,39,260,10,250,4,20,112,14,3,2,2,27,3,63
15,220,165,29,136,2,134,1,13,47,14,2,1,0,14,3,39
15,221,1040,137,903,13,890,9,164,178,92,10,3,1,75,13,345
15,222,188,20,168,2,166,1,13,68,21,2,2,0,20,3,36
15,223,195,36,159,5,154,2,14,39,23,3,1,1,19,7,45
15,224,117,14,103,2,101,3,9,21,13,6,0,0,8,2,39
15,225,197,32,165,1,164,1,24,66,13,2,1,0,29,2,26
15,226,198,34,164,5,159,1,29,65,12,0,1,0,17,7,27
15,227,134,24,110,5,105,0,12,35,8,2,0,2,18,4,24
15,228,504,83,421,7,414,5,67,121,36,4,1,1,64,11,104
15,229,99,17,82,0,82,1,7,33,3,2,0,0,22,5,9
15,230,182,25,157,5,152,6,24,36,14,6,1,0,10,2,53
15,231,516,93,423,13,410,3,72,135,27,4,3,0,69,2,95
15,232,193,25,168,2,166,2,36,52,13,4,1,1,28,2,27
15,233,183,13,170,8,162,2,32,41,19,3,0,1,10,6,48
15,234,313,60,253,2,251,3,41,83,18,0,0,0,40,2,64
15,235,427,56,371,14,357,4,77,97,24,3,5,1,56,11,79
15,236,580,94,486,13,473,7,79,174,41,6,3,1,52,5,105
15,237,156,23,133,3,130,0,15,50,11,2,1,0,21,3,27
15,238,148,26,122,1,121,1,27,39,5,3,1,0,9,2,34
15,240,179,32,147,4,143,7,23,31,15,2,0,0,27,1,37
15,241,54,11,43,1,42,0,9,12,3,1,0,0,9,1,7
15,242,92,13,79,1,78,3,10,27,3,2,0,0,17,0,16
15,243,516,117,399,10,389,3,79,132,25,4,3,1,37,2,103
15,244,357,43,314,5,309,4,70,86,27,3,3,1,43,3,69
15,245,197,24,173,4,169,6,24,50,10,6,0,1,28,2,42
15,246,236,45,191,2,189,4,42,50,18,2,0,0,23,4,46
15,247,33,6,27,0,27,0,5,15,2,0,0,0,3,0,2
15,248,489,68,421,8,413,5,65,152,38,7,2,2,59,5,78
15,249,85,12,73,0,73,0,10,30,10,2,0,0,10,1,10
15,250,452,107,345,5,340,6,58,67,35,5,1,0,33,12,123
15,251,159,27,132,2,130,0,29,33,14,1,1,1,17,0,34
15,252,304,30,274,6,268,3,46,69,26,1,0,1,24,4,94
15,253,79,20,59,0,59,0,8,11,2,0,0,0,13,0,25
15,254,130,13,117,0,117,0,13,26,16,1,1,1,9,0,50
15,255,932,116,816,16,800,9,144,218,76,9,3,3,80,10,248
15,256,85,26,59,0,59,0,7,24,6,0,0,0,7,0,15
15,257,129,19,110,2,108,1,34,26,5,0,1,1,4,0,36
15,258,1534,221,1313,30,1283,18,213,392,104,14,15,8,108,20,391
15,259,237,31,206,4,202,0,39,59,19,0,1,0,35,4,45
15,260,97,17,80,0,80,1,19,26,5,2,2,0,6,2,17
15,261,816,124,692,18,674,9,86,191,71,9,3,1,85,10,209
15,262,481,68,413,11,402,6,54,109,34,6,3,1,64,11,114
15,263,143,28,115,3,112,1,15,39,9,1,1,2,18,1,25
15,264,261,54,207,6,201,2,34,59,14,4,2,1,25,7,53
15,265,1449,208,1241,35,1206,9,179,249,115,17,11,2,94,25,505
15,266,458,69,389,8,381,5,52,84,38,4,2,0,38,7,151
15,267,3225,412,2813,75,2738,35,379,651,300,33,10,3,277,56,994
15,268,753,121,632,19,613,9,100,157,34,5,2,2,59,14,231
15,269,126,25,101,3,98,0,15,20,5,2,0,0,16,1,39
16,1,381,72,309,10,299,2,63,72,36,6,2,0,25,5,88
16,2,340,51,289,9,280,3,63,40,37,11,0,2,27,2,95
16,3,610,78,532,13,519,4,122,113,57,14,3,0,32,16,158
16,4,231,34,197,4,193,2,33,45,14,3,3,0,18,4,71
16,5,724,117,607,14,593,11,114,204,50,8,1,0,26,16,163
16,7,414,82,332,5,327,5,43,68,51,6,5,1,25,11,112
16,8,269,41,228,8,220,1,48,45,34,3,2,0,22,9,56
16,9,281,34,247,4,243,6,49,41,35,4,2,1,23,3,79
16,10,144,30,114,6,108,4,15,38,5,2,1,0,15,2,26
16,11,395,57,338,5,333,9,67,74,51,8,2,1,23,10,88
16,12,387,56,331,6,325,2,58,86,31,9,2,1,28,13,95
16,13,323,47,276,5,271,6,51,75,30,4,5,0,30,3,67
16,14,93,16,77,2,75,2,27,19,2,0,0,0,2,1,22
16,15,26212,6622,19590,320,19270,554,2520,4813,2264,229,79,44,1631,281,6855
16,16,692,101,591,17,574,14,94,91,73,8,3,2,46,16,227
16,17,144,17,127,3,124,1,15,22,21,3,4,0,4,0,54
16,18,615,101,514,11,503,9,109,148,44,12,2,0,55,8,116
16,19,987,150,837,12,825,11,176,198,64,8,8,4,78,6,272
16,20,172,27,145,2,143,7,25,44,16,2,2,0,10,0,37
16,21,119,24,95,1,94,0,24,36,3,0,0,0,13,3,15
16,23,244,29,215,2,213,6,36,62,15,1,0,2,17,6,68
16,24,376,51,325,6,319,9,67,78,32,5,5,0,28,2,93
16,25,977,164,813,19,794,16,155,220,72,7,3,3,85,19,214
16,26,1027,102,925,18,907,9,136,189,88,5,5,0,88,14,373
16,27,121,12,109,0,109,0,29,12,17,1,2,0,17,7,24
16,28,3287,610,2677,55,2622,49,428,646,252,46,25,5,241,56,874
16,29,207,38,169,3,166,3,35,38,18,1,3,1,15,5,47
16,30,804,171,633,15,618,11,117,142,65,8,3,2,61,22,187
16,31,312,30,282,6,276,3,46,61,53,4,0,1,26,3,79
16,32,373,36,337,9,328,4,59,79,25,1,1,1,41,4,113
16,33,98,19,79,3,76,1,16,18,5,1,0,0,5,1,29
16,34,124,26,98,2,96,1,20,34,4,0,0,0,5,0,32
16,35,223,45,178,1,177,2,34,46,11,2,0,0,31,6,45
16,36,203,34,169,7,162,5,29,36,15,3,2,0,14,5,53
16,37,114,19,95,3,92,1,8,30,10,3,0,0,14,2,24
16,38,277,47,230,6,224,4,33,37,33,3,5,0,19,5,85
16,39,354,48,306,10,296,2,59,67,26,4,2,0,36,3,97
16,40,222,39,183,4,179,4,33,36,18,2,2,0,21,3,60
16,41,104,13,91,2,89,7,22,23,8,0,1,0,5,2,21
16,42,134,19,115,3,112,1,19,25,14,2,0,0,12,2,37
16,43,170,18,152,0,152,3,45,26,22,4,0,0,9,4,39
16,44,173,16,157,1,156,6,30,34,21,1,1,1,19,3,40
16,45,272,27,245,6,239,4,73,53,16,3,1,1,23,3,62
16,46,628,106,522,22,500,12,97,107,64,7,8,4,40,14,147
16,47,184,21,163,6,157,1,32,51,13,1,2,1,21,4,31
16,48,104,18,86,1,85,1,11,13,11,4,0,0,11,0,34
16,49,282,51,231,4,227,8,47,50,18,3,1,0,21,8,71
16,50,197,32,165,1,164,1,31,62,11,1,1,1,19,6,31
16,51,134,17,117,1,116,5,24,18,10,1,0,0,6,2,50
16,52,216,49,167,1,166,6,27,35,17,6,0,0,20,4,51
16,53,115,17,98,1,97,1,16,12,17,2,1,0,9,0,39
16,54,130,21,109,2,107,0,15,31,8,2,1,0,15,5,30
16,55,706,107,599,17,582,9,163,111,70,7,5,0,38,16,163
16,56,616,136,480,8,472,10,73,120,52,9,2,0,63,13,130
16,57,285,52,233,2,231,2,62,95,12,1,1,0,17,3,38
16,58,1078,146,932,13,919,16,141,212,87,13,8,0,93,17,332
16,59,125,22,103,3,100,0,20,20,18,0,1,1,14,0,26
16,60,389,52,337,5,332,9,63,88,23,1,1,4,39,4,100
16,61,2946,448,2498,55,2443,41,438,409,308,30,27,3,186,51,950
16,62,102,20,82,1,81,1,16,18,13,0,1,0,5,1,26
16,63,145,35,110,2,108,4,38,16,8,3,1,0,13,1,24
16,64,735,96,639,15,624,4,129,150,96,8,4,0,53,15,165
16,65,413,72,341,15,326,5,64,69,40,7,1,1,16,5,118
16,66,384,54,330,6,324,8,72,49,59,6,3,0,30,7,90
16,67,351,53,298,3,295,5,58,61,39,8,3,0,21,4,96
16,68,401,72,329,10,319,6,95,67,36,6,2,0,13,6,88
16,69,285,42,243,6,237,2,72,40,30,5,1,0,22,4,61
16,70,1362,266,1096,31,1065,10,158,258,154,12,5,3,69,30,366
16,71,393,63,330,13,317,2,54,53,57,3,4,1,28,7,108
16,72,375,57,318,7,311,6,67,77,40,6,2,1,13,6,93
16,73,1382,327,1055,24,1031,13,202,242,94,14,2,6,74,21,363
16,74,236,40,196,4,192,3,24,36,32,4,0,2,22,5,64
16,75,200,24,176,6,170,4,32,42,22,0,0,0,22,4,44
16,76,758,144,614,16,598,4,120,106,60,11,3,2,51,14,227
16,77,430,62,368,5,363,5,78,89,59,4,1,0,30,11,86
16,78,4282,605,3677,75,3602,62,641,827,426,40,24,4,329,75,1174
16,79,230,50,180,2,178,1,46,42,22,5,1,0,12,3,46
16,81,161,39,122,3,119,1,27,32,17,0,1,0,10,3,28
16,82,274,28,246,11,235,6,46,58,28,2,1,0,29,3,62
16,83,290,44,246,12,234,3,26,80,19,4,2,0,20,2,78
16,84,254,43,211,4,207,9,47,35,27,3,3,0,11,3,69
16,85,2220,399,1821,45,1776,11,282,392,221,26,17,10,152,43,622
16,86,671,101,570,15,555,4,84,72,102,7,4,2,50,13,217
16,87,119,28,91,3,88,2,14,15,13,2,1,1,4,0,36
16,88,876,135,741,15,726,18,115,183,72,11,7,3,61,28,228
16,89,2590,425,2165,53,2112,17,348,538,207,37,13,2,200,35,715
16,90,2448,437,2011,43,1968,20,417,468,182,31,13,6,183,31,617
16,91,148,38,110,2,108,8,21,18,16,7,1,0,14,3,20
16,92,159,45,114,1,113,5,17,17,18,0,2,0,7,4,43
16,93,1187,170,1017,28,989,18,190,213,123,9,6,2,82,16,330
16,94,115,12,103,2,101,0,17,24,14,1,1,0,12,2,30
16,95,123,15,108,3,105,1,21,21,18,1,0,0,10,1,32
16,96,340,93,247,7,240,3,40,62,24,4,0,2,18,5,82
16,97,1934,330,1604,27,1577,28,298,410,159,27,14,4,137,39,461
16,98,122,25,97,1,96,1,27,30,11,2,0,1,7,1,16
16,99,139,19,120,4,116,3,22,22,12,2,3,0,5,1,46
16,100,566,77,489,17,472,3,80,67,89,8,6,2,46,13,158
16,101,686,80,606,14,592,9,124,133,58,10,1,1,43,10,203
16,102,12698,2875,9823,346,9477,206,1350,2628,1063,134,66,21,862,196,2951
16,103,100,15,85,0,85,3,11,16,6,1,3,0,11,3,31
16,104,358,49,309,6,303,3,52,76,59,4,2,0,35,6,66
16,105,460,54,406,14,392,5,96,88,42,4,4,2,39,6,106
16,106,1990,302,1688,28,1660,30,237,364,237,31,17,1,156,41,546
16,107,346,53,293,12,281,7,41,67,55,2,4,0,17,9,79
16,108,124,31,93,7,86,0,22,30,2,1,0,0,6,0,25
16,109,441,72,369,4,365,6,94,61,41,6,1,1,35,9,111
16,110,337,62,275,3,272,4,58,64,26,4,5,1,29,1,80
16,111,164,36,128,1,127,3,27,33,14,2,0,0,12,4,32
16,112,59,14,45,1,44,0,10,5,6,0,0,0,5,3,15
16,113,5124,1116,4008,91,3917,59,742,675,481,67,33,11,353,55,1441
16,114,134,23,111,1,110,1,13,35,10,1,0,0,13,3,34
16,115,133,21,112,0,112,2,23,27,4,7,1,1,13,5,29
16,116,337,100,237,5,232,6,42,84,16,3,2,2,14,4,59
16,117,94,13,81,0,81,2,17,23,8,1,1,0,5,0,24
16,118,103,16,87,3,84,4,9,19,14,7,0,3,4,1,23
16,119,1016,156,860,21,839,23,191,195,99,9,2,0,62,11,247
16,120,1132,170,962,16,946,15,177,199,117,7,4,3,93,15,316
16,121,346,60,286,4,282,7,78,62,29,8,0,1,25,10,62
16,122,127,19,108,6,102,2,16,29,4,1,0,0,13,2,35
16,123,409,50,359,6,353,6,75,115,13,1,2,0,45,1,95
16,124,502,96,406,21,385,8,65,74,56,3,2,1,30,7,139
16,125,207,25,182,4,178,4,50,51,16,1,1,1,17,1,36
16,127,90,15,75,3,72,2,14,13,11,1,0,0,2,2,27
16,128,168,24,144,4,140,0,18,17,39,2,2,1,14,2,45
16,129,181,37,144,6,138,1,33,42,13,3,1,1,17,7,20
16,130,147,20,127,3,124,1,23,38,13,3,2,0,13,0,31
16,131,370,49,321,7,314,10,41,55,57,7,5,0,29,6,104
16,132,800,129,671,13,658,6,123,110,115,21,2,0,63,13,205
16,133,144,37,107,3,104,1,23,32,10,0,0,0,15,3,20
16,134,843,139,704,10,694,9,87,73,124,18,5,3,62,15,298
16,135,255,34,221,6,215,3,28,66,17,6,1,0,12,6,76
16,136,499,51,448,11,437,9,86,95,40,4,3,2,19,19,160
16,137,251,31,220,7,213,10,37,62,11,1,1,1,26,6,58
16,138,2755,374,2381,41,2340,37,407,548,224,28,15,5,216,57,803
16,139,161,29,132,7,125,7,23,42,8,0,2,0,13,2,28
16,140,299,45,254,6,248,4,43,58,37,4,0,1,20,2,79
16,141,261,31,230,7,223,2,44,41,35,2,2,0,25,3,69
16,142,169,16,153,4,149,2,22,21,15,1,1,0,24,5,58
16,143,546,89,457,6,451,8,82,108,65,5,0,1,37,20,125
16,144,328,59,269,7,262,5,39,54,30,6,4,1,27,3,93
16,145,452,51,401,6,395,6,82,109,32,4,2,1,31,11,117
16,146,1460,177,1283,30,1253,24,255,297,123,16,3,4,106,35,390
16,147,211,34,177,1,176,1,61,41,16,2,2,0,12,3,38
16,148,624,96,528,7,521,11,97,134,52,11,8,1,28,9,170
16,149,458,91,367,10,357,2,53,54,74,7,3,0,27,9,128
16,150,1386,182,1204,18,1186,25,229,315,97,19,11,0,107,28,355
16,151,635,35,600,10,590,9,107,135,63,12,7,2,49,10,196
16,152,595,91,504,12,492,4,81,132,54,4,4,1,38,13,161
16,153,364,74,290,4,286,4,66,73,15,4,3,0,28,1,92
16,154,3912,634,3278,64,3214,50,519,689,401,41,16,2,274,63,1159
16,155,125,19,106,2,104,0,20,27,6,1,3,0,10,3,34
16,156,495,82,413,9,404,10,92,60,44,3,4,0,22,15,154
16,157,133,20,113,1,112,0,18,18,19,1,4,1,10,0,41
16,158,228,25,203,6,197,2,42,42,28,2,2,0,16,3,60
16,160,416,61,355,6,349,3,90,112,26,3,5,1,25,13,71
16,161,136,34,102,2,100,1,27,17,11,4,3,1,7,2,27
16,162,130,14,116,0,116,1,18,44,15,3,0,0,9,2,24
16,163,834,162,672,9,663,17,139,188,51,7,3,2,69,18,169
16,164,213,29,184,9,175,2,38,24,31,7,2,1,18,4,48
16,165,268,27,241,3,238,9,48,56,30,3,1,0,30,3,58
16,166,3889,685,3204,51,3153,63,451,709,362,44,11,7,271,65,1170
16,167,3334,722,2612,57,2555,41,348,696,238,42,15,7,213,48,907
16,168,611,77,534,13,521,10,92,93,80,9,0,0,56,19,162
16,169,464,76,388,10,378,4,60,122,54,7,4,1,33,6,87
16,170,330,68,262,10,252,4,43,83,27,4,2,1,24,4,60
16,171,526,109,417,8,409,7,93,105,39,5,8,0,35,12,105
16,172,91,11,80,3,77,2,14,23,8,2,0,0,7,3,18
16,173,166,38,128,11,117,4,19,25,15,3,3,0,8,2,38
16,174,382,67,315,5,310,7,69,83,35,2,2,0,24,14,74
16,175,373,42,331,4,327,3,62,89,30,0,1,0,36,9,97
16,176,251,30,221,1,220,3,30,69,22,7,0,2,26,5,56
16,177,93,17,76,3,73,0,12,33,4,2,0,0,9,0,13
16,178,137,13,124,10,114,2,16,36,12,3,2,1,16,1,25
16,179,175,27,148,3,145,2,37,28,15,2,1,1,21,4,34
16,180,165,17,148,1,147,5,24,38,15,1,0,1,14,6,43
16,181,413,51,362,12,350,4,79,45,58,15,2,2,21,7,117
16,182,355,76,279,1,278,6,55,68,23,5,3,1,23,2,92
16,183,150,33,117,1,116,8,17,28,14,4,0,0,7,2,36
16,184,82,10,72,2,70,1,16,11,10,4,2,0,7,3,16
16,185,148,20,128,4,124,2,18,32,8,0,0,0,10,2,52
16,186,425,75,350,2,348,9,69,138,19,3,1,0,33,9,67
16,187,1627,221,1406,28,1378,25,197,319,117,9,10,3,125,21,552
16,188,246,30,216,5,211,4,42,24,33,11,3,1,18,8,67
16,189,176,20,156,4,152,11,28,35,18,5,4,0,9,1,41
16,190,157,36,121,3,118,5,21,28,17,1,1,0,10,1,34
16,191,135,30,105,4,101,2,17,26,10,3,1,0,16,1,25
16,192,1902,306,1596,39,1557,6,251,268,203,29,21,3,119,21,636
16,193,830,116,714,11,703,8,174,175,71,17,7,3,60,8,180
16,194,107,11,96,0,96,0,17,20,10,0,1,1,12,1,34
16,195,247,56,191,5,186,2,40,16,32,4,1,0,16,5,70
16,196,611,115,496,11,485,1,106,107,52,6,2,0,28,4,179
16,197,89,18,71,2,69,3,10,16,7,2,1,2,11,3,14
16,198,371,43,328,6,322,2,72,85,38,3,1,2,28,11,80
16,199,2630,469,2161,55,2106,44,292,448,262,30,21,5,205,43,756
16,200,398,50,348,8,340,5,70,44,53,14,5,0,13,5,131
16,201,158,34,124,3,121,3,35,29,7,3,0,0,10,3,31
16,202,495,75,420,14,406,8,88,108,33,4,5,4,41,9,106
16,203,85,9,76,1,75,3,23,24,4,0,1,0,2,3,15
16,204,329,81,248,4,244,11,49,66,18,3,3,0,27,10,57
16,205,434,70,364,8,356,6,81,74,41,7,0,1,27,12,107
16,206,1097,163,934,16,918,10,170,228,88,17,5,4,97,16,283
16,207,437,96,341,9,332,11,60,65,39,6,1,1,29,7,113
16,208,318,54,264,8,256,3,63,54,24,6,0,4,8,4,90
16,209,566,51,515,15,500,11,89,85,84,7,9,1,43,12,159
16,210,630,86,544,13,531,18,110,92,67,8,6,0,42,12,176
16,211,437,66,371,11,360,2,66,108,35,4,3,0,24,7,111
16,212,345,55,290,17,273,2,47,93,38,4,2,3,9,5,70
16,213,311,65,246,8,238,6,30,57,31,7,3,1,25,2,76
16,214,72,19,53,0,53,0,7,11,9,0,0,1,9,0,16
16,215,137,26,111,2,109,0,21,26,8,1,1,0,15,3,34
16,216,627,106,521,12,509,14,83,147,42,12,6,0,56,4,145
16,217,846,159,687,12,675,9,127,136,66,12,7,3,71,25,219
16,218,295,34,261,6,255,3,77,52,16,5,3,1,19,11,68
16,220,442,67,375,7,368,4,86,87,29,8,1,2,31,10,110
16,221,217,30,187,5,182,3,40,55,12,3,3,0,10,1,55
16,222,318,86,232,7,225,6,34,74,13,3,1,1,22,7,64
16,223,1732,288,1444,36,1408,20,214,376,128,19,11,4,121,36,479
16,224,464,99,365,5,360,8,58,93,43,4,2,2,35,13,102
16,225,489,86,403,14,389,10,56,89,50,6,1,4,33,7,133
16,226,607,104,503,7,496,8,107,131,55,5,1,2,43,15,129
16,227,118,24,94,4,90,0,14,21,12,5,0,0,6,4,28
16,228,116,18,98,4,94,0,26,17,15,2,1,0,7,1,25
16,229,208,32,176,5,171,3,42,45,15,5,3,1,23,1,33
16,230,776,117,659,9,650,8,103,166,71,7,6,1,58,11,219
16,231,237,37,200,3,197,3,28,32,39,3,1,1,22,7,61
16,232,1722,240,1482,24,1458,23,244,242,266,18,4,4,129,38,490
16,233,393,70,323,5,318,2,78,77,26,6,1,1,33,5,89
16,234,556,76,480,11,469,3,116,119,33,4,1,0,37,8,148
16,236,2027,344,1683,37,1646,44,287,340,174,34,17,4,155,33,558
16,237,226,53,173,8,165,2,26,36,18,2,1,0,25,0,55
16,238,82,9,73,0,73,1,17,15,6,2,0,0,7,3,22
16,239,110,23,87,4,83,0,5,14,22,0,2,0,9,3,28
16,240,71,13,58,0,58,2,9,14,3,0,0,0,12,3,15
16,241,171,18,153,7,146,6,35,19,23,3,4,0,14,3,39
16,242,1082,204,878,16,862,16,187,181,104,10,6,5,69,31,253
16,243,878,171,707,10,697,13,139,184,61,12,3,1,54,10,220
16,244,1900,438,1462,27,1435,21,291,326,126,21,12,1,107,29,501
16,245,788,161,627,17,610,10,125,82,82,16,10,3,43,15,224
16,246,247,57,190,3,187,10,31,41,14,1,2,0,19,8,61
16,247,155,30,125,4,121,3,31,32,4,3,0,0,7,2,39
16,248,174,29,145,8,137,0,25,43,11,2,0,0,22,0,34
16,249,229,52,177,6,171,1,34,30,22,5,1,1,8,7,62
16,250,188,23,165,7,158,1,32,39,21,1,1,1,15,1,46
16,251,198,30,168,6,162,5,35,34,19,2,1,2,9,4,51
16,252,138,22,116,3,113,2,23,24,9,2,2,1,15,1,34
16,253,320,69,251,8,243,3,38,68,21,3,2,0,18,6,84
16,254,212,42,170,7,163,2,40,32,19,6,1,0,11,3,49
16,255,115,23,92,4,88,2,10,25,19,2,0,0,10,2,18
16,256,166,29,137,3,134,2,17,28,15,4,2,0,19,5,42
16,257,294,76,218,8,210,8,32,61,8,1,0,0,26,5,69
16,258,390,76,314,6,308,4,51,67,36,9,0,1,33,9,98
16,259,397,58,339,7,332,1,51,57,58,9,2,0,29,5,120
16,260,209,40,169,6,163,3,41,37,6,4,2,2,19,3,46
16,261,350,49,301,10,291,6,61,70,30,6,2,1,22,4,89
16,262,123,21,102,3,99,1,11,18,12,2,1,0,4,1,49
16,263,285,48,237,6,231,1,40,45,45,2,0,0,23,7,68
16,264,278,40,238,10,228,0,31,60,28,5,0,0,18,12,74
16,267,77,13,64,1,63,0,11,30,6,0,0,0,4,1,11
16,268,153,22,131,1,130,1,19,37,12,3,0,1,9,3,45
16,269,745,117,628,12,616,16,127,120,83,15,2,0,50,10,193
16,270,311,56,255,5,250,5,33,39,43,2,5,1,33,6,83
16,271,2174,301,1873,42,1831,48,207,484,196,19,4,5,199,22,647
16,272,382,48,334,5,329,0,61,99,33,1,1,0,23,7,104
16,273,125,24,101,3,98,2,16,24,8,2,1,1,8,0,36
16,274,310,38,272,7,265,4,58,66,27,4,3,0,19,4,80
16,275,137,24,113,1,112,6,16,26,8,2,2,1,7,0,44
16,276,517,78,439,8,431,4,76,113,45,14,3,0,53,6,117
16,277,425,65,360,9,351,12,80,79,28,8,2,2,25,3,112
16,279,197,29,168,1,167,5,23,47,14,0,1,0,12,4,61
16,280,1382,210,1172,21,1151,16,197,221,132,23,12,2,71,27,450
16,281,2361,478,1883,49,1834,34,257,523,180,24,12,8,145,39,612
16,282,388,66,322,10,312,5,64,68,35,6,0,2,26,6,100
16,283,435,54,381,9,372,4,76,86,38,7,6,1,33,5,116
16,284,99,9,90,1,89,4,20,17,8,3,0,0,9,6,22
16,285,350,58,292,5,287,3,46,71,35,7,2,1,14,3,105
16,286,1337,268,1069,17,1052,14,220,238,105,7,6,6,98,25,333
16,287,2963,423,2540,58,2482,31,524,550,257,38,7,5,255,40,775
16,289,237,60,177,7,170,0,37,46,21,0,2,0,16,6,42
16,290,187,34,153,7,146,4,11,38,16,2,1,0,12,4,58
16,291,5486,1066,4420,101,4319,78,670,775,619,49,35,11,364,72,1646
16,292,2476,570,1906,47,1859,24,291,435,231,16,13,8,131,35,675
16,293,316,50,266,8,258,2,60,49,27,3,2,0,10,7,98
16,294,548,92,456,8,448,6,63,96,59,3,7,1,41,11,161
16,295,992,172,820,18,802,13,166,172,109,10,9,1,56,14,252
16,296,257,50,207,1,206,2,39,50,21,2,1,0,25,6,60
16,297,282,47,235,4,231,4,39,63,18,1,1,1,29,9,66
16,298,343,47,296,3,293,5,55,83,32,7,3,0,31,3,74
16,300,481,84,397,15,382,7,72,86,27,6,3,1,30,9,141
16,301,188,24,164,6,158,5,22,40,10,0,2,0,36,4,39
16,302,148,32,116,2,114,2,21,34,10,1,0,0,9,2,35
16,303,280,54,226,7,219,3,51,60,19,2,4,1,23,4,52
16,304,826,113,713,13,700,28,111,234,45,6,2,1,75,16,182
16,306,260,44,216,4,212,8,44,34,31,5,3,1,16,8,62
16,307,226,29,197,1,196,3,34,53,21,5,3,1,13,4,59
16,308,751,133,618,15,603,6,119,152,55,9,4,0,46,12,200
16,309,139,21,118,7,111,1,17,23,25,1,1,0,11,5,27
16,310,201,30,171,2,169,2,48,29,17,5,0,1,17,6,44
16,312,636,88,548,7,541,10,121,125,46,9,0,4,43,16,167
16,314,144,25,119,1,118,3,26,20,16,2,2,0,9,0,40
16,315,112,24,88,0,88,1,12,29,9,2,1,0,8,2,24
16,316,294,40,254,8,246,3,55,74,23,3,3,1,22,13,49
16,317,385,56,329,9,320,2,83,65,33,4,1,0,13,3,116
16,318,223,47,176,8,168,2,40,32,19,4,2,0,17,2,50
16,320,610,104,506,9,497,4,112,120,42,6,3,0,57,7,146
16,321,41,5,36,1,35,0,4,13,4,1,0,0,6,1,6
16,322,76,13,63,0,63,1,6,16,8,1,0,0,11,0,20
16,323,394,33,361,10,351,8,76,65,53,9,2,1,27,8,102
16,325,102,21,81,2,79,1,18,11,12,1,0,1,7,0,28
16,326,110,11,99,3,96,0,14,34,9,1,1,0,6,1,30
16,328,255,48,207,4,203,7,41,53,9,2,3,1,22,13,52
16,329,611,141,470,10,460,15,81,68,54,7,5,1,36,7,186
16,330,709,87,622,10,612,14,119,127,87,6,3,2,46,29,179
16,331,77,10,67,0,67,6,12,18,6,0,0,1,11,2,11
16,332,115,21,94,6,88,0,14,25,10,2,1,0,9,1,26
16,334,115,19,96,4,92,3,19,26,4,2,1,0,15,1,21
16,335,111,17,94,3,91,0,25,19,6,3,0,2,13,4,19
16,336,295,46,249,4,245,5,48,61,29,0,6,0,9,4,83
16,337,718,101,617,15,602,7,90,102,136,11,6,3,36,16,195
16,338,220,27,193,2,191,0,49,48,16,0,0,0,22,2,54
16,339,230,38,192,5,187,3,41,45,17,0,2,1,13,5,60
16,340,818,139,679,5,674,9,128,153,75,20,4,3,63,15,204
16,341,2238,511,1727,35,1692,30,288,295,205,17,13,10,117,29,688
16,342,229,40,189,7,182,0,32,76,18,2,1,0,21,3,29
16,343,222,41,181,3,178,1,27,57,16,4,3,0,11,6,53
16,344,787,95,692,16,676,7,126,178,55,14,5,2,65,13,211
16,345,171,21,150,2,148,1,26,25,23,1,1,1,23,5,42
16,346,232,42,190,4,186,6,49,38,22,6,1,1,16,3,44
16,347,353,72,281,8,273,5,55,68,26,3,4,0,28,5,79
16,348,1086,154,932,15,917,15,177,183,91,13,6,1,90,19,322
16,349,430,72,358,2,356,1,100,64,32,7,4,1,30,7,110
16,350,658,105,553,14,539,3,119,104,66,6,6,1,33,9,192
16,351,445,64,381,7,374,13,71,90,45,5,3,2,31,10,104
16,352,180,27,153,7,146,2,26,35,18,3,1,0,10,6,45
16,353,630,76,554,12,542,13,114,92,62,6,11,1,35,21,187
16,354,94,21,73,2,71,6,4,14,9,0,0,0,8,4,26
16,355,909,128,781,14,767,14,177,179,81,11,5,5,66,12,217
16,356,30,1,29,0,29,1,6,3,8,0,0,0,0,0,11
16,357,130,34,96,4,92,0,26,28,9,0,2,0,5,1,21
16,358,5245,762,4483,68,4415,103,715,978,453,64,21,7,478,77,1519
16,359,856,152,704,11,693,9,149,187,73,21,6,2,77,9,160
16,360,369,60,309,6,303,6,58,84,26,6,2,0,23,8,90
16,361,276,44,232,6,226,3,49,40,29,2,2,0,25,7,69
16,362,291,67,224,12,212,11,41,58,16,5,3,0,19,3,56
16,363,337,35,302,5,297,5,45,76,51,5,2,1,22,8,82
16,364,55,6,49,0,49,0,14,15,4,0,2,0,3,3,8
16,365,84,14,70,2,68,2,28,12,6,0,0,0,7,1,12
16,366,1682,363,1319,26,1293,19,238,388,114,24,8,3,181,28,290
16,368,628,93,535,14,521,12,107,109,60,5,2,2,43,11,170
16,369,785,126,659,13,646,5,129,157,48,7,1,0,54,10,235
16,370,977,183,794,13,781,9,165,138,100,13,9,2,67,16,262
16,371,174,21,153,4,149,2,38,38,11,4,1,1,19,7,28
16,372,126,15,111,2,109,3,35,18,5,1,0,0,13,3,31
16,373,177,28,149,3,146,1,21,31,13,0,2,0,9,2,67
16,374,6437,1462,4975,92,4883,100,802,1030,562,58,16,10,406,85,1814
16,375,266,43,223,3,220,1,35,39,31,5,2,2,22,3,80
16,376,212,40,172,6,166,3,23,42,21,3,0,2,14,1,57
16,377,83,14,69,4,65,3,20,8,7,0,3,0,3,1,20
16,378,458,59,399,11,388,5,58,69,52,8,3,3,54,12,124
16,379,1143,149,994,18,976,9,202,163,123,24,18,1,71,24,341
16,380,292,52,240,9,231,5,46,37,34,7,5,0,15,2,80
16,381,127,23,104,5,99,4,19,16,6,3,1,2,14,5,29
16,382,637,91,546,8,538,11,99,123,80,8,3,0,45,10,159
16,383,583,99,484,8,476,3,122,105,54,7,2,1,19,18,145
16,384,494,100,394,5,389,7,71,83,36,12,6,0,32,10,132
16,385,938,126,812,9,803,16,144,152,85,13,4,2,69,22,296
16,386,330,50,280,10,270,4,68,93,13,0,1,1,26,6,58
16,387,326,41,285,7,278,3,55,80,15,1,0,1,19,7,97
16,388,635,89,546,8,538,7,114,115,56,8,1,2,55,6,174
16,389,79,21,58,2,56,0,7,5,6,2,1,0,7,3,25
16,390,229,25,204,7,197,5,31,54,17,6,0,0,8,2,74
16,391,124,17,107,7,100,0,19,22,15,1,0,0,11,2,30
16,392,169,24,145,2,143,0,33,25,27,1,2,0,11,2,42
16,393,1528,223,1305,30,1275,23,292,272,130,18,7,2,103,35,393
16,394,78,14,64,1,63,1,13,26,8,0,1,0,5,1,8
16,395,245,28,217,2,215,2,29,52,25,2,3,0,25,9,68
16,396,81,13,68,1,67,2,13,15,9,0,0,0,6,0,22
16,397,329,55,274,6,268,4,50,69,31,1,1,0,20,2,90
16,398,68,3,65,0,65,2,10,18,18,0,0,0,2,2,13
16,399,278,47,231,3,228,2,39,87,12,3,0,0,37,12,36
16,400,468,59,409,15,394,2,56,101,51,6,0,2,38,6,132
16,401,113,17,96,1,95,2,26,21,9,2,0,1,7,1,26
16,402,222,37,185,8,177,2,41,38,11,3,4,0,15,5,58
16,403,91,20,71,5,66,2,11,15,8,1,1,0,5,1,22
16,404,86,14,72,3,69,1,7,17,8,3,0,0,5,3,25
16,405,150,36,114,1,113,0,29,36,4,1,3,1,8,4,27
16,406,282,37,245,5,240,6,57,37,30,2,3,1,25,1,78
16,408,488,72,416,10,406,10,72,105,50,2,2,1,34,6,124
16,409,751,118,633,25,608,13,89,148,77,3,5,0,56,9,208
16,410,210,31,179,7,172,2,36,32,20,3,3,4,14,7,51
16,411,458,79,379,3,376,5,69,103,37,6,3,0,21,8,124
16,412,278,57,221,4,217,9,54,34,21,7,2,0,21,10,59
16,413,96,19,77,3,74,1,16,13,9,0,1,0,4,0,30
16,414,322,55,267,10,257,2,57,31,28,6,1,1,18,5,108
16,415,772,89,683,7,676,16,120,135,69,18,3,3,63,11,238
16,416,409,60,349,7,342,9,58,68,58,2,2,3,24,10,108
16,417,115,20,95,1,94,2,25,27,13,1,0,0,8,0,18
16,418,1362,192,1170,10,1160,25,198,230,128,15,5,1,111,16,431
16,419,284,34,250,2,248,6,50,75,20,2,2,0,24,1,68
16,420,246,38,208,7,201,9,40,48,13,3,1,1,17,9,60
16,421,323,41,282,6,276,3,67,62,34,5,1,1,18,5,80
16,422,497,74,423,7,416,10,90,68,52,10,5,1,29,9,142
16,423,250,46,204,5,199,5,51,56,17,2,3,1,14,6,44
16,424,371,78,293,9,284,6,66,67,28,3,5,1,20,7,81
16,425,437,82,355,6,349,3,59,69,47,5,3,4,34,7,118
17,2,99,19,80,2,78,1,16,22,14,0,0,1,4,2,18
17,3,2755,496,2259,44,2215,28,357,510,270,32,15,1,209,49,744
17,4,228,30,198,1,197,7,23,82,23,3,0,0,18,5,36
17,5,155,30,125,5,120,0,24,33,10,0,1,0,21,3,28
17,6,207,34,173,1,172,2,46,64,4,4,2,0,16,4,30
17,7,243,36,207,4,203,5,43,50,28,5,2,0,18,1,51
17,8,1374,180,1194,23,1171,13,186,279,144,24,5,2,109,30,379
17,9,568,88,480,9,471,9,99,109,47,5,3,0,40,13,146
17,10,3028,494,2534,39,2495,68,296,692,301,24,15,6,240,43,810
17,11,256,33,223,6,217,3,35,52,27,8,2,2,19,13,56
17,12,134,23,111,3,108,2,15,32,15,2,0,1,15,6,20
17,13,270,34,236,9,227,2,41,59,20,4,4,1,23,4,69
17,15,559,102,457,12,445,13,107,119,47,5,3,0,43,15,93
17,16,617,155,462,8,454,9,99,129,30,11,2,4,40,10,120
17,17,465,86,379,5,374,9,99,103,36,6,2,1,37,8,73
17,18,570,91,479,2,477,8,113,112,58,10,4,1,35,11,125
17,19,1110,164,946,14,932,28,121,383,75,11,4,2,108,14,186
17,20,259,46,213,7,206,0,32,62,31,4,1,0,25,4,47
17,21,2552,449,2103,37,2066,43,536,637,168,23,12,8,145,39,455
17,22,775,151,624,23,601,14,144,147,53,8,5,1,56,20,153
17,23,255,43,212,1,211,5,63,54,14,4,0,0,22,3,46
17,24,1144,216,928,22,906,8,198,264,64,12,14,6,69,28,243
17,25,524,106,418,7,411,3,90,101,34,4,1,3,40,8,127
17,26,341,55,286,8,278,4,59,88,24,2,0,0,18,6,77
17,27,400,53,347,11,336,8,64,73,38,7,4,0,27,6,109
17,28,6205,1175,5030,92,4938,115,648,1130,695,60,27,14,414,86,1749
17,29,153,24,129,0,129,3,19,28,10,3,1,0,10,5,50
17,30,396,62,334,5,329,5,64,105,29,4,1,3,41,7,70
17,31,172,34,138,1,137,4,30,20,20,2,1,1,12,0,47
17,32,467,69,398,6,392,7,84,92,52,7,3,0,35,7,105
17,33,357,62,295,7,288,3,101,53,22,2,1,0,14,4,88
17,34,347,66,281,7,274,6,65,83,31,6,1,2,23,3,54
17,35,109,17,92,2,90,0,24,24,9,4,0,0,3,2,24
17,36,496,56,440,11,429,9,115,110,40,9,3,0,39,15,89
17,37,484,87,397,11,386,4,90,85,38,11,5,1,30,11,111
17,38,360,53,307,6,301,9,84,50,42,9,4,1,26,5,71
17,39,148,24,124,6,118,0,36,29,5,0,2,0,13,10,23
17,40,318,46,272,5,267,1,73,71,33,3,2,0,20,6,58
17,41,716,92,624,8,616,15,112,150,97,8,5,0,57,19,153
17,42,307,56,251,3,248,4,53,56,18,3,2,1,29,5,77
17,43,564,90,474,12,462,5,119,108,50,9,2,4,22,13,130
17,44,770,128,642,18,624,9,156,137,84,19,3,1,42,9,164
17,45,741,131,610,16,594,6,191,136,31,14,9,4,50,13,140
17,46,348,72,276,8,268,13,53,73,34,3,2,2,24,8,56
17,47,195,35,160,9,151,0,45,51,11,2,0,0,10,4,28
17,48,261,36,225,8,217,4,35,71,20,6,2,0,20,4,55
17,49,73,17,56,1,55,0,3,24,5,1,0,0,7,4,11
17,50,346,59,287,5,282,3,77,74,31,2,3,1,32,6,53
17,51,2166,309,1857,28,1829,53,225,752,133,15,13,4,156,42,436
17,52,544,91,453,11,442,6,112,96,56,4,9,1,41,11,106
17,53,922,149,773,11,762,14,195,201,76,13,11,4,67,13,168
17,54,174,30,144,5,139,2,25,21,30,6,3,1,9,3,39
17,55,171,31,140,3,137,4,36,25,9,1,1,1,13,0,47
17,56,378,44,334,8,326,4,87,83,23,7,2,0,29,8,83
17,57,456,63,393,4,389,6,68,80,63,7,4,0,47,2,112
17,58,2701,512,2189,53,2136,39,486,707,215,37,19,3,158,38,434
17,59,838,112,726,19,707,17,95,182,65,13,4,0,80,16,235
17,60,178,41,137,5,132,2,33,44,2,1,0,0,16,3,31
17,61,115,21,94,4,90,0,20,14,12,1,0,0,9,3,31
17,62,204,32,172,2,170,3,34,27,25,2,3,1,16,6,53
17,63,305,45,260,4,256,7,51,57,32,6,0,2,35,4,62
17,64,2268,363,1905,44,1861,34,323,672,129,18,7,9,180,48,441
17,65,1238,115,1123,26,1097,29,170,288,117,15,2,2,118,30,326
17,66,215,31,184,1,183,5,36,68,16,3,1,1,19,5,29
17,67,161,27,134,3,131,2,26,39,18,1,2,0,12,2,29
17,68,221,41,180,8,172,5,26,62,10,2,1,0,13,3,50
17,69,183,37,146,2,144,5,38,37,10,3,3,1,20,4,23
17,70,650,131,519,16,503,8,119,126,39,8,5,1,52,6,139
17,71,370,71,299,9,290,6,59,96,41,1,4,0,21,11,51
17,72,936,165,771,12,759,11,151,215,71,11,6,1,73,11,209
17,73,985,116,869,23,846,10,161,202,126,12,8,1,72,21,233
17,74,708,102,606,15,591,9,162,120,72,18,1,1,48,8,152
17,75,920,128,792,14,778,6,211,186,73,12,13,2,55,14,206
17,76,258,57,201,3,198,5,37,45,22,4,2,0,20,7,56
17,77,983,183,800,21,779,12,204,210,70,8,5,2,58,11,199
17,78,333,45,288,0,288,2,81,88,28,3,1,2,18,9,56
17,79,1023,135,888,18,870,21,179,273,92,9,5,4,91,16,180
17,80,614,98,516,10,506,18,107,119,67,2,4,0,48,11,130
17,81,296,52,244,7,237,3,58,43,21,3,3,0,20,6,80
17,82,420,69,351,19,332,7,55,107,28,2,2,2,44,8,77
17,83,476,95,381,2,379,8,87,123,42,8,0,2,31,4,74
17,84,423,73,350,4,346,4,75,96,38,11,1,0,41,10,70
17,85,283,40,243,2,241,5,44,61,35,6,1,0,27,2,60
17,86,2895,368,2527,59,2468,26,482,674,290,35,16,5,240,71,629
17,87,123,19,104,0,104,0,17,38,9,1,1,1,6,2,29
17,89,644,102,542,11,531,19,73,118,80,14,2,1,55,10,159
17,91,1454,326,1128,23,1105,21,287,260,101,13,5,2,97,30,289
17,92,134,19,115,3,112,0,31,31,10,0,1,1,8,1,29
17,93,3362,697,2665,36,2629,61,441,906,308,40,11,5,201,45,611
17,94,4941,866,4075,60,4015,100,475,1368,355,37,16,9,408,85,1162
17,95,170,26,144,0,144,3,29,35,15,3,0,0,12,0,47
17,96,67,9,58,2,56,2,14,12,7,0,0,0,11,0,10
17,97,552,70,482,15,467,6,97,165,47,8,3,0,36,12,93
17,98,471,56,415,9,406,3,99,139,30,4,2,0,37,11,81
17,99,537,71,466,6,460,4,87,109,41,8,3,0,37,12,159
17,100,877,136,741,16,725,14,103,200,56,8,5,1,89,15,234
17,101,256,58,198,1,197,3,38,47,20,7,0,0,13,7,62
17,102,941,113,828,22,806,9,146,195,87,12,8,4,93,11,241
17,103,105,15,90,2,88,2,15,17,13,1,1,0,8,0,31
17,104,757,129,628,8,620,8,112,153,64,14,7,1,60,18,183
17,105,312,59,253,8,245,4,37,71,21,3,1,0,16,6,86
17,106,199,35,164,7,157,2,42,49,10,7,1,0,6,1,39
17,107,760,108,652,11,641,13,149,159,75,15,6,2,55,14,153
17,108,293,29,264,6,258,2,51,55,25,6,1,1,25,2,90
17,109,801,116,685,12,673,20,99,182,75,6,2,0,59,11,219
17,110,770,136,634,12,622,10,112,112,87,9,4,0,54,17,217
17,111,633,96,537,8,529,8,117,146,43,4,3,0,43,9,156
17,112,409,50,359,7,352,8,70,122,22,4,5,0,33,7,81
17,113,485,68,417,4,413,6,137,99,40,10,4,0,20,13,84
17,114,159,21,138,1,137,0,20,40,14,1,1,1,13,2,45
17,115,261,37,224,8,216,7,38,46,33,4,2,1,12,3,70
17,116,212,41,171,5,166,10,36,46,13,3,0,1,13,7,37
17,117,114,26,88,3,85,1,11,19,14,1,0,1,8,2,28
17,118,273,35,238,4,234,4,57,42,26,5,5,0,26,4,65
17,119,763,113,650,10,640,19,162,173,49,16,4,0,46,15,156
17,120,1187,178,1009,27,982,21,210,241,90,15,3,3,105,32,262
17,121,1245,189,1056,20,1036,25,91,520,80,14,5,4,76,16,205
17,122,195,32,163,2,161,2,37,55,14,4,2,0,16,1,30
17,124,248,65,183,3,180,2,41,42,20,6,2,1,18,7,41
17,125,354,41,313,8,305,3,49,65,42,6,6,0,22,9,103
17,126,225,26,199,7,192,2,49,36,23,0,1,1,16,6,58
17,127,1057,167,890,11,879,27,173,221,92,11,3,1,94,16,241
17,128,544,79,465,19,446,9,92,102,50,6,0,2,43,23,119
17,129,337,50,287,3,284,5,96,83,12,5,2,2,24,3,52
17,130,370,56,314,9,305,2,75,54,27,4,4,0,33,6,100
17,131,1543,213,1330,30,1300,24,303,421,81,15,18,1,114,43,280
17,132,457,72,385,12,373,6,85,72,39,6,2,2,27,15,119
17,133,479,89,390,15,375,7,80,111,32,6,2,0,41,14,82
17,134,308,45,263,8,255,10,44,64,29,15,0,1,15,8,69
17,135,194,34,160,1,159,4,29,33,17,5,3,0,13,4,51
17,136,826,126,700,10,690,17,122,176,92,6,6,0,58,14,199
17,137,171,25,146,0,146,0,24,17,19,3,0,0,10,1,72
17,138,225,31,194,5,189,5,26,65,18,3,2,3,18,2,47
17,139,275,41,234,7,227,4,31,83,31,3,1,1,19,5,49
17,140,2675,464,2211,54,2157,42,449,768,219,22,10,3,142,32,470
17,141,358,45,313,10,303,2,51,79,47,7,3,0,31,6,77
17,142,4013,632,3381,62,3319,76,402,957,355,42,11,5,368,54,1049
17,143,525,79,446,7,439,8,89,79,61,12,2,3,43,7,135
17,145,365,60,305,4,301,12,61,88,18,2,0,0,39,7,74
17,146,2628,393,2235,52,2183,37,457,594,212,31,14,7,192,50,589
17,147,802,122,680,7,673,16,157,126,83,11,3,0,61,14,202
17,148,352,50,302,8,294,4,43,65,47,4,0,2,40,14,75
17,149,50,13,37,0,37,0,8,7,0,2,0,0,1,0,19
17,150,425,72,353,13,340,7,84,82,24,4,3,1,30,8,97
17,151,786,162,624,23,601,8,139,189,58,4,1,0,33,15,154
17,152,623,126,497,12,485,10,133,163,25,9,3,1,43,12,86
17,153,1594,291,1303,23,1280,21,228,251,157,17,5,2,119,43,437
17,154,470,82,388,11,377,7,74,97,55,7,1,4,38,10,84
17,155,1762,335,1427,26,1401,20,303,433,132,16,7,7,133,40,310
17,156,95,14,81,2,79,1,17,18,8,2,2,0,7,2,22
17,157,126,22,104,2,102,2,25,19,11,4,0,0,16,0,25
17,158,507,60,447,14,433,9,95,83,66,7,2,2,35,7,127
17,159,297,50,247,9,238,4,60,49,33,3,3,0,27,1,58
17,160,253,45,208,9,199,6,44,65,13,0,1,0,18,6,46
17,161,2525,341,2184,42,2142,45,325,885,176,18,10,5,163,28,487
17,162,156,45,111,2,109,1,15,42,9,2,2,1,6,4,27
17,163,376,49,327,8,319,8,75,67,42,7,2,0,43,6,69
17,164,1892,243,1649,26,1623,36,240,401,196,14,3,5,167,25,536
17,165,309,46,263,6,257,2,68,91,15,3,1,0,16,4,57
17,166,891,152,739,22,717,8,186,142,92,16,7,0,51,18,197
17,167,527,97,430,10,420,3,136,93,45,5,0,1,22,11,104
17,168,3677,625,3052,44,3008,62,417,1062,217,20,9,10,303,59,849
17,169,46,2,44,0,44,0,2,6,7,2,0,0,4,1,22
17,171,504,69,435,10,425,12,77,105,23,9,4,2,48,21,124
17,172,1921,328,1593,35,1558,27,322,485,131,20,13,1,129,48,382
17,173,213,27,186,2,184,12,57,39,13,1,0,0,22,6,34
17,174,597,118,479,12,467,6,100,147,48,1,3,3,42,14,103
17,175,426,64,362,5,357,3,98,80,30,10,3,1,40,6,86
17,176,78,19,59,0,59,2,11,22,1,1,1,0,13,2,6
17,177,93,16,77,3,74,0,13,19,3,2,0,0,13,2,22
17,178,63,15,48,1,47,0,11,12,3,1,1,0,9,1,9
17,179,1184,175,1009,29,980,18,184,276,127,9,7,2,103,20,234
17,180,85,11,74,1,73,3,24,6,4,2,1,0,3,4,26
17,181,228,23,205,4,201,8,45,41,22,3,3,0,16,3,60
17,182,374,61,313,6,307,7,77,56,26,1,2,0,32,8,98
17,183,623,84,539,13,526,10,135,188,46,13,4,2,47,9,72
17,184,412,78,334,8,326,7,72,85,38,12,3,1,32,5,71
17,185,1329,215,1114,32,1082,17,271,314,117,21,10,2,78,20,232
17,186,481,68,413,6,407,10,70,109,44,7,2,0,56,9,100
17,187,341,51,290,16,274,2,64,80,21,3,0,2,19,7,76
17,188,331,36,295,3,292,4,40,61,26,1,1,2,29,8,120
17,189,530,97,433,9,424,8,93,137,37,4,4,1,41,5,94
17,190,2017,271,1746,13,1733,42,182,491,168,16,6,5,184,27,612
17,191,273,41,232,6,226,3,51,44,21,6,5,1,18,5,72
17,192,617,94,523,18,505,7,87,120,60,8,6,1,61,15,140
17,193,1757,264,1493,27,1466,39,211,357,170,20,8,0,143,39,479
17,194,2397,434,1963,34,1929,40,270,442,259,37,8,6,176,38,653
17,195,244,48,196,2,194,6,35,41,24,2,5,0,17,6,58
17,196,361,67,294,6,288,7,60,95,25,4,2,1,26,6,62
17,197,2701,678,2023,41,1982,38,257,547,171,27,7,6,233,35,661
17,198,197,22,175,5,170,7,28,45,28,5,0,1,10,6,40
17,199,92,11,81,1,80,0,22,18,5,0,0,0,5,0,30
17,200,5781,970,4811,82,4729,137,538,1540,426,24,15,9,470,78,1492
17,201,272,27,245,11,234,13,47,74,15,2,0,2,23,4,54
17,202,421,48,373,8,365,11,60,91,48,11,5,1,26,18,94
17,203,483,65,418,11,407,13,82,82,52,5,1,1,41,6,124
17,204,241,37,204,6,198,7,46,62,16,2,0,0,8,5,52
17,205,277,37,240,5,235,6,50,61,29,1,0,2,19,3,64
17,206,249,61,188,5,183,2,31,40,16,10,3,1,17,12,51
17,207,682,87,595,2,593,15,75,289,36,4,2,0,41,7,124
17,208,563,59,504,9,495,9,90,115,60,7,1,0,52,25,136
17,209,195,17,178,9,169,1,36,53,10,4,2,0,18,3,42
17,210,411,80,331,7,324,2,83,115,24,5,2,2,27,4,60
17,211,592,114,478,11,467,6,86,94,58,11,8,1,40,11,152
17,212,127,19,108,1,107,1,20,28,21,0,0,0,11,3,23
17,213,130,25,105,0,105,1,31,32,6,0,0,0,8,5,22
17,214,324,48,276,11,265,7,66,58,24,4,6,1,20,9,70
17,215,42,5,37,0,37,1,11,12,5,0,0,0,5,0,3
17,216,674,97,577,8,569,13,129,126,67,16,7,1,33,8,169
17,217,209,49,160,0,160,4,29,44,18,0,1,0,14,4,46
17,218,3494,720,2774,71,2703,49,520,704,261,45,18,9,263,62,772
17,219,4327,937,3390,50,3340,55,702,1006,306,45,22,15,261,91,837
17,220,308,58,250,14,236,2,41,65,26,8,1,3,23,5,62
17,221,612,116,496,11,485,10,82,116,46,9,6,4,53,17,142
17,222,2145,324,1821,42,1779,45,230,545,167,24,7,5,199,31,526
17,223,164,30,134,3,131,3,18,25,22,2,1,0,5,1,54
17,224,1681,327,1354,40,1314,19,234,365,109,27,7,1,131,18,403
17,225,1599,290,1309,19,1290,24,257,494,93,9,6,1,108,23,275
17,226,712,116,596,18,578,7,109,139,69,11,8,0,49,12,174
17,227,190,48,142,3,139,5,36,41,8,3,1,0,11,6,28
17,228,2158,338,1820,40,1780,24,374,563,128,25,4,4,174,47,437
17,229,175,44,131,3,128,3,30,26,16,0,1,0,13,2,37
17,230,2658,452,2206,52,2154,43,432,774,141,27,12,5,180,49,491
17,231,83,10,73,2,71,3,10,13,8,2,2,1,6,2,24
17,232,1039,195,844,30,814,14,200,256,67,10,6,2,65,25,169
17,233,257,43,214,8,206,5,35,67,19,6,3,0,27,2,42
17,234,279,47,232,11,221,6,39,58,25,0,5,3,15,6,64
17,235,482,58,424,9,415,1,74,132,44,4,3,0,37,16,104
17,236,1070,198,872,20,852,17,235,198,70,18,4,0,78,19,213
17,237,397,64,333,10,323,4,82,99,36,10,3,1,26,1,61
17,238,138,27,111,3,108,1,35,24,8,1,0,0,8,3,28
17,239,339,45,294,5,289,5,68,96,16,5,2,0,25,4,68
17,240,2271,419,1852,27,1825,31,275,479,191,34,6,3,147,42,617
17,241,1122,212,910,18,892,13,187,257,75,15,10,0,75,25,235
17,242,602,87,515,11,504,6,85,162,48,12,1,3,61,16,110
17,243,899,164,735,16,719,15,153,162,66,11,4,1,71,18,218
17,244,488,82,406,8,398,4,75,123,36,6,2,3,46,6,97
17,245,545,105,440,11,429,13,52,91,50,5,1,3,56,15,143
17,246,337,61,276,8,268,13,82,67,21,5,3,0,27,2,48
17,247,636,93,543,8,535,15,89,173,55,9,1,1,50,13,129
17,248,845,187,658,21,637,19,120,198,61,4,5,1,54,15,160
17,249,144,22,122,4,118,1,21,53,9,1,0,0,14,2,17
17,250,385,84,301,5,296,3,68,74,35,1,1,0,19,9,86
17,252,235,32,203,7,196,4,42,53,20,0,0,1,21,7,48
17,253,822,151,671,23,648,9,182,148,60,10,6,4,60,15,154
17,254,165,24,141,8,133,6,25,37,13,3,3,0,5,3,38
17,255,483,67,416,4,412,2,102,110,39,8,3,2,31,12,103
17,256,242,44,198,5,193,10,46,37,22,3,0,0,17,3,55
17,257,577,130,447,10,437,4,94,110,39,12,4,0,36,7,131
17,258,249,56,193,5,188,3,33,49,9,3,2,0,23,3,63
17,259,133,22,111,3,108,1,24,34,8,2,0,1,13,4,21
17,260,329,53,276,8,268,12,62,40,35,3,5,3,26,8,74
17,261,300,51,249,4,245,2,74,44,20,2,2,0,26,5,70
17,262,872,110,762,14,748,19,174,203,75,9,8,0,70,20,170
17,263,459,99,360,2,358,2,88,69,39,5,2,1,34,8,110
17,264,4787,725,4062,73,3989,107,491,994,476,59,19,6,404,79,1354
17,265,785,126,659,15,644,7,175,155,70,8,8,2,54,20,145
17,266,496,114,382,4,378,9,92,105,29,6,4,1,29,9,94
17,267,692,83,609,10,599,14,134,147,59,7,3,1,55,18,161
17,268,182,29,153,3,150,3,23,44,9,0,2,2,19,4,44
17,269,549,84,465,16,449,9,106,117,39,3,4,1,54,10,106
17,270,442,72,370,7,363,6,64,98,29,1,6,0,31,11,117
17,271,259,42,217,7,210,2,61,32,20,3,6,2,11,2,71
17,272,290,40,250,4,246,5,50,36,51,2,2,0,23,5,72
17,273,732,122,610,19,591,6,111,181,62,11,7,0,52,14,147
17,274,5538,849,4689,91,4598,133,465,1254,535,47,15,9,498,69,1573
17,275,665,86,579,12,567,12,112,133,58,11,2,4,45,12,178
17,276,65,19,46,3,43,0,9,11,2,2,0,0,2,0,17
17,277,571,90,481,9,472,12,123,117,31,6,6,1,43,8,125
17,278,433,60,373,8,365,4,77,101,37,8,4,0,27,10,97
17,279,440,76,364,11,353,5,98,102,19,5,4,3,27,8,82
17,280,512,51,461,12,449,11,105,120,60,2,4,1,40,7,99
17,281,126,20,106,1,105,2,15,22,10,1,1,0,10,2,42
17,282,164,27,137,3,134,4,26,45,10,2,1,0,14,3,29
17,283,3214,712,2502,62,2440,32,491,624,265,45,10,7,216,64,686
17,284,1309,191,1118,29,1089,26,232,373,64,19,10,5,107,27,226
17,285,863,103,760,15,745,27,134,181,83,9,3,3,68,11,226
17,286,743,108,635,14,621,10,58,347,37,6,3,0,41,15,104
17,287,195,32,163,4,159,2,29,31,19,1,2,0,14,7,54
17,288,210,31,179,2,177,1,47,56,23,8,2,0,9,2,29
17,289,314,28,286,5,281,8,51,83,33,5,0,0,20,6,75
17,290,234,31,203,3,200,0,42,55,24,5,1,0,17,10,46
17,291,3812,548,3264,64,3200,74,440,830,386,47,14,2,280,74,1053
17,292,309,51,258,5,253,4,51,70,36,9,2,1,18,7,55
17,293,482,73,409,5,404,2,64,122,54,5,5,2,39,5,106
17,294,166,37,129,3,126,1,20,31,16,3,2,0,12,7,34
17,295,361,39,322,5,317,4,60,93,29,7,2,0,28,9,85
17,296,851,152,699,10,689,23,139,156,75,7,5,4,72,20,188
17,297,2025,314,1711,25,1686,38,201,733,116,14,5,0,155,24,400
17,298,659,103,556,9,547,13,128,136,51,13,3,1,31,13,158
17,299,17436,4333,13103,227,12876,311,2205,3228,1559,191,66,27,1061,230,3998
17,300,49957,11089,38868,592,38276,1410,4127,9260,4836,493,180,69,3419,520,13962
17,301,62,4,58,3,55,0,6,16,4,1,0,0,6,0,22
17,302,494,104,390,8,382,6,92,105,29,6,1,2,38,7,96
17,303,764,131,633,15,618,14,141,104,78,11,4,1,62,10,193
17,304,342,33,309,7,302,5,53,79,28,10,0,0,44,7,76
17,305,334,57,277,6,271,2,59,72,26,6,1,0,24,11,70
17,306,14884,2897,11987,191,11796,250,1855,4741,808,113,44,24,998,230,2733
17,307,988,152,836,30,806,11,167,218,68,18,5,1,68,20,230
17,308,1931,290,1641,41,1600,34,340,425,166,25,7,2,156,35,410
17,309,1541,309,1232,31,1201,16,298,266,132,15,11,5,76,23,359
17,310,725,123,602,18,584,9,134,191,49,5,2,1,61,17,115
17,311,949,156,793,13,780,16,136,265,56,21,3,2,73,25,183
17,312,638,110,528,14,514,6,118,172,40,14,1,0,35,11,117
17,313,327,61,266,7,259,5,52,58,29,5,4,0,21,2,83
17,314,697,116,581,8,573,6,105,107,64,10,2,0,48,8,223
17,315,846,105,741,17,724,15,116,180,76,14,5,1,66,28,223
17,316,346,69,277,8,269,7,56,81,23,8,1,0,20,5,68
17,317,403,66,337,5,332,1,71,114,24,5,2,0,35,8,72
17,318,625,93,532,14,518,15,58,234,42,0,4,1,38,6,120
17,319,101,23,78,0,78,2,9,11,10,2,3,0,4,1,36
17,320,276,47,229,9,220,7,50,53,22,3,1,2,26,2,54
17,321,212,32,180,2,178,2,31,56,19,7,0,0,19,3,41
17,322,373,60,313,7,306,6,52,92,22,10,0,1,43,4,76
17,323,1316,224,1092,18,1074,28,187,385,109,16,12,2,79,17,239
17,324,92,12,80,4,76,1,19,17,12,0,2,0,6,0,19
17,325,448,78,370,9,361,9,83,129,30,6,2,0,27,16,59
17,326,258,38,220,5,215,2,50,58,26,6,1,0,37,4,31
17,327,222,49,173,2,171,5,35,44,13,4,2,0,15,3,50
17,328,703,130,573,18,555,10,149,178,41,5,8,3,52,9,100
17,329,254,25,229,4,225,6,51,59,26,4,0,0,16,11,52
17,330,868,215,653,8,645,14,162,163,71,20,7,5,54,26,123
17,331,833,129,704,15,689,12,141,178,55,17,3,5,79,13,186
17,332,309,51,258,11,247,3,34,59,48,2,1,1,22,5,72
17,333,4569,870,3699,86,3613,53,539,1396,245,32,10,9,317,72,940
17,334,178,18,160,3,157,1,34,47,17,3,3,0,13,4,35
17,335,192,30,162,2,160,3,54,38,20,3,0,1,20,5,16
17,336,1986,215,1771,32,1739,26,273,479,199,18,7,6,195,51,485
17,337,3348,579,2769,53,2716,49,519,824,304,44,17,3,189,54,713
17,338,1356,241,1115,23,1092,12,214,239,143,19,4,2,109,16,334
17,339,1001,143,858,21,837,13,158,185,100,14,4,3,90,14,256
17,340,831,108,723,9,714,19,115,166,105,11,2,2,70,12,212
17,341,169,26,143,7,136,2,28,45,22,5,0,0,12,2,20
17,342,273,33,240,2,238,5,45,68,27,1,2,2,31,9,48
17,343,94,22,72,1,71,1,17,20,5,3,0,0,3,2,20
17,344,899,164,735,15,720,15,150,146,72,8,2,1,70,11,245
17,345,258,22,236,8,228,2,42,65,28,4,0,1,26,7,53
17,346,993,166,827,18,809,14,193,186,88,15,5,0,77,34,197
17,347,5669,1450,4219,69,4150,102,629,1111,415,67,25,11,349,92,1349
17,348,384,52,332,5,327,10,73,87,28,7,2,2,38,10,70
17,349,1685,274,1411,39,1372,38,225,364,149,18,7,5,145,32,389
17,350,692,89,603,7,596,11,108,162,43,10,6,1,61,10,184
17,351,1378,252,1126,21,1105,20,266,246,112,23,9,3,92,23,311
17,352,81,15,66,1,65,1,12,25,3,1,0,1,10,4,8
17,353,1397,141,1256,22,1234,24,214,336,138,12,5,1,110,31,363
17,354,502,81,421,6,415,6,109,101,38,6,3,0,50,16,86
17,355,400,76,324,11,313,4,86,101,11,5,0,1,29,8,68
17,356,264,48,216,6,210,0,41,71,14,3,0,0,16,7,58
17,357,445,79,366,9,357,8,68,107,32,6,1,1,28,11,95
17,358,246,43,203,5,198,1,34,52,21,6,4,1,14,7,58
17,359,834,134,700,26,674,13,130,170,82,7,8,3,69,14,178
17,360,2843,434,2409,51,2358,103,270,896,187,31,7,9,257,31,567
17,361,109,14,95,4,91,2,16,20,9,1,2,0,7,4,30
17,362,185,26,159,0,159,2,32,54,15,2,2,2,18,8,24
17,363,344,53,291,6,285,4,62,79,25,7,1,2,27,9,69
17,364,311,50,261,1,260,6,61,77,27,3,0,2,23,8,53
17,365,416,94,322,11,311,5,64,76,33,11,2,1,32,4,83
17,366,324,59,265,9,256,0,50,79,21,6,2,1,25,6,66
17,367,128,29,99,1,98,3,28,23,12,2,0,0,12,4,14
17,369,1612,260,1352,26,1326,27,169,556,122,8,5,5,114,31,289
17,371,108,12,96,1,95,0,19,25,8,0,0,0,20,0,23
17,372,59,9,50,1,49,1,11,12,8,0,0,0,2,2,13
17,373,1248,169,1079,19,1060,30,146,258,139,19,6,1,120,20,321
17,374,176,34,142,5,137,3,36,22,16,2,1,1,12,0,44
17,375,793,114,679,10,669,20,194,197,31,10,0,2,65,18,132
17,376,866,118,748,9,739,15,160,154,77,9,0,0,83,20,221
17,377,89,10,79,3,76,0,12,19,5,0,0,0,6,1,33
17,378,324,57,267,8,259,4,67,63,17,5,3,0,20,6,74
17,379,173,37,136,3,133,1,27,58,6,2,1,2,13,1,22
17,380,3793,706,3087,51,3036,56,447,1255,186,23,10,7,274,51,727
17,381,186,21,165,4,161,2,47,32,19,1,3,0,10,6,41
17,382,379,53,326,5,321,4,59,64,42,11,1,4,25,11,100
17,383,281,43,238,3,235,4,45,75,18,1,0,1,11,10,70
17,384,154,31,123,3,120,1,16,39,16,2,0,0,6,6,34
17,385,5636,1099,4537,96,4441,114,848,1522,425,73,19,13,371,79,977
17,386,263,48,215,11,204,4,75,26,20,6,4,1,12,9,47
17,387,1208,160,1048,28,1020,20,209,312,99,15,6,2,97,23,237
17,388,196,25,171,4,167,1,39,45,18,1,1,1,11,2,48
17,389,404,61,343,8,335,9,82,107,24,5,0,0,32,4,72
17,390,128,27,101,4,97,3,30,24,7,0,1,0,11,0,21
17,391,1596,248,1348,39,1309,37,160,314,140,20,6,0,107,39,486
17,392,50,10,40,1,39,1,13,13,2,2,0,0,2,1,5
17,393,1220,201,1019,17,1002,14,233,272,96,17,10,2,87,23,248
17,394,622,86,536,16,520,15,78,130,72,12,5,0,57,12,139
17,395,406,65,341,9,332,15,56,64,42,5,2,3,31,7,107
17,396,1098,166,932,21,911,23,135,266,83,7,6,0,75,21,295
17,397,1849,356,1493,31,1462,36,269,403,156,30,10,11,134,24,389
17,398,124,14,110,3,107,2,20,28,9,3,0,0,13,3,29
17,400,452,53,399,8,391,7,87,72,52,3,3,0,38,14,115
17,401,88,11,77,0,77,1,11,27,7,2,0,0,7,0,22
17,402,120,14,106,3,103,1,23,27,7,0,0,0,7,3,35
17,403,528,97,431,10,421,4,61,94,59,5,2,3,37,7,149
17,404,372,49,323,7,316,8,56,93,24,9,1,2,38,11,74
17,405,150,19,131,2,129,0,27,34,11,3,0,0,16,0,38
17,406,267,36,231,4,227,5,43,75,24,1,3,3,20,5,48
17,407,2852,451,2401,57,2344,46,333,570,269,42,14,1,211,56,802
17,408,509,84,425,12,413,8,130,76,45,11,2,2,32,11,96
17,409,2265,339,1926,36,1890,26,379,615,141,34,10,3,161,38,483
17,410,487,104,383,11,372,7,80,125,29,3,2,2,41,4,79
17,411,1191,239,952,15,937,26,136,334,94,11,7,2,79,6,242
17,412,424,53,371,6,365,4,63,82,50,8,2,0,28,10,118
17,413,795,135,660,11,649,19,107,202,54,7,5,1,68,16,170
17,414,3557,506,3051,58,2993,78,422,729,321,34,11,3,286,77,1032
17,415,19260,4836,14424,301,14123,394,1944,3470,1822,207,65,17,1396,255,4553
17,416,47,6,41,0,41,1,4,7,2,1,0,1,1,0,24
17,417,138,30,108,7,101,5,23,28,14,1,1,0,2,2,25
17,418,516,81,435,13,422,6,80,112,45,5,3,0,37,10,124
17,420,1562,206,1356,22,1334,18,207,419,135,8,10,4,126,27,380
17,421,5402,1103,4299,63,4236,58,824,1257,338,55,20,9,369,106,1200
17,422,77,20,57,1,56,0,8,20,2,0,0,0,8,2,16
17,423,55,11,44,2,42,0,9,9,4,1,1,1,3,5,9
17,424,213,45,168,2,166,2,46,44,18,7,0,0,5,6,38
17,425,1519,249,1270,32,1238,21,274,322,118,25,10,2,94,27,345
17,426,198,32,166,4,162,4,13,58,19,1,0,0,7,3,57
17,427,167,31,136,4,132,3,25,40,7,4,3,0,17,0,33
17,428,406,80,326,3,323,4,49,89,28,3,2,0,32,17,99
17,429,1306,249,1057,24,1033,25,214,285,114,15,9,11,109,37,214
17,430,300,62,238,5,233,4,60,43,27,4,2,0,29,5,59
17,431,521,81,440,14,426,6,89,132,39,10,0,1,28,7,114
17,432,295,43,252,2,250,6,54,63,24,4,1,2,21,2,73
17,433,170,26,144,2,142,6,33,44,4,1,0,0,15,2,37
17,434,4563,862,3701,79,3622,55,529,946,381,58,20,11,314,68,1240
17,435,126,16,110,0,110,3,16,29,16,2,0,0,12,2,30
17,436,553,102,451,10,441,4,94,69,57,7,8,0,48,11,143
17,437,112,13,99,4,95,6,12,44,5,0,0,1,12,4,11
17,438,235,39,196,5,191,3,43,71,15,6,3,2,11,2,35
17,439,522,84,438,14,424,6,95,97,45,9,1,0,53,11,107
17,440,292,46,246,3,243,1,39,58,20,6,1,0,18,4,96
17,441,785,128,657,14,643,9,146,180,61,9,7,2,58,13,158
17,442,276,42,234,8,226,4,48,82,17,6,1,0,14,8,46
17,443,1113,175,938,24,914,31,154,226,96,15,4,3,91,11,283
17,444,1046,120,926,28,898,20,163,214,127,9,2,0,71,24,268
17,445,253,61,192,7,185,10,33,59,10,2,3,0,11,7,50
17,446,364,55,309,6,303,2,64,75,37,0,2,1,28,6,88
17,447,1177,152,1025,24,1001,15,236,204,130,26,6,3,84,25,272
17,448,885,142,743,21,722,14,150,179,68,8,7,3,86,14,193
17,449,5931,1239,4692,102,4590,79,963,1030,563,80,33,11,400,114,1317
17,450,211,34,177,5,172,1,25,46,22,7,2,0,8,2,59
17,451,385,78,307,7,300,4,69,63,29,4,2,0,31,11,87
17,452,4016,790,3226,52,3174,53,611,1060,279,37,18,14,261,75,766
17,453,966,140,826,20,806,11,184,231,80,13,7,1,79,17,183
17,454,293,47,246,3,243,0,61,64,19,3,0,2,24,3,67
17,455,556,115,441,13,428,4,111,133,39,5,3,3,39,11,80
17,457,567,101,466,13,453,7,106,97,62,6,8,1,36,5,125
17,458,122,17,105,2,103,3,24,24,10,2,0,0,6,3,31
17,459,433,74,359,14,345,9,79,79,29,6,3,0,19,10,111
17,460,607,88,519,12,507,14,91,115,57,8,4,2,50,13,153
17,461,3480,645,2835,43,2792,43,396,1194,195,23,6,5,262,41,627
17,462,530,64,466,5,461,13,78,81,78,8,3,1,45,14,140
17,463,801,96,705,21,684,14,111,184,71,4,2,1,66,11,220
17,464,118,17,101,2,99,3,11,34,5,0,1,0,8,3,34
17,465,494,66,428,10,418,6,96,92,40,4,2,2,28,9,139
17,466,1444,226,1218,27,1191,18,190,277,166,12,12,2,126,16,372
17,467,172,21,151,0,151,8,22,28,17,1,0,1,12,2,60
17,468,132,31,101,5,96,2,13,28,9,3,0,0,15,1,25
17,469,401,59,342,12,330,3,94,89,31,2,2,0,22,10,77
17,470,225,31,194,2,192,3,33,54,33,6,1,0,20,6,36
17,471,199,46,153,8,145,3,35,31,16,2,0,0,13,1,44
17,472,1158,138,1020,19,1001,19,184,241,122,14,11,5,86,15,304
17,473,90,12,78,6,72,4,9,27,3,1,0,0,5,0,23
17,474,556,87,469,10,459,9,86,102,58,3,1,1,37,6,156
17,476,204,28,176,4,172,4,41,55,14,0,1,0,11,5,41
17,477,106,33,73,0,73,0,12,26,7,4,0,0,2,0,22
17,478,45,11,34,0,34,2,7,7,4,0,0,0,3,2,9
17,479,237,32,205,3,202,0,52,60,11,6,0,0,15,4,54
17,480,439,68,371,6,365,15,80,71,43,6,2,0,35,16,97
17,481,126,20,106,2,104,2,21,36,15,2,0,0,6,0,22
17,482,461,63,398,8,390,4,69,108,42,7,6,2,46,9,97
17,483,998,146,852,19,833,14,194,227,66,18,4,3,65,19,223
17,484,1506,203,1303,27,1276,27,290,395,125,17,8,2,94,37,281
17,485,827,120,707,9,698,16,102,235,77,14,2,2,64,21,165
17,486,745,168,577,7,570,11,107,220,61,4,3,2,38,17,107
18,1,294,38,256,2,254,4,51,48,44,4,5,0,28,6,64
18,2,165,19,146,4,142,3,31,41,19,2,0,0,15,1,30
18,3,1372,231,1141,31,1110,9,266,258,135,15,7,5,111,16,288
18,4,808,164,644,16,628,9,152,152,86,11,3,2,59,13,141
18,5,687,92,595,12,583,9,105,123,79,10,2,1,49,21,184
18,6,203,32,171,4,167,2,38,48,14,4,1,0,18,1,41
18,7,70,6,64,1,63,4,7,26,7,2,0,1,6,1,9
18,8,368,41,327,4,323,6,87,74,47,2,5,0,24,8,70
18,9,248,47,201,3,198,5,35,39,21,6,1,0,20,9,62
18,10,170,17,153,2,151,1,26,38,32,3,1,0,9,4,37
18,11,1797,351,1446,40,1406,11,313,401,135,27,8,2,141,37,331
18,12,365,65,300,6,294,2,82,74,25,2,5,0,20,11,73
18,13,267,34,233,3,230,4,44,48,22,3,5,1,25,5,73
18,14,163,23,140,6,134,1,30,36,9,2,0,0,19,7,30
18,15,4297,850,3447,62,3385,46,714,992,296,44,19,4,277,92,901
18,16,267,42,225,11,214,3,34,54,21,5,4,1,31,3,58
18,17,258,47,211,5,206,2,44,74,22,1,3,1,16,2,41
18,18,1447,258,1189,24,1165,11,317,346,98,7,7,6,121,36,216
18,19,350,56,294,5,289,6,60,91,35,4,1,0,26,5,61
18,20,668,88,580,7,573,21,142,141,60,7,3,1,58,14,126
18,21,223,29,194,3,191,3,45,54,16,5,1,1,17,5,44
18,22,302,47,255,4,251,2,57,94,20,5,3,2,19,6,43
18,23,1038,160,878,17,861,20,216,239,98,14,4,1,81,14,174
18,24,92,18,74,3,71,0,17,33,2,0,1,0,10,0,8
18,25,552,86,466,3,463,3,107,62,95,5,3,2,15,10,161
18,26,711,104,607,12,595,10,134,118,89,6,3,5,35,15,180
18,27,471,59,412,10,402,6,117,77,59,5,2,2,30,17,87
18,28,815,105,710,18,692,3,130,203,58,7,3,1,72,22,193
18,29,267,57,210,13,197,2,50,44,22,7,3,0,13,4,52
18,30,932,158,774,20,754,12,209,197,78,12,0,1,80,20,145
18,31,470,95,375,16,359,5,95,86,44,2,3,1,26,6,91
18,32,1145,176,969,28,941,16,213,255,83,10,6,3,79,29,247
18,33,44849,11954,32895,914,31981,716,4237,8298,4507,292,186,74,3177,555,9939
18,34,258,29,229,2,227,3,47,60,22,2,0,0,19,8,66
18,35,603,81,522,9,513,6,128,158,46,11,1,0,38,22,103
18,36,474,73,401,2,399,6,79,114,76,1,0,2,31,12,78
18,37,903,162,741,12,729,7,156,343,34,13,4,0,50,21,101
18,38,420,81,339,5,334,3,77,76,34,4,2,1,27,7,103
18,39,290,39,251,3,248,3,45,135,11,1,0,0,26,5,22
18,40,272,60,212,6,206,1,50,56,28,6,1,0,29,2,33
18,41,148,34,114,1,113,2,28,35,9,2,1,0,18,0,18
18,42,255,39,216,7,209,5,43,41,31,4,1,1,17,3,63
18,43,154,19,135,4,131,2,36,30,16,0,0,1,14,1,31
18,44,290,54,236,4,232,4,59,37,40,3,4,2,21,7,55
18,45,304,47,257,2,255,2,93,52,34,5,0,1,10,7,51
18,46,122,19,103,0,103,2,35,24,13,0,0,0,7,2,20
18,47,508,73,435,11,424,5,104,109,33,3,6,0,38,15,111
18,48,286,47,239,2,237,3,70,30,23,4,2,0,34,4,67
18,49,391,41,350,7,343,1,78,102,46,2,0,0,24,5,85
18,50,2813,506,2307,49,2258,26,402,483,322,29,12,6,218,64,696
18,51,158,45,113,3,110,3,26,34,15,3,1,0,7,2,19
18,52,853,128,725,17,708,6,171,171,74,13,11,1,72,27,162
18,53,265,53,212,6,206,2,53,54,30,3,0,1,10,7,46
18,54,193,44,149,5,144,2,35,48,18,2,0,0,14,2,23
18,55,771,118,653,14,639,4,160,111,95,16,8,2,34,13,196
18,56,212,32,180,5,175,2,50,31,39,0,2,1,8,1,41
18,57,1503,255,1248,29,1219,7,253,285,139,21,10,3,115,35,351
18,58,1134,221,913,19,894,16,175,227,129,11,9,0,71,20,236
18,59,784,127,657,17,640,13,129,151,61,5,5,1,64,18,193
18,60,35,3,32,2,30,0,4,4,10,0,0,1,2,1,8
18,61,93,17,76,1,75,1,11,21,12,1,0,0,6,1,22
18,62,234,41,193,2,191,2,36,52,14,1,5,0,29,6,46
18,63,146,18,128,4,124,4,30,16,26,1,2,0,10,2,33
18,64,182,43,139,2,137,0,37,32,23,0,4,0,6,2,33
18,65,554,75,479,6,473,10,102,81,78,5,2,1,36,12,146
18,66,730,118,612,10,602,9,142,149,100,9,3,3,53,15,119
18,67,558,95,463,4,459,5,124,189,23,4,5,0,33,9,67
18,68,45,8,37,3,34,0,5,16,2,0,0,0,4,0,7
18,69,317,27,290,7,283,1,65,72,25,2,1,2,30,2,83
18,70,182,16,166,2,164,2,37,60,15,2,0,1,13,2,32
18,71,25,2,23,2,21,0,2,8,2,0,0,0,5,0,4
18,72,199,19,180,5,175,1,52,45,13,2,3,0,9,3,47
18,73,182,21,161,2,159,0,29,30,32,4,1,0,17,4,42
18,74,170,25,145,2,143,4,40,33,18,1,1,0,9,4,33
18,75,774,97,677,9,668,8,156,120,90,9,3,2,55,12,213
18,76,372,60,312,6,306,4,114,79,22,2,4,1,21,5,54
18,77,278,44,234,14,220,2,52,47,31,7,2,0,20,8,51
18,78,63,12,51,0,51,0,15,13,5,0,1,0,2,0,15
18,79,418,59,359,13,346,7,72,104,36,3,4,1,31,6,82
18,80,114,15,99,3,96,3,23,32,11,0,0,0,8,3,16
18,81,281,46,235,6,229,4,53,60,31,2,1,1,19,8,50
18,82,864,116,748,10,738,20,160,165,114,9,3,2,52,22,191
18,83,619,123,496,16,480,6,104,141,35,6,10,2,36,11,129
18,84,174,32,142,4,138,1,28,57,10,0,0,0,13,1,28
18,85,169,16,153,4,149,3,34,31,33,0,1,0,10,2,35
18,86,438,53,385,14,371,4,86,71,32,7,1,1,26,8,135
18,87,2985,637,2348,55,2293,30,456,577,247,36,20,8,224,53,642
18,88,171,24,147,0,147,0,35,65,11,3,1,0,11,0,21
18,89,354,50,304,5,299,5,93,69,27,0,0,0,34,2,69
18,90,318,43,275,7,268,4,51,81,15,2,4,1,18,10,82
18,91,153,13,140,5,135,2,29,24,31,1,0,1,2,6,39
18,92,627,83,544,10,534,9,103,160,46,7,9,0,65,15,120
18,93,117,18,99,3,96,0,20,29,11,2,3,0,9,1,21
18,94,279,41,238,4,234,3,46,65,26,4,5,1,21,4,59
18,95,146,26,120,4,116,2,35,31,16,2,1,0,4,1,24
18,96,1508,275,1233,23,1210,11,222,221,307,30,9,2,99,16,293
18,97,1651,261,1390,32,1358,17,214,378,144,12,6,2,122,23,440
18,98,118,18,100,0,100,1,25,30,11,1,0,0,12,1,19
18,99,198,54,144,4,140,0,37,42,9,2,1,0,16,8,25
18,100,601,106,495,11,484,4,119,138,63,10,3,5,45,11,86
18,101,294,54,240,5,235,3,60,58,28,1,0,0,17,3,65
18,102,236,44,192,2,190,0,58,39,29,1,1,0,16,1,45
18,103,1091,189,902,13,889,9,187,208,147,21,7,3,69,18,220
18,104,135,20,115,2,113,5,22,34,11,1,1,0,9,3,27
18,105,338,47,291,7,284,4,93,62,26,1,5,2,36,10,45
18,106,219,42,177,4,173,3,55,26,28,7,2,0,10,4,38
18,107,109,10,99,1,98,4,16,28,4,0,1,0,14,2,29
18,108,2757,637,2120,38,2082,27,485,424,296,31,15,5,174,59,566
18,109,1401,270,1131,25,1106,25,254,273,139,22,6,1,94,37,255
18,110,826,130,696,10,686,11,167,184,68,10,1,1,54,11,179
18,111,154,27,127,3,124,3,16,32,31,1,1,0,14,4,22
18,112,283,44,239,4,235,0,78,67,19,5,1,0,14,4,47
18,113,141,8,133,2,131,4,26,38,6,3,4,0,13,3,34
18,114,166,33,133,1,132,5,35,35,14,2,2,0,10,4,25
18,115,666,123,543,17,526,8,110,131,80,12,3,0,39,16,127
18,116,230,39,191,3,188,1,48,60,17,1,1,1,16,10,33
18,117,402,62,340,9,331,11,94,89,36,3,4,0,36,3,55
18,118,1105,205,900,14,886,4,249,169,107,14,12,3,60,20,248
18,119,161,13,148,2,146,3,24,47,17,0,1,1,14,3,36
18,120,446,67,379,5,374,3,103,79,38,7,4,4,28,5,103
18,121,102,14,88,2,86,0,20,22,9,0,0,0,13,0,22
18,122,144,18,126,0,126,5,30,29,14,1,0,0,12,7,28
18,123,37,4,33,0,33,0,1,16,1,0,0,0,7,4,4
18,124,264,35,229,4,225,2,51,80,34,1,0,0,17,5,35
18,125,1014,232,782,16,766,14,159,199,95,9,6,2,70,32,180
18,126,966,109,857,18,839,9,162,203,100,11,6,1,89,13,245
18,127,1170,174,996,18,978,12,221,234,127,12,6,4,79,21,262
18,128,116,16,100,2,98,0,28,27,15,3,1,0,6,1,17
18,129,156,12,144,4,140,3,40,33,16,1,0,0,17,3,27
18,130,236,28,208,2,206,10,55,47,18,2,2,2,22,5,43
18,131,32,1,31,1,30,0,5,11,7,0,0,0,6,0,1
18,132,134,21,113,3,110,4,18,53,6,1,0,0,15,3,10
18,133,1033,198,835,12,823,11,144,145,189,14,3,0,65,18,234
18,134,493,63,430,7,423,7,102,87,57,9,5,0,37,8,111
18,135,214,31,183,9,174,4,42,46,14,2,2,0,12,6,46
18,136,247,42,205,4,201,8,46,47,30,5,2,0,15,8,40
18,137,463,73,390,1,389,1,78,80,57,3,6,5,42,9,108
18,138,1725,280,1445,39,1406,32,263,367,198,18,9,3,140,33,343
18,139,526,66,460,5,455,2,99,66,102,3,2,1,15,16,149
18,140,1134,175,959,27,932,16,219,202,173,11,10,1,70,19,211
18,141,5111,998,4113,106,4007,60,790,1048,511,53,28,3,339,75,1100
18,142,587,98,489,9,480,2,102,121,50,11,4,0,41,17,132
18,143,249,52,197,2,195,3,51,38,28,0,2,0,13,6,54
18,144,429,84,345,8,337,4,87,128,30,1,2,0,39,6,40
18,145,1184,154,1030,24,1006,27,237,272,107,7,4,2,105,26,219
18,146,286,58,228,2,226,1,52,54,25,8,3,1,15,4,63
18,147,213,51,162,2,160,1,42,54,7,2,0,2,11,5,36
18,148,2017,304,1713,33,1680,29,361,396,342,15,11,7,158,19,342
18,149,471,86,385,13,372,6,65,91,63,6,8,0,40,7,86
18,150,534,73,461,7,454,9,107,104,72,3,2,0,46,5,106
18,151,323,52,271,7,264,2,45,69,43,4,3,0,25,4,69
18,152,92,13,79,1,78,0,21,16,30,0,0,0,2,2,7
18,153,250,53,197,3,194,5,53,39,27,5,6,1,21,0,37
18,154,183,47,136,1,135,1,32,36,10,1,0,1,9,9,36
18,155,369,59,310,8,302,5,83,81,32,5,2,2,18,7,67
18,156,405,62,343,3,340,10,56,49,72,6,4,0,24,3,116
18,157,482,54,428,14,414,7,83,78,79,2,3,2,37,11,112
18,158,537,67,470,12,458,1,85,126,64,3,5,0,57,11,106
18,159,708,125,583,4,579,12,101,218,37,23,5,0,44,15,124
18,160,1057,162,895,49,846,11,220,248,67,8,3,1,68,17,203
18,161,221,41,180,2,178,2,43,46,16,1,2,0,16,6,46
18,162,226,22,204,3,201,9,41,54,30,3,1,0,16,6,41
18,163,244,45,199,3,196,7,23,43,37,5,0,0,16,3,62
18,164,114,6,108,3,105,1,20,39,6,2,0,0,12,0,25
18,165,994,156,838,11,827,15,205,225,102,8,8,3,65,13,183
18,166,325,32,293,6,287,5,59,91,34,6,4,0,26,4,58
18,167,233,23,210,0,210,2,51,48,18,0,4,0,16,2,69
18,168,225,31,194,8,186,4,51,31,22,3,0,0,17,7,51
18,169,179,26,153,0,153,5,40,33,22,5,2,0,7,1,38
18,170,603,105,498,4,494,4,124,146,48,13,3,1,51,8,96
18,171,197,41,156,3,153,0,46,33,23,3,5,0,4,2,37
18,172,1518,259,1259,30,1229,20,220,291,163,23,17,2,75,29,389
18,173,233,30,203,9,194,3,52,47,14,5,3,1,15,6,48
18,174,142,17,125,1,124,2,24,29,24,2,2,0,17,3,21
18,175,516,116,400,6,394,4,100,94,37,6,3,0,32,9,109
18,176,331,52,279,2,277,7,65,36,37,2,3,1,23,6,97
18,177,45,11,34,1,33,2,10,11,2,1,1,0,1,0,5
18,178,192,24,168,3,165,2,43,38,10,3,1,0,17,4,47
18,179,615,71,544,8,536,10,75,160,49,6,5,0,54,13,164
18,180,1385,198,1187,27,1160,28,210,292,140,5,7,3,120,23,332
18,181,390,39,351,6,345,5,66,60,61,8,0,2,23,11,109
18,182,155,19,136,3,133,4,36,37,17,0,0,1,10,6,22
18,183,110,19,91,4,87,1,24,30,8,1,1,1,5,4,12
18,184,202,30,172,3,169,5,38,42,22,2,2,1,10,3,44
18,185,207,22,185,0,185,2,58,57,12,1,0,0,10,3,42
18,186,358,54,304,6,298,7,73,76,50,3,2,0,24,6,57
18,187,486,97,389,7,382,3,75,97,43,6,1,0,50,13,94
18,188,206,22,184,8,176,2,41,31,23,2,1,0,15,7,54
18,189,358,53,305,8,297,7,56,65,39,6,2,2,42,5,73
18,190,604,108,496,15,481,5,150,123,51,7,4,1,39,4,97
18,191,155,20,135,2,133,0,50,38,16,2,1,1,5,0,20
18,192,235,34,201,5,196,7,44,38,16,2,2,2,18,7,60
18,193,202,28,174,6,168,3,26,26,38,5,2,0,15,3,50
18,194,803,115,688,26,662,13,170,145,80,7,7,1,61,23,155
18,195,170,22,148,0,148,3,28,44,18,1,1,1,14,4,34
18,196,74,15,59,0,59,0,15,20,6,0,0,0,6,2,10
18,197,7772,1947,5825,116,5709,79,1042,1524,637,79,45,18,486,130,1669
18,198,294,36,258,4,254,4,34,72,27,4,2,1,27,9,74
18,199,226,32,194,10,184,4,38,38,33,5,3,0,14,4,45
18,200,280,48,232,4,228,0,80,61,21,1,1,0,14,8,42
18,201,505,67,438,6,432,4,90,99,54,8,2,0,31,21,123
18,202,34,1,33,1,32,0,0,18,5,0,1,0,4,0,4
18,203,92,10,82,2,80,3,19,15,16,1,0,0,8,6,12
18,204,271,42,229,9,220,4,59,65,18,1,1,3,23,6,40
18,205,7153,1289,5864,123,5741,92,848,1682,630,60,43,10,631,108,1637
18,206,1186,168,1018,18,1000,23,181,266,131,7,3,2,101,19,267
18,207,4963,1058,3905,93,3812,33,668,852,607,55,29,7,300,72,1189
18,208,344,48,296,4,292,8,66,85,27,0,3,0,26,4,73
18,209,347,37,310,9,301,3,63,65,36,4,6,0,31,7,86
18,210,456,58,398,8,390,3,105,81,93,1,5,1,14,6,81
18,211,585,72,513,15,498,8,95,117,52,5,7,1,42,15,156
18,212,449,75,374,12,362,2,80,106,32,6,6,2,37,3,88
18,213,3834,723,3111,56,3055,33,524,651,580,25,29,15,226,64,908
18,214,516,91,425,4,421,3,98,54,122,6,5,1,19,7,106
18,215,133,27,106,1,105,0,23,36,13,0,0,0,6,2,25
18,216,448,75,373,8,365,3,114,74,41,3,0,2,41,14,73
18,217,144,17,127,5,122,3,23,43,20,0,1,0,4,0,28
18,218,501,80,421,4,417,5,91,116,46,2,5,0,40,9,103
18,219,304,47,257,4,253,12,39,49,51,5,2,0,24,10,61
18,220,314,43,271,4,267,2,72,40,36,3,3,0,22,5,84
18,221,222,23,199,3,196,5,57,33,25,3,4,0,25,3,41
18,222,34,2,32,0,32,0,3,17,0,0,0,0,4,1,7
18,223,1637,254,1383,23,1360,24,300,388,137,14,11,4,139,21,322
18,224,257,47,210,6,204,2,32,65,29,5,1,0,19,9,42
18,225,220,41,179,6,173,1,54,50,19,0,1,0,15,3,30
18,226,324,33,291,7,284,5,47,69,34,4,0,1,27,6,91
18,227,201,27,174,2,172,2,35,82,3,2,0,0,10,4,34
18,228,188,29,159,3,156,1,31,50,26,4,2,0,6,2,34
18,229,495,59,436,5,431,11,100,118,47,6,6,2,38,12,91
18,230,247,25,222,3,219,3,65,45,32,0,5,0,20,7,42
18,231,586,130,456,19,437,4,95,104,57,7,6,1,40,4,119
18,232,218,41,177,1,176,1,39,40,31,1,0,0,14,4,46
18,233,1235,254,981,13,968,19,216,293,87,12,9,5,88,17,222
18,234,382,97,285,3,282,2,80,77,42,3,3,0,13,5,57
18,235,948,140,808,24,784,7,167,176,110,12,5,4,78,9,216
18,236,106,27,79,1,78,2,17,14,8,1,1,0,6,2,27
18,237,372,42,330,4,326,5,67,80,65,2,3,2,23,8,71
18,238,116,20,96,1,95,1,17,21,13,1,2,1,12,2,25
18,239,132,34,98,1,97,1,24,25,10,2,0,0,12,3,20
18,240,566,124,442,11,431,3,83,128,39,1,3,1,42,17,114
18,241,1025,162,863,12,851,9,131,348,68,11,7,2,72,20,183
18,242,2361,453,1908,41,1867,20,450,446,192,21,18,5,152,53,510
18,243,359,83,276,3,273,1,80,89,21,1,7,0,22,1,51
18,244,60,6,54,2,52,0,13,14,6,2,0,0,4,0,13
18,245,356,55,301,2,299,5,75,71,31,4,6,0,40,2,65
18,246,809,126,683,11,672,8,160,186,53,8,10,2,60,14,171
18,247,500,74,426,8,418,4,81,120,52,6,6,0,45,7,97
18,248,302,35,267,3,264,7,53,42,43,2,1,3,28,5,80
18,249,353,57,296,1,295,6,72,95,28,4,2,1,29,5,53
18,250,56,9,47,2,45,0,11,13,3,1,0,0,3,2,12
18,251,49,3,46,1,45,1,9,11,5,2,1,0,7,1,8
18,252,298,54,244,4,240,1,42,68,41,2,1,1,20,5,59
18,253,351,48,303,5,298,3,59,73,34,3,2,0,36,11,77
18,254,507,98,409,5,404,3,94,96,53,2,1,1,32,9,113
18,255,699,91,608,6,602,10,122,168,59,4,4,2,73,12,148
18,256,275,39,236,5,231,4,42,72,27,1,2,0,16,6,61
18,257,486,72,414,4,410,2,84,89,52,1,6,3,49,16,108
18,258,528,74,454,11,443,3,104,165,44,2,8,0,37,8,72
18,259,255,45,210,4,206,0,54,54,34,3,0,0,15,1,45
18,260,59,13,46,1,45,0,17,10,1,1,3,1,6,2,4
18,261,331,50,281,3,278,3,74,72,37,0,2,2,21,1,66
18,262,269,45,224,4,220,4,42,60,22,1,2,0,18,3,68
18,263,460,70,390,4,386,2,88,69,108,5,0,1,30,8,75
18,264,77,19,58,3,55,1,19,10,3,0,0,1,4,2,15
18,265,597,115,482,11,471,5,126,81,69,5,4,3,16,7,155
18,266,254,42,212,1,211,12,48,47,19,2,0,1,18,6,58
18,267,3171,487,2684,65,2619,28,430,588,395,34,14,3,265,56,806
18,268,320,67,253,7,246,1,56,50,46,5,1,0,24,0,63
18,269,617,118,499,8,491,1,122,176,39,6,4,0,42,6,95
18,270,583,120,463,7,456,10,121,58,61,11,6,2,45,4,138
18,271,929,129,800,20,780,12,157,231,82,17,3,5,81,13,179
18,272,455,69,386,12,374,4,71,96,62,4,4,0,30,4,99
18,273,665,94,571,7,564,16,119,136,81,6,2,1,48,10,145
18,274,262,37,225,9,216,4,30,126,10,1,1,3,16,6,19
18,275,128,19,109,3,106,4,35,30,12,2,0,0,7,1,15
18,276,142,21,121,1,120,2,28,49,11,0,0,2,9,4,15
18,277,36,2,34,1,33,0,7,16,4,1,0,0,2,0,3
18,278,437,72,365,10,355,13,83,91,41,5,2,0,31,9,80
18,279,19137,4751,14386,222,14164,224,2558,2522,3407,159,132,26,898,225,4013
18,280,572,63,509,9,500,7,106,123,65,10,7,2,46,14,120
18,281,1529,271,1258,18,1240,12,312,273,210,20,8,2,106,21,276
18,282,413,52,361,12,349,2,60,97,45,6,1,2,36,7,93
18,283,84,28,56,1,55,0,16,8,10,2,0,0,9,2,8
18,284,185,35,150,2,148,4,23,49,13,0,0,0,18,4,37
18,285,333,55,278,3,275,2,50,73,46,7,4,1,13,5,74
18,286,346,33,313,10,303,4,80,80,32,3,5,1,33,6,59
18,287,268,39,229,5,224,2,53,68,25,5,2,1,21,7,40
18,288,183,26,157,2,155,3,31,41,15,2,0,1,21,0,41
18,289,376,31,345,7,338,4,98,74,38,5,3,2,33,8,73
18,290,390,61,329,9,320,8,75,65,46,1,10,1,34,7,73
19,1,305,41,264,11,253,2,28,44,28,1,4,0,15,6,125
19,2,333,36,297,5,292,4,34,50,32,4,0,2,38,9,119
19,3,234,22,212,7,205,2,26,35,14,0,1,0,12,2,113
19,4,618,63,555,12,543,13,59,93,63,7,1,0,32,13,262
19,5,2933,422,2511,45,2466,40,383,550,249,23,9,6,134,29,1043
19,6,102,9,93,4,89,2,11,29,7,0,1,0,6,1,32
19,7,710,94,616,10,606,7,96,145,65,12,3,1,31,7,239
19,8,221,27,194,0,194,1,14,30,53,1,2,0,13,3,77
19,9,113,14,99,0,99,0,9,11,17,1,1,0,9,2,49
19,10,2487,399,2088,48,2040,35,219,437,220,19,14,4,122,20,950
19,11,995,137,858,14,844,15,98,207,58,7,9,1,39,13,397
19,12,219,22,197,2,195,4,27,35,26,2,0,1,16,5,79
19,13,698,106,592,16,576,8,63,120,63,4,1,1,40,9,267
19,14,189,27,162,1,161,2,11,42,26,0,0,0,9,1,70
19,15,566,73,493,7,486,6,74,89,40,3,4,0,38,14,218
19,16,272,27,245,2,243,4,27,48,40,5,0,0,7,4,108
19,17,88,15,73,0,73,0,9,16,12,0,0,0,8,1,27
19,18,171,19,152,5,147,0,13,42,10,2,0,0,7,1,72
19,19,846,109,737,14,723,15,77,170,57,17,1,2,52,20,312
19,20,109,11,98,9,89,1,2,9,15,3,0,0,8,2,49
19,21,88,11,77,0,77,1,5,10,15,0,1,0,5,0,40
19,22,252,26,226,1,225,5,25,30,25,1,0,2,22,1,114
19,23,1002,105,897,10,887,12,132,190,67,9,4,1,65,13,394
19,24,445,58,387,7,380,4,44,87,32,0,2,1,34,4,172
19,25,326,24,302,8,294,3,35,83,31,3,2,0,27,5,105
19,26,178,27,151,0,151,3,15,24,23,3,0,0,12,5,66
19,27,137,7,130,2,128,2,9,25,17,0,1,0,10,0,64
19,28,2229,407,1822,40,1782,17,242,437,116,18,10,4,100,31,807
19,29,223,19,204,6,198,8,20,44,21,1,1,0,27,3,73
19,30,747,76,671,11,660,7,119,99,63,9,2,0,45,7,309
19,31,33123,7324,25799,529,25270,357,3474,6429,2234,211,116,42,1836,388,10183
19,32,153,21,132,3,129,1,7,35,19,1,0,0,8,2,56
19,33,671,108,563,21,542,2,74,107,102,9,2,1,44,12,189
19,34,242,46,196,4,192,0,28,43,20,3,5,0,25,1,67
19,35,418,47,371,10,361,7,68,50,44,3,3,0,25,2,159
19,36,1093,170,923,30,893,9,114,183,107,11,9,3,78,23,356
19,37,973,129,844,22,822,15,84,149,107,7,4,1,60,13,382
19,38,1305,141,1164,13,1151,22,96,140,114,7,3,2,65,17,685
19,39,194,20,174,4,170,0,23,44,10,5,1,0,12,4,71
19,40,171,19,152,4,148,1,13,24,11,0,1,0,11,1,86
19,41,457,41,416,5,411,3,31,64,45,4,0,1,28,8,227
19,42,518,81,437,12,425,4,33,31,113,1,1,0,27,3,212
19,43,355,27,328,8,320,3,34,57,43,3,3,0,20,6,151
19,44,196,15,181,5,176,7,28,47,21,2,0,0,6,1,64
19,45,201,34,167,2,165,4,20,34,19,5,3,0,5,3,72
19,46,117,17,100,5,95,0,20,17,11,2,0,1,14,4,26
19,47,309,41,268,9,259,6,50,58,22,5,0,0,19,3,96
19,48,261,23,238,3,235,3,18,24,29,0,0,0,17,2,142
19,49,559,70,489,8,481,8,60,91,67,6,1,0,40,11,197
19,50,357,25,332,5,327,4,53,79,29,5,0,0,18,3,136
19,51,168,19,149,6,143,13,21,29,5,4,0,1,11,1,58
19,52,66,15,51,2,49,1,3,26,7,0,0,0,5,0,7
19,53,193,22,171,4,167,6,28,46,15,3,2,0,8,6,53
19,54,181,18,163,5,158,3,11,45,18,2,0,0,9,2,68
19,55,243,14,229,2,227,6,45,35,24,4,1,0,17,4,91
19,56,334,37,297,6,291,6,40,50,41,3,1,0,18,5,127
19,57,459,46,413,7,406,16,57,80,46,7,2,1,25,7,165
19,58,309,47,262,3,259,4,51,70,32,3,0,0,15,2,82
19,59,367,41,326,5,321,1,45,101,37,0,1,1,20,1,114
19,60,540,66,474,17,457,11,56,95,64,7,2,3,33,9,177
19,61,879,115,764,14,750,16,101,126,76,7,2,2,54,13,353
19,62,931,104,827,21,806,10,103,212,74,3,1,2,59,14,328
19,63,2338,263,2075,42,2033,19,326,464,174,21,7,5,140,40,837
19,64,83,5,78,3,75,0,14,15,10,2,0,0,5,2,27
19,65,60,8,52,1,51,3,17,8,2,0,0,0,5,3,13
19,66,1344,174,1170,26,1144,14,206,223,129,3,4,3,77,18,467
19,67,196,16,180,4,176,1,20,42,14,2,1,0,18,0,78
19,68,562,54,508,12,496,9,86,94,61,4,0,1,42,6,193
19,69,160,28,132,3,129,2,13,49,6,1,2,0,12,3,41
19,70,312,38,274,3,271,9,39,47,24,6,1,0,21,4,120
19,71,204,15,189,1,188,3,9,30,56,3,3,0,16,4,64
19,72,2001,238,1763,25,1738,22,287,406,171,16,6,2,144,32,652
19,73,2418,369,2049,40,2009,26,253,536,189,25,4,2,129,29,816
19,74,39,3,36,0,36,1,3,5,6,3,0,0,9,1,8
19,75,293,33,260,6,254,2,24,42,35,3,1,1,16,7,123
19,76,337,37,300,4,296,6,37,49,60,1,3,1,24,3,112
19,77,104,12,92,0,92,1,15,29,13,1,0,0,4,1,28
19,78,328,26,302,12,290,5,25,62,49,1,2,0,25,5,116
19,79,396,46,350,3,347,2,66,79,49,5,0,1,28,14,103
19,80,480,75,405,9,396,2,43,86,31,9,2,0,44,10,169
19,81,473,69,404,5,399,6,54,92,63,4,1,0,21,4,154
19,82,837,77,760,25,735,6,83,131,114,11,1,0,31,9,349
19,83,117,14,103,2,101,1,14,16,13,1,0,0,9,4,43
19,84,266,49,217,2,215,2,22,48,20,0,0,0,12,7,104
19,85,622,57,565,21,544,11,67,88,46,6,0,1,30,12,283
19,86,291,58,233,1,232,3,32,55,21,1,0,0,21,2,97
19,87,100,14,86,5,81,1,6,10,32,2,0,0,6,1,23
19,88,61,2,59,2,57,0,0,1,30,1,0,0,1,0,24
19,89,164,16,148,1,147,2,18,16,26,2,1,0,10,2,70
19,90,104,10,94,2,92,0,14,21,8,0,0,2,7,0,40
19,91,242,34,208,9,199,0,18,36,32,2,0,0,13,2,96
19,92,96,14,82,1,81,1,4,12,11,3,1,0,5,1,43
19,93,654,57,597,11,586,13,104,115,95,5,1,1,33,12,207
19,94,907,120,787,18,769,9,120,148,78,14,3,0,48,11,338
19,95,120,24,96,1,95,3,9,21,18,0,0,0,7,1,36
19,96,416,53,363,5,358,1,33,60,39,1,0,0,29,7,188
19,97,128,12,116,2,114,4,17,16,11,0,2,0,11,2,51
19,98,681,67,614,15,599,12,53,98,83,6,3,0,40,8,296
19,99,189,24,165,3,162,0,32,40,10,1,1,0,20,2,56
19,100,884,129,755,11,744,4,83,130,143,8,4,0,38,19,315
19,101,1030,133,897,17,880,19,95,117,102,8,6,1,32,11,489
19,102,266,36,230,4,226,0,30,43,59,1,2,0,5,2,84
19,103,72,6,66,5,61,1,7,10,3,1,1,1,16,2,19
19,104,85,14,71,0,71,0,7,21,10,0,0,0,7,2,24
19,105,454,62,392,9,383,9,58,70,37,5,1,0,38,11,154
19,106,323,36,287,4,283,7,26,63,36,3,1,1,19,3,124
19,107,1213,138,1075,17,1058,11,184,241,110,6,3,2,73,22,406
19,108,92,8,84,3,81,0,15,22,3,1,0,0,10,0,30
19,109,138,14,124,7,117,0,16,9,11,1,2,2,5,3,68
19,110,141,16,125,2,123,0,17,25,11,2,1,0,4,1,62
19,111,96,12,84,1,83,2,9,14,15,3,0,0,4,1,35
19,112,88,14,74,1,73,3,7,16,23,3,2,0,3,3,13
19,113,506,77,429,17,412,8,52,100,40,3,2,0,42,8,157
19,114,164,12,152,3,149,1,24,31,11,0,3,0,20,5,54
19,115,259,23,236,5,231,4,17,67,26,3,0,1,24,8,81
19,116,194,11,183,2,181,4,27,34,15,2,1,1,15,2,80
19,117,558,68,490,12,478,8,100,107,51,6,3,2,42,7,152
19,118,706,72,634,14,620,6,52,166,59,9,1,1,39,17,270
19,119,109,12,97,4,93,0,9,17,14,4,0,1,10,1,37
19,120,194,34,160,4,156,1,24,29,18,2,0,0,15,5,62
19,121,1856,314,1542,51,1491,21,194,380,93,21,9,5,119,40,609
19,122,174,24,150,3,147,2,11,27,15,1,2,0,13,4,72
19,123,5592,683,4909,99,4810,53,701,1129,384,54,18,14,340,77,2040
19,124,1046,107,939,20,919,10,116,165,101,15,5,1,59,16,431
19,125,810,80,730,10,720,6,88,161,86,7,1,3,43,14,311
19,126,177,22,155,2,153,6,25,29,11,3,4,0,12,3,60
19,127,134,15,119,1,118,0,11,14,16,2,1,0,12,1,61
19,128,218,23,195,3,192,0,32,52,30,4,0,1,13,3,57
19,129,534,56,478,11,467,6,80,111,36,0,3,2,27,5,197
19,130,314,37,277,4,273,5,33,74,32,1,1,0,20,9,98
19,131,460,58,402,4,398,6,64,121,43,2,1,1,12,7,141
19,132,86,14,72,1,71,2,8,6,9,0,1,0,3,2,40
19,133,237,42,195,6,189,0,22,42,16,2,4,0,19,8,76
19,134,572,72,500,8,492,1,87,69,41,11,4,0,26,10,243
19,135,299,32,267,5,262,3,37,52,31,4,3,0,25,4,103
19,136,1862,325,1537,24,1513,18,208,317,203,9,4,2,110,28,614
19,137,61,9,52,2,50,2,2,12,10,2,0,2,4,0,16
19,138,1037,147,890,16,874,10,134,218,95,15,1,0,59,9,333
19,139,77,11,66,0,66,1,8,17,18,1,0,0,3,2,16
19,140,577,62,515,11,504,9,54,141,50,9,2,1,42,8,188
19,141,165,22,143,2,141,1,28,29,20,1,1,0,9,0,52
19,142,135,16,119,4,115,1,25,37,7,1,1,0,13,3,27
19,143,482,51,431,13,418,4,51,99,54,7,5,0,15,6,177
19,144,191,27,164,1,163,2,20,43,12,1,0,0,10,2,73
19,145,363,37,326,5,321,5,45,56,67,4,4,1,20,6,113
19,146,1879,187,1692,24,1668,33,161,257,193,9,5,1,113,25,871
19,147,474,58,416,8,408,4,72,98,34,0,1,2,23,8,166
19,148,1279,178,1101,37,1064,23,147,232,115,12,2,1,60,16,456
19,149,207,29,178,2,176,5,19,19,25,0,0,0,11,2,95
19,150,322,32,290,1,289,7,41,52,32,0,0,1,29,6,121
19,151,647,71,576,8,568,12,95,102,93,4,2,1,32,12,215
19,152,357,37,320,5,315,6,48,47,55,2,0,2,16,5,134
19,153,2866,429,2437,53,2384,25,320,664,211,21,11,5,135,32,960
19,154,290,33,257,5,252,6,37,62,17,0,0,0,29,3,98
19,155,219,18,201,6,195,6,18,25,23,1,2,1,22,0,97
19,156,109,8,101,3,98,3,19,25,8,1,1,1,9,1,30
19,157,190,27,163,2,161,0,37,25,32,3,2,0,8,3,51
19,158,161,24,137,1,136,2,18,11,21,3,0,0,9,0,72
19,159,96,14,82,5,77,1,5,16,18,2,0,0,8,1,26
19,160,186,21,165,1,164,1,22,35,33,2,0,0,16,5,50
19,161,393,25,368,8,360,7,43,88,38,2,2,1,21,4,154
19,162,858,81,777,13,764,9,94,157,83,5,2,0,53,8,353
19,163,243,18,225,2,223,5,25,45,28,3,0,0,17,7,93
19,164,578,62,516,7,509,15,35,77,100,15,3,1,23,6,234
19,165,130,6,124,4,120,6,10,32,18,0,1,1,5,2,45
19,166,91,8,83,2,81,2,8,4,8,0,0,0,13,3,43
19,167,54,6,48,2,46,1,3,10,2,0,2,0,8,1,19
19,168,101,13,88,1,87,1,9,4,40,3,1,0,3,0,26
19,169,236,28,208,4,204,1,29,53,23,0,0,0,12,6,80
19,170,167,16,151,4,147,3,13,40,12,4,1,0,6,3,65
19,171,174,17,157,4,153,1,12,31,22,3,2,0,17,2,63
19,172,129,16,113,4,109,0,12,33,6,1,0,0,4,1,52
19,173,266,36,230,7,223,1,26,87,19,1,3,0,26,2,58
19,174,146,23,123,2,121,1,12,26,19,2,0,0,8,0,53
19,175,88,16,72,3,69,1,11,15,8,0,0,0,0,2,32
19,176,914,111,803,19,784,5,94,116,90,16,4,5,61,11,382
19,177,152,16,136,2,134,2,32,16,15,3,0,0,4,1,61
19,178,692,78,614,16,598,9,93,71,84,3,1,2,56,10,269
19,179,180,15,165,4,161,9,17,36,12,0,0,1,14,6,66
19,180,596,62,534,5,529,12,91,108,54,6,2,2,36,19,199
19,181,390,47,343,11,332,8,41,65,40,4,1,1,29,8,135
19,182,691,77,614,10,604,9,95,129,66,7,2,0,47,16,233
19,183,133,17,116,2,114,8,11,19,13,1,0,0,10,1,51
19,184,143,19,124,4,120,2,17,18,8,0,0,0,12,2,61
19,185,173,17,156,0,156,3,17,17,29,1,0,0,6,0,83
19,186,175,30,145,3,142,3,25,23,21,4,2,0,8,0,56
19,187,311,34,277,9,268,2,37,39,26,3,2,0,22,3,134
19,188,283,24,259,6,253,3,38,67,22,1,0,0,13,8,101
19,189,45,7,38,1,37,1,7,13,3,1,0,0,3,0,9
19,190,167,27,140,1,139,2,19,38,9,1,1,0,14,2,53
19,191,527,79,448,16,432,4,90,76,38,3,0,1,33,8,179
19,192,412,53,359,2,357,6,35,46,72,3,0,1,22,2,170
19,193,162,18,144,5,139,1,13,44,16,2,1,1,11,0,50
19,194,1036,109,927,15,912,7,88,104,147,5,3,3,44,9,502
19,195,285,19,266,7,259,2,53,62,18,2,0,1,14,8,99
19,196,356,33,323,8,315,1,51,46,37,3,1,0,21,7,148
19,198,100,20,80,4,76,2,8,20,7,0,0,0,4,1,34
19,199,233,25,208,2,206,2,24,54,23,1,0,0,17,3,82
19,200,77,10,67,2,65,2,11,19,11,1,0,0,12,1,8
19,201,540,71,469,7,462,1,83,95,62,5,6,1,43,8,158
19,202,1495,154,1341,24,1317,12,186,327,101,12,1,1,103,30,544
19,203,1523,149,1374,43,1331,21,141,204,124,12,5,2,93,15,714
19,204,255,31,224,4,220,4,33,57,20,1,2,0,12,5,86
19,205,97,15,82,1,81,0,5,22,5,2,1,0,10,0,36
19,206,85,19,66,1,65,0,12,5,14,0,1,0,4,1,28
19,207,820,85,735,10,725,5,96,159,79,9,2,0,40,14,321
19,208,201,29,172,6,166,4,27,23,23,5,1,0,11,1,71
19,209,150,15,135,4,131,2,9,37,39,1,0,0,13,2,28
19,210,78,9,69,1,68,4,5,4,19,0,0,0,4,0,32
19,211,783,98,685,8,677,12,75,124,68,12,6,1,30,9,340
19,212,84,8,76,0,76,0,9,16,14,0,0,0,1,1,35
19,213,506,35,471,3,468,4,61,111,58,5,1,0,31,10,187
19,214,419,71,348,9,339,4,38,81,27,0,3,0,34,6,146
19,215,124,24,100,3,97,1,16,19,4,0,1,0,4,1,51
19,216,233,34,199,4,195,2,37,33,11,3,0,0,10,5,94
19,217,152,16,136,0,136,1,16,36,13,3,1,0,9,0,57
19,218,382,73,309,8,301,7,41,57,34,4,2,0,23,2,131
19,219,48,6,42,1,41,4,5,9,5,0,1,1,2,3,11
19,220,420,49,371,8,363,3,44,77,35,3,0,0,18,7,176
19,221,93,9,84,1,83,2,3,27,18,0,2,0,2,1,28
19,222,349,32,317,6,311,2,26,55,67,3,1,0,14,6,137
19,223,231,29,202,6,196,1,28,57,9,0,2,0,18,4,77
19,225,160,25,135,0,135,4,16,19,22,2,1,0,10,2,59
19,226,114,13,101,1,100,1,19,34,12,0,0,1,6,0,27
19,227,1021,79,942,21,921,14,99,90,174,6,4,2,29,8,495
19,228,68,9,59,0,59,9,2,5,6,2,0,0,1,3,31
19,229,3744,500,3244,64,3180,28,510,685,314,27,12,3,241,38,1322
19,230,292,27,265,4,261,0,40,72,8,3,0,0,23,6,109
19,231,160,20,140,0,140,5,15,25,25,2,0,0,9,0,59
19,232,79,4,75,0,75,0,8,10,9,1,0,0,8,1,38
19,233,242,27,215,3,212,3,33,41,21,1,1,0,21,6,85
19,234,406,46,360,8,352,2,44,51,60,3,3,1,21,7,160
19,235,216,15,201,9,192,1,19,42,33,1,0,2,15,5,74
19,236,405,43,362,5,357,0,55,49,40,6,4,0,29,6,168
19,237,861,99,762,12,750,8,99,195,49,15,3,5,40,5,331
19,238,207,28,179,7,172,0,25,35,23,2,1,0,11,1,74
19,239,300,26,274,8,266,0,37,61,16,4,0,0,28,3,117
19,240,285,35,250,2,248,5,28,55,24,0,0,1,18,10,107
19,241,255,38,217,3,214,3,25,71,32,0,0,1,10,4,68
19,242,329,38,291,1,290,9,40,58,23,3,0,1,23,4,129
19,243,758,91,667,15,652,3,78,178,29,7,4,2,59,15,277
19,244,83,13,70,2,68,4,8,14,15,2,0,0,4,1,20
19,245,110,24,86,5,81,4,6,16,5,0,0,0,5,1,44
19,246,1354,144,1210,26,1184,10,190,223,93,13,5,2,99,22,527
19,247,181,17,164,1,163,3,27,43,21,5,0,0,13,3,48
19,248,555,61,494,11,483,3,81,110,42,7,2,1,47,12,178
19,249,351,43,308,7,301,10,40,48,61,4,3,1,16,2,116
19,250,568,87,481,7,474,7,86,95,38,6,0,1,48,12,181
19,251,240,24,216,4,212,4,24,63,15,3,0,0,27,5,71
19,252,338,55,283,7,276,1,51,52,15,6,2,2,27,4,116
19,253,207,32,175,3,172,2,22,36,37,0,3,0,6,3,63
19,254,186,24,162,1,161,0,23,30,13,1,1,1,15,3,74
19,255,1432,146,1286,35,1251,20,161,314,128,9,5,2,92,26,494
19,256,325,52,273,7,266,4,33,64,27,6,1,0,21,0,110
19,257,257,29,228,5,223,2,27,49,29,2,0,2,10,5,97
19,258,444,57,387,6,381,7,50,56,45,5,1,0,29,5,183
19,259,193,30,163,3,160,4,22,39,11,0,0,1,18,4,61
19,260,212,24,188,3,185,8,19,39,16,0,2,1,18,6,76
19,261,556,72,484,4,480,4,64,105,58,3,3,0,36,4,203
19,262,161,19,142,4,138,0,19,36,23,4,0,2,16,1,37
19,263,263,25,238,9,229,6,42,58,32,2,2,1,10,0,76
19,264,426,44,382,10,372,3,50,118,31,5,1,0,40,10,114
19,265,313,60,253,0,253,0,30,66,62,4,4,0,9,6,72
19,266,84,11,73,1,72,2,9,9,4,4,0,0,12,2,30
19,268,46,3,43,1,42,0,2,12,13,2,0,0,4,2,7
19,269,1070,130,940,25,915,8,104,233,131,5,3,2,53,27,349
19,270,425,54,371,15,356,1,35,65,28,2,0,3,25,1,196
19,271,213,35,178,0,178,1,24,46,16,1,4,1,6,1,78
19,272,9859,1746,8113,129,7984,116,729,1252,749,81,20,13,420,101,4503
19,273,685,86,599,9,590,15,87,144,64,8,4,1,57,11,199
19,274,3174,377,2797,68,2729,24,394,715,187,22,12,5,234,41,1095
19,275,6773,1244,5529,144,5385,64,741,1196,477,67,30,9,365,97,2339
19,276,1952,360,1592,37,1555,24,213,342,184,15,6,4,80,27,660
19,277,149,11,138,4,134,1,26,53,4,2,1,0,1,4,42
19,278,1751,197,1554,34,1520,19,247,329,151,14,2,4,128,36,590
19,279,248,24,224,6,218,6,37,49,15,3,0,0,23,3,82
19,280,159,14,145,1,144,1,15,46,11,0,0,0,9,6,56
19,281,84,12,72,2,70,2,4,13,23,1,0,0,6,3,18
19,282,425,52,373,4,369,4,69,60,34,5,2,0,18,6,171
19,283,65,8,57,3,54,0,12,9,7,0,0,0,3,2,21
19,284,101,11,90,4,86,2,12,15,23,2,1,0,7,5,19
19,285,968,124,844,15,829,12,123,145,114,4,2,0,46,12,371
19,286,475,60,415,11,404,5,57,69,45,5,2,1,15,8,197
19,287,203,16,187,5,182,4,28,44,7,7,0,1,11,2,78
19,288,968,112,856,13,843,11,114,189,101,2,3,1,49,19,354
19,289,597,55,542,16,526,7,90,93,74,5,1,1,49,8,198
2A,1,2263,444,1819,35,1784,32,500,371,161,15,3,5,87,23,587
2A,4,33346,8684,24662,405,24257,497,6615,7232,2319,264,74,60,1258,230,5708
2A,6,2573,582,1991,41,1950,47,618,453,242,17,4,4,108,18,439
2A,8,1109,248,861,17,844,22,238,268,86,6,5,3,49,12,155
2A,11,72,21,51,1,50,1,12,18,4,0,0,0,2,0,13
2A,14,68,8,60,3,57,0,12,16,2,7,4,0,3,1,12
2A,17,1314,325,989,19,970,24,315,269,96,17,0,4,46,8,191
2A,18,128,47,81,3,78,0,34,5,18,1,0,0,0,2,18
2A,19,89,19,70,0,70,5,12,26,2,1,0,0,2,0,22
2A,21,116,22,94,2,92,0,16,46,9,1,0,0,5,1,14
2A,22,103,32,71,1,70,2,16,24,6,1,0,2,12,1,6
2A,24,236,87,149,7,142,4,25,52,10,4,1,0,13,2,31
2A,26,147,28,119,4,115,2,38,29,14,0,1,0,1,1,29
2A,27,81,24,57,1,56,0,11,20,1,5,0,0,2,0,17
2A,28,242,94,148,3,145,1,21,64,5,2,0,0,7,0,45
2A,31,588,200,388,12,376,7,75,142,52,4,1,2,18,2,73
2A,32,2596,668,1928,16,1912,51,524,550,218,17,6,2,98,15,431
2A,35,233,33,200,1,199,3,19,69,24,7,1,0,11,4,61
2A,38,61,13,48,0,48,2,4,4,30,1,0,0,1,0,6
2A,40,473,127,346,10,336,16,54,130,16,6,5,1,20,3,85
2A,41,2432,549,1883,34,1849,49,458,654,194,13,0,3,86,18,374
2A,48,562,134,428,12,416,8,112,156,27,5,0,1,27,4,76
2A,56,132,24,108,4,104,3,34,38,3,5,0,1,3,1,16
2A,60,88,21,67,0,67,4,9,21,5,1,0,0,0,9,18
2A,61,135,39,96,4,92,1,12,43,9,4,0,0,2,2,19
2A,62,294,89,205,6,199,7,56,50,34,5,1,0,12,3,31
2A,64,59,14,45,2,43,0,15,18,1,0,0,1,3,0,5
2A,65,931,255,676,17,659,21,163,248,53,6,3,2,23,6,134
2A,66,63,12,51,1,50,0,8,23,5,2,0,1,1,3,7
2A,70,405,119,286,5,281,3,80,116,12,3,0,0,22,4,41
2A,71,178,66,112,1,111,2,22,30,29,0,1,0,6,0,21
2A,85,1000,232,768,6,762,26,189,225,72,4,2,3,52,10,179
2A,89,199,41,158,2,156,0,15,124,3,2,0,0,5,0,7
2A,90,700,224,476,6,470,6,112,174,34,8,3,0,19,9,105
2A,91,243,63,180,0,180,1,43,73,12,1,0,0,7,1,42
2A,92,826,240,586,13,573,19,118,238,28,8,0,2,51,13,96
2A,94,146,13,133,1,132,0,0,114,10,0,0,0,3,0,5
2A,98,711,159,552,9,543,13,140,226,38,4,2,1,26,7,86
2A,99,316,119,197,5,192,5,46,45,14,1,0,0,7,1,73
2A,100,64,18,46,0,46,0,5,16,6,1,1,1,3,0,13
2A,103,1517,440,1077,24,1053,23,302,272,118,14,2,0,59,11,252
2A,104,784,183,601,9,592,23,141,164,61,5,4,1,51,9,133
2A,108,204,66,138,4,134,4,31,35,15,2,0,0,9,0,38
2A,114,1014,297,717,13,704,19,163,206,57,9,7,1,46,22,174
2A,115,139,42,97,4,93,3,28,26,15,2,0,0,3,2,14
2A,117,109,23,86,2,84,1,10,32,11,1,0,0,5,0,24
2A,118,198,39,159,7,152,6,42,48,10,6,1,0,8,0,31
2A,119,186,36,150,2,148,1,41,52,7,0,0,0,3,0,44
2A,127,101,33,68,3,65,2,11,22,11,1,0,0,1,1,16
2A,128,105,41,64,2,62,1,16,16,6,0,0,0,4,0,19
2A,129,73,15,58,1,57,0,4,23,7,0,1,0,6,1,15
2A,130,2456,603,1853,35,1818,38,449,738,128,18,5,1,115,20,306
2A,131,197,51,146,1,145,8,30,40,2,1,0,3,7,0,54
2A,132,139,18,121,1,120,0,9,97,2,0,0,0,4,3,5
2A,133,180,52,128,2,126,1,19,40,16,1,1,0,15,5,28
2A,139,896,222,674,12,662,9,168,253,50,9,0,2,43,10,118
2A,141,226,74,152,3,149,2,53,30,15,2,0,1,5,0,41
2A,142,658,162,496,13,483,11,104,139,49,10,0,0,37,10,123
2A,144,179,60,119,0,119,6,39,21,10,8,0,0,4,0,31
2A,146,62,14,48,1,47,0,5,13,14,0,0,0,2,0,13
2A,154,178,59,119,4,115,8,22,31,3,1,0,0,2,3,45
2A,158,70,27,43,1,42,1,11,18,2,0,0,0,3,0,7
2A,160,277,71,206,3,203,4,42,59,15,5,1,0,30,2,45
2A,163,464,114,350,2,348,4,83,94,42,2,2,1,16,6,98
2A,174,120,27,93,4,89,1,19,10,13,0,1,0,1,3,41
2A,181,365,56,309,5,304,8,77,44,82,10,0,2,13,3,65
2A,186,310,89,221,6,215,2,67,83,7,1,1,0,7,1,46
2A,189,1165,319,846,10,836,16,233,266,61,11,1,1,37,5,205
2A,191,82,19,63,1,62,2,22,15,9,0,0,1,5,0,8
2A,196,143,47,96,1,95,2,17,45,4,1,0,0,10,0,16
2A,197,144,31,113,1,112,29,25,35,3,3,0,0,3,0,14
2A,198,487,119,368,3,365,11,99,106,40,3,3,0,4,5,94
2A,200,254,98,156,1,155,1,56,58,2,1,0,1,4,0,32
2A,203,112,35,77,0,77,2,12,39,2,0,0,1,2,0,19
2A,204,170,71,99,4,95,0,31,22,14,0,0,0,3,1,24
2A,209,1517,422,1095,14,1081,30,313,306,106,15,4,2,69,8,228
2A,211,594,173,421,7,414,7,84,154,68,3,1,0,22,4,71
2A,212,462,107,355,7,348,6,41,91,19,1,0,0,26,4,160
2A,215,668,162,506,6,500,5,140,210,34,5,4,0,25,14,63
2A,228,1032,235,797,11,786,12,192,291,73,5,1,1,44,11,156
2A,232,275,76,199,4,195,6,33,83,17,0,0,1,11,1,43
2A,240,146,31,115,3,112,0,38,28,6,2,0,0,0,0,38
2A,247,8281,2170,6111,110,6001,152,1421,2108,521,69,11,11,388,73,1247
2A,249,2171,566,1605,38,1567,44,417,459,103,21,4,5,75,20,419
2A,253,86,27,59,0,59,1,12,35,1,0,1,0,2,2,5
2A,254,285,70,215,1,214,4,39,76,32,3,0,1,6,2,51
2A,258,190,64,126,0,126,5,17,63,11,0,0,0,7,1,22
2A,259,98,39,59,0,59,1,14,32,3,0,0,0,2,1,6
2A,262,110,37,73,1,72,0,41,14,7,2,0,0,5,1,2
2A,266,124,45,79,0,79,1,19,28,2,2,1,0,3,0,23
2A,268,100,23,77,4,73,0,14,33,7,1,0,0,12,0,6
2A,269,1205,281,924,16,908,14,228,343,74,7,2,1,106,12,121
2A,270,336,79,257,3,254,3,58,82,17,9,2,2,14,2,65
2A,271,1746,433,1313,14,1299,17,457,332,94,25,2,5,68,9,290
2A,272,2369,555,1814,48,1766,26,393,459,372,16,3,3,97,22,375
2A,276,490,118,372,15,357,12,33,157,41,7,0,2,26,6,73
2A,278,141,43,98,1,97,4,15,38,8,1,0,0,11,1,19
2A,279,144,42,102,0,102,0,13,35,11,1,0,0,3,1,38
2A,282,218,42,176,5,171,9,22,73,6,3,0,1,8,6,43
2A,284,347,85,262,6,256,5,47,52,70,1,0,2,8,5,66
2A,285,103,25,78,0,78,2,5,44,7,2,0,0,4,0,14
2A,288,909,200,709,7,702,24,171,259,69,6,1,0,37,4,131
2A,295,89,25,64,1,63,2,14,21,4,1,0,0,3,1,17
2A,300,859,218,641,9,632,17,143,242,67,14,6,0,39,5,99
2A,308,548,134,414,5,409,4,89,167,43,2,1,2,14,9,78
2A,310,94,20,74,1,73,2,26,29,6,0,0,0,4,0,6
2A,312,399,102,297,3,294,3,83,81,19,4,0,0,6,1,97
2A,322,270,129,141,5,136,6,19,96,6,0,0,0,3,0,6
2A,323,263,82,181,1,180,3,59,50,12,2,1,0,5,1,47
2A,324,420,127,293,2,291,13,60,79,29,3,2,1,11,4,89
2A,326,173,28,145,2,143,6,13,40,33,5,0,1,8,4,33
2A,330,487,136,351,3,348,8,102,79,42,3,1,0,17,1,95
2A,331,75,30,45,1,44,0,12,13,2,1,0,0,4,0,12
2A,336,299,60,239,2,237,12,58,84,17,4,0,0,12,0,50
2A,345,335,96,239,1,238,2,66,52,43,4,1,1,10,2,57
2A,348,956,265,691,12,679,6,166,261,37,18,6,3,31,3,148
2A,349,456,124,332,1,331,8,97,60,69,4,7,1,23,0,62
2A,351,315,55,260,4,256,9,68,62,26,5,2,1,19,0,64
2A,357,49,11,38,0,38,3,3,4,7,1,1,0,3,0,16
2A,358,90,23,67,1,66,2,8,39,8,1,0,0,1,0,7
2A,359,317,123,194,1,193,0,35,106,6,1,3,0,4,2,36
2A,360,179,39,140,0,140,1,42,52,6,3,0,0,10,1,25
2A,362,1700,378,1322,24,1298,26,350,489,119,14,2,1,93,16,188
2A,363,76,28,48,0,48,2,14,20,4,0,2,0,2,0,4
2B,2,171,26,145,0,145,5,30,57,20,4,0,0,6,1,22
2B,3,73,17,56,1,55,1,3,15,11,0,1,0,4,0,20
2B,5,33,14,19,0,19,2,2,5,2,0,0,0,0,0,8
2B,7,358,107,251,4,247,2,37,43,21,0,1,0,5,3,135
2B,9,1263,373,890,16,874,8,288,305,46,4,2,2,34,7,178
2B,10,253,45,208,4,204,7,40,90,8,1,0,0,5,1,52
2B,12,118,48,70,1,69,1,5,13,7,0,2,0,8,3,30
2B,13,38,11,27,0,27,1,0,0,4,3,0,0,0,0,19
2B,15,25,4,21,0,21,1,1,4,0,0,0,0,1,4,10
2B,16,462,135,327,2,325,2,54,73,24,3,0,1,15,7,146
2B,20,462,123,339,9,330,5,72,108,29,4,0,0,2,6,104
2B,23,176,46,130,1,129,5,22,33,13,1,0,1,9,1,44
2B,25,110,33,77,2,75,2,9,15,11,1,0,1,1,0,35
2B,29,194,45,149,6,143,3,34,37,22,1,1,1,11,2,31
2B,30,210,41,169,1,168,4,22,62,23,3,0,0,5,3,46
2B,33,19805,5100,14705,284,14421,314,3651,3549,1761,195,50,38,684,143,4036
2B,34,402,89,313,3,310,16,69,96,32,5,0,0,17,5,70
2B,36,101,22,79,0,79,3,4,7,6,0,0,0,3,0,56
2B,37,4508,906,3602,73,3529,56,1111,1144,304,28,12,11,178,48,637
2B,39,253,71,182,1,181,1,36,54,15,3,0,0,8,0,64
2B,42,4290,1034,3256,80,3176,63,793,1559,178,34,7,8,110,23,401
2B,43,1352,248,1104,12,1092,30,234,390,97,16,9,2,66,14,234
2B,45,103,21,82,1,81,0,11,56,6,0,0,0,0,0,8
2B,46,216,50,166,3,163,2,37,55,22,3,1,1,8,4,30
2B,47,524,180,344,10,334,8,52,169,16,3,0,0,13,1,72
2B,49,1652,431,1221,24,1197,30,368,373,85,13,5,3,57,17,246
2B,50,3752,982,2770,44,2726,62,662,1234,173,26,7,7,115,28,412
2B,51,121,36,85,2,83,6,12,37,7,0,0,0,8,1,12
2B,52,94,20,74,0,74,3,2,51,2,0,0,0,2,0,14
2B,53,36,18,18,0,18,0,1,7,2,0,0,0,1,0,7
2B,54,286,45,241,10,231,4,34,72,28,2,2,0,8,0,81
2B,55,165,36,129,1,128,4,25,34,9,2,1,0,3,1,49
2B,57,249,73,176,0,176,4,40,28,12,1,0,0,5,0,86
2B,58,296,75,221,6,215,4,32,73,32,4,6,0,6,2,56
2B,59,255,61,194,2,192,3,49,37,13,5,0,4,7,1,73
2B,63,56,21,35,0,35,5,5,3,9,1,0,0,5,0,7
2B,67,44,19,25,1,24,0,2,6,1,0,0,0,0,0,15
2B,68,77,22,55,2,53,0,3,9,4,1,0,0,3,1,32
2B,69,157,42,115,3,112,1,12,31,8,2,0,0,6,0,52
2B,72,58,18,40,2,38,0,4,11,1,0,0,0,1,1,20
2B,73,311,133,178,5,173,7,27,57,9,1,4,2,5,3,58
2B,74,255,63,192,5,187,7,19,38,38,4,0,0,10,0,71
2B,75,62,14,48,0,48,1,0,2,7,0,0,0,2,0,36
2B,77,419,100,319,17,302,2,57,114,29,1,1,0,25,2,71
2B,78,71,17,54,3,51,1,9,23,5,1,0,0,3,0,9
2B,79,466,113,353,6,347,10,117,72,41,6,2,3,15,6,75
2B,80,209,36,173,2,171,4,43,26,19,0,1,1,11,2,64
2B,81,73,16,57,1,56,1,20,19,2,1,1,0,4,1,7
2B,82,55,27,28,1,27,1,2,4,2,1,0,0,5,3,9
2B,83,213,60,153,3,150,1,39,47,6,6,0,0,6,0,45
2B,84,177,42,135,1,134,3,31,57,6,5,0,0,2,0,30
2B,86,233,67,166,3,163,1,40,49,54,1,0,0,1,0,17
2B,87,1523,476,1047,17,1030,24,263,405,35,8,3,2,39,5,246
2B,88,195,61,134,0,134,5,29,45,6,2,0,0,5,0,42
2B,93,737,162,575,13,562,22,108,179,70,9,0,1,27,5,141
2B,95,241,81,160,2,158,8,18,25,26,0,0,0,5,2,74
2B,96,3760,1088,2672,68,2604,61,516,773,212,40,9,6,140,27,820
2B,97,73,14,59,2,57,4,10,18,2,1,0,0,1,0,21
2B,101,106,33,73,0,73,2,32,11,11,0,2,0,0,0,15
2B,102,101,23,78,1,77,0,7,9,0,0,0,0,4,0,57
2B,105,122,19,103,2,101,2,10,24,23,2,1,0,2,0,37
2B,106,19,5,14,0,14,3,2,1,1,0,0,0,0,0,7
2B,107,239,52,187,4,183,0,49,90,9,2,0,0,5,0,28
2B,109,252,37,215,1,214,6,35,86,10,4,0,0,9,2,62
2B,110,63,25,38,0,38,1,3,16,5,2,0,0,1,0,10
2B,111,84,20,64,0,64,0,12,16,5,0,0,0,15,1,15
2B,112,205,50,155,5,150,17,26,55,15,3,0,0,7,2,25
2B,113,97,26,71,0,71,0,12,16,8,0,0,0,5,0,30
2B,116,58,20,38,0,38,0,6,7,1,0,0,0,2,0,22
2B,120,3776,885,2891,46,2845,62,854,759,308,28,3,8,122,38,663
2B,121,404,103,301,2,299,15,62,91,34,2,0,0,19,10,66
2B,122,62,15,47,1,46,0,16,11,3,1,0,1,0,1,13
2B,123,2215,652,1563,24,1539,30,330,644,89,22,2,3,73,16,330
2B,124,469,148,321,8,313,3,40,154,30,2,2,1,12,2,67
2B,125,57,14,43,0,43,2,8,16,3,1,1,0,0,1,11
2B,126,73,19,54,0,54,0,5,19,6,0,0,0,1,1,22
2B,134,2210,613,1597,22,1575,26,339,630,95,14,3,3,85,17,363
2B,135,497,184,313,0,313,5,60,51,57,3,0,1,2,3,131
2B,136,175,31,144,1,143,3,19,59,12,1,0,0,12,4,33
2B,137,32,8,24,0,24,1,6,4,0,0,0,0,1,0,12
2B,138,128,33,95,3,92,3,24,24,9,0,0,0,4,1,27
2B,140,131,31,100,3,97,1,9,32,6,0,0,0,1,1,47
2B,143,635,189,446,2,444,14,106,124,34,5,1,3,11,2,144
2B,145,292,108,184,1,183,3,24,64,42,1,1,3,0,8,37
2B,147,299,142,157,1,156,8,30,22,28,1,0,0,11,3,53
2B,148,2806,724,2082,33,2049,49,661,648,149,17,5,0,101,26,393
2B,149,136,69,67,0,67,1,15,16,13,0,0,0,3,0,19
2B,150,867,170,697,14,683,22,183,258,67,4,0,0,41,7,101
2B,152,696,163,533,12,521,20,114,103,76,14,7,3,26,8,150
2B,153,137,32,105,0,105,1,31,23,8,1,0,0,12,0,29
2B,155,77,30,47,2,45,0,6,19,2,0,0,0,2,0,16
2B,156,37,9,28,0,28,1,2,6,4,0,0,0,0,0,15
2B,157,49,34,15,1,14,0,5,6,0,0,0,0,1,0,2
2B,159,113,26,87,1,86,2,10,35,21,0,1,1,0,1,15
2B,161,95,25,70,3,67,2,14,10,12,1,0,0,4,2,22
2B,162,722,199,523,6,517,11,125,146,47,4,2,1,23,6,152
2B,164,46,16,30,0,30,1,0,4,6,0,1,0,1,0,17
2B,165,220,56,164,3,161,1,37,25,9,4,0,0,8,6,71
2B,166,578,177,401,6,395,15,112,149,29,0,0,1,13,3,73
2B,167,349,80,269,6,263,12,48,50,28,3,0,0,4,4,114
2B,168,1261,212,1049,15,1034,25,132,205,82,5,1,1,45,14,524
2B,169,868,275,593,18,575,10,144,118,69,5,0,0,38,5,186
2B,170,138,33,105,3,102,5,32,19,15,2,0,0,5,0,24
2B,171,58,10,48,0,48,1,1,5,10,0,1,0,0,0,30
2B,172,573,121,452,13,439,5,86,101,97,5,2,2,34,4,103
2B,173,274,92,182,2,180,8,35,25,34,3,1,0,8,3,63
2B,175,106,23,83,1,82,3,13,39,5,2,0,0,8,0,12
2B,176,103,19,84,0,84,0,14,16,4,0,0,0,3,0,47
2B,177,107,20,87,0,87,3,8,11,12,0,1,0,5,1,46
2B,178,116,31,85,5,80,1,8,33,9,1,0,0,8,0,20
2B,179,73,17,56,0,56,1,7,4,3,1,0,0,0,0,40
2B,180,126,34,92,1,91,0,19,38,12,1,0,0,2,0,19
2B,182,208,68,140,0,140,10,37,41,9,0,0,1,9,0,33
2B,183,113,21,92,3,89,13,8,7,12,1,0,0,0,2,46
2B,184,103,29,74,2,72,0,15,13,18,2,0,1,5,1,17
2B,185,1030,193,837,18,819,33,185,323,67,7,3,1,42,6,152
2B,187,175,53,122,5,117,2,21,57,12,1,0,0,6,1,17
2B,188,360,96,264,4,260,7,35,63,25,6,2,0,17,5,100
2B,190,223,69,154,0,154,6,32,30,15,2,0,0,6,1,62
2B,192,217,62,155,8,147,2,34,38,35,1,0,0,5,1,31
2B,193,470,112,358,7,351,8,82,126,30,4,1,0,24,4,72
2B,194,46,7,39,2,37,1,7,12,1,0,1,0,9,0,6
2B,195,160,32,128,1,127,2,7,4,16,0,0,0,1,0,97
2B,199,134,27,107,2,105,2,14,24,13,7,0,0,0,0,45
2B,201,224,71,153,2,151,2,13,93,2,1,0,0,3,0,37
2B,202,30,3,27,0,27,0,0,6,3,0,0,0,1,0,17
2B,205,604,160,444,17,427,16,103,101,54,5,2,0,19,9,118
2B,206,50,15,35,0,35,1,2,6,0,1,0,0,0,0,25
2B,207,1968,535,1433,24,1409,25,348,302,184,9,2,1,63,8,467
2B,208,124,35,89,3,86,1,6,2,6,0,0,0,0,0,71
2B,210,158,38,120,2,118,1,27,32,13,6,0,0,9,0,30
2B,213,110,41,69,0,69,0,8,11,11,0,0,0,1,0,38
2B,214,48,11,37,0,37,0,18,4,2,0,0,0,3,0,10
2B,216,26,4,22,2,20,2,7,10,0,0,0,0,1,0,0
2B,217,61,11,50,0,50,0,5,36,1,0,0,0,1,2,5
2B,218,178,49,129,1,128,6,18,50,11,0,0,0,6,2,35
2B,219,144,31,113,4,109,1,13,43,10,1,1,0,4,3,33
2B,220,110,29,81,2,79,1,13,24,17,2,0,0,6,0,16
2B,221,30,9,21,0,21,3,8,4,1,0,1,0,1,0,3
2B,222,101,61,40,0,40,0,10,18,2,0,0,0,2,0,8
2B,223,491,149,342,3,339,6,61,144,44,1,1,0,15,2,65
2B,224,579,103,476,11,465,13,98,163,78,12,1,1,15,7,77
2B,225,170,52,118,5,113,2,27,57,4,0,0,0,2,4,17
2B,226,112,23,89,0,89,3,11,22,10,0,1,0,11,0,31
2B,227,68,17,51,0,51,0,7,13,0,0,0,0,0,0,31
2B,229,419,202,217,3,214,3,28,44,22,3,1,0,3,3,107
2B,230,143,48,95,3,92,3,18,38,7,0,1,1,5,0,19
2B,231,91,23,68,4,64,10,7,13,8,1,0,1,2,1,21
2B,233,242,66,176,4,172,0,28,68,22,3,0,0,10,2,39
2B,234,82,18,64,3,61,4,7,21,3,1,2,0,0,1,22
2B,235,108,25,83,2,81,2,8,38,3,2,0,0,3,0,25
2B,236,266,73,193,2,191,0,30,80,20,1,0,0,9,4,47
2B,238,153,38,115,2,113,5,18,14,24,4,0,1,3,0,44
2B,239,183,36,147,4,143,6,25,47,17,0,3,0,9,3,33
2B,241,37,5,32,0,32,0,10,13,5,0,0,0,2,0,2
2B,242,424,87,337,7,330,2,113,110,22,7,4,0,11,4,57
2B,243,55,18,37,1,36,2,12,12,3,0,0,0,2,0,5
2B,244,98,26,72,1,71,0,29,19,6,0,0,0,4,0,13
2B,245,57,8,49,2,47,2,8,8,13,2,0,0,1,1,12
2B,246,330,90,240,11,229,0,24,167,11,0,2,0,5,0,20
2B,248,78,13,65,2,63,3,24,13,2,0,0,0,12,1,8
2B,250,185,42,143,0,143,5,46,14,47,2,1,0,6,5,17
2B,251,2354,721,1633,27,1606,35,449,613,107,20,5,3,67,13,294
2B,252,231,71,160,8,152,3,43,48,13,2,1,0,12,3,27
2B,255,89,23,66,2,64,4,15,16,2,3,0,1,5,0,18
2B,256,40,7,33,0,33,2,2,3,0,1,0,0,5,0,20
2B,257,139,27,112,0,112,4,22,28,22,0,2,0,15,0,19
2B,260,187,48,139,3,136,14,19,14,14,2,1,1,6,0,65
2B,261,553,134,419,8,411,15,59,141,61,7,5,2,24,5,92
2B,263,143,30,113,2,111,0,6,22,14,0,0,0,3,3,63
2B,264,110,19,91,1,90,1,5,73,3,1,1,0,2,0,4
2B,265,349,76,273,4,269,10,68,81,15,15,1,0,12,7,60
2B,267,87,24,63,2,61,8,2,6,5,0,1,0,1,0,38
2B,273,65,15,50,1,49,4,9,15,10,0,0,0,2,0,9
2B,274,135,35,100,4,96,3,28,40,6,0,0,0,4,4,11
2B,275,102,27,75,1,74,3,20,20,2,1,0,0,2,1,25
2B,277,370,136,234,5,229,4,84,60,12,9,1,0,14,2,43
2B,280,134,43,91,3,88,4,24,23,8,7,0,0,10,0,12
2B,281,897,198,699,14,685,15,179,157,97,7,3,2,29,6,190
2B,283,622,146,476,3,473,9,130,186,40,1,3,1,15,10,78
2B,286,552,143,409,2,407,5,84,148,52,6,0,1,19,2,90
2B,287,133,38,95,1,94,0,13,25,4,0,0,0,10,1,41
2B,289,117,32,85,2,83,2,22,28,1,2,1,0,2,1,24
2B,290,277,63,214,5,209,9,46,60,15,0,1,0,4,4,70
2B,291,64,6,58,3,55,3,4,36,1,0,0,0,2,1,8
2B,292,112,29,83,1,82,0,18,29,5,1,0,0,2,2,25
2B,293,417,69,348,2,346,0,8,48,14,0,1,0,7,2,266
2B,296,130,29,101,3,98,0,27,32,5,1,0,0,7,2,24
2B,297,58,15,43,2,41,0,13,9,3,1,0,1,2,0,12
2B,298,1468,309,1159,14,1145,22,239,498,88,7,5,2,80,14,190
2B,299,161,51,110,3,107,2,17,46,9,2,0,0,5,0,26
2B,301,77,12,65,0,65,0,20,16,9,0,0,0,2,1,17
2B,302,104,28,76,0,76,7,6,14,4,0,0,0,5,0,40
2B,303,435,124,311,8,303,5,45,152,15,3,0,1,15,5,62
2B,304,157,48,109,0,109,7,29,12,12,0,0,0,6,2,41
2B,305,2062,374,1688,40,1648,23,207,425,361,16,8,1,84,18,505
2B,306,163,65,98,0,98,14,9,20,10,2,1,0,4,2,36
2B,307,833,238,595,16,579,10,216,157,69,5,1,2,23,9,87
2B,309,1661,393,1268,13,1255,39,292,361,171,15,5,3,77,21,271
2B,311,540,142,398,11,387,12,142,91,30,1,1,0,14,8,88
2B,313,1126,286,840,9,831,15,219,241,78,14,3,2,30,4,225
2B,314,408,141,267,5,262,15,51,96,25,2,2,0,7,5,59
2B,315,283,50,233,4,229,7,22,42,28,1,0,0,7,4,118
2B,316,687,167,520,6,514,11,102,125,74,8,2,0,19,4,169
2B,317,120,35,85,1,84,1,5,17,21,0,0,0,0,2,38
2B,318,500,122,378,6,372,13,59,189,32,3,1,1,12,3,59
2B,319,523,165,358,4,354,12,106,116,18,3,0,0,15,8,76
2B,320,258,78,180,1,179,3,37,84,10,2,0,0,10,0,33
2B,321,56,13,43,1,42,1,9,18,1,1,0,0,2,0,10
2B,327,208,38,170,4,166,4,27,52,17,1,0,0,5,4,56
2B,328,167,48,119,3,116,2,15,25,13,2,2,0,3,3,51
2B,329,94,32,62,0,62,0,9,23,1,4,0,0,1,0,24
2B,332,182,50,132,4,128,3,1,44,15,6,0,2,16,0,41
2B,333,124,28,96,6,90,4,19,17,18,1,1,0,4,0,26
2B,334,178,53,125,1,124,3,25,39,3,0,0,1,5,1,47
2B,335,294,94,200,2,198,6,37,63,17,0,1,0,14,0,60
2B,337,185,59,126,1,125,0,21,48,19,1,0,0,6,2,28
2B,338,92,15,77,1,76,1,13,26,3,0,0,0,1,1,31
2B,339,39,12,27,0,27,0,4,12,0,0,0,0,0,1,10
2B,340,132,37,95,0,95,0,20,15,25,4,0,0,6,0,25
2B,341,664,136,528,8,520,13,93,91,54,1,2,0,17,9,240
2B,342,1712,441,1271,29,1242,17,450,380,88,17,7,2,67,14,200
2B,343,1078,374,704,11,693,22,198,179,59,5,2,3,35,7,183
2B,344,71,16,55,0,55,0,8,27,6,0,0,0,4,3,7
2B,346,1653,446,1207,29,1178,20,358,260,179,13,4,4,44,7,289
2B,347,378,86,292,3,289,7,31,138,26,2,1,1,8,1,74
2B,350,197,72,125,2,123,1,32,44,6,2,0,0,4,1,33
2B,352,216,45,171,5,166,10,42,53,14,6,1,0,4,0,36
2B,353,2215,457,1758,26,1732,48,347,645,136,27,5,2,93,21,408
2B,354,351,140,211,2,209,6,17,79,18,3,2,0,8,1,75
2B,355,392,93,299,9,290,5,116,61,18,2,0,0,3,1,84
2B,356,200,52,148,6,142,3,25,55,10,1,0,0,5,1,42
2B,361,221,45,176,0,176,3,31,80,6,6,0,0,8,0,42
2B,364,75,15,60,1,59,1,6,33,0,0,0,0,1,1,17
2B,365,296,86,210,4,206,2,26,33,4,4,0,0,9,0,128
2B,366,185,34,151,8,143,9,7,23,51,3,2,0,11,2,35
21,1,313,44,269,5,264,3,69,64,30,6,2,0,23,13,54
21,2,263,36,227,2,225,10,26,56,27,4,1,0,24,9,68
21,3,964,119,845,14,831,27,122,283,58,6,1,1,100,15,218
21,4,255,48,207,6,201,0,50,70,17,2,2,2,16,5,37
21,5,864,110,754,11,743,8,203,186,54,7,8,0,65,16,196
21,6,138,26,112,3,109,7,18,27,13,3,1,1,7,1,31
21,7,168,21,147,4,143,1,35,40,13,3,0,0,10,0,41
21,8,353,52,301,5,296,9,36,63,49,3,2,4,24,6,100
21,9,179,30,149,2,147,1,32,34,12,3,1,1,21,5,37
21,10,123,20,103,2,101,1,15,37,5,4,1,0,16,0,22
21,11,68,7,61,0,61,0,6,34,9,0,0,0,3,1,8
21,12,299,52,247,3,244,4,51,74,18,7,3,0,20,2,65
21,13,295,33,262,9,253,11,53,38,33,3,1,2,27,4,81
21,14,74,17,57,2,55,1,12,13,7,1,0,0,2,3,16
21,15,77,13,64,2,62,1,12,26,6,2,0,0,3,3,9
21,16,573,83,490,9,481,8,103,182,26,2,1,1,55,12,91
21,17,400,72,328,10,318,14,53,72,40,3,0,0,23,14,99
21,18,36,6,30,0,30,0,11,9,0,0,0,0,2,0,8
21,20,179,28,151,0,151,4,28,57,9,1,0,0,11,4,37
21,21,1832,219,1613,30,1583,37,274,469,114,13,5,2,206,42,421
21,22,385,89,296,8,288,9,71,76,23,2,4,1,25,7,70
21,23,1079,206,873,19,854,9,201,242,88,14,3,1,58,14,224
21,24,123,39,84,0,84,2,13,38,5,0,0,0,5,2,19
21,25,53,12,41,0,41,0,11,8,5,0,0,0,7,0,10
21,26,136,28,108,2,106,0,22,31,9,4,1,0,14,3,22
21,27,861,107,754,7,747,10,115,286,49,11,2,0,102,17,155
21,28,518,94,424,7,417,7,97,121,42,5,3,0,32,4,106
21,29,61,4,57,0,57,2,13,12,4,1,0,0,9,0,16
21,30,77,5,72,3,69,3,17,10,9,2,1,0,4,2,21
21,31,282,47,235,5,230,5,64,40,30,2,2,1,23,6,57
21,32,132,17,115,1,114,4,22,29,6,3,1,0,22,1,26
21,33,123,29,94,1,93,1,37,22,5,0,1,1,9,1,16
21,34,133,14,119,2,117,3,33,35,6,4,0,0,12,4,20
21,35,245,26,219,4,215,2,63,62,19,1,1,1,14,9,43
21,36,51,3,48,2,46,1,9,17,7,1,0,0,6,1,4
21,37,285,33,252,4,248,1,34,96,15,2,4,0,47,8,41
21,38,4965,1261,3704,69,3635,62,868,1071,316,34,24,5,271,80,904
21,39,38,2,36,2,34,1,6,13,0,1,0,0,7,0,6
21,40,62,12,50,0,50,0,6,20,1,0,0,0,7,2,14
21,41,153,35,118,2,116,1,25,38,10,3,3,0,9,6,21
21,42,114,13,101,2,99,0,22,32,5,1,1,0,5,1,32
21,43,182,25,157,2,155,3,15,51,13,5,2,0,17,2,47
21,44,84,16,68,4,64,0,18,21,5,2,0,2,7,0,9
21,45,198,28,170,6,164,0,39,35,24,0,0,0,8,8,50
21,46,73,5,68,3,65,9,10,11,8,0,0,0,1,3,23
21,47,67,14,53,0,53,3,11,6,8,1,2,0,4,0,18
21,48,344,34,310,4,306,12,60,83,23,3,0,0,34,5,86
21,49,40,6,34,0,34,0,13,8,1,0,0,0,2,0,10
21,50,211,26,185,1,184,6,31,37,18,5,0,1,7,3,76
21,51,91,12,79,2,77,8,22,14,7,6,1,0,10,1,8
21,52,38,7,31,0,31,0,7,10,2,0,1,1,1,5,4
21,53,162,23,139,1,138,2,30,46,6,4,1,0,13,2,34
21,54,14302,3270,11032,194,10838,182,1858,3676,907,113,62,20,1071,168,2781
21,55,18,3,15,0,15,0,1,8,2,0,0,0,0,0,4
21,56,579,89,490,10,480,12,81,148,39,7,1,1,51,13,127
21,57,248,46,202,3,199,4,67,40,19,0,1,2,22,1,43
21,58,219,47,172,2,170,2,39,66,8,3,2,0,8,1,41
21,59,637,86,551,10,541,10,72,213,35,5,0,2,50,10,144
21,60,1125,148,977,17,960,20,160,310,101,7,1,2,79,26,254
21,61,66,8,58,0,58,2,12,26,2,0,0,0,10,0,6
21,62,191,23,168,7,161,1,39,35,21,3,1,0,16,2,43
21,63,93,11,82,1,81,2,10,27,11,0,0,0,12,1,18
21,64,70,14,56,0,56,3,8,24,4,0,1,0,4,0,12
21,65,92,13,79,3,76,0,21,25,2,0,1,0,10,0,17
21,66,62,4,58,0,58,2,12,25,1,0,1,0,7,0,10
21,67,461,62,399,5,394,1,103,81,48,3,2,0,29,10,117
21,68,112,22,90,2,88,7,15,20,8,2,0,0,10,1,25
21,69,108,13,95,2,93,2,11,20,21,1,0,0,14,4,20
21,70,79,7,72,2,70,3,11,17,15,1,1,0,2,2,18
21,71,563,94,469,11,458,10,97,149,36,4,1,1,46,11,103
21,72,127,12,115,2,113,1,28,26,9,1,0,0,11,2,35
21,73,80,10,70,2,68,3,11,19,7,0,0,0,6,1,21
21,74,180,24,156,3,153,2,36,41,12,2,1,1,20,1,37
21,75,58,11,47,0,47,6,6,15,3,0,0,0,7,1,9
21,76,480,79,401,7,394,5,73,132,23,0,1,0,52,4,104
21,77,108,22,86,1,85,0,17,42,7,0,1,1,7,0,10
21,78,54,11,43,0,43,2,11,17,0,2,1,0,3,1,6
21,79,114,12,102,2,100,1,28,34,3,2,1,0,10,5,16
21,80,494,85,409,10,399,14,109,81,54,8,2,0,30,8,93
21,81,98,11,87,3,84,3,25,18,19,1,0,0,1,0,17
21,82,59,5,54,0,54,1,11,17,5,0,0,1,5,1,13
21,83,115,28,87,0,87,1,24,20,6,2,0,0,18,2,14
21,84,62,8,54,0,54,2,9,13,7,0,1,0,9,0,13
21,85,118,17,101,4,97,4,13,26,9,1,0,1,23,5,15
21,86,984,151,833,13,820,14,161,298,69,6,2,1,76,23,170
21,87,601,107,494,9,485,6,114,103,37,16,2,1,44,15,147
21,88,198,23,175,1,174,3,31,41,22,6,2,0,9,6,54
21,89,314,43,271,8,263,8,62,101,15,2,1,1,18,4,51
21,90,58,8,50,2,48,0,8,20,2,1,0,0,1,1,15
21,91,42,8,34,2,32,0,8,11,4,0,1,0,0,1,7
21,92,163,21,142,2,140,1,30,49,20,2,2,0,9,1,26
21,93,133,33,100,0,100,2,18,36,9,2,0,0,8,7,18
21,94,260,37,223,3,220,4,76,63,19,3,2,0,12,7,34
21,95,58,15,43,0,43,0,13,18,2,1,1,0,2,2,4
21,96,118,31,87,4,83,1,32,7,8,1,1,0,5,4,24
21,97,32,1,31,4,27,0,3,13,1,0,0,0,3,0,7
21,98,130,34,96,1,95,2,15,29,12,0,0,0,15,3,19
21,99,256,44,212,5,207,1,61,50,13,5,0,0,12,4,61
21,100,28,5,23,1,22,2,2,5,4,0,1,0,1,1,6
21,101,154,34,120,1,119,4,32,20,13,1,1,0,19,3,26
21,102,131,18,113,0,113,0,27,31,11,3,3,0,12,0,26
21,103,1889,395,1494,22,1472,11,458,367,128,15,6,4,111,27,345
21,104,77,11,66,1,65,2,12,26,6,0,0,0,13,1,5
21,105,467,43,424,9,415,9,98,97,37,9,4,0,42,7,112
21,106,511,39,472,11,461,8,97,99,63,2,3,1,29,12,147
21,107,678,80,598,8,590,13,80,226,44,4,2,2,65,18,136
21,108,91,12,79,1,78,2,17,18,13,3,1,0,6,1,17
21,109,195,46,149,4,145,1,43,38,10,3,0,0,16,3,31
21,110,479,74,405,5,400,4,59,119,53,5,1,0,32,5,122
21,111,197,30,167,2,165,5,39,57,14,0,1,0,11,4,34
21,112,311,53,258,2,256,3,70,70,30,2,1,1,19,4,56
21,113,111,13,98,3,95,0,26,20,14,1,0,0,11,5,18
21,114,150,31,119,1,118,3,25,31,9,0,2,0,12,4,32
21,115,307,58,249,1,248,0,86,82,9,1,2,1,22,6,39
21,116,149,27,122,5,117,5,30,35,8,3,0,0,11,2,23
21,117,72,9,63,0,63,2,12,17,6,1,0,0,3,4,18
21,118,33,1,32,0,32,0,7,17,0,0,0,0,2,2,4
21,119,50,3,47,3,44,0,11,21,1,0,0,0,2,2,7
21,120,141,32,109,1,108,7,22,31,12,1,1,1,3,1,29
21,121,74,9,65,3,62,2,9,19,7,0,0,0,9,4,12
21,122,246,43,203,2,201,5,36,49,28,0,2,1,28,3,49
21,123,31,9,22,0,22,0,6,13,0,0,0,0,1,0,2
21,124,165,35,130,1,129,1,34,38,1,2,0,0,19,3,31
21,125,214,44,170,2,168,3,38,39,23,2,6,1,11,5,40
21,126,491,65,426,10,416,5,94,103,56,4,0,0,28,7,119
21,127,394,41,353,4,349,11,76,93,40,6,1,0,32,10,80
21,128,193,26,167,2,165,5,53,46,8,4,1,0,17,5,26
21,129,40,4,36,2,34,4,8,11,4,0,0,0,6,0,1
21,130,236,24,212,5,207,2,64,42,22,4,2,0,13,5,53
21,131,330,50,280,6,274,2,71,84,21,4,3,1,30,3,55
21,132,257,27,230,2,228,12,39,63,30,4,2,0,21,9,48
21,133,247,46,201,6,195,6,29,78,14,0,1,1,31,5,30
21,134,226,34,192,2,190,5,40,44,15,4,5,1,15,6,55
21,135,255,36,219,4,215,3,49,60,15,2,1,1,12,5,67
21,136,23,2,21,0,21,0,5,7,2,0,0,0,2,0,5
21,137,78,18,60,5,55,2,11,9,7,0,0,0,6,1,19
21,138,458,94,364,6,358,2,84,94,32,1,1,0,42,7,95
21,139,264,33,231,1,230,4,55,61,24,4,1,0,21,11,49
21,140,76,9,67,0,67,3,18,26,3,0,1,1,2,3,10
21,141,41,6,35,0,35,0,6,4,5,2,1,0,0,0,17
21,142,158,24,134,0,134,2,22,37,17,0,0,0,15,5,36
21,143,79,18,61,0,61,3,18,7,3,0,1,0,5,4,20
21,144,38,8,30,4,26,2,4,12,3,0,0,0,0,0,5
21,145,39,4,35,0,35,0,8,11,3,0,0,0,3,0,10
21,146,101,19,82,2,80,0,19,26,8,2,0,0,5,0,20
21,147,38,5,33,0,33,0,4,8,1,0,0,0,6,2,12
21,148,253,42,211,5,206,2,53,65,16,1,2,0,19,3,45
21,149,125,22,103,3,100,1,37,23,3,0,0,0,14,4,18
21,150,299,34,265,4,261,4,39,122,17,1,2,0,20,8,48
21,151,73,15,58,0,58,2,14,12,7,0,2,0,5,1,15
21,152,82,13,69,1,68,2,8,26,9,0,0,0,7,2,14
21,153,148,31,117,4,113,1,30,29,12,1,2,0,6,4,28
21,154,3638,907,2731,62,2669,37,619,854,222,16,12,9,223,39,638
21,155,34,0,34,0,34,2,9,5,3,0,0,0,6,1,8
21,156,35,6,29,0,29,0,4,11,5,0,0,0,1,1,7
21,157,14,3,11,1,10,0,3,3,0,1,0,0,2,0,1
21,158,135,23,112,5,107,1,20,39,10,2,1,0,9,3,22
21,159,103,23,80,2,78,3,19,24,5,2,0,0,5,1,19
21,160,70,11,59,1,58,3,14,9,5,0,0,0,10,1,16
21,161,70,0,70,11,59,0,16,17,10,1,2,0,7,1,5
21,162,354,40,314,10,304,5,56,83,39,6,0,1,24,4,86
21,163,180,21,159,7,152,4,42,49,15,6,0,0,11,4,21
21,164,119,19,100,4,96,5,22,22,12,0,1,0,14,1,19
21,165,56,8,48,1,47,1,10,8,13,0,0,0,6,1,8
21,166,8847,2216,6631,119,6512,100,1159,1110,918,59,50,16,389,91,2620
21,167,85,11,74,1,73,3,18,21,3,0,0,0,6,3,19
21,168,48,11,37,0,37,2,6,13,8,0,0,0,2,1,5
21,169,111,17,94,3,91,2,19,18,10,0,0,0,5,2,35
21,170,221,23,198,3,195,2,47,62,17,2,1,3,11,5,45
21,171,6784,1154,5630,113,5517,85,1121,1347,511,61,30,21,500,113,1728
21,172,222,43,179,4,175,5,44,38,15,1,4,0,22,1,45
21,173,431,56,375,11,364,4,79,157,15,1,0,0,34,10,64
21,175,114,7,107,4,103,2,27,26,13,1,0,0,10,1,23
21,176,86,9,77,1,76,4,21,26,8,1,0,0,1,1,14
21,177,147,14,133,1,132,3,32,35,13,0,0,1,20,2,26
21,178,93,9,84,1,83,4,22,7,9,0,0,1,9,0,31
21,179,620,99,521,5,516,10,103,184,38,4,3,1,56,8,109
21,180,116,37,79,4,75,1,18,7,14,0,2,0,7,3,23
21,181,125,13,112,1,111,4,17,25,16,1,1,0,12,3,32
21,182,73,12,61,0,61,3,15,15,7,3,2,0,4,0,12
21,183,536,100,436,6,430,8,110,92,54,4,4,0,33,6,119
21,184,50,11,39,0,39,1,13,6,3,0,0,0,5,0,11
21,185,357,41,316,8,308,5,61,112,20,2,1,2,29,7,69
21,186,472,60,412,11,401,8,86,70,55,8,5,1,29,6,133
21,187,122,16,106,0,106,1,25,27,9,1,0,1,17,4,21
21,189,305,38,267,7,260,5,48,102,15,1,0,0,29,11,49
21,190,401,51,350,8,342,6,75,89,25,7,2,1,44,3,90
21,191,586,62,524,12,512,2,98,161,45,9,3,1,46,7,140
21,192,547,48,499,12,487,9,64,169,26,6,0,2,55,11,145
21,193,272,31,241,1,240,2,30,83,23,2,0,0,22,10,68
21,194,715,129,586,9,577,9,148,159,43,10,9,2,40,4,153
21,195,126,22,104,0,104,0,16,20,17,0,0,0,17,2,32
21,196,825,164,661,20,641,3,151,129,98,10,2,0,48,8,192
21,197,30,3,27,0,27,1,6,11,1,0,1,0,4,1,2
21,198,204,37,167,5,162,2,29,39,21,5,0,0,22,4,40
21,199,125,14,111,1,110,4,21,22,19,2,1,0,13,3,25
21,200,954,119,835,17,818,11,146,251,76,7,1,1,84,17,224
21,201,211,24,187,3,184,1,52,58,8,0,0,0,14,4,47
21,202,146,25,121,1,120,0,36,28,11,2,1,0,13,2,27
21,203,113,23,90,4,86,3,11,28,7,2,1,0,3,4,27
21,204,86,20,66,0,66,0,8,7,8,0,0,0,6,5,32
21,205,203,37,166,2,164,0,42,34,21,4,0,0,17,3,43
21,207,63,12,51,0,51,2,8,6,9,1,2,0,4,1,18
21,208,138,27,111,0,111,3,35,32,8,4,0,1,5,3,20
21,209,1366,181,1185,20,1165,36,207,374,103,9,3,3,113,27,290
21,210,356,51,305,6,299,12,55,83,33,6,1,1,30,13,65
21,211,122,17,105,2,103,3,31,30,3,1,0,0,6,1,28
21,212,258,34,224,1,223,2,45,43,27,5,3,0,13,10,75
21,213,529,52,477,8,469,5,112,152,38,5,3,0,44,9,101
21,214,146,18,128,1,127,3,30,26,15,0,1,0,10,1,41
21,215,102,14,88,0,88,0,24,32,11,3,0,0,4,4,10
21,216,70,17,53,1,52,0,20,7,8,0,0,1,7,0,9
21,217,106,9,97,2,95,5,20,20,8,0,0,0,8,4,30
21,218,81,13,68,0,68,14,3,18,10,0,0,0,3,0,20
21,219,93,6,87,0,87,3,7,28,10,0,0,0,10,3,26
21,220,123,20,103,3,100,2,18,30,10,2,2,0,14,3,19
21,221,39,3,36,1,35,2,3,2,3,0,0,0,8,4,13
21,222,108,19,89,2,87,0,19,30,9,1,0,0,13,4,11
21,223,1237,172,1065,23,1042,32,95,427,68,6,3,3,114,23,271
21,224,69,9,60,1,59,0,10,24,6,0,0,0,4,2,13
21,225,110,24,86,0,86,0,19,18,18,0,2,0,7,0,22
21,226,271,29,242,1,241,9,33,61,31,3,0,0,21,5,78
21,227,301,34,267,5,262,6,39,113,14,1,1,1,26,5,56
21,228,113,21,92,6,86,4,16,20,9,0,1,0,12,0,24
21,229,75,10,65,3,62,2,4,23,3,1,0,0,14,2,13
21,230,221,25,196,8,188,6,26,70,12,2,1,0,27,3,41
21,231,81618,14288,67330,1090,66240,1977,8874,18463,6925,595,307,174,6406,1012,21507
21,232,168,18,150,2,148,2,33,50,9,3,1,1,11,3,35
21,233,136,24,112,5,107,1,28,28,10,1,3,0,6,3,27
21,234,51,11,40,0,40,0,11,9,2,2,0,0,3,0,13
21,235,47,2,45,1,44,0,17,15,1,1,0,0,6,0,4
21,236,170,23,147,1,146,2,39,22,10,2,0,0,10,0,61
21,237,80,10,70,2,68,0,11,28,6,0,0,0,12,1,10
21,238,97,16,81,2,79,9,11,17,18,1,0,0,4,4,15
21,239,510,67,443,3,440,4,141,99,35,5,3,2,26,15,110
21,240,177,27,150,4,146,6,40,29,14,1,1,1,15,2,37
21,241,229,25,204,3,201,5,27,64,16,2,0,2,30,4,51
21,242,191,39,152,3,149,1,39,47,16,1,1,0,12,1,31
21,243,81,13,68,5,63,3,15,16,8,1,0,0,6,0,14
21,244,54,12,42,1,41,1,25,8,3,0,0,0,0,0,4
21,245,231,19,212,5,207,6,32,77,13,1,0,0,31,6,41
21,246,129,20,109,1,108,3,31,29,13,0,4,0,13,0,15
21,247,569,101,468,2,466,4,99,127,41,5,5,0,44,16,125
21,248,66,5,61,6,55,0,8,23,6,0,0,0,3,0,15
21,249,534,105,429,10,419,3,127,103,45,9,1,1,31,4,95
21,250,90,18,72,0,72,0,14,31,5,0,2,0,2,3,15
21,251,157,23,134,3,131,5,24,41,7,1,3,0,14,4,32
21,252,80,9,71,2,69,0,16,27,8,2,0,0,5,1,10
21,253,124,27,97,1,96,4,25,31,0,2,0,0,15,5,14
21,254,133,6,127,1,126,4,20,43,13,0,2,0,9,1,34
21,255,223,24,199,3,196,0,14,94,17,0,1,0,22,4,44
21,256,208,24,184,1,183,3,52,66,16,0,4,1,13,3,25
21,257,53,3,50,2,48,2,9,16,4,0,0,0,8,2,7
21,258,162,27,135,3,132,2,20,28,16,1,4,0,10,5,46
21,259,220,26,194,6,188,0,27,55,20,4,0,0,27,9,46
21,260,115,8,107,0,107,3,27,22,16,3,0,0,16,2,18
21,261,483,43,440,6,434,7,84,125,41,3,0,4,56,9,105
21,262,38,11,27,0,27,0,6,16,0,0,0,0,2,3,0
21,263,1211,168,1043,25,1018,22,196,355,65,9,5,0,112,15,239
21,264,59,17,42,0,42,2,3,13,5,1,0,0,4,1,13
21,265,662,99,563,11,552,8,68,196,46,4,1,0,69,13,147
21,266,134,23,111,0,111,2,19,40,14,0,0,0,13,3,20
21,267,410,67,343,8,335,1,73,122,25,1,4,0,31,5,73
21,268,138,19,119,2,117,2,34,55,4,3,0,0,4,1,14
21,269,349,60,289,6,283,5,65,101,16,2,4,0,38,6,46
21,270,148,20,128,0,128,8,14,53,9,1,0,0,21,1,21
21,271,279,49,230,13,217,7,40,67,18,3,2,1,30,6,43
21,272,131,21,110,4,106,4,27,21,15,0,1,0,7,2,29
21,273,849,91,758,8,750,19,112,215,66,3,0,1,70,11,253
21,274,114,13,101,0,101,1,33,29,12,0,1,0,11,0,14
21,275,140,36,104,3,101,1,31,13,9,0,2,0,7,2,36
21,276,110,12,98,1,97,0,30,38,3,0,0,0,12,2,12
21,277,581,110,471,16,455,2,133,131,39,2,3,2,41,9,93
21,278,6718,913,5805,93,5712,132,628,2356,368,38,17,15,727,105,1326
21,279,36,10,26,0,26,0,4,12,1,0,0,0,1,0,8
21,280,119,17,102,1,101,0,32,29,8,0,2,0,12,3,15
21,281,112,22,90,1,89,2,38,20,2,1,0,1,4,1,20
21,282,84,10,74,1,73,0,12,29,4,4,1,0,4,0,19
21,283,64,7,57,2,55,1,16,19,3,1,0,0,1,0,14
21,284,213,31,182,2,180,3,24,64,26,4,2,0,22,4,31
21,285,331,44,287,5,282,2,74,93,30,10,1,0,17,2,53
21,286,71,7,64,1,63,0,7,24,8,3,0,0,12,1,8
21,287,139,25,114,1,113,4,26,27,9,0,4,2,14,2,25
21,288,174,36,138,3,135,5,45,29,8,3,1,0,7,2,35
21,289,91,8,83,1,82,1,18,16,19,1,0,0,3,0,24
21,290,552,87,465,5,460,12,90,136,41,9,0,4,41,10,117
21,291,277,43,234,3,231,6,32,54,28,5,5,3,31,6,61
21,292,3645,695,2950,58,2892,41,680,680,310,39,9,8,219,76,830
21,293,110,19,91,2,89,2,22,21,9,1,0,0,10,3,21
21,294,298,41,257,6,251,9,62,83,24,4,1,0,21,1,46
21,295,2178,356,1822,35,1787,29,362,456,196,20,6,7,158,38,515
21,296,169,15,154,5,149,3,39,49,21,1,0,1,10,2,23
21,297,465,62,403,8,395,5,75,120,25,4,3,0,53,9,101
21,298,79,13,66,0,66,1,22,22,5,0,0,1,6,1,8
21,299,96,10,86,1,85,4,5,28,9,0,0,0,11,3,25
21,300,269,31,238,6,232,12,54,50,38,4,6,0,17,1,50
21,301,171,29,142,4,138,2,50,37,13,1,1,0,6,3,25
21,302,106,13,93,1,92,0,23,22,14,2,1,0,8,1,21
21,303,12,0,12,1,11,0,2,2,1,0,0,0,2,1,3
21,304,210,21,189,4,185,3,25,60,28,1,1,0,19,5,43
21,305,186,36,150,2,148,1,43,41,12,2,1,1,5,2,40
21,306,134,8,126,2,124,2,28,33,15,0,1,0,24,3,18
21,307,124,9,115,1,114,3,17,30,16,1,0,0,11,2,34
21,308,215,31,184,3,181,0,60,52,10,3,2,0,13,1,40
21,309,67,13,54,1,53,2,10,9,5,2,0,0,12,1,12
21,310,95,9,86,0,86,2,10,29,9,2,0,0,8,3,23
21,311,64,12,52,2,50,0,16,14,4,0,0,0,4,1,11
21,312,31,6,25,3,22,1,2,6,2,1,0,0,7,0,3
21,313,52,13,39,0,39,0,7,20,6,0,0,0,2,0,4
21,314,90,13,77,0,77,0,6,12,6,3,0,1,12,5,32
21,315,873,129,744,12,732,17,111,268,53,5,3,1,70,10,194
21,316,261,40,221,4,217,2,45,74,24,1,5,0,13,0,53
21,317,3023,640,2383,43,2340,35,461,581,214,20,10,1,217,46,755
21,318,136,26,110,0,110,6,20,34,7,0,0,1,16,4,22
21,319,540,70,470,12,458,9,94,145,53,7,7,3,23,15,102
21,320,573,96,477,9,468,4,140,118,37,5,2,0,33,15,114
21,321,91,12,79,2,77,1,13,23,6,2,0,0,17,1,14
21,322,231,43,188,2,186,2,46,46,17,2,4,0,7,8,54
21,323,88,3,85,3,82,2,17,29,7,0,1,0,6,0,20
21,324,31,4,27,2,25,0,4,4,1,1,0,0,8,1,6
21,325,157,28,129,0,129,3,36,48,9,2,0,0,12,5,14
21,326,72,9,63,0,63,1,8,19,7,1,2,2,5,6,12
21,327,94,16,78,1,77,4,14,21,10,1,0,0,4,1,22
21,328,52,5,47,1,46,1,5,10,17,1,0,0,0,0,12
21,329,52,6,46,3,43,5,10,5,4,0,0,0,9,2,8
21,330,304,42,262,4,258,3,43,91,11,0,1,1,27,5,76
21,331,261,30,231,5,226,2,51,79,20,3,0,0,18,5,48
21,332,694,110,584,11,573,6,141,175,62,5,5,2,62,10,105
21,333,150,20,130,1,129,1,49,34,8,0,2,0,11,3,21
21,334,458,120,338,8,330,7,91,72,40,4,2,1,21,0,92
21,335,97,9,88,1,87,0,15,22,5,2,1,1,14,1,26
21,336,618,93,525,9,516,8,117,149,45,10,5,3,27,15,137
21,337,947,177,770,9,761,9,218,169,62,7,2,4,38,16,236
21,338,140,13,127,6,121,0,21,47,13,2,0,0,10,1,27
21,339,381,36,345,5,340,5,59,76,32,2,3,1,36,6,120
21,340,148,22,126,1,125,2,39,25,13,2,0,2,8,5,29
21,341,79,10,69,3,66,1,11,17,3,0,1,0,9,4,20
21,342,290,68,222,3,219,4,83,56,16,1,0,0,17,1,41
21,343,90,10,80,1,79,0,15,24,8,0,2,2,7,4,17
21,344,161,23,138,1,137,0,58,37,7,0,1,0,5,4,25
21,345,142,19,123,2,121,1,38,42,7,1,0,0,12,0,20
21,346,252,47,205,8,197,8,32,67,28,2,2,0,13,3,42
21,347,250,38,212,1,211,7,20,103,15,0,0,0,25,3,38
21,348,76,12,64,0,64,2,23,13,5,1,1,0,5,2,12
21,349,491,95,396,10,386,6,81,101,29,4,5,1,40,7,112
21,350,45,10,35,0,35,0,7,15,8,0,1,0,1,0,3
21,351,833,147,686,15,671,9,182,168,51,7,7,0,46,15,186
21,352,455,76,379,9,370,3,85,114,23,7,2,0,29,11,96
21,353,916,102,814,13,801,7,188,208,100,1,4,0,71,13,209
21,354,52,8,44,2,42,0,9,9,4,0,0,1,8,1,10
21,355,5616,1041,4575,84,4491,76,920,1007,514,45,24,6,351,82,1466
21,356,1039,149,890,26,864,7,278,231,70,12,2,1,58,16,189
21,357,93,12,81,0,81,0,27,29,2,1,0,0,7,3,12
21,358,164,27,137,2,135,1,30,34,13,2,1,0,12,2,40
21,359,54,9,45,0,45,0,8,16,5,1,0,1,4,2,8
21,360,101,23,78,2,76,3,17,17,4,1,0,0,6,3,25
21,361,365,67,298,7,291,5,91,76,22,2,3,0,19,4,69
21,362,100,12,88,4,84,3,12,20,8,3,1,0,10,1,26
21,363,267,34,233,6,227,4,52,75,13,8,2,0,18,8,47
21,364,74,13,61,1,60,1,6,13,4,0,1,0,14,1,20
21,365,69,10,59,0,59,3,19,18,5,1,0,0,5,1,7
21,366,163,18,145,4,141,4,44,40,7,0,1,0,15,2,28
21,367,171,22,149,2,147,4,39,28,12,7,1,1,14,6,35
21,368,205,32,173,2,171,6,37,46,18,5,0,0,11,9,39
21,369,216,42,174,0,174,6,49,54,16,0,1,0,13,1,34
21,370,626,103,523,7,516,7,123,169,39,4,5,1,49,7,112
21,371,608,117,491,10,481,8,140,137,34,4,7,1,34,14,102
21,372,75,6,69,3,66,2,10,15,6,3,1,0,3,3,23
21,373,594,74,520,13,507,12,115,85,77,14,4,1,48,12,139
21,374,172,27,145,4,141,0,37,48,4,0,3,0,4,3,42
21,375,203,44,159,6,153,4,31,37,21,4,1,1,12,4,38
21,376,78,7,71,1,70,3,6,30,3,0,0,0,8,0,20
21,377,39,4,35,1,34,3,5,12,2,1,0,0,6,0,5
21,378,91,22,69,0,69,0,17,17,7,0,0,1,6,1,20
21,379,145,31,114,3,111,0,25,33,15,0,1,1,10,8,18
21,380,50,8,42,1,41,0,15,9,4,0,0,0,6,1,6
21,381,75,8,67,2,65,1,15,24,5,0,1,1,10,3,5
21,382,178,20,158,0,158,0,35,40,28,2,1,1,14,6,31
21,383,1173,209,964,17,947,8,211,254,84,12,3,1,85,23,266
21,384,54,5,49,0,49,1,6,21,5,0,0,0,9,1,6
21,385,264,42,222,6,216,5,43,47,26,3,2,0,11,5,74
21,386,229,41,188,7,181,1,28,53,23,7,0,1,15,1,52
21,387,152,18,134,3,131,4,26,54,5,2,3,0,8,4,25
21,388,307,52,255,8,247,4,62,66,19,4,0,0,22,4,66
21,389,222,40,182,4,178,7,52,30,16,0,0,0,19,3,51
21,390,4036,688,3348,60,3288,79,574,972,297,31,11,14,285,71,954
21,391,583,64,519,7,512,8,98,198,33,5,1,0,75,7,87
21,392,55,7,48,0,48,1,7,23,0,2,0,0,4,1,10
21,393,110,13,97,2,95,3,26,25,4,0,2,0,8,2,25
21,394,155,23,132,6,126,0,21,22,18,0,1,1,6,3,54
21,395,83,14,69,1,68,5,11,24,6,3,0,0,4,3,12
21,396,70,6,64,1,63,1,13,28,3,0,0,0,1,0,17
21,397,122,13,109,6,103,2,25,32,9,0,0,0,11,3,21
21,398,235,27,208,2,206,6,48,50,17,5,5,0,5,4,66
21,399,146,18,128,5,123,1,34,46,5,0,1,0,11,2,23
21,400,44,3,41,2,39,0,8,22,0,0,0,0,1,0,8
21,401,276,31,245,2,243,4,44,76,19,2,0,1,24,8,65
21,402,17,2,15,0,15,0,0,12,0,0,0,0,1,0,2
21,403,77,10,67,2,65,5,16,8,9,0,2,0,6,1,18
21,404,357,67,290,9,281,2,56,62,33,3,0,0,29,4,92
21,405,579,69,510,10,500,5,108,161,32,9,5,5,61,12,102
21,406,196,36,160,1,159,6,32,42,25,1,4,1,12,2,34
21,407,173,14,159,4,155,4,30,42,13,1,1,0,13,4,47
21,408,1078,141,937,17,920,25,108,367,54,6,4,5,120,10,221
21,409,393,53,340,8,332,4,75,68,41,4,3,1,33,8,95
21,410,33,3,30,0,30,0,3,19,2,0,0,0,3,0,3
21,411,357,58,299,7,292,9,70,96,20,2,3,1,19,8,64
21,412,1234,246,988,24,964,13,162,435,54,17,6,2,86,27,162
21,413,303,29,274,7,267,4,58,86,32,2,2,1,26,4,52
21,414,205,29,176,3,173,1,43,40,23,2,1,1,22,4,36
21,415,204,34,170,0,170,3,25,99,8,3,1,0,11,7,13
21,416,1289,174,1115,25,1090,9,247,289,100,15,5,4,86,25,310
21,417,84,13,71,2,69,4,9,9,10,1,1,0,8,2,25
21,418,60,22,38,1,37,0,14,7,2,0,0,0,3,1,10
21,419,204,14,190,4,186,6,43,57,13,4,4,0,21,8,30
21,420,145,35,110,4,106,5,22,22,10,1,2,0,10,3,31
21,421,184,43,141,0,141,2,38,38,11,1,0,0,12,1,38
21,422,124,16,108,2,106,2,26,27,3,2,0,0,12,0,34
21,423,564,76,488,5,483,5,106,145,49,5,3,1,55,8,106
21,424,94,20,74,1,73,0,10,23,7,2,0,0,8,3,20
21,425,3837,880,2957,51,2906,45,571,640,344,42,38,9,222,66,929
21,426,198,25,173,2,171,3,25,62,11,1,2,0,20,5,42
21,427,140,15,125,4,121,2,30,44,3,2,0,0,5,1,34
21,428,159,33,126,2,124,4,18,59,5,0,2,0,18,2,16
21,429,244,30,214,6,208,4,53,63,20,2,0,1,19,2,44
21,430,67,4,63,4,59,2,12,10,5,1,1,1,11,3,13
21,431,112,15,97,5,92,4,13,18,16,2,2,0,9,0,28
21,432,250,36,214,4,210,0,68,76,10,1,0,0,17,7,31
21,433,324,61,263,4,259,1,100,55,25,3,0,0,23,10,42
21,434,111,21,90,1,89,1,20,23,11,2,0,1,13,2,16
21,435,211,39,172,1,171,6,62,47,10,2,0,0,8,4,32
21,436,80,6,74,0,74,0,15,18,7,2,0,0,10,3,19
21,437,134,21,113,1,112,1,27,35,7,2,3,1,10,3,23
21,438,82,11,71,0,71,0,16,25,9,0,1,0,5,0,15
21,439,71,3,68,0,68,4,13,13,9,0,1,0,13,0,15
21,440,186,25,161,1,160,5,46,44,16,1,0,2,9,1,36
21,441,237,49,188,0,188,3,23,67,21,5,1,0,24,1,43
21,442,521,94,427,2,425,15,73,161,30,1,0,2,43,8,92
21,444,66,10,56,3,53,0,12,24,4,0,0,0,0,2,11
21,445,171,40,131,1,130,2,29,41,4,0,1,1,6,3,43
21,446,161,30,131,1,130,3,18,36,9,2,0,1,14,6,41
21,447,67,9,58,1,57,0,16,18,4,0,1,0,8,2,8
21,448,71,12,59,0,59,0,24,5,5,3,0,0,3,1,18
21,449,165,29,136,3,133,2,21,39,7,3,0,1,12,6,42
21,450,159,19,140,0,140,5,24,56,12,1,3,1,4,3,31
21,451,72,5,67,2,65,0,12,21,8,1,0,0,7,3,13
21,452,1313,193,1120,28,1092,18,223,255,96,15,8,4,102,26,345
21,454,117,27,90,2,88,2,17,37,6,2,1,0,8,2,13
21,455,200,53,147,1,146,2,43,22,18,1,0,0,12,5,43
21,456,146,31,115,1,114,3,23,23,18,1,0,0,6,1,39
21,457,72,13,59,0,59,3,11,16,7,1,0,0,8,1,12
21,458,705,84,621,11,610,5,120,166,55,5,1,2,88,11,157
21,459,158,20,138,2,136,7,36,36,10,3,0,0,13,5,26
21,460,68,11,57,0,57,0,22,11,4,0,0,0,6,3,11
21,461,1079,236,843,14,829,12,172,244,78,13,5,1,65,26,213
21,462,622,74,548,16,532,14,92,171,47,3,2,1,58,7,137
21,463,41,3,38,0,38,1,8,15,3,1,0,0,5,0,5
21,464,3734,688,3046,50,2996,68,581,862,259,35,29,12,271,64,815
21,465,59,7,52,0,52,0,13,14,5,0,2,1,4,0,13
21,466,35,7,28,0,28,5,2,11,1,0,0,0,4,0,5
21,467,118,23,95,1,94,1,21,28,15,0,1,0,7,2,19
21,468,94,16,78,2,76,2,19,31,5,0,0,0,7,0,12
21,469,361,53,308,4,304,3,55,123,16,3,1,0,34,5,64
21,470,32,3,29,0,29,0,3,17,1,0,0,0,7,0,1
21,471,24,3,21,0,21,1,3,8,0,3,2,0,2,1,1
21,472,146,20,126,6,120,0,38,25,15,3,2,1,8,6,22
21,473,705,114,591,12,579,6,124,158,62,5,5,0,64,18,137
21,474,295,47,248,3,245,1,70,69,25,2,2,1,23,7,45
21,475,372,53,319,11,308,1,103,70,20,3,3,1,15,12,80
21,476,127,22,105,0,105,2,20,27,9,0,0,0,16,1,30
21,477,66,13,53,0,53,1,10,11,9,0,0,0,5,1,16
21,478,227,29,198,2,196,4,54,59,15,5,0,1,12,1,45
21,479,93,7,86,3,83,2,15,36,5,1,0,1,9,2,12
21,480,233,41,192,4,188,5,31,64,17,0,0,2,19,2,48
21,481,1152,133,1019,19,1000,16,176,305,115,9,2,2,105,17,253
21,482,498,85,413,9,404,9,123,110,33,6,6,0,31,9,77
21,483,201,22,179,4,175,2,37,51,14,5,0,1,17,5,43
21,484,57,2,55,1,54,5,21,12,4,1,0,0,4,0,7
21,485,1989,406,1583,34,1549,33,308,381,157,12,10,0,123,24,501
21,486,396,56,340,6,334,3,73,93,30,0,2,1,34,18,80
21,487,299,52,247,6,241,3,59,58,25,2,1,0,21,8,64
21,488,173,31,142,5,137,5,44,39,12,3,2,0,10,2,20
21,489,54,16,38,0,38,2,3,14,4,1,0,0,12,0,2
21,490,140,29,111,4,107,0,28,35,5,1,0,0,8,1,29
21,491,57,12,45,2,43,1,10,20,3,0,0,0,0,0,9
21,492,402,86,316,9,307,4,43,145,13,3,0,0,38,9,52
21,493,406,55,351,8,343,9,95,79,31,8,2,1,34,9,75
21,494,69,13,56,1,55,0,7,18,5,0,0,0,3,2,20
21,495,86,14,72,0,72,0,27,19,1,0,0,0,8,3,14
21,496,945,193,752,15,737,8,227,175,49,13,5,1,56,25,178
21,497,156,17,139,1,138,7,23,50,13,1,1,1,8,2,32
21,498,55,6,49,0,49,0,10,14,2,0,2,0,7,0,14
21,499,124,18,106,2,104,2,35,30,7,1,1,0,7,1,20
21,500,417,95,322,11,311,5,57,62,48,10,1,0,15,0,113
21,501,952,192,760,23,737,10,166,234,62,8,4,3,71,18,161
21,502,458,79,379,10,369,5,102,80,35,6,3,1,24,2,111
21,503,119,20,99,1,98,2,24,29,5,2,1,0,10,3,22
21,504,72,5,67,0,67,2,5,12,11,0,0,1,6,2,28
21,505,526,95,431,13,418,12,71,115,49,8,3,0,52,6,102
21,506,296,37,259,2,257,5,52,96,18,4,3,1,28,7,43
21,507,109,14,95,4,91,3,28,14,12,0,0,0,6,0,28
21,508,294,51,243,4,239,7,44,90,22,0,1,0,22,4,49
21,510,154,28,126,2,124,0,20,50,10,2,3,0,10,2,27
21,511,125,21,104,1,103,0,22,29,7,3,1,0,8,6,27
21,512,351,71,280,4,276,7,57,123,23,2,3,0,19,1,41
21,513,147,13,134,7,127,8,33,38,5,2,0,0,13,2,26
21,514,95,10,85,3,82,0,14,32,6,4,2,1,9,0,14
21,515,6648,1215,5433,97,5336,143,802,961,635,62,26,11,463,82,2151
21,516,63,10,53,0,53,4,8,15,9,0,0,0,7,0,10
21,517,351,44,307,12,295,5,45,104,28,3,0,1,32,3,74
21,518,179,30,149,3,146,0,27,41,11,5,1,1,14,3,43
21,519,304,72,232,4,228,1,44,94,7,1,2,1,36,6,36
21,520,101,10,91,2,89,7,13,23,8,1,1,0,5,4,27
21,521,601,57,544,11,533,4,127,132,42,3,3,2,46,17,157
21,522,325,39,286,6,280,4,57,70,31,0,1,0,21,11,85
21,523,92,7,85,2,83,2,20,18,9,4,1,0,7,0,22
21,524,83,3,80,2,78,0,15,25,5,0,0,1,6,1,25
21,525,726,115,611,7,604,5,169,163,68,3,5,0,29,8,154
21,526,41,4,37,1,36,1,9,8,4,0,0,0,1,0,13
21,527,230,35,195,7,188,1,59,52,10,1,1,0,22,4,38
21,528,118,16,102,1,101,0,17,32,13,0,1,0,15,1,22
21,529,39,6,33,0,33,0,10,8,2,1,0,0,1,1,10
21,530,145,28,117,3,114,2,27,20,8,0,3,0,16,3,35
21,531,399,84,315,1,314,7,81,79,38,4,2,0,30,5,68
21,532,751,90,661,8,653,12,134,244,44,7,3,0,60,22,127
21,533,96,16,80,2,78,2,14,27,4,0,0,0,10,0,21
21,534,552,60,492,8,484,5,107,139,32,3,3,2,49,19,125
21,535,949,105,844,14,830,9,163,277,64,6,3,5,70,24,209
21,536,233,41,192,3,189,6,48,56,16,3,0,2,18,8,32
21,537,100,12,88,2,86,0,13,20,12,2,0,0,8,0,31
21,538,122,20,102,1,101,2,25,16,7,5,1,1,9,1,34
21,539,57,3,54,0,54,1,11,28,2,1,0,0,7,0,4
21,540,5318,779,4539,82,4457,82,684,1328,399,46,23,14,465,89,1327
21,541,209,30,179,2,177,9,18,99,14,0,0,0,16,5,16
21,542,287,26,261,6,255,4,60,73,23,3,3,0,19,8,62
21,543,167,39,128,1,127,2,29,29,9,4,1,0,19,8,26
21,544,49,5,44,3,41,0,11,11,4,0,0,0,2,1,12
21,545,703,138,565,9,556,5,164,95,55,10,5,2,26,7,187
21,546,180,44,136,2,134,2,46,32,19,1,2,0,7,0,25
21,547,163,13,150,4,146,0,34,53,21,2,1,0,6,4,25
21,548,148,20,128,1,127,4,30,27,9,0,0,0,20,3,34
21,549,87,20,67,1,66,1,4,27,13,1,0,1,3,0,16
21,550,83,12,71,2,69,0,15,14,1,0,0,0,12,5,22
21,552,42,2,40,0,40,0,10,14,4,1,0,0,5,0,6
21,553,97,15,82,1,81,5,18,15,10,1,0,0,13,1,18
21,554,700,208,492,10,482,9,121,157,52,7,4,0,29,9,94
21,555,1067,159,908,19,889,16,160,266,71,8,2,4,105,28,229
21,556,171,28,143,2,141,0,42,51,16,0,0,1,12,0,19
21,557,109,15,94,4,90,1,12,40,8,1,0,0,4,4,20
21,558,671,121,550,16,534,3,129,146,29,11,3,1,62,15,135
21,559,504,53,451,9,442,9,101,114,31,9,2,1,46,8,121
21,560,259,53,206,6,200,9,50,35,29,1,0,0,20,3,53
21,561,333,47,286,6,280,5,60,84,32,3,2,0,44,7,43
21,562,165,22,143,3,140,1,27,32,12,2,4,0,14,2,46
21,563,115,17,98,2,96,3,20,24,9,2,0,0,9,3,26
21,564,359,71,288,10,278,13,56,76,29,0,4,0,43,5,52
21,565,330,40,290,4,286,5,64,89,18,1,0,0,30,7,72
21,566,105,10,95,4,91,4,16,21,13,2,2,0,9,1,23
21,567,220,42,178,4,174,3,55,56,7,2,0,2,21,5,23
21,568,600,81,519,8,511,8,117,145,63,5,3,1,39,6,124
21,569,196,28,168,2,166,3,22,68,15,2,0,2,16,5,33
21,570,138,28,110,0,110,3,19,43,12,0,1,0,12,3,17
21,571,170,30,140,2,138,0,34,28,14,2,1,0,10,3,46
21,572,215,41,174,2,172,1,54,48,19,0,0,1,12,8,29
21,573,245,39,206,2,204,3,37,74,27,2,0,0,29,6,26
21,574,324,60,264,5,259,8,71,79,28,4,2,1,14,7,45
21,575,236,32,204,2,202,5,79,48,16,2,1,1,12,3,35
21,576,112,14,98,2,96,0,24,37,4,5,0,0,7,2,17
21,577,816,135,681,12,669,6,210,147,64,12,5,0,45,7,173
21,578,218,26,192,1,191,2,42,54,18,4,1,0,15,5,50
21,579,181,36,145,6,139,2,34,37,8,2,2,0,17,2,35
21,580,126,18,108,3,105,2,17,29,12,0,0,0,16,3,26
21,581,132,41,91,2,89,3,17,27,9,7,1,0,6,1,18
21,582,559,88,471,12,459,10,74,176,33,8,1,4,52,8,93
21,583,42,5,37,0,37,0,14,7,0,1,0,0,7,0,8
21,584,1802,349,1453,32,1421,24,314,434,97,16,20,1,120,21,374
21,585,727,116,611,10,601,5,140,186,59,5,1,2,47,15,141
21,586,454,40,414,4,410,11,83,125,34,4,4,1,47,12,89
21,587,183,20,163,3,160,3,36,52,11,3,1,0,27,0,27
21,588,69,9,60,1,59,1,18,17,4,2,0,0,6,4,7
21,589,64,13,51,0,51,1,7,18,4,0,1,0,6,2,12
21,590,1088,164,924,23,901,16,170,360,70,5,2,3,98,13,164
21,591,640,65,575,13,562,12,84,199,34,4,0,1,75,5,148
21,592,177,25,152,3,149,8,19,50,22,2,0,1,9,3,35
21,593,81,6,75,2,73,2,13,16,12,2,3,0,5,2,18
21,594,164,21,143,4,139,5,21,52,14,7,1,0,19,0,20
21,595,125,13,112,1,111,2,28,31,7,2,0,0,13,1,27
21,596,233,22,211,8,203,3,45,61,20,2,2,0,22,8,40
21,597,49,6,43,0,43,0,4,14,6,0,2,0,4,2,11
21,598,143,15,128,2,126,1,31,18,22,1,1,0,7,7,38
21,599,1693,307,1386,31,1355,11,275,315,133,14,8,7,108,18,466
21,600,97,7,90,2,88,1,18,28,5,1,0,0,7,3,25
21,601,92,15,77,1,76,3,8,13,11,2,0,0,11,1,27
21,602,40,7,33,0,33,0,2,15,1,0,0,0,5,0,10
21,603,2792,446,2346,59,2287,54,347,602,272,37,10,6,223,50,686
21,604,121,10,111,5,106,3,23,23,21,1,0,0,16,1,18
21,605,1763,277,1486,29,1457,22,299,375,130,15,6,2,144,30,434
21,606,1309,178,1131,32,1099,24,232,371,84,11,14,1,97,22,243
21,607,1681,401,1280,26,1254,21,316,302,130,11,7,4,89,18,356
21,608,100,9,91,1,90,1,26,27,4,1,0,0,7,0,24
21,609,349,65,284,7,277,4,85,78,19,2,0,1,15,7,66
21,610,251,41,210,1,209,3,76,61,8,1,1,0,8,5,46
21,611,619,102,517,7,510,17,131,129,38,7,4,0,56,14,114
21,612,79,7,72,1,71,0,17,19,6,0,1,0,8,3,17
21,613,115,13,102,0,102,0,19,36,14,1,2,0,6,1,23
21,614,225,29,196,9,187,8,45,50,11,2,5,1,24,7,34
21,615,234,51,183,3,180,0,48,47,14,1,2,0,19,6,43
21,616,171,31,140,5,135,0,31,53,5,2,1,0,18,2,23
21,617,7664,1261,6403,97,6306,163,800,2048,574,34,38,16,615,95,1923
21,618,429,78,351,9,342,4,102,98,21,3,1,0,31,3,79
21,619,186,25,161,1,160,0,40,49,16,0,0,2,12,5,36
21,620,142,19,123,0,123,1,24,41,16,1,2,0,11,0,27
21,621,170,16,154,5,149,1,39,31,13,0,0,1,20,2,42
21,622,182,21,161,4,157,5,42,40,16,3,0,0,10,2,39
21,623,974,194,780,16,764,8,201,181,91,4,6,0,60,16,197
21,624,108,17,91,2,89,4,24,15,8,0,2,0,13,2,21
21,625,80,11,69,0,69,0,12,27,5,2,2,0,7,3,11
21,626,72,12,60,1,59,1,12,18,5,0,1,2,4,2,14
21,627,103,15,88,0,88,3,11,18,15,1,0,0,11,2,27
21,628,72,10,62,2,60,1,16,27,2,2,3,0,3,2,4
21,629,247,37,210,5,205,3,61,63,20,2,1,0,20,5,30
21,630,165,18,147,8,139,2,27,43,7,1,3,0,24,3,29
21,631,53,8,45,1,44,0,8,10,7,1,0,0,3,1,14
21,632,733,94,639,17,622,8,154,154,56,9,2,0,37,14,188
21,633,171,30,141,1,140,0,30,39,9,0,1,0,11,5,45
21,634,142,19,123,3,120,1,32,23,9,0,0,0,26,2,27
21,635,114,12,102,3,99,2,20,37,6,0,0,0,9,1,24
21,636,262,46,216,4,212,2,68,55,8,2,4,1,25,2,45
21,637,176,25,151,4,147,1,37,49,6,1,0,1,8,3,41
21,638,697,87,610,9,601,9,151,152,54,11,2,2,52,11,157
21,639,503,89,414,5,409,1,106,120,43,4,3,0,38,14,80
21,640,143,26,117,2,115,1,14,31,17,1,2,0,12,5,32
21,641,319,29,290,4,286,3,72,70,23,6,1,1,25,11,74
21,642,350,71,279,4,275,9,73,55,19,10,4,0,16,12,77
21,643,257,38,219,10,209,1,68,56,24,0,0,1,9,6,44
21,644,122,6,116,3,113,1,28,12,18,1,1,0,13,2,37
21,645,408,67,341,5,336,8,111,71,23,8,3,1,26,7,78
21,646,111,15,96,1,95,0,22,43,6,1,0,0,8,0,15
21,647,106,22,84,3,81,2,14,16,4,1,1,0,8,2,33
21,648,161,20,141,0,141,3,34,51,13,0,1,0,11,6,22
21,649,57,7,50,1,49,0,6,26,1,0,0,0,6,1,9
21,650,124,15,109,6,103,2,18,20,21,0,1,0,13,3,25
21,651,169,23,146,1,145,3,27,54,9,2,1,0,17,3,29
21,652,229,27,202,6,196,1,50,52,15,2,0,1,26,5,44
21,653,44,4,40,1,39,0,4,10,7,1,0,0,5,1,11
21,655,217,50,167,4,163,6,28,44,17,1,1,2,22,1,41
21,656,525,76,449,8,441,7,85,142,42,4,5,1,35,11,109
21,657,1729,246,1483,24,1459,22,261,505,74,8,2,2,196,36,353
21,658,40,7,33,5,28,0,6,5,2,2,0,0,1,2,10
21,659,136,29,107,4,103,1,14,30,13,1,0,0,6,4,34
21,660,59,8,51,4,47,2,11,9,5,2,0,0,7,2,9
21,661,1187,122,1065,19,1046,30,197,290,109,11,2,2,95,19,291
21,662,42,7,35,2,33,0,11,7,4,0,0,0,4,1,6
21,663,2068,380,1688,27,1661,17,365,297,211,24,9,7,116,33,582
21,664,77,7,70,0,70,0,7,33,5,2,0,0,7,2,14
21,665,115,13,102,0,102,3,37,22,12,2,0,1,8,1,16
21,666,66,9,57,3,54,3,12,14,0,0,0,0,7,2,16
21,667,305,38,267,9,258,10,41,87,26,3,2,0,25,14,50
21,669,53,1,52,1,51,3,7,12,5,0,0,0,9,2,13
21,670,201,32,169,2,167,5,54,30,23,3,2,1,7,4,38
21,671,51,10,41,2,39,0,2,20,5,0,1,0,4,2,5
21,672,34,9,25,0,25,1,10,6,0,0,0,0,1,0,7
21,673,171,30,141,4,137,3,40,24,12,1,0,1,20,3,33
21,674,199,36,163,3,160,2,51,57,10,3,0,0,15,5,17
21,675,66,11,55,2,53,3,6,16,1,2,0,0,3,0,22
21,676,205,26,179,8,171,3,26,43,13,6,0,0,28,0,52
21,677,85,13,72,5,67,0,18,18,2,2,0,0,7,3,17
21,678,172,18,154,0,154,5,24,26,17,3,2,0,22,7,48
21,679,107,19,88,0,88,2,15,23,8,4,2,0,8,4,22
21,680,358,41,317,7,310,1,74,83,25,10,1,1,27,5,83
21,681,85,12,73,2,71,1,18,32,4,1,0,1,5,1,8
21,682,161,15,146,2,144,5,35,46,10,5,0,1,14,3,25
21,683,316,78,238,5,233,2,65,73,4,1,3,1,30,9,45
21,684,589,68,521,9,512,9,97,166,47,5,3,3,52,15,115
21,685,209,42,167,10,157,0,36,59,10,0,3,2,16,6,25
21,686,129,16,113,1,112,4,14,56,8,0,0,0,9,3,18
21,687,165,24,141,2,139,3,32,38,6,1,3,0,7,1,48
21,688,120,13,107,4,103,0,22,35,11,1,1,0,10,2,21
21,689,127,20,107,1,106,4,10,33,13,1,0,0,11,0,34
21,690,108,12,96,1,95,0,14,34,8,1,0,0,13,2,23
21,691,286,21,265,3,262,6,57,57,17,3,0,1,35,5,81
21,692,210,20,190,3,187,4,41,58,13,0,2,0,24,3,42
21,693,65,13,52,1,51,0,14,19,2,0,0,0,5,4,7
21,694,41,7,34,3,31,2,7,14,2,0,1,0,3,1,1
21,695,39,3,36,1,35,0,2,17,2,0,0,0,4,5,5
21,696,69,14,55,1,54,1,7,18,8,0,0,0,5,2,13
21,698,329,37,292,6,286,5,46,53,51,3,3,2,28,7,88
21,699,762,111,651,15,636,5,159,164,53,8,4,1,66,11,165
21,700,87,9,78,1,77,3,15,24,12,1,0,0,7,2,13
21,701,101,15,86,4,82,0,18,25,4,6,1,0,7,3,18
21,702,223,47,176,5,171,0,38,53,11,1,1,0,19,2,46
21,703,46,6,40,1,39,2,7,3,4,4,1,0,0,1,17
21,704,88,7,81,0,81,0,22,29,3,0,1,2,6,1,17
21,705,62,12,50,0,50,3,9,11,10,2,0,0,5,0,10
21,706,107,24,83,4,79,1,20,22,10,2,1,0,11,1,11
21,707,204,44,160,5,155,3,32,38,18,1,0,1,30,7,25
21,708,235,28,207,4,203,4,65,63,11,1,0,1,21,6,31
21,709,151,14,137,9,128,2,21,27,13,2,3,0,13,4,43
21,710,722,141,581,15,566,11,110,162,61,8,7,1,54,11,141
21,711,95,11,84,5,79,2,15,15,10,1,1,0,8,1,26
21,712,248,33,215,3,212,0,36,128,5,1,0,1,20,6,15
21,713,243,39,204,6,198,1,50,39,18,3,4,0,19,3,61
21,714,336,60,276,4,272,7,50,153,14,3,0,0,17,4,24
21,715,165,25,140,1,139,0,40,48,9,1,1,0,8,3,29
21,716,164,23,141,3,138,3,15,56,5,3,0,0,8,4,44
21,717,255,40,215,3,212,3,36,76,18,2,0,0,10,1,66
22,1,432,51,381,5,376,2,48,118,27,4,1,1,40,3,132
22,2,839,79,760,13,747,16,110,177,68,12,5,1,110,14,234
22,3,623,84,539,16,523,13,111,83,70,5,3,1,44,10,183
22,4,3672,670,3002,70,2932,93,462,464,506,42,27,12,288,46,992
22,5,753,98,655,8,647,14,80,112,132,14,5,5,61,8,216
22,6,172,27,145,1,144,10,22,28,17,4,1,1,21,1,39
22,7,3253,490,2763,45,2718,80,248,919,263,21,12,4,295,56,820
22,8,845,75,770,13,757,14,117,156,89,6,3,2,87,11,272
22,9,132,17,115,0,115,1,24,21,19,1,0,1,16,1,31
22,11,764,100,664,12,652,17,114,118,100,16,6,0,81,9,191
22,12,632,61,571,9,562,5,83,142,71,4,8,1,65,13,170
22,13,1741,272,1469,29,1440,38,171,273,191,30,15,5,144,21,552
22,14,797,94,703,17,686,14,85,167,70,23,6,1,66,24,230
22,15,1144,133,1011,29,982,16,154,245,105,8,7,2,144,21,280
22,16,451,90,361,6,355,15,34,145,26,6,1,1,34,5,88
22,18,256,35,221,4,217,11,35,43,18,3,1,0,20,1,85
22,19,289,31,258,5,253,5,32,65,35,4,1,0,38,7,66
22,20,2057,271,1786,22,1764,27,270,497,154,20,12,4,220,28,532
22,21,817,103,714,9,705,13,148,120,93,14,6,1,46,16,248
22,23,330,44,286,3,283,15,27,61,32,5,1,2,45,2,93
22,24,175,29,146,2,144,6,20,28,18,2,0,0,27,2,41
22,25,1713,259,1454,22,1432,13,166,288,256,20,14,5,103,42,525
22,26,540,78,462,7,455,15,59,102,49,13,3,1,53,13,147
22,27,383,53,330,3,327,4,64,128,19,7,1,2,23,11,68
22,28,622,68,554,11,543,11,65,127,83,9,4,2,61,11,170
22,29,306,40,266,4,262,4,34,69,26,4,0,0,46,6,73
22,30,638,68,570,12,558,14,73,91,93,10,5,2,51,5,214
22,31,568,72,496,7,489,17,74,88,97,7,2,0,36,8,160
22,32,1785,251,1534,23,1511,39,276,384,140,23,7,4,165,34,439
22,33,286,36,250,3,247,7,34,58,18,1,2,1,14,6,106
22,34,1072,104,968,16,952,28,108,142,174,14,2,2,97,14,371
22,35,835,119,716,14,702,19,132,137,72,8,9,2,76,12,235
22,36,166,15,151,4,147,4,25,40,17,2,1,0,20,3,35
22,37,329,41,288,6,282,6,23,45,60,4,1,0,29,7,107
22,38,685,101,584,14,570,7,67,156,61,10,4,3,47,13,202
22,39,472,55,417,8,409,1,58,90,61,9,5,0,36,11,138
22,40,401,45,356,3,353,12,53,40,60,5,2,1,28,11,141
22,41,162,21,141,2,139,1,32,19,29,4,0,0,13,3,38
22,42,365,45,320,6,314,5,46,76,55,4,3,0,43,8,74
22,43,178,20,158,3,155,3,23,58,10,1,1,1,21,2,35
22,44,1186,132,1054,14,1040,13,157,241,117,14,1,2,134,25,336
22,45,326,37,289,6,283,10,64,59,27,9,2,2,33,3,74
22,46,568,89,479,12,467,6,78,114,63,4,7,2,42,6,145
22,47,763,76,687,19,668,11,83,162,81,9,5,2,98,10,207
22,48,1601,242,1359,32,1327,30,179,351,140,28,4,1,126,22,446
22,49,1274,178,1096,23,1073,25,154,352,69,18,9,1,113,33,299
22,50,8065,1735,6330,129,6201,190,582,1832,691,81,30,14,713,89,1979
22,51,433,57,376,9,367,8,57,64,34,6,4,3,39,5,147
22,52,266,40,226,4,222,3,21,47,38,6,2,2,26,6,71
22,53,481,42,439,6,433,4,87,132,34,9,1,1,61,7,97
22,54,3362,448,2914,47,2867,72,371,987,211,22,12,7,309,60,816
22,55,2508,324,2184,41,2143,60,259,658,241,29,14,3,216,36,627
22,56,1180,152,1028,11,1017,23,167,275,95,18,12,1,130,15,281
22,57,258,30,228,9,219,15,46,49,12,4,0,0,27,2,64
22,58,337,37,300,8,292,8,53,72,28,1,2,2,38,4,84
22,59,1035,109,926,18,908,21,117,204,119,22,5,0,104,21,295
22,60,484,74,410,11,399,4,58,159,29,6,3,0,39,6,95
22,61,1111,146,965,17,948,48,135,172,136,23,4,3,101,12,314
22,62,446,62,384,1,383,9,86,84,46,8,2,0,35,15,98
22,63,404,55,349,7,342,3,75,70,48,2,5,0,31,3,105
22,64,535,76,459,10,449,9,37,152,55,5,3,0,39,5,144
22,65,1239,120,1119,27,1092,25,151,263,122,15,6,4,132,22,352
22,66,828,103,725,19,706,15,119,144,121,12,11,3,42,12,227
22,67,1920,274,1646,23,1623,36,187,344,200,19,12,7,159,29,630
22,68,291,23,268,9,259,6,53,68,26,1,3,0,29,4,69
22,69,181,16,165,3,162,10,17,40,13,2,2,0,23,4,51
22,70,4412,955,3457,70,3387,115,435,748,411,44,16,10,334,49,1225
22,71,503,73,430,10,420,14,55,115,30,7,5,0,60,8,126
22,72,340,61,279,5,274,4,36,42,41,7,6,1,31,2,104
22,73,294,30,264,7,257,5,35,58,29,3,2,1,43,5,76
22,74,554,69,485,9,476,8,73,157,42,5,5,0,56,7,123
22,75,462,55,407,7,400,7,82,110,27,8,7,0,47,12,100
22,76,1094,118,976,11,965,11,154,316,78,7,5,1,116,20,257
22,77,865,80,785,9,776,10,142,210,66,4,1,2,81,11,249
22,78,157,22,135,4,131,6,19,37,17,1,1,0,6,0,44
22,79,1570,171,1399,30,1369,27,221,363,170,13,11,2,138,21,403
22,80,545,56,489,6,483,8,73,115,61,9,2,0,57,12,146
22,81,3216,410,2806,49,2757,85,407,658,335,27,11,7,299,41,887
22,82,627,80,547,12,535,13,84,94,69,7,4,0,42,4,218
22,83,538,64,474,8,466,10,70,130,42,4,6,2,47,8,147
22,84,1237,121,1116,20,1096,35,140,245,128,7,15,1,130,15,380
22,85,272,22,250,1,249,8,42,56,30,1,0,0,28,3,81
22,86,535,77,458,7,451,6,80,112,45,8,3,1,57,4,135
22,87,502,88,414,4,410,13,56,64,91,5,5,4,37,6,129
22,88,210,24,186,4,182,4,27,56,27,0,2,1,25,2,38
22,90,734,84,650,10,640,12,77,146,82,10,8,2,47,15,241
22,91,297,24,273,4,269,14,32,40,61,4,2,1,33,3,79
22,92,233,34,199,0,199,10,23,26,31,2,0,0,22,2,83
22,93,8880,1081,7799,120,7679,145,961,2067,776,80,43,13,894,122,2578
22,94,1339,146,1193,19,1174,49,126,448,85,9,7,1,124,17,308
22,95,137,14,123,1,122,8,14,20,9,5,3,0,22,2,39
22,96,379,58,321,3,318,1,82,61,38,3,4,1,25,7,96
22,97,484,40,444,9,435,8,85,87,43,5,1,1,66,10,129
22,98,957,106,851,15,836,12,104,184,76,14,8,3,133,22,280
22,99,758,95,663,17,646,12,102,150,81,11,7,1,80,12,190
22,100,502,49,453,10,443,6,63,159,39,6,2,1,33,9,125
22,101,889,118,771,12,759,30,110,180,88,17,8,4,78,11,233
22,102,417,77,340,3,337,3,51,76,30,11,4,1,37,8,116
22,103,610,64,546,13,533,16,56,136,54,3,5,0,62,18,183
22,104,319,51,268,4,264,4,38,59,45,4,1,0,24,1,88
22,105,797,101,696,11,685,12,129,148,65,8,8,2,54,14,245
22,106,5508,728,4780,96,4684,96,552,1078,614,50,41,9,585,83,1576
22,107,588,64,524,9,515,12,45,97,79,10,3,1,60,13,195
22,108,98,11,87,0,87,8,9,10,17,0,2,0,7,1,33
22,109,195,34,161,1,160,6,22,48,35,2,3,0,11,1,32
22,110,330,38,292,10,282,10,44,43,44,13,2,1,23,5,97
22,111,382,42,340,3,337,10,93,70,25,4,1,0,32,9,93
22,112,350,41,309,2,307,10,55,60,30,2,3,0,34,9,104
22,113,13565,1996,11569,207,11362,556,1099,2108,1609,129,72,19,1200,158,4412
22,114,662,108,554,12,542,5,100,182,62,7,5,1,59,6,115
22,115,396,59,337,4,333,9,42,56,59,4,1,1,37,8,116
22,116,859,126,733,12,721,16,143,127,108,10,3,1,90,11,212
22,117,1158,111,1047,22,1025,20,162,247,137,14,10,1,120,19,295
22,118,2984,338,2646,57,2589,54,297,695,271,26,13,6,331,43,853
22,119,500,67,433,7,426,24,40,93,73,11,3,2,34,3,143
22,121,1216,139,1077,16,1061,22,188,277,104,16,9,2,120,20,303
22,122,550,78,472,15,457,15,78,79,52,13,6,0,56,3,155
22,123,2159,248,1911,37,1874,43,176,531,189,28,12,5,247,22,621
22,124,148,19,129,2,127,11,8,34,30,0,1,1,10,2,30
22,126,114,8,106,3,103,1,15,19,21,1,0,0,12,5,29
22,127,1349,213,1136,19,1117,31,152,348,108,15,7,5,92,22,337
22,128,327,39,288,4,284,12,24,86,26,2,2,0,41,6,85
22,129,70,14,56,0,56,4,7,11,10,1,1,1,2,0,19
22,131,725,120,605,10,595,9,78,144,92,10,7,1,64,6,184
22,132,205,27,178,1,177,1,16,52,28,2,2,0,20,2,54
22,133,486,77,409,12,397,7,96,128,23,12,3,0,32,1,95
22,134,2500,266,2234,37,2197,83,206,477,236,27,11,2,256,41,858
22,135,1792,248,1544,32,1512,42,218,200,345,25,7,3,121,15,536
22,136,7338,1353,5985,119,5866,88,846,1590,581,85,39,7,637,71,1922
22,137,1088,130,958,23,935,33,136,158,148,8,5,4,74,25,344
22,138,298,65,233,0,233,6,57,29,39,6,1,0,32,3,60
22,139,87,9,78,0,78,5,9,17,14,0,0,0,15,1,17
22,140,368,44,324,6,318,7,66,86,36,4,2,1,31,8,77
22,141,149,20,129,0,129,10,18,27,20,1,1,1,6,1,44
22,143,1360,186,1174,19,1155,20,158,325,109,13,4,1,110,24,391
22,144,955,91,864,18,846,19,108,140,131,16,6,2,100,16,308
22,145,544,75,469,8,461,10,80,118,50,5,2,0,38,11,147
22,146,325,47,278,5,273,39,45,27,58,9,2,0,11,8,74
22,147,2148,351,1797,23,1774,24,339,486,145,21,12,2,196,37,512
22,148,198,20,178,4,174,3,39,56,22,0,0,0,14,1,39
22,149,378,45,333,3,330,10,32,91,34,4,4,0,44,6,105
22,150,695,95,600,6,594,20,107,122,65,8,8,1,67,8,188
22,151,701,79,622,10,612,14,84,130,71,7,0,0,95,11,200
22,152,862,96,766,13,753,21,108,179,87,16,6,0,72,12,252
22,153,422,61,361,10,351,13,33,120,36,10,2,0,28,2,107
22,154,706,74,632,17,615,14,80,125,78,7,3,0,75,13,220
22,155,1576,192,1384,29,1355,19,249,337,121,25,11,5,150,29,409
22,156,473,46,427,3,424,6,50,57,69,11,0,4,41,4,182
22,157,481,51,430,9,421,8,68,56,50,7,1,0,44,6,181
22,158,1551,174,1377,23,1354,28,197,386,104,18,11,3,144,26,437
22,160,659,62,597,8,589,7,66,121,56,14,2,1,67,5,250
22,161,2174,331,1843,32,1811,46,163,375,242,13,6,8,254,28,676
22,162,6402,1336,5066,82,4984,166,656,1403,586,69,35,7,488,80,1494
22,163,516,66,450,11,439,15,78,72,60,6,2,1,52,9,144
22,164,1391,170,1221,16,1205,32,169,156,191,22,11,3,140,18,463
22,165,434,65,369,7,362,4,56,98,32,4,6,0,60,9,93
22,166,2396,353,2043,30,2013,61,282,550,214,25,12,4,205,43,617
22,167,148,25,123,4,119,6,14,16,18,5,2,0,13,1,44
22,168,6895,1213,5682,90,5592,235,595,1657,581,61,19,11,633,103,1697
22,169,116,10,106,4,102,20,20,8,19,2,0,0,13,0,20
22,170,1066,93,973,33,940,21,167,236,115,15,12,3,105,30,236
22,171,3053,358,2695,55,2640,52,360,624,356,39,16,3,280,63,847
22,172,2356,416,1940,41,1899,38,304,509,173,19,12,5,166,39,634
22,173,1572,191,1381,23,1358,47,218,342,161,10,2,2,164,41,371
22,174,622,79,543,10,533,6,118,106,66,11,6,2,55,16,147
22,175,1036,134,902,18,884,21,126,198,79,15,4,2,106,19,314
22,176,4833,663,4170,76,4094,93,573,826,566,58,30,8,432,66,1442
22,177,944,94,850,12,838,22,100,169,125,9,5,2,93,14,299
22,178,967,102,865,29,836,22,118,179,117,7,7,0,70,25,291
22,179,1520,232,1288,13,1275,33,175,406,161,16,4,4,107,17,352
22,180,1358,160,1198,30,1168,24,144,260,98,8,9,5,116,25,479
22,181,531,85,446,7,439,5,70,91,56,3,1,2,28,3,180
22,182,2256,240,2016,29,1987,55,270,476,199,36,17,2,266,39,627
22,183,2277,306,1971,39,1932,30,386,463,190,22,23,4,169,30,615
22,184,1219,163,1056,23,1033,23,140,295,133,15,1,0,109,16,301
22,185,1746,256,1490,33,1457,36,170,318,200,12,12,7,151,26,525
22,186,3644,472,3172,42,3130,92,341,1208,276,28,9,9,349,53,765
22,187,10166,1035,9131,162,8969,315,1058,2246,1064,115,34,21,1004,153,2959
22,188,667,45,622,9,613,16,112,111,67,12,2,2,66,18,207
22,189,475,77,398,8,390,11,72,85,50,8,1,0,32,5,126
22,190,2578,351,2227,46,2181,55,384,497,246,32,25,9,179,45,709
22,191,1435,190,1245,26,1219,22,142,400,102,13,5,9,128,13,385
22,192,79,8,71,1,70,1,7,17,10,2,1,0,3,1,28
22,193,1208,156,1052,18,1034,22,150,238,129,22,8,5,114,17,329
22,194,2996,435,2561,38,2523,54,288,544,415,27,15,6,245,33,896
22,195,2369,438,1931,25,1906,38,332,497,177,28,13,4,150,43,624
22,196,719,73,646,21,625,24,88,127,57,17,1,1,86,13,211
22,197,2107,261,1846,36,1810,51,269,561,159,30,11,7,214,31,477
22,198,3461,454,3007,56,2951,162,277,618,481,42,19,10,260,42,1040
22,199,979,126,853,14,839,6,187,229,57,4,5,2,50,17,282
22,200,451,77,374,9,365,5,64,60,30,9,4,0,33,10,150
22,201,755,108,647,13,634,27,91,170,81,8,3,0,47,13,194
22,202,576,96,480,14,466,8,72,73,51,11,5,2,55,10,179
22,203,2496,377,2119,35,2084,31,323,533,230,17,9,5,193,29,714
22,204,995,105,890,12,878,21,120,185,99,8,6,2,87,10,340
22,205,346,52,294,6,288,5,33,79,25,8,0,0,31,9,98
22,206,2031,271,1760,27,1733,30,243,333,218,29,23,7,197,44,609
22,207,1751,221,1530,21,1509,32,185,316,262,11,17,11,137,22,516
22,208,1193,166,1027,29,998,40,182,223,100,6,7,1,107,17,315
22,209,2160,292,1868,40,1828,41,240,522,178,20,12,4,203,27,581
22,210,2854,433,2421,38,2383,89,335,739,232,26,15,9,205,36,697
22,211,2682,368,2314,42,2272,94,254,386,347,32,17,6,228,36,872
22,212,914,114,800,12,788,14,109,132,64,8,14,4,77,12,354
22,213,2676,341,2335,51,2284,103,300,527,356,29,11,5,218,27,708
22,214,2856,467,2389,43,2346,93,398,567,287,31,19,4,204,31,712
22,215,8247,1181,7066,121,6945,165,874,1282,1095,103,52,14,718,97,2545
22,216,566,73,493,6,487,13,67,71,79,13,6,1,66,7,164
22,217,374,50,324,6,318,4,49,73,64,4,5,1,31,4,83
22,218,1227,202,1025,10,1015,26,125,238,165,19,8,1,96,20,317
22,219,1429,187,1242,21,1221,26,159,448,95,17,7,6,138,27,298
22,220,1359,131,1228,25,1203,35,154,206,165,22,11,1,120,22,467
22,221,1415,193,1222,26,1196,47,200,248,165,18,16,1,82,18,401
22,222,4035,689,3346,39,3307,100,533,887,380,31,34,9,322,64,947
22,223,1427,211,1216,31,1185,31,158,183,192,16,9,1,135,12,448
22,224,1349,157,1192,21,1171,50,137,180,185,16,11,4,100,26,462
22,225,3736,501,3235,74,3161,75,360,514,498,47,28,16,283,41,1299
22,226,1983,262,1721,26,1695,54,204,371,257,24,5,1,155,32,592
22,227,568,69,499,7,492,11,73,70,106,10,6,1,47,9,159
22,228,1142,165,977,11,966,29,150,147,196,20,13,2,70,13,326
22,229,849,124,725,15,710,19,102,143,114,9,5,3,84,6,225
22,231,274,41,233,3,230,9,30,35,51,2,1,0,25,6,71
22,232,1480,158,1322,40,1282,39,190,375,124,14,6,6,131,25,372
22,233,1750,228,1522,27,1495,52,267,323,199,20,12,0,111,29,482
22,234,763,102,661,12,649,11,113,144,62,7,4,2,64,13,229
22,235,186,20,166,0,166,5,20,43,18,2,1,1,11,1,64
22,236,541,67,474,9,465,16,116,96,63,8,3,0,37,9,117
22,237,1613,176,1437,30,1407,33,217,351,126,21,5,5,145,34,470
22,238,456,51,405,3,402,15,60,60,99,10,2,1,28,3,124
22,239,845,125,720,18,702,26,92,153,78,11,3,1,62,9,267
22,240,885,115,770,10,760,15,125,217,62,12,4,2,123,19,181
22,241,787,115,672,11,661,8,95,213,56,14,5,1,80,17,172
22,242,1164,151,1013,21,992,18,137,252,111,6,8,1,97,24,338
22,243,445,54,391,11,380,9,41,59,81,9,2,0,37,6,136
22,244,366,33,333,6,327,7,45,77,60,6,3,0,31,5,93
22,245,838,117,721,5,716,37,92,121,136,15,7,1,72,13,222
22,246,1452,164,1288,30,1258,19,173,258,129,18,8,7,178,30,438
22,247,812,124,688,10,678,13,102,151,85,9,13,2,97,9,197
22,248,1383,196,1187,17,1170,32,158,229,147,20,11,0,123,14,436
22,249,533,96,437,5,432,1,85,70,45,11,2,3,48,5,162
22,250,742,101,641,14,627,17,81,160,60,10,5,0,52,11,231
22,251,4725,531,4194,72,4122,141,514,1087,552,35,20,16,483,54,1220
22,253,138,16,122,3,119,5,17,28,19,1,3,0,11,1,34
22,254,858,135,723,14,709,16,102,175,88,5,3,2,76,17,225
22,255,622,74,548,5,543,11,104,132,42,7,7,0,64,7,169
22,256,903,117,786,13,773,23,120,195,96,8,4,1,57,18,251
22,257,307,31,276,7,269,4,30,50,50,7,1,0,36,1,90
22,258,2855,360,2495,46,2449,51,380,638,260,31,9,6,263,56,755
22,259,2899,398,2501,55,2446,44,355,585,246,35,10,7,268,48,848
22,260,343,39,304,9,295,1,48,109,24,7,2,4,35,13,52
22,261,257,35,222,4,218,8,52,52,20,4,1,0,26,6,49
22,262,2049,309,1740,42,1698,40,199,481,195,31,6,3,175,39,529
22,263,232,34,198,2,196,2,33,34,17,5,1,0,20,2,82
22,264,869,157,712,6,706,23,79,155,79,6,4,2,85,3,270
22,265,1363,165,1198,31,1167,26,148,202,146,21,10,4,144,15,451
22,266,2311,392,1919,24,1895,80,239,365,295,35,20,8,184,32,637
22,267,272,29,243,3,240,1,55,61,16,2,1,0,25,7,72
22,268,450,69,381,2,379,11,74,74,39,5,1,0,30,8,137
22,269,192,17,175,4,171,4,23,39,24,5,6,0,9,2,59
22,271,283,28,255,1,254,6,43,43,50,4,1,0,19,5,83
22,272,1646,207,1439,32,1407,38,192,263,225,19,10,3,145,21,491
22,273,1542,154,1388,22,1366,42,207,420,105,16,4,0,183,31,358
22,274,228,32,196,3,193,6,37,33,23,4,5,1,17,5,62
22,275,960,102,858,27,831,13,147,196,88,8,3,2,86,16,272
22,276,149,12,137,2,135,7,14,34,9,0,2,0,18,3,48
22,277,1727,203,1524,22,1502,26,245,299,167,16,20,4,198,42,485
22,278,31120,7166,23954,347,23607,901,2524,5201,3158,268,132,71,2606,320,8426
22,279,835,121,714,16,698,8,119,179,55,6,6,2,79,16,228
22,280,810,155,655,10,645,21,75,131,74,9,0,5,70,5,255
22,281,1079,122,957,23,934,10,158,191,134,12,3,2,84,24,316
22,282,3318,473,2845,46,2799,66,357,1035,261,31,11,8,252,38,740
22,283,693,97,596,7,589,18,94,96,77,7,1,0,46,2,248
22,284,234,26,208,1,207,5,28,55,22,2,1,0,11,1,82
22,285,227,29,198,3,195,1,31,49,21,4,1,0,18,1,69
22,286,343,37,306,5,301,5,62,78,33,2,0,0,41,8,72
22,287,1158,121,1037,12,1025,26,156,229,146,14,14,2,119,20,299
22,288,292,39,253,7,246,5,27,97,18,6,3,1,38,3,48
22,289,180,22,158,2,156,1,25,27,31,2,2,0,16,4,48
22,290,257,29,228,4,224,8,47,35,21,7,0,0,26,5,75
22,291,212,27,185,3,182,2,29,47,11,0,4,0,17,5,67
22,292,371,57,314,3,311,3,46,78,34,6,0,0,37,3,104
22,293,326,53,273,1,272,10,37,81,32,0,3,0,26,4,79
22,294,221,41,180,2,178,6,23,38,17,5,1,0,28,3,57
22,295,243,26,217,2,215,5,19,70,36,3,1,1,24,2,54
22,296,463,66,397,6,391,6,60,86,42,2,4,1,47,14,129
22,297,547,69,478,13,465,13,66,123,55,6,8,1,57,8,128
22,298,332,32,300,5,295,4,47,84,19,2,2,0,43,6,88
22,299,968,122,846,25,821,18,142,181,87,11,9,1,71,14,287
22,300,293,33,260,6,254,5,55,69,34,3,3,2,25,10,48
22,302,905,105,800,15,785,28,76,293,59,7,1,1,63,5,252
22,303,533,90,443,9,434,5,93,86,44,9,4,0,39,10,144
22,304,390,41,349,9,340,7,57,53,61,12,3,1,38,10,98
22,305,333,56,277,5,272,5,45,91,22,3,2,0,37,8,59
22,306,419,46,373,8,365,10,54,127,40,4,5,1,41,3,80
22,307,1534,202,1332,26,1306,29,197,289,154,17,12,4,128,28,448
22,308,505,72,433,8,425,16,56,71,66,3,5,0,40,15,153
22,309,166,22,144,3,141,1,24,41,13,1,1,1,12,0,47
22,310,373,43,330,8,322,11,37,48,57,8,1,2,23,6,129
22,311,671,74,597,10,587,11,79,146,62,6,8,4,47,10,214
22,312,166,20,146,3,143,1,20,37,23,3,0,2,23,4,30
22,313,268,31,237,5,232,1,35,56,21,0,2,0,48,2,67
22,314,307,42,265,3,262,3,57,61,27,0,9,0,31,5,69
22,315,224,18,206,7,199,8,21,37,28,2,6,1,26,4,66
22,316,341,37,304,5,299,13,40,77,46,1,0,1,22,4,95
22,317,202,18,184,6,178,4,25,51,11,0,1,0,20,0,66
22,318,228,17,211,7,204,3,20,39,32,3,0,0,20,9,78
22,319,397,76,321,4,317,12,59,72,42,4,2,0,38,5,83
22,320,135,22,113,1,112,15,12,16,25,1,2,0,10,0,31
22,321,1326,198,1128,28,1100,27,118,221,178,23,15,1,140,17,360
22,322,284,21,263,8,255,9,53,51,37,11,2,0,20,5,67
22,323,618,79,539,20,519,8,90,134,39,9,2,2,59,10,166
22,324,1188,159,1029,13,1016,40,116,214,132,9,5,2,103,14,381
22,325,2907,507,2400,33,2367,63,301,852,197,29,15,12,264,40,594
22,326,343,49,294,10,284,12,39,67,23,3,1,1,27,10,101
22,327,1092,98,994,21,973,24,127,223,118,16,6,0,115,14,330
22,328,301,37,264,3,261,15,21,56,41,6,3,0,29,0,90
22,330,317,54,263,5,258,3,36,76,16,2,2,0,42,7,74
22,331,145,19,126,1,125,2,18,33,21,3,0,1,19,2,26
22,332,329,38,291,5,286,7,51,66,29,3,5,4,32,4,85
22,333,549,75,474,7,467,8,89,81,70,4,2,3,38,8,164
22,334,101,10,91,0,91,1,5,33,11,2,1,0,13,1,24
22,335,198,28,170,2,168,3,40,56,13,4,3,0,20,2,27
22,337,838,134,704,14,690,14,116,174,82,9,5,2,69,18,201
22,338,564,64,500,14,486,8,80,74,56,7,9,2,56,7,187
22,339,1650,157,1493,32,1461,29,202,404,131,17,11,2,169,27,469
22,340,891,130,761,14,747,33,75,111,104,11,4,2,91,23,293
22,341,500,47,453,12,441,11,90,76,59,9,2,2,42,6,144
22,342,262,33,229,5,224,8,48,45,27,3,2,0,10,7,74
22,343,3377,488,2889,35,2854,118,292,732,343,39,8,11,313,39,959
22,344,518,56,462,7,455,13,71,62,92,7,1,4,30,9,166
22,345,616,77,539,5,534,15,68,102,86,8,6,2,55,7,185
22,346,724,75,649,16,633,16,99,181,77,4,4,3,62,14,173
22,347,884,106,778,10,768,14,102,174,84,15,3,2,83,7,284
22,348,386,37,349,7,342,0,54,66,44,3,7,1,33,1,133
22,349,1164,117,1047,13,1034,50,140,179,156,9,5,0,94,20,381
22,350,170,19,151,2,149,25,21,23,20,8,0,0,11,2,39
22,351,481,71,410,5,405,9,47,81,71,8,0,0,52,7,130
22,352,240,27,213,6,207,3,25,52,28,5,1,0,36,0,57
22,353,2316,297,2019,28,1991,77,236,599,222,18,8,3,184,33,611
22,354,742,100,642,14,628,11,86,104,107,7,6,2,71,7,227
22,356,645,63,582,7,575,26,86,178,63,9,2,1,80,12,118
22,357,209,23,186,2,184,0,22,66,21,0,1,0,26,4,44
22,358,406,45,361,6,355,4,58,48,46,5,2,0,17,10,165
22,359,314,43,271,7,264,13,40,60,39,5,2,0,21,2,82
22,360,6296,944,5352,143,5209,104,629,1155,618,39,25,6,575,84,1974
22,361,507,62,445,10,435,14,71,111,48,9,3,1,49,4,125
22,362,1536,222,1314,27,1287,30,133,345,167,11,12,3,108,15,463
22,363,1136,146,990,17,973,46,121,219,136,9,5,2,91,18,326
22,364,1892,210,1682,34,1648,23,259,316,186,32,16,2,157,32,625
22,365,145,21,124,0,124,36,12,12,34,3,1,0,2,3,21
22,366,359,47,312,10,302,5,49,53,77,6,1,0,35,2,74
22,367,527,51,476,12,464,5,79,107,40,9,2,1,65,7,149
22,368,485,28,457,6,451,13,72,94,37,9,0,4,38,11,173
22,369,525,62,463,9,454,7,51,101,43,9,3,0,50,10,180
22,370,265,24,241,7,234,18,27,53,22,4,0,1,16,5,88
22,371,802,106,696,15,681,6,161,204,46,5,4,0,42,13,200
22,372,1354,131,1223,30,1193,22,185,217,183,28,13,3,99,25,418
22,373,93,13,80,2,78,3,14,18,12,0,2,0,7,0,22
22,375,517,48,469,11,458,17,68,76,42,7,7,0,64,5,172
22,376,1137,124,1013,22,991,20,173,230,101,10,3,1,111,30,312
22,377,670,75,595,11,584,17,92,157,74,2,2,2,58,5,175
22,378,154,11,143,2,141,1,21,36,13,2,1,0,14,2,51
22,379,1147,194,953,19,934,41,97,221,112,16,4,3,89,25,326
22,380,529,59,470,9,461,18,79,84,46,10,6,1,38,5,174
22,381,250,22,228,7,221,4,28,47,35,3,3,0,21,3,77
22,383,194,29,165,6,159,5,21,32,23,6,0,2,9,1,60
22,384,764,80,684,9,675,13,99,193,61,6,4,2,73,13,211
22,385,727,123,604,14,590,26,78,138,53,10,1,1,84,10,189
22,386,522,65,457,9,448,3,61,129,59,8,6,2,69,7,104
22,387,1012,141,871,7,864,31,137,139,174,12,10,1,58,18,284
22,388,796,66,730,15,715,10,107,159,83,8,9,3,62,12,262
22,389,3304,378,2926,49,2877,56,439,669,303,34,15,10,342,43,966
22,390,569,71,498,12,486,9,85,142,61,6,4,0,46,7,126
22,391,880,134,746,15,731,11,115,168,96,13,8,1,74,10,235
23,1,1102,171,931,21,910,9,174,261,82,11,5,2,66,17,283
23,2,738,121,617,22,595,7,85,154,79,7,6,3,45,11,198
23,3,112,22,90,3,87,1,13,30,4,2,4,0,6,2,25
23,4,472,98,374,13,361,5,60,56,53,13,3,0,29,7,135
23,5,155,33,122,4,118,1,29,34,8,0,0,0,15,3,28
23,6,217,38,179,2,177,2,34,41,39,2,1,0,17,3,38
23,7,230,41,189,6,183,6,35,33,30,1,0,1,11,5,61
23,8,2792,584,2208,63,2145,51,284,524,264,38,8,6,156,31,783
23,9,106,9,97,1,96,0,15,32,6,1,1,1,10,4,26
23,10,110,20,90,2,88,0,15,23,10,1,1,0,5,0,33
23,11,149,21,128,3,125,2,16,34,20,3,2,0,7,0,41
23,12,111,24,87,3,84,0,14,14,11,1,1,1,11,3,28
23,13,1009,196,813,20,793,6,116,150,91,12,6,2,68,23,319
23,14,102,13,89,1,88,1,5,25,11,0,0,1,5,1,39
23,15,723,139,584,5,579,8,72,183,89,4,4,0,41,10,168
23,16,138,11,127,3,124,6,20,40,16,3,0,0,6,5,28
23,17,180,51,129,3,126,5,22,27,15,0,1,0,9,0,47
23,18,243,29,214,8,206,3,15,57,23,6,0,0,20,7,75
23,19,36,4,32,0,32,1,5,2,2,1,0,0,2,0,19
23,20,328,63,265,1,264,1,31,41,32,1,3,1,32,3,119
23,21,622,126,496,11,485,6,89,131,49,4,2,0,45,5,154
23,22,316,57,259,6,253,5,39,61,27,3,2,0,18,0,98
23,23,89,9,80,5,75,1,10,15,9,1,1,0,6,2,30
23,24,436,64,372,11,361,5,74,62,30,7,4,2,27,9,141
23,25,1075,201,874,22,852,18,152,208,66,13,7,0,69,21,298
23,26,310,61,249,6,243,3,68,44,22,2,3,1,32,2,66
23,27,225,44,181,9,172,1,35,40,15,4,3,1,12,5,56
23,28,84,9,75,1,74,1,19,7,4,1,0,0,4,3,35
23,29,189,40,149,6,143,2,26,31,18,1,4,1,13,2,45
23,30,1709,332,1377,29,1348,13,222,268,188,20,14,3,95,14,511
23,31,1046,200,846,14,832,3,108,210,85,19,9,0,62,10,326
23,32,675,130,545,7,538,5,82,93,88,16,2,0,45,13,194
23,33,341,56,285,3,282,3,68,38,24,4,6,0,15,6,118
23,34,27,2,25,2,23,1,2,9,0,0,0,0,4,0,7
23,35,547,88,459,8,451,8,71,89,74,7,1,1,44,5,151
23,36,777,143,634,20,614,8,96,172,69,5,9,2,43,11,199
23,37,97,19,78,3,75,0,8,20,4,1,0,1,10,2,29
23,38,176,26,150,3,147,3,33,25,33,0,2,0,11,1,39
23,39,531,121,410,8,402,13,59,94,44,7,4,0,36,8,137
23,40,122,14,108,1,107,0,31,29,9,1,1,0,11,2,23
23,41,224,38,186,4,182,2,36,35,27,1,0,1,11,3,66
23,42,114,21,93,2,91,1,17,22,6,0,0,0,8,1,36
23,43,95,16,79,2,77,1,16,15,11,1,0,0,4,4,25
23,44,84,12,72,2,70,0,9,17,6,0,0,0,5,1,32
23,45,664,106,558,7,551,8,92,161,66,2,2,0,46,8,166
23,46,70,8,62,3,59,1,4,24,1,0,1,0,10,1,17
23,47,183,30,153,1,152,4,22,35,35,0,1,0,9,2,44
23,48,374,55,319,10,309,13,31,78,44,4,0,0,35,4,100
23,49,186,28,158,2,156,11,20,17,25,2,2,0,7,1,71
23,50,121,17,104,4,100,3,12,39,13,0,0,1,7,1,24
23,51,78,8,70,2,68,0,9,13,21,0,1,0,7,0,17
23,52,280,39,241,5,236,5,45,25,40,4,0,1,23,6,87
23,53,167,31,136,3,133,6,23,22,19,1,2,1,19,3,37
23,54,208,43,165,10,155,2,29,36,26,2,1,0,13,5,41
23,55,36,7,29,0,29,0,4,4,7,0,0,0,9,0,5
23,56,310,60,250,2,248,6,41,44,49,8,3,0,11,4,82
23,57,457,75,382,10,372,7,82,71,44,6,4,0,28,9,121
23,58,95,15,80,1,79,0,11,23,8,1,0,0,16,3,17
23,59,97,19,78,2,76,6,19,22,6,1,0,0,1,2,19
23,60,109,15,94,2,92,1,14,15,10,0,0,0,6,2,44
23,61,522,71,451,8,443,3,94,124,43,2,2,0,28,14,133
23,62,456,85,371,10,361,6,73,68,48,8,8,2,27,9,112
23,63,141,28,113,3,110,0,27,20,17,2,0,1,13,6,24
23,64,548,84,464,7,457,5,88,118,42,6,6,0,45,10,137
23,65,227,45,182,2,180,4,25,43,21,3,1,2,16,2,63
23,66,185,27,158,3,155,1,31,41,8,0,0,0,22,6,46
23,67,551,84,467,6,461,5,71,124,55,8,0,0,29,11,158
23,68,535,77,458,14,444,5,98,153,37,5,6,1,36,4,99
23,69,375,77,298,17,281,6,35,74,28,4,1,0,19,4,110
23,70,503,105,398,8,390,9,59,120,48,7,5,1,19,7,115
23,71,163,20,143,5,138,0,26,43,17,0,0,0,9,3,40
23,72,219,37,182,4,178,2,33,36,20,4,3,0,15,4,61
23,73,383,66,317,8,309,4,58,95,23,3,1,0,63,6,56
23,74,140,18,122,5,117,6,29,15,16,1,3,0,8,0,39
23,75,817,134,683,22,661,9,89,216,66,15,6,3,44,18,195
23,76,1094,192,902,21,881,15,145,207,105,10,11,0,101,28,259
23,77,314,43,271,5,266,16,32,38,68,3,2,0,12,2,93
23,78,133,17,116,6,110,0,25,24,13,4,0,0,3,2,39
23,79,1163,220,943,33,910,27,156,211,102,7,8,2,76,23,298
23,80,99,16,83,4,79,1,8,13,10,1,3,0,3,2,38
23,81,335,69,266,7,259,3,39,57,40,1,1,2,31,5,80
23,82,248,47,201,3,198,1,37,28,29,4,3,0,19,5,72
23,83,190,18,172,2,170,0,34,48,13,1,0,0,18,1,55
23,84,124,28,96,2,94,3,11,18,11,3,0,0,15,0,33
23,86,230,39,191,7,184,5,27,36,19,1,0,0,16,6,74
23,87,551,152,399,6,393,6,68,96,50,3,7,0,29,19,115
23,88,118,22,96,3,93,2,20,22,7,2,0,0,7,4,29
23,89,626,106,520,11,509,7,86,140,53,13,4,0,45,16,145
23,90,293,68,225,1,224,10,22,20,61,8,0,2,13,4,84
23,91,169,42,127,1,126,3,18,26,18,2,1,0,12,3,43
23,92,519,77,442,7,435,6,88,84,46,3,2,3,41,5,157
23,93,1232,175,1057,40,1017,5,181,301,114,21,1,2,94,22,276
23,95,989,196,793,25,768,12,137,169,101,9,2,5,91,12,230
23,96,8724,1802,6922,143,6779,132,811,1365,870,82,41,24,548,98,2808
23,97,233,37,196,3,193,1,30,62,12,3,2,0,30,7,46
23,98,91,21,70,1,69,2,15,16,11,0,0,0,7,0,18
23,99,308,61,247,7,240,5,48,40,37,6,0,0,23,4,77
23,100,368,50,318,5,313,6,47,83,41,2,1,1,35,6,91
23,101,355,41,314,3,311,1,56,65,34,5,1,1,26,13,109
23,102,283,42,241,2,239,1,57,54,34,4,0,2,15,1,71
23,103,332,71,261,4,257,2,35,70,26,4,1,0,30,3,86
23,104,203,33,170,6,164,3,28,35,20,3,0,0,10,4,61
23,105,577,151,426,10,416,8,95,85,40,10,3,0,27,14,134
23,106,317,51,266,8,258,1,51,75,21,4,5,0,21,6,74
23,107,145,20,125,1,124,3,23,26,21,0,1,1,9,3,37
23,108,130,23,107,0,107,0,23,21,16,1,0,1,15,1,29
23,109,146,31,115,1,114,0,28,17,8,2,0,0,15,1,43
23,110,67,17,50,3,47,3,3,14,5,0,0,0,1,4,17
23,111,221,30,191,3,188,2,36,30,50,6,1,1,19,5,38
23,112,665,140,525,19,506,6,114,108,47,6,8,1,51,15,150
23,113,298,58,240,10,230,2,31,55,24,0,0,0,19,0,99
23,114,377,45,332,9,323,7,60,95,28,1,2,0,26,4,100
23,115,191,27,164,3,161,8,22,21,31,8,3,0,15,3,50
23,116,494,105,389,9,380,15,64,63,54,10,4,0,41,9,120
23,117,267,36,231,9,222,1,29,69,30,1,1,0,19,4,68
23,118,180,40,140,3,137,6,18,28,20,3,1,0,12,2,47
23,119,42,15,27,0,27,1,1,6,1,1,0,1,3,0,13
23,120,173,31,142,1,141,2,33,36,14,1,3,0,8,6,38
23,121,43,5,38,2,36,0,10,7,6,0,0,0,1,0,12
23,122,83,15,68,4,64,1,10,3,10,0,2,1,11,4,22
23,123,191,33,158,3,155,1,21,40,15,4,0,0,26,2,46
23,124,525,85,440,19,421,7,53,90,58,6,2,0,29,10,166
23,125,95,13,82,2,80,3,14,19,14,1,0,0,2,1,26
23,126,273,38,235,3,232,0,59,36,36,3,1,0,11,5,81
23,127,219,39,180,4,176,12,25,34,21,4,2,1,13,8,56
23,128,116,12,104,2,102,2,10,24,10,1,1,0,10,3,41
23,129,71,17,54,3,51,1,6,15,5,0,0,0,3,0,21
23,130,487,82,405,13,392,4,58,45,90,6,8,1,28,8,144
23,131,655,151,504,27,477,8,84,137,51,4,6,2,50,8,127
23,132,304,58,246,3,243,6,37,70,26,2,2,0,26,3,71
23,133,307,52,255,2,253,2,49,47,51,3,3,0,14,3,81
23,134,165,22,143,0,143,1,32,31,19,3,0,1,9,4,43
23,136,270,39,231,11,220,9,44,49,23,6,1,1,19,12,56
23,137,452,72,380,3,377,8,73,88,50,5,1,0,18,7,127
23,138,168,28,140,3,137,1,29,29,14,3,0,0,15,0,46
23,139,428,91,337,9,328,3,67,93,23,2,7,0,29,9,95
23,140,377,59,318,4,314,6,61,64,44,6,2,0,33,6,92
23,141,577,119,458,16,442,7,69,84,63,8,4,2,35,8,162
23,142,250,40,210,5,205,3,37,62,27,3,0,2,19,3,49
23,143,392,57,335,8,327,8,54,58,73,2,4,3,23,4,98
23,144,248,53,195,5,190,0,39,44,17,2,0,1,23,6,58
23,145,253,34,219,8,211,3,40,68,24,0,1,2,15,5,53
23,146,205,41,164,3,161,4,27,36,28,1,0,1,8,3,53
23,147,80,11,69,4,65,1,16,13,4,1,0,0,4,1,25
23,148,187,31,156,4,152,1,23,27,26,2,1,0,16,5,51
23,149,476,75,401,5,396,2,71,88,52,7,2,2,33,6,133
23,150,128,20,108,4,104,1,13,12,24,2,0,1,3,0,48
23,151,407,76,331,9,322,7,48,89,32,7,2,1,30,10,96
23,152,66,15,51,3,48,0,10,12,6,0,0,1,7,0,12
23,154,581,105,476,8,468,9,85,101,67,9,7,1,51,6,132
23,155,312,39,273,10,263,1,62,73,26,6,3,3,18,3,68
23,156,81,13,68,3,65,0,12,21,11,0,0,0,10,1,10
23,157,73,12,61,0,61,1,18,12,11,0,0,0,3,0,16
23,158,137,18,119,2,117,0,20,47,8,1,0,0,11,0,30
23,159,144,23,121,7,114,0,11,30,9,4,0,0,14,1,45
23,160,265,37,228,6,222,0,37,58,18,4,1,1,24,6,73
23,161,63,13,50,0,50,0,4,14,10,0,0,0,3,1,18
23,162,327,60,267,6,261,8,46,44,34,4,2,1,23,4,95
23,164,460,84,376,12,364,1,86,92,28,4,2,0,28,10,113
23,165,462,79,383,8,375,5,68,85,49,10,5,1,30,4,118
23,166,180,38,142,3,139,1,20,51,17,0,2,0,4,4,40
23,167,305,48,257,6,251,7,26,57,34,3,2,0,37,2,83
23,168,643,126,517,13,504,11,86,87,70,5,2,1,31,7,204
23,169,452,51,401,8,393,1,82,68,63,5,1,0,30,5,138
23,170,195,19,176,1,175,9,17,32,44,1,2,0,12,3,55
23,171,112,27,85,4,81,2,23,21,8,1,0,0,12,0,14
23,172,99,21,78,3,75,1,18,13,9,1,0,0,2,3,28
23,173,133,22,111,6,105,6,39,23,8,0,0,0,10,1,18
23,174,471,112,359,6,353,7,93,76,39,4,3,0,37,9,85
23,175,115,13,102,0,102,2,14,8,19,2,2,0,6,1,48
23,176,3994,836,3158,57,3101,64,457,629,429,44,16,12,224,45,1181
23,177,965,155,810,16,794,19,98,162,148,10,6,2,74,19,256
23,178,182,35,147,6,141,0,33,28,12,3,0,1,11,2,51
23,179,243,32,211,5,206,3,26,42,29,6,2,2,13,2,81
23,180,400,46,354,13,341,1,67,74,36,13,4,0,27,5,114
23,181,172,31,141,0,141,3,31,33,15,1,1,0,11,1,45
23,182,162,20,142,2,140,2,25,31,20,1,1,0,12,1,47
23,183,62,6,56,1,55,4,2,21,9,1,0,1,4,1,12
23,184,101,22,79,0,79,1,9,38,2,1,0,0,11,2,15
23,185,288,67,221,8,213,1,23,69,20,6,4,0,22,12,56
23,186,122,15,107,4,103,4,10,8,21,1,0,0,6,3,50
23,187,185,25,160,4,156,0,16,46,27,2,4,2,14,6,39
23,188,193,33,160,3,157,3,32,29,16,0,0,0,13,5,59
23,189,681,117,564,8,556,9,110,99,62,10,0,1,28,12,225
23,190,162,33,129,3,126,2,25,34,7,4,0,0,15,0,39
23,191,169,21,148,4,144,5,17,23,31,2,4,0,12,0,50
23,192,628,117,511,17,494,15,75,102,60,6,1,0,37,10,188
23,193,1974,254,1720,32,1688,29,227,339,236,30,11,3,133,31,649
23,194,116,18,98,2,96,4,23,23,8,0,1,0,7,1,29
23,195,782,94,688,28,660,15,114,87,104,8,4,3,66,10,249
23,196,181,25,156,5,151,1,20,47,29,1,1,0,14,1,37
23,197,298,57,241,8,233,9,37,51,35,2,3,0,17,5,74
23,198,141,16,125,5,120,5,13,26,22,1,1,0,13,0,39
23,199,352,58,294,5,289,3,43,70,34,4,1,1,26,2,105
23,200,186,32,154,3,151,4,14,34,40,3,0,1,6,0,49
23,201,190,35,155,2,153,4,17,36,31,4,1,1,7,5,47
23,202,213,57,156,5,151,2,30,31,18,3,6,0,17,2,42
23,203,200,27,173,2,171,4,29,48,12,2,4,0,17,9,46
23,204,124,15,109,0,109,1,21,39,5,1,0,0,6,3,33
23,205,142,24,118,2,116,1,13,30,13,2,1,0,9,0,47
23,206,525,70,455,6,449,7,74,85,80,3,4,4,26,11,155
23,207,160,35,125,3,122,5,26,24,17,0,2,0,10,1,37
23,208,349,51,298,4,294,7,28,51,54,1,3,0,19,7,124
23,209,147,20,127,0,127,2,20,34,17,2,2,0,12,4,34
23,210,205,32,173,0,173,0,27,51,15,1,0,0,16,1,62
23,211,302,48,254,8,246,1,35,36,27,6,1,0,34,7,99
23,212,108,9,99,6,93,3,21,16,16,4,1,2,10,1,19
23,213,158,21,137,2,135,4,24,23,32,3,1,0,14,4,30
23,214,200,29,171,2,169,2,28,28,13,2,1,1,22,3,69
23,215,109,21,88,1,87,0,13,19,10,2,0,0,3,1,39
23,216,147,23,124,2,122,6,7,18,32,6,3,0,13,4,33
23,217,312,48,264,7,257,6,41,34,56,4,3,0,10,7,96
23,218,114,28,86,0,86,1,16,21,6,1,1,0,9,3,28
23,219,904,140,764,22,742,17,158,145,115,6,3,1,52,19,226
23,220,502,97,405,14,391,13,82,121,27,9,3,5,36,6,89
23,221,217,48,169,10,159,0,30,19,15,3,0,1,21,5,65
23,222,146,15,131,5,126,1,20,39,18,5,0,0,8,1,34
23,223,213,44,169,1,168,1,24,35,34,1,1,0,7,0,65
23,224,92,13,79,0,79,1,7,15,15,0,0,0,7,3,31
23,225,104,20,84,1,83,1,10,13,14,0,0,1,23,1,20
23,226,159,24,135,4,131,1,22,30,14,7,3,0,12,4,38
23,227,226,43,183,5,178,1,29,36,30,2,1,1,12,4,62
23,228,163,20,143,1,142,1,26,31,15,2,2,0,17,3,45
23,229,265,46,219,6,213,3,53,51,22,1,2,0,15,4,62
23,230,150,26,124,0,124,3,21,27,18,1,0,1,16,0,37
23,231,708,124,584,16,568,9,83,109,104,8,2,0,31,10,212
23,232,226,32,194,4,190,12,23,47,23,2,1,0,18,3,61
23,233,133,22,111,0,111,2,30,19,9,0,0,0,15,2,34
23,234,151,37,114,7,107,0,18,22,13,4,0,0,14,3,33
23,235,581,123,458,9,449,9,72,96,91,5,1,0,38,10,127
23,236,234,40,194,6,188,1,17,39,39,2,1,0,10,3,76
23,237,61,8,53,8,45,0,4,11,9,0,0,0,9,2,10
23,238,314,44,270,6,264,5,44,68,38,3,1,0,23,6,76
23,239,590,98,492,18,474,8,63,105,66,9,3,4,35,10,171
23,240,400,73,327,7,320,3,61,60,49,4,4,2,26,3,108
23,241,207,35,172,2,170,2,34,36,26,5,2,0,15,2,48
23,242,178,33,145,2,143,2,19,40,14,3,2,0,4,2,57
23,243,129,24,105,2,103,0,14,20,13,2,0,0,15,5,34
23,244,521,142,379,14,365,5,79,94,41,10,3,2,26,11,94
23,245,1684,242,1442,41,1401,23,185,239,219,27,8,5,113,34,548
23,246,307,55,252,5,247,9,39,71,33,3,1,1,19,2,69
23,247,1359,205,1154,29,1125,18,167,191,158,29,8,1,83,14,456
23,248,308,41,267,8,259,9,50,39,40,1,2,2,29,7,80
23,249,188,37,151,1,150,4,21,55,12,6,0,1,9,0,42
23,250,255,50,205,2,203,4,42,28,28,9,1,0,14,3,74
23,251,113,20,93,4,89,4,16,21,14,2,0,0,9,1,22
23,252,153,35,118,2,116,6,17,16,15,0,0,0,4,5,53
23,253,146,25,121,0,121,4,19,20,22,6,1,1,15,0,33
23,254,289,70,219,3,216,8,35,35,27,5,2,0,19,4,81
23,255,96,9,87,0,87,2,24,18,7,0,0,0,6,3,27
23,257,661,104,557,11,546,15,98,151,57,9,1,3,35,17,160
23,258,230,29,201,7,194,0,37,32,32,2,4,1,20,6,60
23,259,90,18,72,0,72,1,12,25,4,0,1,0,8,3,18
23,260,157,21,136,5,131,5,21,36,25,0,1,0,8,1,34
23,261,239,33,206,4,202,3,44,30,15,4,0,0,22,6,78
23,262,120,14,106,3,103,5,13,28,16,2,2,0,7,1,29
23,263,292,55,237,11,226,2,44,63,15,5,2,1,17,10,67
23,264,43,2,41,1,40,2,5,4,10,0,0,0,4,2,13
23,265,83,21,62,1,61,2,5,18,7,2,0,0,13,2,12
23,266,158,24,134,3,131,0,25,44,8,2,1,0,6,3,42
24,1,511,100,411,12,399,17,76,107,63,4,0,0,24,5,103
24,2,1358,230,1128,24,1104,22,156,223,154,21,4,3,113,23,385
24,4,274,38,236,1,235,5,43,49,29,7,1,0,12,3,86
24,5,297,49,248,8,240,3,35,63,20,6,1,1,28,5,78
24,6,181,27,154,3,151,7,26,36,17,1,2,1,10,4,47
24,7,440,75,365,9,356,8,55,77,68,5,3,0,31,3,106
24,8,508,56,452,20,432,2,92,120,38,6,2,2,31,6,133
24,9,248,21,227,11,216,3,38,57,17,3,1,0,22,5,70
24,10,1019,114,905,20,885,12,172,170,127,15,11,3,73,15,287
24,11,847,101,746,17,729,13,100,183,103,10,6,2,40,11,261
24,12,288,36,252,6,246,6,35,61,29,4,1,1,25,1,83
24,13,1472,207,1265,24,1241,28,191,281,163,22,6,4,95,16,435
24,14,495,57,438,8,430,5,68,83,83,3,3,1,27,8,149
24,15,242,45,197,0,197,5,29,50,33,3,0,1,17,1,58
24,16,644,90,554,21,533,8,109,136,82,8,7,0,34,14,135
24,18,351,56,295,8,287,10,36,68,35,8,3,0,22,8,97
24,19,330,40,290,7,283,7,44,73,37,6,4,0,29,6,77
24,20,644,73,571,11,560,9,98,115,101,11,5,0,40,10,171
24,21,360,35,325,2,323,13,47,79,30,3,4,0,29,4,114
24,22,167,15,152,3,149,6,33,33,19,3,2,0,11,4,38
24,23,295,31,264,5,259,4,50,45,32,5,0,2,13,8,100
24,24,38,4,34,0,34,0,2,8,9,0,0,0,3,1,11
24,25,201,24,177,7,170,7,24,35,21,0,2,0,7,6,68
24,26,1356,148,1208,16,1192,26,184,259,154,15,1,3,74,19,457
24,27,277,40,237,2,235,9,40,46,39,6,2,0,24,6,63
24,28,790,122,668,24,644,16,101,184,67,6,5,3,73,13,176
24,29,420,72,348,17,331,5,59,97,46,8,4,1,24,9,78
24,30,553,54,499,8,491,16,90,54,77,11,6,0,24,5,208
24,31,186,14,172,3,169,9,27,40,22,0,1,0,16,6,48
24,32,298,34,264,8,256,5,47,58,43,4,0,0,18,6,75
24,33,153,34,119,3,116,4,11,13,21,0,0,0,10,2,55
24,34,166,21,145,4,141,6,21,37,15,2,0,0,11,4,45
24,35,1083,205,878,19,859,34,126,212,111,9,6,5,63,20,273
24,36,145,27,118,2,116,8,9,19,17,4,0,1,5,2,51
24,37,19868,4346,15522,281,15241,354,2932,3801,1736,163,75,27,1366,242,4545
24,38,309,34,275,15,260,8,53,46,33,8,0,0,13,4,95
24,39,158,19,139,3,136,2,15,44,18,1,0,0,21,2,33
24,40,381,64,317,4,313,16,41,75,46,2,4,2,23,11,93
24,41,129,22,107,4,103,4,9,19,18,5,0,0,13,1,34
24,42,420,45,375,5,370,5,63,58,49,3,1,0,37,6,148
24,43,126,24,102,1,101,1,22,21,14,2,0,2,17,1,21
24,44,363,51,312,9,303,5,55,68,55,3,1,1,20,0,95
24,45,181,15,166,4,162,3,18,41,25,0,0,1,27,1,46
24,46,106,15,91,1,90,4,8,16,8,2,0,0,11,1,40
24,47,208,21,187,6,181,5,31,36,30,3,1,0,9,6,60
24,48,248,45,203,1,202,1,63,43,31,3,3,1,7,2,48
24,50,299,45,254,4,250,9,29,69,32,0,1,1,24,8,77
24,51,189,25,164,3,161,11,40,41,21,6,0,0,8,2,32
24,52,113,18,95,4,91,3,16,24,19,5,2,1,3,3,15
24,53,4830,817,4013,105,3908,66,563,719,687,55,14,11,314,64,1415
24,54,401,43,358,8,350,9,60,72,31,10,3,1,36,9,119
24,55,525,73,452,9,443,11,49,93,70,8,2,0,31,9,170
24,56,183,20,163,7,156,5,18,38,20,2,3,1,12,5,52
24,57,54,5,49,1,48,0,6,4,7,0,0,0,9,0,22
24,58,178,19,159,2,157,1,37,46,17,2,2,3,12,3,34
24,59,278,32,246,5,241,10,56,39,28,4,7,0,30,1,66
24,60,68,9,59,1,58,0,5,20,12,2,0,0,8,0,11
24,61,109,16,93,3,90,3,11,23,24,2,1,1,8,0,17
24,62,124,24,100,2,98,6,22,21,7,1,1,0,6,2,32
24,63,120,11,109,2,107,3,18,28,7,1,0,0,9,0,41
24,64,1580,234,1346,32,1314,26,211,403,138,21,5,5,131,33,341
24,65,186,33,153,6,147,2,32,32,26,2,2,0,13,3,35
24,66,206,34,172,4,168,11,29,23,26,2,0,0,10,1,66
24,67,2020,283,1737,35,1702,30,256,472,196,16,5,6,127,45,549
24,68,1604,275,1329,35,1294,35,176,322,175,26,7,7,113,30,403
24,69,287,39,248,8,240,3,56,43,37,4,2,0,24,3,68
24,70,396,67,329,9,320,8,49,80,38,7,0,0,25,6,107
24,71,332,67,265,8,257,11,47,63,29,4,1,0,21,3,78
24,73,295,33,262,6,256,7,40,50,41,3,1,0,38,5,71
24,74,410,63,347,11,336,16,58,72,35,8,0,1,29,9,108
24,75,233,19,214,4,210,7,30,45,48,1,1,0,18,5,55
24,76,282,23,259,7,252,5,42,69,29,5,0,1,20,5,76
24,77,297,37,260,7,253,4,63,77,24,5,0,1,30,2,47
24,79,155,11,144,2,142,1,27,33,13,2,0,0,8,2,56
24,80,300,48,252,6,246,2,35,61,44,3,3,0,28,4,66
24,81,506,72,434,4,430,15,64,103,54,8,5,1,35,10,135
24,82,1162,136,1026,15,1011,33,169,178,142,10,2,4,85,16,372
24,83,174,24,150,4,146,2,32,34,16,2,0,1,15,4,40
24,84,89,11,78,0,78,3,10,19,13,1,0,1,9,1,21
24,85,134,10,124,2,122,0,22,16,17,1,0,0,14,0,52
24,86,430,86,344,7,337,11,37,84,51,5,3,0,27,7,112
24,87,488,75,413,13,400,9,44,99,51,15,7,1,43,3,128
24,88,241,25,216,6,210,7,54,46,34,4,1,0,16,2,46
24,89,379,43,336,5,331,6,61,47,51,10,2,0,20,6,128
24,90,466,48,418,14,404,8,71,104,37,7,4,1,44,7,121
24,91,952,143,809,16,793,20,109,157,105,10,2,2,75,20,293
24,92,371,62,309,2,307,5,43,87,57,5,2,0,29,7,72
24,93,158,19,139,6,133,2,42,23,16,1,0,0,11,5,33
24,94,308,47,261,11,250,1,49,71,25,7,3,0,22,8,64
24,95,353,52,301,7,294,9,42,75,39,3,1,2,25,6,92
24,96,609,82,527,14,513,6,75,90,60,10,5,1,46,9,211
24,97,287,33,254,3,251,2,45,62,24,4,1,0,21,5,87
24,98,2064,245,1819,34,1785,42,207,371,277,13,8,5,203,29,630
24,99,141,19,122,3,119,5,20,27,14,3,1,1,6,2,40
24,100,402,52,350,6,344,3,66,89,33,8,7,0,20,10,108
24,101,244,25,219,5,214,6,43,62,27,3,3,1,12,8,49
24,102,3541,558,2983,75,2908,63,414,628,398,39,11,6,220,59,1070
24,103,516,62,454,15,439,4,64,87,88,7,3,2,21,10,153
24,104,473,56,417,5,412,10,58,57,85,9,5,0,24,11,153
24,105,113,13,100,4,96,2,22,15,14,2,0,0,5,0,36
24,106,357,36,321,5,316,9,37,59,76,4,1,0,20,7,103
24,107,338,38,300,11,289,5,45,85,49,5,0,2,16,5,77
24,108,869,124,745,16,729,15,132,143,133,11,6,3,46,12,228
24,109,114,19,95,3,92,1,13,27,7,2,0,0,9,1,32
24,110,59,10,49,0,49,0,9,5,6,1,1,0,0,0,27
24,111,63,14,49,0,49,1,3,11,3,0,0,0,8,3,20
24,113,69,8,61,2,59,0,4,10,3,0,1,0,7,0,34
24,114,55,5,50,3,47,3,13,17,3,0,0,0,2,1,8
24,115,1790,312,1478,25,1453,35,261,286,200,19,8,5,137,30,472
24,116,129,15,114,2,112,2,19,10,21,1,0,0,9,3,47
24,117,301,29,272,6,266,9,61,52,26,5,0,0,18,4,91
24,118,258,48,210,4,206,1,28,41,29,3,2,0,19,2,81
24,119,236,36,200,7,193,6,31,59,18,4,3,0,20,2,50
24,120,525,79,446,11,435,6,62,98,50,8,2,0,42,3,164
24,121,47,5,42,1,41,0,3,11,5,3,0,1,7,0,11
24,122,77,6,71,1,70,1,10,13,16,0,0,0,4,1,25
24,123,108,21,87,1,86,3,18,14,3,4,0,0,8,3,33
24,124,215,29,186,6,180,0,29,49,20,4,0,4,15,8,51
24,126,194,17,177,2,175,5,43,45,24,1,0,0,14,1,42
24,127,166,17,149,3,146,2,24,37,17,0,0,0,10,2,54
24,128,155,26,129,1,128,0,22,11,18,1,0,0,15,3,58
24,129,361,52,309,5,304,6,65,64,38,2,1,0,17,6,105
24,130,642,78,564,10,554,8,91,101,83,6,3,2,33,12,215
24,131,68,4,64,2,62,0,13,19,7,2,3,0,5,3,10
24,132,191,28,163,5,158,9,25,42,15,1,0,0,19,2,45
24,133,1047,170,877,26,851,14,144,213,129,16,7,2,50,21,255
24,134,644,59,585,14,571,10,78,124,64,10,3,2,43,14,223
24,135,558,72,486,11,475,13,64,110,60,3,2,2,25,6,190
24,136,134,20,114,2,112,0,18,32,26,1,1,0,4,2,28
24,137,590,65,525,6,519,9,61,106,150,5,0,1,35,7,145
24,138,6254,1175,5079,92,4987,109,684,963,820,69,13,10,346,80,1893
24,139,1405,173,1232,24,1208,29,220,242,201,20,6,3,88,30,369
24,140,1136,159,977,16,961,15,190,174,134,12,6,1,101,21,307
24,141,156,15,141,4,137,3,18,24,6,1,1,0,9,3,72
24,142,735,83,652,10,642,24,83,128,101,11,4,0,54,13,224
24,143,562,103,459,6,453,10,79,102,57,7,1,0,24,7,166
24,144,93,13,80,3,77,0,11,23,13,0,1,1,2,1,25
24,145,1396,223,1173,33,1140,26,246,243,170,16,2,2,65,22,348
24,146,182,11,171,2,169,4,21,39,35,0,0,0,12,4,54
24,147,584,81,503,9,494,5,73,106,101,5,2,1,28,12,161
24,148,252,55,197,7,190,2,42,29,26,0,0,0,27,5,59
24,150,436,43,393,2,391,11,52,132,48,4,2,1,29,2,110
24,151,105,15,90,4,86,4,9,21,17,0,0,0,8,1,26
24,152,747,89,658,12,646,16,102,188,73,10,1,0,44,12,200
24,153,334,33,301,5,296,6,31,49,61,4,1,1,24,4,115
24,154,252,22,230,6,224,10,26,38,44,2,1,0,17,5,81
24,155,352,51,301,9,292,12,50,44,66,7,2,0,29,5,77
24,156,832,146,686,15,671,13,94,133,90,10,4,1,63,12,251
24,157,579,81,498,15,483,13,104,81,69,4,0,0,26,6,180
24,158,354,35,319,10,309,0,40,82,54,0,1,0,16,10,106
24,159,330,55,275,10,265,2,57,72,26,6,5,0,19,6,72
24,160,337,36,301,5,296,4,50,57,46,6,1,1,22,8,101
24,161,112,17,95,0,95,3,17,28,10,2,0,0,13,0,22
24,162,379,36,343,7,336,2,61,51,54,5,1,0,34,4,124
24,163,119,18,101,2,99,0,13,18,11,0,1,0,5,1,50
24,164,831,147,684,15,669,13,65,165,79,9,3,3,72,8,252
24,165,287,41,246,1,245,8,58,61,40,3,3,0,17,3,52
24,166,606,69,537,10,527,10,85,89,99,5,2,0,51,4,182
24,167,1889,322,1567,27,1540,28,277,416,191,17,7,5,140,47,412
24,168,354,59,295,3,292,9,49,72,44,6,1,1,40,3,67
24,170,238,28,210,10,200,3,47,53,23,1,4,0,16,4,49
24,171,481,56,425,5,420,2,88,78,65,5,2,0,42,8,130
24,172,708,103,605,18,587,27,78,123,110,12,4,1,31,18,183
24,174,138,25,113,2,111,2,13,28,17,2,2,0,6,7,34
24,175,255,43,212,3,209,1,27,43,40,1,4,0,10,3,80
24,176,31,4,27,1,26,1,4,4,7,0,0,0,1,0,9
24,177,526,66,460,12,448,12,88,103,74,1,1,4,32,3,130
24,178,204,34,170,4,166,7,37,47,14,4,0,1,11,3,42
24,179,545,50,495,10,485,2,91,90,68,3,2,0,36,6,187
24,180,244,47,197,6,191,1,26,27,67,2,2,0,9,5,52
24,181,236,30,206,3,203,6,53,55,29,3,4,1,13,4,35
24,182,1102,199,903,18,885,15,180,212,86,19,7,2,75,19,270
24,183,208,42,166,4,162,9,23,39,20,3,1,2,9,2,54
24,184,126,15,111,2,109,4,4,22,20,2,1,1,6,2,47
24,186,201,20,181,6,175,6,42,52,20,4,2,3,9,5,32
24,188,416,45,371,6,365,8,64,96,41,6,2,0,26,8,114
24,189,371,67,304,4,300,4,86,73,22,5,2,1,27,8,72
24,190,155,13,142,5,137,6,21,47,5,1,0,2,19,4,32
24,191,142,20,122,4,118,2,28,15,17,0,0,0,5,2,49
24,192,79,11,68,1,67,1,8,17,8,1,0,0,4,4,24
24,193,367,45,322,2,320,6,65,91,26,3,2,3,36,5,83
24,194,993,127,866,9,857,7,205,242,77,8,4,0,64,17,233
24,195,108,23,85,1,84,4,12,7,12,2,0,0,9,0,38
24,196,404,31,373,12,361,4,57,91,37,6,0,2,21,8,135
24,197,601,69,532,8,524,10,98,119,72,3,5,3,51,12,151
24,198,198,36,162,4,158,5,39,29,21,2,0,1,12,1,48
24,199,268,33,235,12,223,4,41,82,18,2,0,1,20,8,47
24,200,447,70,377,7,370,13,64,79,39,5,1,1,20,11,137
24,202,171,24,147,5,142,1,14,43,13,0,0,0,22,2,47
24,203,48,9,39,1,38,3,2,11,7,0,0,0,4,3,8
24,204,170,10,160,4,156,2,33,35,11,0,0,1,12,6,56
24,205,460,48,412,9,403,5,74,58,89,3,3,1,36,5,129
24,206,111,12,99,1,98,1,12,36,7,1,0,1,14,0,26
24,207,479,59,420,7,413,6,68,103,47,9,0,1,33,13,133
24,208,162,27,135,7,128,4,29,14,22,4,0,1,11,7,36
24,209,107,12,95,9,86,1,23,23,11,1,1,0,8,0,18
24,210,697,110,587,12,575,12,72,164,79,6,4,3,27,12,196
24,211,332,44,288,10,278,13,45,58,51,4,2,3,22,2,78
24,212,562,86,476,10,466,12,95,137,49,4,1,0,45,7,116
24,213,122,13,109,2,107,2,36,20,10,3,1,0,5,2,28
24,214,775,130,645,19,626,5,132,198,63,8,4,2,45,12,157
24,215,166,21,145,7,138,7,15,28,20,1,1,2,18,2,44
24,216,95,17,78,2,76,1,24,14,11,0,1,0,6,0,19
24,217,355,44,311,4,307,2,91,72,30,4,0,1,30,8,69
24,218,925,123,802,37,765,9,139,154,137,7,4,4,62,13,236
24,219,152,25,127,4,123,0,25,38,8,2,1,1,17,4,27
24,220,516,101,415,10,405,3,95,87,47,4,6,1,27,6,129
24,221,105,11,94,5,89,4,7,18,18,1,0,0,1,3,37
24,222,1783,267,1516,29,1487,24,330,276,230,26,9,1,138,23,430
24,223,2493,395,2098,38,2060,38,360,424,264,22,10,4,192,34,712
24,224,504,49,455,9,446,13,92,103,64,4,1,2,44,8,115
24,225,1783,281,1502,41,1461,26,335,373,158,15,5,2,120,36,391
24,226,965,170,795,10,785,13,257,185,73,7,3,2,43,13,189
24,227,763,92,671,18,653,10,101,170,93,6,3,1,51,15,203
24,228,409,46,363,13,350,6,64,53,68,2,1,3,26,4,123
24,229,1454,231,1223,23,1200,13,237,207,155,16,7,4,64,9,488
24,230,105,21,84,0,84,3,16,8,17,1,1,0,4,2,32
24,231,83,7,76,5,71,4,13,15,7,3,0,0,8,4,17
24,232,68,6,62,2,60,1,17,9,5,1,3,0,8,3,13
24,233,124,24,100,2,98,0,24,12,14,2,0,0,17,0,29
24,234,293,60,233,2,231,8,41,58,43,1,2,0,22,3,53
24,235,236,33,203,6,197,2,31,48,18,3,2,1,21,4,67
24,236,708,81,627,16,611,14,124,100,89,10,6,3,49,20,196
24,237,1072,144,928,22,906,17,194,218,100,14,8,4,103,26,222
24,238,118,20,98,6,92,1,9,19,23,2,0,1,4,1,32
24,239,201,17,184,5,179,2,31,34,30,10,1,0,18,3,50
24,240,281,30,251,5,246,15,28,46,30,4,2,0,37,1,83
24,241,383,72,311,6,305,5,50,32,41,3,4,0,23,3,144
24,242,216,26,190,6,184,11,37,39,24,0,2,0,17,1,53
24,243,721,126,595,14,581,9,117,135,62,7,5,0,39,14,193
24,244,96,11,85,2,83,0,26,14,10,1,3,0,12,4,13
24,245,210,19,191,7,184,6,30,46,22,2,0,0,17,5,56
24,246,286,43,243,8,235,5,57,46,42,6,2,2,23,5,47
24,247,128,21,107,1,106,2,13,31,20,0,3,0,8,5,24
24,248,282,36,246,10,236,2,54,46,20,7,5,0,16,6,80
24,249,130,23,107,7,100,2,15,40,13,1,1,1,6,4,17
24,251,460,57,403,6,397,6,76,76,63,8,1,1,32,14,120
24,252,617,89,528,8,520,5,75,115,70,3,6,3,52,10,181
24,253,765,98,667,15,652,9,100,174,83,12,4,2,53,16,199
24,254,173,29,144,1,143,0,20,32,32,2,1,0,14,2,40
24,255,465,46,419,11,408,5,52,105,82,7,1,1,35,3,117
24,256,2065,272,1793,51,1742,26,305,309,284,25,8,2,140,42,601
24,257,204,31,173,2,171,3,27,26,38,3,1,0,11,2,60
24,258,743,78,665,14,651,19,110,106,115,7,3,1,45,19,226
24,259,813,120,693,14,679,22,133,168,104,14,2,0,59,11,166
24,260,452,71,381,11,370,9,62,68,52,9,2,3,35,8,122
24,261,273,46,227,4,223,7,44,47,22,0,2,2,25,8,66
24,262,241,24,217,7,210,10,28,32,42,4,1,0,13,4,76
24,263,278,47,231,4,227,2,32,74,27,5,0,1,20,4,62
24,264,1344,212,1132,20,1112,12,276,260,124,21,6,5,70,17,321
24,266,1138,138,1000,27,973,15,173,193,131,22,6,2,93,27,311
24,267,138,16,122,1,121,4,30,39,12,5,0,0,9,1,21
24,268,501,66,435,8,427,10,72,83,75,10,4,1,38,7,127
24,269,578,107,471,17,454,4,71,82,87,5,3,1,50,6,145
24,270,463,55,408,6,402,10,59,81,62,7,1,1,40,8,133
24,271,492,80,412,8,404,9,49,102,55,5,4,1,25,17,137
24,272,333,60,273,6,267,10,54,65,24,4,1,0,19,3,87
24,273,258,32,226,4,222,12,40,57,24,2,1,0,27,6,53
24,274,729,136,593,10,583,12,107,178,44,4,5,3,74,13,143
24,276,273,32,241,7,234,8,40,59,35,2,2,0,33,0,55
24,277,235,29,206,5,201,3,41,34,30,5,1,0,19,6,62
24,278,57,7,50,1,49,0,8,14,4,0,0,0,6,3,14
24,279,50,3,47,2,45,0,7,13,6,0,3,0,3,0,13
24,280,370,49,321,7,314,12,31,68,54,3,2,0,32,6,106
24,281,154,16,138,2,136,2,25,29,26,2,1,0,14,3,34
24,282,128,17,111,5,106,6,25,38,12,0,2,0,10,2,11
24,283,142,14,128,1,127,5,18,36,16,1,0,1,4,4,42
24,284,123,10,113,5,108,3,27,26,9,1,1,0,12,5,24
24,285,294,40,254,6,248,4,45,87,30,3,0,2,25,3,49
24,286,408,54,354,10,344,4,45,97,49,6,4,1,36,6,96
24,287,101,14,87,4,83,4,24,29,5,0,0,2,6,4,9
24,288,244,34,210,3,207,10,62,41,27,2,0,0,22,2,41
24,289,1034,146,888,20,868,12,205,268,83,10,7,5,51,18,209
24,290,150,18,132,3,129,0,17,31,26,1,0,4,13,1,36
24,291,2309,370,1939,38,1901,43,248,474,300,21,11,9,122,37,636
24,292,349,58,291,5,286,1,75,64,46,2,2,1,23,8,64
24,293,211,25,186,3,183,1,37,32,28,0,2,1,14,4,64
24,294,4186,693,3493,95,3398,49,648,852,389,47,19,3,270,56,1065
24,295,992,120,872,13,859,21,117,177,161,21,4,4,55,22,277
24,296,830,126,704,16,688,11,150,161,91,8,6,4,65,9,183
24,297,633,112,521,15,506,3,144,106,46,9,5,2,40,10,141
24,298,212,25,187,5,182,4,21,40,31,4,1,1,18,1,61
24,299,2074,361,1713,33,1680,23,309,380,279,16,8,4,103,30,528
24,300,275,30,245,6,239,7,40,67,31,2,2,0,18,8,64
24,301,293,50,243,3,240,2,54,68,23,3,3,0,12,3,72
24,302,283,47,236,11,225,5,34,58,15,0,2,0,26,7,78
24,303,172,22,150,5,145,4,23,39,12,1,0,1,19,1,45
24,304,764,86,678,12,666,9,106,113,136,4,6,1,38,15,238
24,305,230,20,210,1,209,2,25,45,46,1,2,0,17,3,68
24,306,96,16,80,2,78,1,16,19,8,0,0,0,16,0,18
24,307,153,15,138,1,137,9,32,21,13,1,0,0,15,3,43
24,308,650,80,570,17,553,13,77,110,84,15,4,5,39,17,189
24,309,2449,353,2096,39,2057,39,401,464,322,36,16,7,130,45,597
24,310,163,21,142,1,141,7,24,39,11,4,1,0,19,0,36
24,311,2248,337,1911,54,1857,20,286,477,205,23,11,2,148,40,645
24,312,2279,293,1986,31,1955,47,278,479,275,32,5,0,168,33,638
24,313,59,10,49,1,48,0,11,6,8,2,0,0,4,0,17
24,314,87,8,79,1,78,3,13,18,15,3,1,0,7,1,17
24,316,318,50,268,6,262,1,52,50,35,1,0,0,24,4,95
24,317,224,36,188,3,185,5,28,59,29,2,0,1,14,2,45
24,318,236,32,204,4,200,10,33,58,24,5,0,1,20,9,40
24,319,375,55,320,5,315,5,62,90,45,4,2,1,25,4,77
24,320,817,128,689,19,670,12,145,141,48,7,1,0,40,20,256
24,321,604,83,521,14,507,1,107,97,52,7,5,0,36,9,193
24,322,18072,3383,14689,261,14428,359,1751,3765,1974,160,80,28,1196,220,4895
24,323,149,23,126,0,126,2,21,25,12,4,1,0,13,5,43
24,324,417,38,379,8,371,4,74,51,76,3,0,0,26,6,131
24,325,178,25,153,4,149,3,39,35,16,1,1,0,12,3,39
24,326,144,23,121,1,120,10,17,29,17,1,1,0,5,1,39
24,327,120,20,100,4,96,0,12,17,26,0,0,0,8,2,31
24,328,1017,120,897,27,870,13,126,235,109,7,8,6,56,14,296
24,329,913,169,744,25,719,6,173,154,76,14,5,3,52,15,221
24,330,546,70,476,6,470,62,44,57,60,4,0,0,43,7,193
24,331,614,99,515,7,508,9,117,141,47,10,0,2,48,7,127
24,333,46,8,38,0,38,0,9,8,4,0,0,0,3,0,14
24,334,162,19,143,3,140,3,21,33,19,0,1,0,9,0,54
24,335,1769,269,1500,33,1467,34,325,337,169,22,2,5,121,25,427
24,336,394,40,354,10,344,7,40,80,42,3,0,2,28,8,134
24,337,133,15,118,3,115,2,15,28,20,0,3,0,10,2,35
24,338,330,37,293,3,290,8,56,72,54,2,0,0,17,7,74
24,339,135,18,117,2,115,2,23,13,14,6,5,1,7,5,39
24,340,3240,537,2703,71,2632,61,556,586,309,42,14,11,243,37,773
24,341,737,107,630,17,613,23,107,135,87,12,4,3,48,14,180
24,343,71,7,64,1,63,0,5,19,2,1,1,0,13,2,20
24,344,42,7,35,1,34,0,10,6,9,1,0,0,2,0,6
24,345,408,55,353,5,348,11,78,73,34,6,2,3,36,7,98
24,346,315,44,271,5,266,0,34,73,26,3,1,0,24,4,101
24,347,124,18,106,4,102,3,13,22,7,2,0,0,21,0,34
24,348,198,26,172,3,169,1,43,29,31,2,0,0,20,3,40
24,349,301,39,262,5,257,13,56,61,31,2,1,1,17,4,71
24,350,1840,254,1586,35,1551,14,260,293,271,23,14,3,111,34,528
24,351,245,32,213,7,206,3,47,51,30,6,1,1,24,3,40
24,352,2818,504,2314,69,2245,35,319,557,257,18,15,2,151,28,863
24,353,270,45,225,9,216,1,52,54,21,1,0,0,18,3,66
24,354,2186,461,1725,38,1687,28,413,450,141,31,11,6,118,24,465
24,355,423,59,364,6,358,5,42,104,37,0,0,0,33,5,132
24,356,1321,179,1142,23,1119,50,177,275,167,15,4,2,55,11,363
24,357,248,39,209,5,204,4,66,46,17,3,1,0,19,3,45
24,359,70,1,69,1,68,1,18,16,7,2,0,0,12,0,12
24,360,252,38,214,2,212,2,32,35,49,2,2,0,23,4,63
24,361,348,31,317,9,308,4,53,81,35,5,3,0,32,5,90
24,362,567,61,506,7,499,9,78,154,58,9,0,0,41,7,143
24,363,101,13,88,1,87,2,18,13,11,0,0,1,9,1,32
24,364,300,50,250,5,245,4,33,60,38,7,5,0,19,8,71
24,365,175,23,152,1,151,3,30,44,14,0,0,1,10,3,46
24,366,642,86,556,22,534,14,70,113,76,5,2,5,46,6,197
24,367,156,18,138,5,133,7,34,26,20,0,0,0,11,2,33
24,368,316,61,255,3,252,1,59,66,22,8,3,0,25,4,64
24,369,120,15,105,4,101,4,11,19,18,1,1,1,12,1,33
24,370,1338,207,1131,18,1113,27,278,284,102,13,3,2,82,14,308
24,371,390,75,315,6,309,12,47,25,56,7,1,0,15,14,132
24,372,4341,883,3458,67,3391,61,615,711,550,46,24,4,244,55,1081
24,373,239,32,207,2,205,3,54,50,17,6,0,2,31,5,37
24,374,245,40,205,4,201,0,46,58,27,3,0,0,12,5,50
24,375,97,7,90,0,90,4,10,13,18,1,0,1,9,3,31
24,376,1047,176,871,22,849,12,142,204,77,10,3,0,36,16,349
24,377,118,4,114,2,112,3,14,22,31,1,0,0,9,2,30
24,378,83,8,75,1,74,3,21,12,8,1,0,1,7,6,15
24,379,378,57,321,7,314,4,62,68,48,4,0,0,30,6,92
24,380,367,59,308,3,305,9,63,86,36,6,3,0,30,9,63
24,381,220,29,191,4,187,2,39,32,28,4,3,1,15,2,61
24,382,402,44,358,5,353,8,63,76,68,8,4,0,25,3,98
24,383,98,12,86,4,82,3,18,13,13,2,0,0,8,4,21
24,384,27,3,24,0,24,1,3,1,2,1,0,0,0,0,16
24,385,181,29,152,3,149,4,36,48,17,3,2,0,20,3,16
24,386,181,31,150,7,143,1,27,31,24,4,0,1,8,3,44
24,388,424,52,372,10,362,14,54,75,44,6,2,0,47,3,117
24,389,103,20,83,0,83,0,8,23,3,2,1,0,9,0,37
24,390,233,22,211,9,202,3,40,52,34,3,0,0,9,1,60
24,391,158,22,136,4,132,3,29,57,11,1,0,0,15,3,13
24,392,412,43,369,11,358,4,54,102,43,3,1,1,33,6,111
24,393,75,7,68,4,64,1,7,16,6,3,1,2,9,3,16
24,394,129,25,104,7,97,6,14,18,11,2,0,0,15,4,27
24,395,316,42,274,8,266,4,37,56,56,6,0,4,20,6,77
24,396,1190,185,1005,26,979,18,143,233,121,19,8,0,90,8,339
24,397,236,30,206,5,201,2,24,38,25,1,0,0,19,1,91
24,398,473,63,410,17,393,7,84,69,77,8,2,2,25,6,113
24,399,81,10,71,1,70,5,13,16,7,3,3,0,10,1,12
24,401,263,39,224,9,215,6,27,57,29,2,0,6,10,4,74
24,402,57,16,41,1,40,0,12,17,0,0,0,0,8,1,2
24,403,70,8,62,1,61,1,12,19,6,0,0,0,3,1,19
24,404,168,21,147,4,143,10,27,27,11,2,1,0,20,4,41
24,405,238,25,213,5,208,16,24,46,40,1,0,1,22,4,54
24,406,71,14,57,0,57,0,8,16,4,0,1,0,5,3,20
24,407,187,25,162,2,160,1,33,46,14,1,1,1,21,3,39
24,408,217,20,197,2,195,5,25,43,25,8,2,2,12,4,69
24,409,836,102,734,15,719,5,139,122,121,5,3,1,41,7,275
24,410,443,70,373,11,362,6,74,86,22,7,2,1,30,7,127
24,411,132,19,113,3,110,6,12,24,19,5,2,0,5,6,31
24,412,717,78,639,18,621,11,88,154,84,12,4,2,45,21,200
24,413,191,30,161,4,157,3,37,34,20,1,4,0,8,5,45
24,414,197,26,171,1,170,5,35,33,38,0,0,2,6,1,50
24,415,160,17,143,4,139,10,26,41,16,2,1,1,9,1,32
24,416,128,12,116,1,115,1,17,25,21,3,1,0,10,0,37
24,417,438,67,371,5,366,13,51,80,61,6,0,0,23,6,126
24,418,697,70,627,9,618,12,101,106,125,9,5,0,32,13,215
24,419,642,82,560,7,553,11,154,141,66,4,7,1,39,4,126
24,420,164,32,132,2,130,1,37,32,15,2,1,1,10,3,28
24,421,195,37,158,2,156,10,20,32,31,1,0,1,8,4,49
24,422,96,6,90,0,90,4,19,33,4,0,0,0,5,0,25
24,423,83,14,69,0,69,1,20,17,8,0,0,0,8,1,14
24,424,105,10,95,6,89,1,18,24,5,1,1,0,5,0,34
24,425,287,33,254,3,251,9,38,67,29,0,1,0,18,1,88
24,426,152,24,128,2,126,3,12,35,23,0,0,0,11,6,36
24,427,152,22,130,4,126,2,28,35,17,0,0,0,3,5,36
24,428,470,72,398,8,390,10,70,65,81,4,1,1,23,2,133
24,429,199,33,166,2,164,4,16,28,30,2,0,0,10,7,67
24,430,96,10,86,2,84,4,14,19,6,1,3,0,5,1,31
24,431,167,17,150,4,146,10,35,33,11,3,0,0,12,4,38
24,432,532,91,441,10,431,16,71,89,104,2,5,0,26,10,108
24,433,74,7,67,0,67,1,15,22,11,1,1,0,4,0,12
24,434,115,23,92,4,88,0,11,10,18,2,0,0,9,1,37
24,435,194,24,170,4,166,4,29,37,20,2,1,0,21,8,44
24,436,912,141,771,17,754,11,161,135,104,10,9,1,44,14,265
24,437,685,77,608,9,599,12,127,142,61,5,1,0,56,11,184
24,438,195,14,181,5,176,7,16,50,45,0,1,1,14,1,41
24,439,726,75,651,20,631,6,104,121,92,2,4,0,48,11,243
24,441,102,10,92,1,91,1,11,16,16,1,1,0,9,1,35
24,442,1501,185,1316,19,1297,24,220,167,330,29,9,4,90,24,400
24,443,340,60,280,6,274,23,26,38,53,0,2,1,13,2,116
24,444,204,25,179,2,177,2,39,28,24,1,1,0,15,1,66
24,445,106,16,90,2,88,4,22,21,5,3,1,0,7,1,24
24,446,45,6,39,1,38,3,7,2,7,1,0,0,6,0,12
24,447,468,48,420,8,412,0,75,75,74,3,5,1,34,10,135
24,448,374,38,336,8,328,9,57,67,49,6,3,0,22,7,108
24,449,769,91,678,21,657,9,147,141,73,11,2,0,48,13,213
24,450,543,80,463,9,454,10,87,108,35,5,0,0,31,8,170
24,451,680,110,570,10,560,9,84,130,84,14,5,0,48,6,180
24,452,189,31,158,3,155,1,21,49,19,0,0,0,17,0,48
24,453,312,47,265,5,260,3,17,77,37,6,5,0,19,6,90
24,454,502,78,424,8,416,6,107,92,43,4,7,0,25,7,125
24,455,556,93,463,20,443,9,78,114,75,2,2,0,33,11,119
24,456,142,21,121,0,121,1,25,42,7,0,1,1,14,2,28
24,457,134,10,124,2,122,2,21,19,15,5,0,0,4,2,54
24,458,272,26,246,4,242,2,31,47,31,5,2,0,19,5,100
24,459,233,35,198,5,193,5,37,46,18,1,1,0,23,9,53
24,460,345,50,295,9,286,2,67,73,31,11,1,1,16,7,77
24,461,580,97,483,14,469,11,98,118,53,5,3,0,48,16,117
24,462,1258,161,1097,24,1073,8,178,200,227,18,9,4,64,26,339
24,463,435,55,380,7,373,9,48,89,52,3,1,4,22,11,134
24,464,213,38,175,5,170,4,41,32,16,0,1,0,9,4,63
24,465,233,36,197,6,191,4,47,43,29,5,0,0,12,2,49
24,466,300,54,246,8,238,3,56,62,14,1,0,1,20,9,72
24,468,243,22,221,7,214,3,34,53,20,3,1,1,32,6,61
24,470,219,27,192,12,180,3,35,21,33,1,2,0,11,5,69
24,471,461,55,406,7,399,11,61,52,54,8,4,0,46,11,152
24,472,679,90,589,10,579,13,126,112,73,11,1,1,62,15,165
24,473,312,36,276,7,269,2,32,74,37,1,3,0,31,3,86
24,474,124,18,106,3,103,2,16,8,9,3,2,1,13,1,48
24,475,133,14,119,5,114,6,13,26,9,1,1,0,10,4,44
24,476,129,16,113,4,109,2,10,15,21,3,0,0,18,1,39
24,477,172,22,150,4,146,9,20,24,17,6,0,0,11,0,59
24,478,124,25,99,0,99,1,16,20,11,0,2,0,10,1,38
24,479,971,177,794,24,770,12,165,184,77,13,9,0,56,9,245
24,480,214,29,185,6,179,2,27,33,29,4,0,0,17,3,64
24,481,388,57,331,5,326,4,66,69,67,5,0,1,18,7,89
24,482,251,28,223,5,218,3,38,50,20,3,1,0,9,6,88
24,483,106,8,98,0,98,0,29,29,15,2,1,0,10,3,9
24,484,704,101,603,9,594,12,101,143,90,7,2,0,38,7,194
24,485,341,41,300,5,295,8,56,55,48,2,2,0,21,8,95
24,486,334,42,292,6,286,13,52,59,52,3,2,0,18,5,82
24,487,1209,140,1069,27,1042,14,235,238,131,17,4,2,73,26,302
24,488,347,50,297,5,292,6,47,72,38,7,1,0,14,6,101
24,489,323,35,288,7,281,7,46,87,44,2,2,0,18,2,73
24,490,358,56,302,6,296,5,58,68,36,5,5,1,19,3,96
24,491,475,72,403,9,394,7,65,62,62,7,2,0,18,10,161
24,492,51,10,41,0,41,1,10,13,3,0,0,0,7,0,7
24,493,93,10,83,0,83,2,4,27,6,0,0,1,7,1,35
24,494,337,39,298,4,294,5,62,72,41,4,1,0,19,4,86
24,495,80,8,72,1,71,0,14,17,3,1,0,3,11,2,20
24,496,270,25,245,6,239,8,28,55,39,0,0,0,23,8,78
24,497,280,35,245,7,238,2,33,71,23,2,1,2,24,6,74
24,498,731,103,628,28,600,4,92,183,66,8,6,0,42,13,186
24,499,637,68,569,16,553,13,98,118,72,7,2,0,52,13,178
24,500,115,9,106,3,103,2,22,20,11,0,1,0,8,4,35
24,501,369,47,322,4,318,15,83,60,39,3,2,2,24,8,82
24,502,77,5,72,1,71,1,8,11,19,1,1,0,5,2,23
24,503,101,10,91,0,91,0,6,31,21,0,0,0,5,2,26
24,504,187,20,167,5,162,1,28,64,16,1,0,0,18,4,30
24,505,276,37,239,6,233,3,29,46,31,2,6,1,21,8,86
24,507,120,18,102,1,101,1,14,34,6,0,0,0,10,3,33
24,508,169,20,149,2,147,3,13,14,21,1,0,1,4,3,87
24,509,445,60,385,14,371,12,57,84,56,0,5,2,23,6,126
24,510,320,54,266,3,263,10,33,59,39,3,2,1,22,5,89
24,511,233,35,198,5,193,2,35,52,18,3,2,1,15,5,60
24,512,230,22,208,3,205,9,38,29,27,2,0,0,28,3,69
24,513,212,16,196,3,193,8,34,36,19,5,0,0,28,4,59
24,514,211,37,174,4,170,5,41,48,24,3,0,2,4,1,42
24,515,392,75,317,6,311,9,37,43,41,6,2,1,25,5,142
24,516,851,117,734,22,712,9,122,204,73,5,5,2,64,21,207
24,517,61,2,59,0,59,1,13,15,5,2,0,1,8,1,13
24,518,183,18,165,3,162,5,27,33,14,2,2,0,27,3,49
24,519,330,37,293,7,286,9,52,54,68,1,4,1,24,8,65
24,520,6889,1037,5852,112,5740,145,715,1443,781,70,26,15,506,113,1926
24,521,758,89,669,14,655,12,128,132,79,3,5,0,61,17,218
24,522,297,30,267,15,252,4,27,54,55,3,1,0,20,3,85
24,523,317,44,273,6,267,8,40,55,31,8,0,1,34,2,88
24,524,117,19,98,3,95,4,19,20,14,7,1,1,4,0,25
24,525,158,17,141,4,137,4,30,26,31,2,1,0,1,4,38
24,526,545,80,465,14,451,9,66,111,49,4,3,1,34,10,164
24,527,682,105,577,13,564,5,82,127,120,4,4,0,39,13,170
24,528,104,13,91,5,86,7,12,15,16,2,1,0,8,0,25
24,529,163,23,140,0,140,3,14,13,17,2,0,0,7,3,81
24,530,173,23,150,5,145,0,24,27,16,4,2,0,17,2,53
24,531,179,32,147,3,144,12,11,35,22,3,0,0,16,1,44
24,532,119,21,98,0,98,3,13,21,11,1,0,0,14,5,30
24,533,77,9,68,0,68,2,15,23,8,0,0,0,7,0,13
24,534,571,82,489,11,478,15,79,122,69,12,2,0,42,9,128
24,535,193,14,179,2,177,2,42,33,26,2,2,0,11,4,55
24,536,164,16,148,5,143,6,26,32,39,2,0,0,6,1,31
24,537,223,27,196,6,190,5,24,54,23,1,1,0,19,2,61
24,538,738,139,599,7,592,11,73,142,79,13,2,4,52,8,208
24,540,986,103,883,21,862,18,110,223,100,16,6,1,65,20,303
24,541,63,9,54,0,54,3,5,13,7,0,1,0,4,0,21
24,542,62,18,44,0,44,1,10,18,8,1,0,0,1,0,5
24,543,897,132,765,15,750,16,164,181,104,6,5,0,50,17,207
24,544,336,44,292,5,287,2,28,56,62,2,0,0,23,9,105
24,545,101,6,95,4,91,1,16,16,5,0,0,0,14,1,38
24,546,38,7,31,2,29,2,1,4,5,0,1,0,3,0,13
24,547,3975,665,3310,68,3242,41,525,679,404,56,23,8,233,53,1220
24,548,241,23,218,3,215,3,43,47,40,5,1,0,16,7,53
24,549,256,50,206,4,202,6,50,51,23,4,1,0,16,3,48
24,550,968,177,791,21,770,16,154,190,79,14,1,0,46,18,252
24,551,2326,417,1909,62,1847,28,238,541,199,16,14,4,140,36,631
24,552,227,29,198,3,195,10,40,42,19,0,0,1,11,4,68
24,553,1273,161,1112,29,1083,24,184,214,153,11,7,3,71,22,394
24,554,319,53,266,7,259,3,58,85,22,3,0,0,25,5,58
24,555,496,57,439,11,428,5,54,104,63,5,3,2,27,6,159
24,557,4844,594,4250,71,4179,96,494,947,653,58,20,5,375,76,1455
24,558,431,59,372,8,364,8,79,84,56,7,2,0,21,5,102
24,559,268,45,223,15,208,18,32,40,29,5,1,1,12,7,63
24,560,117,14,103,0,103,0,4,44,8,4,0,1,9,0,33
24,561,308,46,262,9,253,5,50,63,31,6,2,0,21,3,72
24,562,232,14,218,5,213,6,38,38,31,2,3,0,17,2,76
24,563,224,27,197,5,192,13,16,45,32,1,0,0,10,5,70
24,564,513,78,435,13,422,14,75,95,57,5,1,1,41,9,124
24,565,305,37,268,4,264,6,48,51,45,5,4,0,31,7,67
24,566,359,45,314,7,307,3,56,72,38,5,3,1,17,5,107
24,567,218,24,194,6,188,3,28,55,26,5,1,0,21,3,46
24,568,761,100,661,12,649,10,167,151,59,4,6,0,45,13,194
24,569,120,19,101,1,100,0,34,21,8,1,0,0,10,1,25
24,570,47,3,44,0,44,0,4,13,9,1,0,0,8,1,8
24,571,1215,188,1027,21,1006,19,197,281,120,13,7,4,82,15,268
24,572,149,16,133,2,131,3,25,27,17,0,1,0,21,2,35
24,573,503,56,447,7,440,7,70,117,33,6,2,0,29,14,162
24,574,263,18,245,6,239,5,32,44,39,4,3,1,11,2,98
24,575,169,16,153,4,149,2,12,34,19,0,4,0,8,1,69
24,576,196,22,174,6,168,5,29,49,17,2,2,2,10,5,47
24,577,494,66,428,9,419,11,55,118,65,6,1,3,33,11,116
24,579,282,61,221,7,214,5,53,51,33,3,1,0,12,4,52
24,580,215,19,196,7,189,2,30,39,23,1,1,1,12,3,77
24,581,675,83,592,14,578,15,61,100,114,10,2,0,45,9,222
24,582,409,45,364,8,356,7,43,89,62,5,5,1,30,10,104
24,584,665,101,564,13,551,9,135,121,47,5,4,2,54,7,167
24,585,509,80,429,19,410,3,62,78,55,9,4,2,42,15,140
24,586,650,94,556,16,540,3,90,116,66,14,7,0,45,4,195
24,587,748,91,657,14,643,15,88,175,79,5,4,1,54,10,212
25,1,154,15,139,4,135,3,32,29,15,2,3,0,10,3,38
25,2,264,46,218,3,215,8,32,44,22,3,3,0,16,5,82
25,3,267,38,229,1,228,4,80,25,32,3,4,2,11,6,61
25,4,792,136,656,18,638,13,207,160,59,9,5,4,42,7,132
25,5,82,16,66,0,66,1,18,4,10,0,0,0,10,0,23
25,6,74,14,60,3,57,0,8,27,7,0,4,0,1,4,6
25,7,75,10,65,1,64,1,23,26,1,0,0,0,7,1,5
25,8,376,56,320,7,313,10,104,77,23,5,0,2,14,13,65
25,9,147,25,122,4,118,0,26,35,22,2,2,1,10,5,15
25,11,557,64,493,11,482,5,132,124,44,5,6,0,47,8,111
25,12,109,14,95,2,93,3,24,42,4,0,0,0,7,3,10
25,13,169,21,148,5,143,0,36,37,10,3,1,0,12,4,40
25,14,575,79,496,10,486,15,95,112,65,3,3,2,26,14,151
25,15,556,75,481,11,470,9,81,149,60,6,3,1,61,6,94
25,16,139,25,114,0,114,3,16,47,8,1,2,1,7,0,29
25,17,78,5,73,0,73,0,15,23,9,0,2,0,3,1,20
25,18,460,55,405,14,391,6,116,95,37,5,5,5,38,12,72
25,19,342,56,286,7,279,5,82,75,24,5,3,2,22,5,56
25,20,756,141,615,14,601,19,170,93,63,10,6,2,31,10,197
25,21,1156,172,984,19,965,17,184,317,89,11,6,5,82,17,237
25,22,1054,111,943,17,926,9,289,237,57,10,12,3,91,21,197
25,24,618,68,550,23,527,20,76,190,61,14,0,3,57,13,93
25,25,514,73,441,6,435,9,64,174,35,4,2,2,50,11,84
25,26,184,31,153,5,148,12,21,46,15,1,3,0,23,2,25
25,27,185,15,170,3,167,6,18,43,11,1,2,1,25,2,58
25,28,128,13,115,3,112,7,22,38,10,0,1,0,21,1,12
25,29,202,29,173,5,168,2,37,69,12,2,1,0,20,2,23
25,30,291,32,259,5,254,12,48,72,31,3,3,0,14,9,62
25,31,8977,2281,6696,124,6572,97,1528,1187,853,74,60,13,406,84,2270
25,32,300,37,263,4,259,2,57,93,16,5,0,1,18,3,64
25,33,481,75,406,9,397,9,112,100,33,7,2,0,28,8,98
25,34,1022,135,887,22,865,17,126,252,108,7,3,0,104,10,238
25,35,844,112,732,10,722,14,120,195,94,5,0,0,71,11,212
25,36,1503,224,1279,35,1244,26,180,365,157,13,1,3,125,15,359
25,38,152,27,125,1,124,1,35,46,12,1,0,0,5,0,24
25,39,577,56,521,9,512,12,96,202,30,4,3,0,57,11,97
25,40,573,84,489,12,477,4,146,120,52,12,3,1,36,11,92
25,41,267,38,229,6,223,4,55,86,4,2,5,1,25,3,38
25,42,172,14,158,9,149,3,21,71,10,2,4,1,14,1,22
25,43,1581,250,1331,26,1305,21,334,380,110,11,7,7,109,12,314
25,44,49,6,43,0,43,2,6,13,6,0,1,0,5,0,10
25,45,54,9,45,2,43,1,6,14,9,0,0,0,2,1,10
25,46,51,8,43,2,41,2,13,19,1,0,0,0,1,0,5
25,47,3864,752,3112,59,3053,62,575,833,287,54,31,7,242,58,904
25,48,2804,495,2309,32,2277,24,616,538,266,23,10,4,145,44,607
25,49,74,8,66,1,65,1,19,16,2,0,1,0,14,2,10
25,50,281,30,251,7,244,7,33,99,15,5,0,1,23,9,52
25,51,478,61,417,12,405,6,84,168,36,1,4,1,33,13,59
25,52,64,7,57,0,57,2,8,20,3,0,1,0,19,2,2
25,53,88,8,80,0,80,3,14,41,3,0,0,1,4,7,7
25,54,356,41,315,8,307,2,95,79,15,1,4,0,31,8,72
25,55,213,24,189,7,182,4,39,58,21,2,1,0,7,2,48
25,56,68372,15849,52523,833,51690,1816,6150,12777,7990,512,257,104,4400,707,16977
25,57,3345,737,2608,46,2562,40,553,359,398,27,15,3,147,31,989
25,58,1046,190,856,22,834,29,158,252,105,8,5,1,51,13,212
25,59,202,33,169,2,167,2,52,44,9,3,1,1,10,3,42
25,60,410,45,365,11,354,10,72,141,24,4,1,1,38,9,54
25,61,100,11,89,0,89,0,19,22,10,0,0,1,7,2,28
25,62,203,14,189,1,188,7,31,72,27,2,2,0,16,1,30
25,63,778,96,682,19,663,9,195,175,47,9,0,2,69,9,148
25,65,46,2,44,2,42,1,6,9,5,0,1,0,7,1,12
25,66,62,12,50,1,49,0,19,13,3,0,0,0,4,0,10
25,67,152,29,123,0,123,1,29,44,11,0,1,0,13,3,21
25,70,275,23,252,10,242,4,38,115,23,3,0,1,25,3,30
25,71,386,53,333,9,324,7,112,67,31,6,1,0,18,7,75
25,72,24,3,21,1,20,0,4,15,0,0,0,0,1,0,0
25,73,573,66,507,11,496,6,122,131,52,7,7,1,43,6,121
25,74,626,66,560,14,546,13,87,265,33,5,3,1,44,8,87
25,75,238,30,208,5,203,6,30,80,23,2,1,1,17,5,38
25,76,96,7,89,1,88,2,17,28,10,2,0,0,11,5,13
25,77,58,11,47,0,47,1,10,20,3,1,0,0,2,1,9
25,78,708,70,638,15,623,10,121,199,55,6,2,1,39,16,174
25,79,304,43,261,6,255,6,56,101,7,1,1,0,30,12,41
25,82,706,96,610,10,600,6,208,102,53,15,2,2,42,19,151
25,83,159,25,134,1,133,5,35,51,9,1,3,0,6,1,22
25,84,760,91,669,12,657,15,112,171,71,7,8,2,67,11,193
25,85,239,27,212,6,206,5,43,66,18,1,1,3,19,5,45
25,86,107,6,101,2,99,8,14,31,7,0,1,0,8,3,27
25,87,127,12,115,1,114,0,30,24,13,2,1,1,8,6,29
25,88,70,9,61,2,59,0,14,11,10,1,0,0,5,1,17
25,89,68,5,63,0,63,0,9,20,7,1,1,0,14,2,9
25,90,38,3,35,0,35,0,5,13,9,0,2,0,1,2,3
25,91,333,36,297,10,287,6,61,101,27,4,0,0,18,12,58
25,92,80,11,69,1,68,1,15,22,9,0,0,1,7,2,11
25,93,56,3,53,2,51,1,12,12,7,0,1,1,4,3,10
25,94,94,4,90,4,86,4,16,27,16,1,2,0,8,0,12
25,95,214,29,185,5,180,3,28,89,10,1,1,0,10,0,38
25,96,93,14,79,1,78,2,13,32,8,1,0,1,10,1,10
25,97,350,41,309,7,302,5,65,100,29,4,2,0,30,5,62
25,98,142,14,128,5,123,7,17,28,24,6,0,0,8,1,32
25,99,107,13,94,2,92,4,21,40,10,0,0,0,11,1,5
25,100,295,23,272,7,265,3,49,73,28,3,2,1,43,4,59
25,101,357,53,304,13,291,6,82,74,41,4,3,0,30,5,46
25,102,36,3,33,2,31,1,6,15,1,0,0,0,1,0,7
25,103,488,83,405,6,399,11,63,105,63,9,1,0,31,6,110
25,104,73,9,64,2,62,4,3,11,17,5,0,0,4,3,15
25,105,394,40,354,13,341,6,81,91,39,4,1,0,23,11,85
25,106,75,9,66,0,66,2,11,11,12,0,0,0,8,0,22
25,107,158,28,130,2,128,1,40,36,9,2,0,0,11,2,27
25,108,206,20,186,5,181,4,40,61,16,3,0,0,25,3,29
25,109,286,37,249,0,249,3,45,66,47,3,1,0,25,2,57
25,110,654,80,574,6,568,12,113,169,52,5,1,3,73,8,132
25,111,274,35,239,6,233,6,33,81,26,4,0,0,26,7,50
25,112,784,115,669,27,642,7,107,182,89,4,3,0,65,18,167
25,113,82,1,81,2,79,1,17,36,4,0,1,0,9,1,10
25,114,311,48,263,8,255,6,54,100,13,2,0,1,18,5,56
25,115,232,35,197,1,196,2,28,91,17,0,1,1,12,5,39
25,116,185,13,172,0,172,2,55,51,18,1,1,0,9,2,33
25,117,66,4,62,0,62,1,21,19,7,1,1,0,7,1,4
25,119,273,40,233,3,230,3,46,82,21,3,1,1,19,6,48
25,120,305,29,276,5,271,4,47,119,29,1,0,0,26,5,40
25,121,217,30,187,6,181,15,6,40,27,2,1,0,41,8,41
25,122,300,26,274,8,266,6,71,89,26,2,3,3,33,10,23
25,123,138,12,126,2,124,3,28,34,13,4,0,0,19,2,21
25,124,197,30,167,4,163,0,44,60,10,2,1,0,6,6,34
25,125,253,25,228,11,217,7,44,67,26,4,1,2,11,2,53
25,126,360,56,304,1,303,9,61,67,47,5,3,1,26,5,79
25,127,1751,278,1473,29,1444,18,221,544,96,13,17,6,104,30,395
25,128,180,12,168,7,161,2,42,43,12,3,1,0,26,3,29
25,129,98,6,92,3,89,4,9,33,3,0,2,0,5,4,29
25,130,32,5,27,1,26,0,3,12,1,0,0,0,2,0,8
25,131,99,23,76,1,75,3,11,28,6,0,0,0,11,4,12
25,132,102,7,95,2,93,4,15,41,10,1,0,1,6,1,14
25,133,1661,231,1430,27,1403,52,218,511,128,12,8,2,117,26,329
25,134,22,2,20,1,19,0,0,5,6,1,0,0,5,0,2
25,136,366,52,314,3,311,13,49,96,28,5,1,1,39,6,73
25,137,172,33,139,4,135,0,31,45,15,5,0,0,10,4,25
25,138,115,17,98,1,97,3,27,34,6,1,0,0,9,4,13
25,139,349,51,298,4,294,4,37,140,14,7,5,3,25,8,51
25,140,158,24,134,2,132,1,28,36,11,1,1,1,14,0,39
25,141,106,20,86,1,85,4,20,27,5,1,2,0,14,1,11
25,142,190,33,157,3,154,4,15,57,20,4,1,1,18,3,31
25,143,152,19,133,1,132,4,20,28,23,2,2,0,19,4,30
25,145,99,14,85,0,85,2,16,32,3,1,1,1,9,5,15
25,147,970,140,830,13,817,24,106,222,104,12,4,3,69,12,261
25,148,296,35,261,7,254,4,47,90,29,1,0,1,30,2,50
25,149,390,48,342,5,337,5,84,99,34,4,0,0,24,11,76
25,150,173,21,152,1,151,6,26,32,17,6,1,2,17,2,42
25,151,86,12,74,3,71,0,11,24,13,0,1,0,8,0,14
25,152,92,11,81,0,81,2,24,28,2,3,0,1,12,4,5
25,153,89,8,81,1,80,0,25,37,4,0,0,0,6,1,7
25,154,237,38,199,4,195,7,39,53,20,4,2,0,11,3,56
25,155,247,29,218,3,215,7,26,61,31,2,1,0,22,3,62
25,156,772,141,631,12,619,5,187,142,60,10,8,1,51,11,144
25,157,857,127,730,20,710,25,143,264,56,8,8,3,55,13,135
25,159,1154,225,929,24,905,11,229,183,112,12,13,1,53,14,277
25,160,520,42,478,11,467,7,64,208,34,12,4,1,62,12,63
25,161,36,18,18,1,17,0,5,5,0,2,0,0,2,0,3
25,162,131,21,110,0,110,2,27,30,14,2,0,0,8,1,26
25,163,82,9,73,1,72,0,21,11,6,0,0,0,5,0,29
25,164,98,24,74,2,72,3,11,17,13,2,0,0,8,2,16
25,166,57,9,48,0,48,0,7,23,3,0,0,1,5,2,7
25,170,894,156,738,15,723,14,172,191,74,6,10,1,53,11,191
25,171,64,7,57,4,53,0,17,14,6,2,1,0,9,2,2
25,172,123,19,104,2,102,2,37,18,13,1,2,0,7,5,17
25,173,140,21,119,0,119,1,30,71,3,0,0,0,3,2,9
25,174,169,22,147,2,145,5,48,44,8,1,2,0,13,0,24
25,175,75,9,66,0,66,0,10,31,6,0,0,0,3,2,14
25,176,212,18,194,7,187,3,35,50,19,3,1,1,20,5,50
25,177,141,25,116,2,114,3,21,44,1,5,2,0,4,0,34
25,178,100,17,83,2,81,1,15,36,7,0,2,1,2,2,15
25,179,48,8,40,1,39,5,3,14,3,0,0,0,3,2,9
25,180,107,12,95,0,95,7,18,16,25,2,0,0,6,2,19
25,181,103,19,84,2,82,1,22,22,7,0,0,0,4,2,24
25,182,70,7,63,0,63,1,10,29,6,0,0,0,2,3,12
25,183,71,7,64,0,64,2,11,30,4,3,0,1,4,0,9
25,184,177,18,159,5,154,4,35,40,12,1,3,2,14,4,39
25,185,53,1,52,2,50,1,1,26,6,2,0,0,6,2,6
25,186,620,74,546,16,530,6,125,148,48,3,0,2,55,13,130
25,187,383,66,317,5,312,1,90,91,21,3,2,0,26,11,67
25,188,609,91,518,13,505,6,136,104,50,6,5,5,44,9,140
25,189,146,7,139,3,136,1,39,43,13,2,1,0,13,3,21
25,190,1177,188,989,24,965,21,272,215,82,11,3,2,87,17,255
25,191,377,59,318,7,311,9,103,65,37,1,1,0,14,6,75
25,192,121,17,104,1,103,0,44,24,4,0,0,0,6,0,25
25,193,1372,254,1118,28,1090,16,159,406,80,12,8,2,112,23,272
25,194,94,11,83,1,82,1,35,13,5,3,1,1,4,3,16
25,195,804,93,711,7,704,18,126,175,91,2,2,0,72,11,207
25,196,1134,165,969,18,951,10,298,225,68,14,8,4,83,18,223
25,197,495,74,421,7,414,12,98,59,69,4,2,4,52,11,103
25,198,446,57,389,3,386,7,128,84,33,1,2,0,37,14,80
25,199,253,12,241,7,234,6,51,97,18,1,3,1,32,4,21
25,200,1058,138,920,18,902,26,145,273,96,8,3,2,95,17,237
25,201,456,42,414,13,401,5,72,164,28,9,3,2,42,10,66
25,202,166,22,144,5,139,1,26,60,16,0,0,0,14,2,20
25,203,111,6,105,1,104,3,14,53,1,2,1,0,13,6,11
25,204,1808,217,1591,40,1551,42,289,529,155,20,5,3,124,26,358
25,207,537,78,459,10,449,11,110,116,35,10,2,1,35,16,113
25,208,132,11,121,5,116,3,16,37,11,1,0,0,21,0,27
25,209,79,7,72,3,69,1,8,31,10,1,0,0,7,0,11
25,210,105,10,95,3,92,0,25,27,7,0,0,1,9,2,21
25,211,69,7,62,1,61,1,18,18,7,1,1,0,6,0,9
25,212,1607,199,1408,22,1386,48,204,403,163,18,4,3,142,26,375
25,213,487,44,443,8,435,11,69,114,60,7,6,0,46,10,112
25,214,365,27,338,5,333,4,103,89,29,9,3,2,21,5,68
25,215,58,4,54,0,54,0,7,17,11,1,0,0,4,0,14
25,216,247,31,216,6,210,2,54,57,20,3,1,0,22,6,45
25,217,436,70,366,1,365,3,71,99,37,3,0,0,39,7,106
25,218,78,4,74,2,72,1,21,33,5,0,0,0,5,0,7
25,219,405,42,363,7,356,10,73,137,13,3,2,0,48,10,60
25,220,391,58,333,4,329,11,55,124,29,3,1,0,45,4,57
25,221,38,1,37,3,34,1,3,11,3,0,1,0,7,0,8
25,222,751,91,660,17,643,11,111,242,39,9,6,5,83,11,126
25,223,291,46,245,3,242,9,43,80,22,4,2,2,33,7,40
25,224,597,78,519,8,511,10,150,109,27,7,3,2,53,10,140
25,225,133,22,111,1,110,2,42,25,5,1,1,0,5,2,27
25,226,181,23,158,6,152,2,45,51,4,2,4,0,7,5,32
25,227,148,14,134,5,129,2,22,47,8,2,2,0,16,8,22
25,228,2458,383,2075,46,2029,31,475,499,209,24,12,3,166,41,569
25,229,238,21,217,4,213,6,41,87,10,4,0,1,19,4,41
25,230,2450,419,2031,46,1985,24,479,524,176,16,19,9,146,25,567
25,231,77,10,67,3,64,1,16,34,1,0,0,0,7,3,2
25,232,88,14,74,2,72,0,30,12,2,0,0,0,7,3,18
25,233,168,13,155,5,150,1,35,51,8,5,1,2,24,3,20
25,234,103,10,93,2,91,1,22,31,1,3,0,0,10,2,21
25,235,216,25,191,2,189,4,39,55,17,1,1,1,14,0,57
25,236,204,19,185,0,185,13,24,80,24,5,0,1,11,3,24
25,237,1576,252,1324,25,1299,21,438,278,153,25,9,2,66,18,289
25,238,105,7,98,5,93,0,27,36,3,0,0,0,5,0,22
25,239,136,14,122,1,121,0,39,49,6,2,4,0,6,1,14
25,240,2004,220,1784,28,1756,30,258,708,144,32,11,6,186,31,350
25,241,116,13,103,1,102,2,17,33,15,1,0,1,11,2,20
25,242,77,10,67,0,67,0,13,19,9,1,1,0,7,0,17
25,243,400,51,349,4,345,8,75,159,24,4,0,1,27,7,40
25,244,61,5,56,1,55,1,13,23,6,1,1,0,3,1,6
25,245,709,77,632,16,616,17,88,221,55,5,2,1,80,6,141
25,246,202,35,167,4,163,2,60,22,17,1,2,2,10,2,45
25,247,77,11,66,2,64,0,9,22,10,1,0,0,3,1,18
25,248,371,41,330,10,320,4,56,135,25,5,2,0,33,11,49
25,249,44,6,38,2,36,0,8,9,3,0,1,0,3,1,11
25,250,319,30,289,7,282,10,63,87,30,11,1,0,17,1,62
25,251,107,10,97,0,97,2,20,25,8,1,0,0,10,3,28
25,252,73,9,64,0,64,0,18,24,4,0,0,0,12,0,6
25,253,225,21,204,3,201,3,47,69,16,5,0,0,11,3,47
25,254,895,128,767,20,747,27,143,267,80,8,4,2,85,27,104
25,255,250,28,222,7,215,6,21,119,12,3,0,0,24,5,25
25,256,541,57,484,13,471,4,117,179,28,3,4,1,40,13,82
25,257,198,43,155,4,151,4,36,45,14,3,0,0,6,1,42
25,258,1525,211,1314,27,1287,28,175,343,172,13,8,0,159,27,362
25,259,1286,220,1066,22,1044,32,203,380,75,9,4,7,95,18,221
25,261,61,13,48,0,48,0,11,18,2,0,1,0,1,2,13
25,262,322,38,284,18,266,12,53,108,13,6,1,0,14,7,52
25,263,153,13,140,2,138,7,24,44,15,7,1,0,14,3,23
25,264,65,5,60,1,59,0,16,14,4,1,1,0,2,1,20
25,265,976,132,844,14,830,13,162,249,81,10,2,2,90,16,205
25,266,112,19,93,1,92,2,28,16,8,2,3,0,8,2,23
25,267,457,55,402,10,392,8,87,104,39,3,0,0,43,8,100
25,268,91,16,75,4,71,0,15,37,5,1,0,0,6,2,5
25,269,60,4,56,0,56,1,17,12,6,1,1,0,12,0,6
25,270,82,10,72,2,70,5,5,35,5,3,0,0,11,2,4
25,271,1033,121,912,28,884,15,137,353,82,11,5,0,91,25,165
25,273,159,11,148,6,142,5,24,38,12,1,1,2,11,5,43
25,274,276,52,224,7,217,6,64,40,24,2,6,0,13,1,61
25,275,177,32,145,3,142,0,43,49,7,3,3,0,18,3,16
25,276,141,10,131,1,130,2,36,40,13,2,0,1,15,0,21
25,277,58,8,50,1,49,2,9,6,4,4,1,0,8,0,15
25,278,382,36,346,8,338,12,66,104,39,3,1,2,34,2,75
25,279,103,15,88,3,85,3,17,18,14,5,2,0,7,1,18
25,280,112,23,89,3,86,1,13,44,7,0,0,1,10,2,8
25,281,215,36,179,4,175,5,55,23,21,4,4,0,13,11,39
25,282,499,72,427,22,405,11,65,147,44,5,3,2,41,18,69
25,283,47,3,44,0,44,0,12,15,2,0,2,0,5,0,8
25,284,3256,698,2558,40,2518,29,510,460,299,24,20,4,130,27,1015
25,285,1066,153,913,23,890,16,118,362,85,14,7,3,115,19,151
25,286,94,12,82,1,81,0,8,43,5,2,0,0,11,6,6
25,287,1048,125,923,11,912,22,133,253,124,9,2,3,105,20,241
25,288,477,50,427,15,412,15,55,222,27,2,2,0,30,8,51
25,289,63,9,54,0,54,0,9,28,0,3,1,0,10,0,3
25,290,76,8,68,2,66,1,14,33,3,0,0,0,4,0,11
25,293,673,69,604,20,584,20,87,220,70,2,2,2,59,19,103
25,295,212,16,196,5,191,12,26,59,16,5,1,0,27,4,41
25,296,547,77,470,13,457,15,72,134,63,7,3,1,66,9,87
25,297,102,9,93,2,91,1,13,31,8,1,0,1,10,1,25
25,298,166,20,146,5,141,1,36,38,7,2,0,1,10,5,41
25,299,86,9,77,3,74,0,24,18,7,0,1,0,4,3,17
25,300,166,14,152,2,150,2,20,59,13,1,0,1,15,9,30
25,301,569,65,504,11,493,8,64,247,40,2,5,2,50,9,66
25,302,81,8,73,3,70,0,14,33,3,1,0,1,8,0,10
25,303,162,20,142,2,140,5,23,48,11,2,0,1,11,5,34
25,304,2558,594,1964,40,1924,28,573,338,205,22,16,0,129,40,573
25,305,385,46,339,2,337,8,82,70,28,6,5,0,41,25,72
25,306,85,16,69,0,69,1,15,25,7,1,0,0,1,0,19
25,307,502,76,426,10,416,12,55,180,39,5,2,1,45,13,64
25,308,257,35,222,6,216,4,21,108,15,3,1,0,22,3,39
25,309,731,108,623,21,602,12,123,195,49,13,3,4,59,15,129
25,310,84,18,66,1,65,0,5,12,11,1,1,0,3,0,32
25,311,156,18,138,1,137,1,48,25,11,3,0,0,14,5,30
25,312,62,7,55,2,53,1,11,8,11,0,1,0,6,0,15
25,313,139,32,107,5,102,2,25,13,8,3,0,0,14,2,35
25,314,195,31,164,2,162,4,48,83,6,0,1,0,11,3,6
25,315,2049,271,1778,39,1739,30,486,386,164,24,14,3,102,21,509
25,316,230,16,214,5,209,3,58,57,22,2,0,0,18,5,44
25,317,168,24,144,2,142,3,45,34,17,1,0,0,11,2,29
25,318,1037,207,830,23,807,25,143,318,69,14,1,4,87,21,125
25,319,78,19,59,0,59,0,12,17,5,0,1,1,4,8,11
25,320,756,89,667,17,650,22,83,277,50,7,7,4,61,23,116
25,321,3265,645,2620,48,2572,46,367,1033,220,34,14,5,243,59,551
25,322,296,38,258,13,245,1,61,80,14,2,1,1,17,3,65
25,323,294,46,248,4,244,4,60,32,33,2,2,0,10,5,96
25,324,116,13,103,2,101,0,24,47,6,0,0,0,7,2,15
25,325,175,17,158,4,154,2,22,71,14,1,0,0,16,1,27
25,326,386,60,326,5,321,8,71,70,33,4,3,0,24,12,96
25,327,56,6,50,0,50,3,11,11,2,2,1,0,4,2,14
25,328,505,54,451,18,433,15,49,128,52,3,4,6,58,8,110
25,329,37,1,36,0,36,1,10,10,3,0,0,0,7,2,3
25,330,129,14,115,4,111,3,25,22,15,0,0,0,15,2,29
25,331,165,19,146,1,145,10,33,62,10,0,0,0,11,2,17
25,332,427,82,345,4,341,10,81,71,50,2,2,1,29,5,90
25,333,258,35,223,1,222,7,52,81,15,5,0,0,27,9,26
25,334,1302,166,1136,24,1112,12,197,424,104,18,5,3,112,28,209
25,335,140,18,122,3,119,2,38,18,16,2,2,1,13,3,24
25,336,371,43,328,11,317,12,42,73,54,6,4,0,25,5,96
25,338,79,12,67,1,66,5,10,26,13,0,0,0,5,0,7
25,339,178,27,151,3,148,2,21,52,15,0,1,1,18,4,34
25,340,178,36,142,1,141,9,33,32,21,0,0,0,14,0,32
25,341,131,7,124,1,123,4,20,54,5,0,3,0,13,2,22
25,342,54,2,52,2,50,2,12,18,3,1,0,0,5,2,7
25,343,113,16,97,5,92,3,21,48,2,0,0,0,9,1,8
25,344,42,5,37,4,33,0,3,17,2,1,0,0,6,1,3
25,345,469,55,414,4,410,2,111,92,27,3,3,1,35,9,127
25,346,137,9,128,3,125,2,15,61,5,0,0,0,19,2,21
25,347,504,53,451,14,437,13,86,171,19,4,6,2,42,11,83
25,348,315,49,266,6,260,9,32,103,19,9,1,0,30,7,50
25,349,349,52,297,5,292,11,56,127,20,1,2,1,25,6,43
25,350,596,70,526,7,519,7,150,109,64,4,3,3,37,12,130
25,351,147,19,128,6,122,2,26,52,5,1,0,0,15,2,19
25,354,140,28,112,8,104,1,41,28,6,2,0,0,12,2,12
25,355,33,2,31,1,30,0,13,13,1,0,0,0,1,1,1
25,356,2791,528,2263,60,2203,35,317,764,156,35,14,6,239,37,600
25,357,467,54,413,18,395,7,96,164,18,5,2,1,36,6,60
25,359,135,15,120,1,119,1,26,40,11,3,0,1,4,3,30
25,360,105,7,98,2,96,4,12,32,8,1,1,0,11,0,27
25,361,489,61,428,7,421,21,61,147,27,6,2,3,55,15,84
25,362,158,17,141,3,138,10,21,49,12,3,1,0,15,3,24
25,364,1107,152,955,23,932,22,156,288,91,10,4,1,92,26,242
25,365,250,18,232,3,229,7,75,28,23,5,2,2,20,4,63
25,366,141,12,129,4,125,3,22,53,11,1,1,0,18,0,16
25,367,3452,648,2804,52,2752,25,833,514,283,50,21,6,177,55,788
25,368,791,73,718,10,708,16,157,166,97,12,7,1,61,17,174
25,369,115,18,97,0,97,1,35,22,8,2,1,0,8,2,18
25,370,1789,296,1493,28,1465,21,460,383,113,15,11,2,114,18,328
25,371,143,12,131,3,128,6,32,41,19,0,4,0,14,5,7
25,372,231,36,195,4,191,3,59,40,23,3,4,0,13,4,42
25,373,33,2,31,0,31,1,3,8,4,0,0,0,4,1,10
25,374,324,41,283,4,279,4,71,101,21,6,2,0,23,1,50
25,375,316,16,300,3,297,4,49,91,18,3,5,0,43,3,81
25,376,80,8,72,2,70,3,19,20,7,0,0,0,10,1,10
25,377,149,26,123,1,122,2,25,30,20,0,0,0,10,1,34
25,378,276,55,221,7,214,7,60,51,17,2,1,2,21,7,46
25,379,64,13,51,1,50,2,12,12,14,0,0,0,1,0,9
25,380,740,169,571,14,557,14,91,224,63,4,1,5,50,8,97
25,381,1676,252,1424,20,1404,31,210,482,136,5,5,7,137,28,363
25,382,318,45,273,2,271,7,40,66,43,2,3,0,25,7,78
25,383,242,26,216,3,213,7,51,67,20,0,1,2,25,3,37
25,384,71,9,62,2,60,0,20,14,9,0,0,0,1,1,15
25,385,95,10,85,0,85,2,19,27,8,1,0,1,6,2,19
25,386,125,16,109,2,107,1,24,46,7,0,1,0,21,1,6
25,387,285,35,250,10,240,4,61,64,22,7,7,0,22,7,46
25,388,14548,3417,11131,214,10917,217,2102,2728,1141,111,85,21,846,152,3514
25,389,79,13,66,1,65,2,12,23,6,3,0,0,8,3,8
25,390,239,19,220,8,212,4,46,75,17,3,1,1,27,8,30
25,391,138,13,125,0,125,6,12,49,13,1,1,0,23,4,16
25,392,118,14,104,1,103,3,19,47,3,0,1,0,7,2,21
25,393,427,98,329,9,320,8,77,68,39,4,0,1,32,1,90
25,394,1189,178,1011,21,990,12,281,159,147,22,7,4,90,21,247
25,395,1115,115,1000,13,987,53,111,350,95,5,15,3,108,19,228
25,397,1498,201,1297,21,1276,24,267,388,124,19,10,2,120,32,290
25,398,69,6,63,0,63,1,10,35,3,2,2,0,6,2,2
25,399,80,9,71,1,70,4,18,15,7,4,2,0,2,2,16
25,400,366,51,315,4,311,8,40,108,42,1,4,2,23,9,74
25,401,24,2,22,0,22,0,5,7,2,2,0,0,0,0,6
25,402,25,2,23,1,22,3,5,9,2,0,0,0,2,0,1
25,403,1534,244,1290,29,1261,20,182,514,111,9,4,3,146,27,245
25,404,81,12,69,1,68,1,13,26,9,1,1,2,9,0,6
25,405,583,68,515,10,505,15,67,199,59,10,3,3,52,13,84
25,406,422,42,380,14,366,7,67,103,68,3,2,0,40,8,68
25,408,58,10,48,3,45,0,12,20,2,3,1,0,1,1,5
25,410,836,90,746,16,730,24,104,199,93,8,5,1,79,15,202
25,411,4578,942,3636,101,3535,77,514,1210,371,45,13,5,327,71,902
25,413,673,102,571,11,560,19,111,213,45,8,7,5,54,10,88
25,414,78,4,74,2,72,2,27,14,3,2,1,0,8,0,15
25,415,247,39,208,5,203,13,21,55,29,1,3,1,16,3,61
25,416,154,10,144,4,140,7,16,42,15,0,1,1,17,3,38
25,417,547,74,473,12,461,14,95,132,42,2,3,0,58,8,107
25,418,916,104,812,18,794,28,106,237,70,10,4,0,98,18,223
25,419,84,17,67,1,66,0,17,11,5,5,2,0,4,3,19
25,420,122,15,107,3,104,3,13,28,28,1,0,0,6,2,23
25,421,53,4,49,3,46,0,9,26,2,0,1,0,1,4,3
25,422,124,9,115,4,111,1,36,26,7,0,0,0,11,1,29
25,424,383,41,342,13,329,8,72,91,29,1,5,5,43,5,70
25,425,253,21,232,11,221,4,35,86,14,1,2,2,34,10,33
25,426,290,31,259,6,253,6,80,66,28,2,2,1,16,7,45
25,427,283,28,255,7,248,2,37,82,22,5,2,3,27,8,60
25,428,1360,214,1146,10,1136,12,301,344,89,7,6,7,96,18,256
25,429,848,114,734,10,724,13,136,120,125,12,9,2,40,7,260
25,430,41,2,39,0,39,0,10,13,1,0,0,0,4,0,11
25,431,329,49,280,2,278,7,80,59,29,0,1,1,39,2,60
25,432,1314,203,1111,28,1083,27,191,460,77,15,14,3,116,20,160
25,433,34,6,28,0,28,0,4,15,0,0,0,0,2,0,7
25,434,3064,468,2596,61,2535,55,367,834,276,19,10,8,214,52,700
25,435,128,16,112,4,108,4,32,31,11,1,0,0,5,0,24
25,436,54,6,48,3,45,0,15,18,1,0,1,0,6,0,4
25,437,243,37,206,8,198,4,33,67,21,6,1,0,20,5,41
25,438,295,42,253,4,249,8,58,64,34,2,2,1,26,0,54
25,439,165,25,140,0,140,2,38,27,23,2,3,0,11,1,33
25,440,302,51,251,5,246,6,57,103,10,4,2,1,16,2,45
25,441,58,8,50,3,47,0,9,24,1,0,0,0,8,2,3
25,442,479,66,413,7,406,15,69,158,37,7,5,1,30,8,76
25,443,46,6,40,2,38,0,18,10,1,0,0,0,3,0,6
25,444,94,8,86,9,77,1,28,28,3,2,1,0,3,2,9
25,445,103,10,93,1,92,4,9,28,13,6,0,1,9,0,22
25,446,193,36,157,4,153,2,28,53,8,1,1,1,30,2,27
25,447,233,34,199,4,195,7,49,76,5,3,0,1,25,9,20
25,448,912,84,828,18,810,15,136,219,83,14,7,2,83,14,237
25,449,110,22,88,2,86,1,16,31,7,2,1,0,10,2,16
25,450,66,12,54,1,53,0,9,11,4,1,0,0,8,1,19
25,451,116,23,93,1,92,3,21,26,8,3,0,2,10,1,18
25,452,291,38,253,6,247,0,87,58,34,2,3,0,12,3,48
25,453,1014,139,875,20,855,22,178,322,56,5,4,0,100,16,152
25,454,1405,163,1242,31,1211,26,168,406,109,10,6,2,152,21,311
25,455,131,14,117,2,115,5,19,28,12,2,1,1,17,6,24
25,456,141,10,131,8,123,2,16,50,10,1,0,0,15,6,23
25,457,81,9,72,3,69,0,12,48,0,0,0,0,5,0,4
25,458,158,23,135,6,129,0,23,57,6,0,0,0,23,2,18
25,459,196,17,179,3,176,10,11,74,16,4,0,0,16,13,32
25,460,97,14,83,2,81,3,19,26,7,2,1,1,5,1,16
25,461,255,43,212,2,210,3,62,46,19,1,2,0,13,5,59
25,462,11803,2723,9080,206,8874,258,1295,2821,1003,101,45,29,827,151,2344
25,463,3293,469,2824,62,2762,29,681,652,263,55,19,2,172,66,823
25,464,82,8,74,3,71,1,10,31,1,5,1,0,12,3,7
25,465,145,19,126,1,125,1,28,40,7,1,2,0,9,3,34
25,466,558,52,506,20,486,11,107,137,58,5,3,1,44,6,114
25,467,1471,169,1302,21,1281,32,192,380,147,12,12,2,122,22,360
25,468,597,104,493,13,480,6,130,121,55,13,2,1,31,11,110
25,469,377,42,335,14,321,7,89,92,31,5,6,0,24,6,61
25,470,125,9,116,6,110,1,39,40,9,1,1,0,5,0,14
25,471,113,20,93,1,92,1,16,38,12,0,0,0,3,3,19
25,472,37,6,31,1,30,2,4,8,1,0,1,0,2,1,11
25,473,532,51,481,13,468,11,86,118,61,3,3,1,38,8,139
25,474,60,8,52,2,50,2,14,9,4,2,1,0,4,1,13
25,475,800,134,666,8,658,13,153,171,68,18,7,3,51,16,158
25,476,95,5,90,4,86,0,18,38,6,1,2,3,7,3,8
25,477,215,34,181,2,179,3,38,47,16,1,3,0,20,1,50
25,478,86,7,79,2,77,0,17,28,1,1,0,0,12,1,17
25,479,309,41,268,3,265,4,68,61,25,3,7,0,14,4,79
25,480,142,13,129,0,129,1,26,49,9,2,0,0,15,0,27
25,481,241,24,217,5,212,2,49,46,23,0,0,1,28,5,58
25,482,459,71,388,10,378,12,69,130,24,4,1,0,35,7,96
25,483,43,6,37,0,37,2,6,11,2,1,0,1,7,0,7
25,485,180,20,160,4,156,1,43,54,13,3,1,0,15,0,26
25,486,265,29,236,2,234,9,30,94,27,5,1,1,22,6,39
25,487,29,1,28,1,27,0,3,14,1,0,0,0,3,0,6
25,488,83,15,68,1,67,5,15,18,12,3,0,1,5,1,7
25,489,237,20,217,5,212,8,30,72,18,2,0,1,34,7,40
25,490,332,39,293,4,289,4,69,94,36,7,0,1,24,2,52
25,491,92,5,87,3,84,0,14,28,6,0,0,0,3,1,32
25,492,66,10,56,2,54,1,6,27,4,0,0,1,11,1,3
25,493,584,71,513,18,495,15,104,140,36,4,3,1,56,15,121
25,494,391,53,338,10,328,15,55,117,23,12,1,1,34,11,59
25,495,1549,235,1314,20,1294,29,254,289,147,15,9,6,113,23,409
25,496,85,7,78,1,77,3,19,22,5,2,2,0,4,4,16
25,497,487,48,439,8,431,9,139,99,37,9,2,0,26,11,99
25,498,41,7,34,0,34,0,9,20,0,1,0,0,0,0,4
25,499,94,21,73,3,70,2,26,11,5,0,1,0,6,3,16
25,500,59,6,53,1,52,1,7,22,6,0,0,0,9,0,7
25,501,27,5,22,2,20,1,8,1,2,0,2,2,1,1,2
25,502,328,36,292,4,288,5,67,91,19,5,5,1,22,8,65
25,503,100,10,90,4,86,0,29,26,2,1,1,0,12,1,14
25,504,56,6,50,1,49,1,14,20,2,0,1,1,3,0,7
25,505,815,123,692,13,679,7,167,176,81,9,9,2,53,9,166
25,506,69,8,61,0,61,0,17,10,6,0,1,1,2,0,24
25,507,67,10,57,1,56,2,15,14,4,0,0,0,5,4,12
25,508,810,111,699,15,684,14,156,203,70,10,3,1,46,17,164
25,509,410,59,351,6,345,11,81,98,41,5,3,4,24,5,73
25,510,236,28,208,6,202,1,50,57,17,2,1,0,22,1,51
25,511,230,31,199,7,192,7,48,69,13,4,3,0,8,5,35
25,512,1605,227,1378,39,1339,32,210,467,101,12,5,2,101,27,382
25,513,39,12,27,2,25,2,2,2,5,0,1,0,2,3,8
25,514,222,28,194,2,192,8,28,83,23,1,2,0,21,4,22
25,515,252,27,225,1,224,9,27,90,23,4,1,1,15,3,51
25,516,78,8,70,1,69,1,12,12,13,4,1,0,3,3,20
25,517,186,23,163,5,158,5,25,64,13,0,1,0,11,4,35
25,518,84,4,80,0,80,0,15,23,17,0,0,0,1,1,23
25,519,728,106,622,14,608,11,170,115,61,12,5,0,25,6,203
25,520,168,43,125,2,123,0,27,45,11,0,1,0,14,3,22
25,521,144,20,124,4,120,0,22,35,7,0,0,0,25,0,31
25,522,112,7,105,3,102,3,26,38,11,0,0,1,11,1,11
25,523,621,75,546,8,538,13,172,123,36,6,4,1,59,10,114
25,524,642,102,540,8,532,15,122,109,69,6,4,2,58,9,138
25,525,239,40,199,2,197,11,22,83,20,2,1,1,16,3,38
25,526,956,149,807,21,786,11,213,145,87,8,7,0,55,21,239
25,527,3384,548,2836,59,2777,51,559,769,303,23,16,4,234,58,760
25,528,74,4,70,4,66,1,16,20,6,2,1,0,3,1,16
25,529,775,115,660,11,649,12,150,262,42,13,2,2,64,9,93
25,530,294,49,245,6,239,6,52,108,17,6,1,0,22,3,24
25,531,64,4,60,0,60,0,13,16,5,1,1,0,12,0,12
25,532,2264,258,2006,31,1975,41,320,545,228,16,11,5,217,37,555
25,533,23,4,19,0,19,1,1,10,2,0,0,0,1,0,4
25,534,119,13,106,1,105,3,25,47,10,0,1,0,9,0,10
25,535,174,10,164,1,163,10,35,34,22,1,0,1,18,2,40
25,536,142,17,125,1,124,1,22,34,19,3,2,0,14,4,25
25,537,205,35,170,3,167,10,35,52,13,1,0,0,21,0,35
25,538,82,18,64,3,61,0,15,21,6,0,0,0,4,3,12
25,539,4419,768,3651,80,3571,39,927,927,323,46,24,9,277,86,913
25,540,255,32,223,4,219,4,65,35,17,0,3,3,25,4,63
25,541,269,45,224,4,220,5,39,97,15,3,2,0,20,4,35
25,542,1093,113,980,19,961,23,146,273,106,11,5,4,96,13,284
25,544,150,24,126,1,125,1,20,59,7,1,0,0,14,1,22
25,545,83,8,75,2,73,0,10,42,5,0,0,0,14,0,2
25,546,58,7,51,0,51,0,16,16,2,1,0,0,5,0,11
25,547,2343,597,1746,38,1708,24,481,280,190,33,20,4,110,29,537
25,548,121,12,109,1,108,1,36,27,7,1,1,1,8,3,23
25,549,455,75,380,5,375,8,79,148,18,5,2,1,49,10,55
25,550,145,8,137,6,131,3,29,37,12,5,0,1,14,2,28
25,551,102,19,83,2,81,0,23,29,2,0,0,1,12,1,13
25,552,113,25,88,1,87,0,47,14,3,2,0,0,2,0,19
25,553,288,47,241,4,237,5,83,66,18,4,0,0,20,3,38
25,554,126,23,103,2,101,3,15,43,12,1,0,0,14,4,9
25,555,834,131,703,14,689,16,197,203,63,6,3,4,43,12,142
25,556,37,5,32,0,32,2,7,7,3,0,0,1,1,0,11
25,557,328,23,305,8,297,12,30,89,28,3,0,1,43,4,87
25,558,647,70,577,15,562,13,78,176,64,3,2,1,73,9,143
25,559,149,21,128,2,126,1,45,47,5,1,1,0,8,2,16
25,560,2556,372,2184,40,2144,51,320,623,286,17,4,6,231,37,569
25,561,197,20,177,4,173,7,28,49,28,0,1,0,22,0,38
25,562,196,16,180,1,179,3,51,45,21,3,1,1,15,4,35
25,563,88,10,78,6,72,4,10,19,9,1,1,0,7,5,16
25,564,695,73,622,7,615,14,105,154,67,10,2,0,73,9,181
25,565,146,15,131,0,131,2,18,51,12,5,1,1,11,3,27
25,566,190,18,172,4,168,4,40,47,20,1,0,1,12,3,40
25,567,109,11,98,6,92,5,13,18,10,4,0,0,15,0,27
25,569,369,40,329,7,322,9,63,88,40,8,0,1,32,10,71
25,570,30,4,26,0,26,1,4,7,0,1,1,1,1,2,8
25,571,378,48,330,6,324,4,80,117,25,1,0,0,32,7,58
25,572,75,1,74,8,66,1,6,11,7,1,2,0,2,3,33
25,573,10,0,10,1,9,0,1,4,3,1,0,0,0,0,0
25,574,165,20,145,1,144,1,64,33,6,1,0,0,11,6,22
25,575,415,51,364,12,352,11,81,75,47,7,1,2,16,9,103
25,576,170,21,149,4,145,8,30,26,22,4,1,0,12,1,41
25,578,3054,500,2554,52,2502,40,514,929,162,25,16,5,236,61,514
25,579,115,15,100,1,99,2,27,37,7,2,0,0,5,1,18
25,580,6770,1448,5322,87,5235,99,1182,1027,568,61,40,20,348,76,1814
25,582,105,14,91,3,88,1,17,23,8,1,1,1,10,4,22
25,583,163,12,151,3,148,0,36,55,12,3,1,1,15,3,22
25,584,78,11,67,2,65,2,6,40,4,2,0,0,3,2,6
25,585,167,23,144,4,140,2,30,44,11,1,2,0,20,1,29
25,586,616,71,545,11,534,16,171,90,61,6,1,0,44,10,135
25,587,105,17,88,4,84,1,16,30,1,3,0,1,7,4,21
25,588,71,9,62,1,61,2,13,20,13,1,0,0,6,0,6
25,589,99,13,86,0,86,0,21,29,4,2,2,1,6,5,16
25,590,67,9,58,1,57,2,11,21,6,0,3,0,4,1,9
25,591,125,24,101,1,100,2,29,44,3,1,0,3,8,2,8
25,592,423,69,354,2,352,13,49,148,35,8,0,0,29,18,52
25,593,273,19,254,1,253,3,49,70,31,3,1,0,28,5,63
25,594,233,24,209,4,205,6,49,60,19,1,1,0,20,4,45
25,595,96,20,76,0,76,2,21,27,8,3,0,0,5,0,10
25,596,47,2,45,1,44,1,8,22,2,0,0,0,3,2,6
25,597,173,28,145,3,142,2,38,52,6,2,0,0,6,6,30
25,598,303,36,267,5,262,2,71,72,18,4,2,1,21,3,68
25,599,153,11,142,1,141,4,30,26,22,3,1,1,14,0,40
25,600,101,11,90,3,87,5,15,37,5,4,2,1,9,1,8
25,601,971,121,850,10,840,19,177,357,50,10,6,3,61,15,142
25,602,88,10,78,1,77,1,12,30,11,2,0,0,6,0,15
25,604,109,16,93,2,91,1,16,32,16,0,0,0,12,2,12
25,605,316,35,281,15,266,9,42,114,21,1,2,0,26,12,39
25,607,59,5,54,5,49,1,9,13,3,1,1,1,9,0,11
25,608,119,16,103,6,97,1,33,14,11,2,1,0,7,0,28
25,609,295,47,248,5,243,8,42,87,24,2,0,1,24,5,50
25,610,38,8,30,2,28,0,5,10,2,1,0,0,1,2,7
25,611,369,38,331,6,325,13,52,100,40,1,1,3,32,2,81
25,612,468,48,420,6,414,9,74,121,48,2,3,0,27,13,117
25,613,78,7,71,3,68,4,13,16,12,2,1,0,5,3,12
25,614,2023,336,1687,32,1655,30,422,406,173,19,15,5,127,29,429
25,615,330,41,289,8,281,3,102,59,29,3,4,1,11,7,62
25,616,202,11,191,4,187,3,36,34,32,0,3,0,24,3,52
25,617,308,45,263,6,257,5,69,67,22,0,1,1,13,5,74
25,618,307,36,271,8,263,6,95,57,14,0,3,0,23,5,60
25,619,135,16,119,2,117,1,21,42,5,3,0,0,22,3,20
25,620,235,31,204,0,204,5,39,96,16,3,0,2,13,8,22
25,621,162,16,146,1,145,7,29,55,16,1,2,0,17,2,16
25,622,206,27,179,5,174,5,39,44,20,0,1,0,19,2,44
25,623,103,15,88,0,88,1,26,39,4,0,0,2,7,0,9
25,624,117,12,105,2,103,2,25,35,20,0,0,0,5,1,15
25,625,51,10,41,1,40,1,8,26,2,0,0,0,0,0,3
25,626,176,13,163,1,162,1,37,75,8,2,0,0,14,5,20
25,627,226,34,192,1,191,9,24,59,25,2,2,1,18,6,45
25,628,128,4,124,2,122,2,7,53,18,1,0,0,12,4,25
25,629,191,22,169,2,167,9,26,35,28,2,2,0,12,4,49
25,630,70,9,61,1,60,1,11,17,10,1,0,0,7,6,7
25,631,393,47,346,6,340,10,74,86,33,1,3,2,37,8,86
25,632,2438,342,2096,47,2049,39,542,487,204,24,21,5,157,36,534
25,633,516,86,430,5,425,7,102,73,58,3,4,3,34,10,131
25,634,438,45,393,9,384,4,56,138,22,7,3,0,56,8,90
25,635,169,21,148,3,145,2,42,34,14,1,1,0,13,4,34
26,1,276,39,237,6,231,7,41,65,35,5,2,0,26,7,43
26,2,1301,184,1117,18,1099,11,291,256,138,13,8,6,93,24,259
26,3,41,6,35,0,35,2,7,5,7,1,1,0,2,0,10
26,4,1714,236,1478,30,1448,35,302,469,125,12,9,2,148,32,314
26,5,1256,136,1120,28,1092,20,296,322,104,17,6,7,89,22,209
26,6,2050,301,1749,24,1725,61,366,425,196,23,17,5,214,39,379
26,7,105,18,87,3,84,2,18,33,2,1,0,0,13,2,13
26,8,901,124,777,13,764,15,240,140,88,13,3,1,40,17,207
26,9,844,130,714,17,697,7,194,156,66,10,5,5,38,14,202
26,10,2866,450,2416,52,2364,42,578,620,245,30,15,4,196,56,578
26,11,1707,262,1445,28,1417,49,284,304,215,11,7,2,144,30,371
26,12,26,10,16,0,16,0,2,4,2,0,0,0,4,1,3
26,13,74,19,55,1,54,6,9,12,14,1,1,0,4,1,6
26,14,399,39,360,9,351,8,93,100,31,2,8,1,41,6,61
26,15,50,9,41,1,40,4,2,5,14,2,0,0,0,0,13
26,16,323,35,288,3,285,9,70,57,58,2,1,3,18,9,58
26,17,45,6,39,0,39,3,1,4,7,2,0,0,7,0,15
26,18,23,5,18,0,18,0,3,11,0,0,0,0,3,1,0
26,19,201,29,172,7,165,4,33,43,20,3,1,2,18,1,40
26,20,224,28,196,2,194,8,49,48,30,1,1,3,17,6,31
26,21,108,9,99,7,92,2,30,17,14,0,0,3,10,2,14
26,22,80,9,71,1,70,7,12,18,5,1,0,0,5,4,18
26,23,626,66,560,9,551,30,120,161,47,5,4,1,53,11,119
26,24,306,26,280,5,275,12,59,64,41,3,2,0,30,6,58
26,25,125,17,108,1,107,14,2,15,25,3,0,0,6,3,39
26,26,85,16,69,0,69,5,18,15,10,2,0,0,3,1,15
26,27,138,21,117,1,116,4,13,34,32,0,0,0,8,3,22
26,28,182,23,159,3,156,3,26,43,20,1,6,1,20,5,31
26,30,11,2,9,1,8,0,0,0,3,0,0,0,0,0,5
26,31,671,83,588,7,581,11,129,142,83,9,0,2,62,12,131
26,32,342,33,309,3,306,16,32,69,39,4,3,0,47,5,91
26,33,558,66,492,4,488,6,137,127,61,6,7,4,31,21,88
26,34,376,54,322,5,317,10,85,79,36,8,4,1,29,9,56
26,35,327,40,287,4,283,24,37,60,56,8,2,0,30,5,61
26,36,82,14,68,0,68,11,2,5,25,2,1,0,4,0,18
26,37,3054,472,2582,32,2550,89,486,685,258,43,15,4,245,56,669
26,38,786,103,683,16,667,9,169,208,53,8,2,2,76,15,125
26,39,593,64,529,13,516,18,140,131,70,14,2,2,48,13,78
26,40,105,22,83,3,80,3,11,14,14,4,0,0,6,2,26
26,41,1003,143,860,15,845,5,207,172,115,6,6,1,90,23,220
26,42,1255,149,1106,18,1088,33,217,295,90,11,8,1,93,30,310
26,43,117,16,101,1,100,1,8,25,32,0,0,0,8,2,24
26,45,1236,169,1067,14,1053,53,219,252,151,14,1,2,110,16,235
26,46,86,16,70,2,68,5,14,14,6,1,1,0,6,3,18
26,47,80,21,59,5,54,6,10,7,15,2,0,0,2,1,11
26,48,67,10,57,1,56,7,4,16,11,1,0,0,3,2,12
26,49,823,117,706,14,692,12,143,224,58,10,7,2,77,18,141
26,50,57,5,52,0,52,5,13,7,3,2,0,0,2,3,17
26,51,58,8,50,1,49,6,10,7,5,0,0,0,2,0,19
26,52,282,26,256,7,249,11,54,62,25,2,2,2,27,10,54
26,54,870,92,778,16,762,11,246,187,91,7,2,4,49,14,151
26,55,107,19,88,3,85,14,5,9,17,3,2,0,6,1,28
26,56,475,71,404,3,401,29,52,88,92,5,5,2,36,8,84
26,57,7377,1526,5851,105,5746,123,1267,1432,632,54,51,20,429,109,1629
26,58,13646,2509,11137,173,10964,245,2000,2924,1181,136,77,27,850,173,3351
26,59,217,30,187,3,184,8,31,52,22,6,7,0,18,1,39
26,60,129,24,105,2,103,5,40,10,20,2,2,0,4,4,16
26,61,434,44,390,10,380,4,101,103,36,4,4,1,36,9,82
26,62,33,9,24,1,23,0,3,5,2,1,0,1,5,0,6
26,63,1764,299,1465,32,1433,57,254,353,214,25,13,5,119,24,369
26,64,5305,804,4501,93,4408,135,868,1267,440,36,29,14,511,106,1002
26,65,539,65,474,7,467,17,96,108,46,7,5,0,59,5,124
26,66,42,4,38,0,38,0,6,15,7,0,0,0,6,0,4
26,67,49,12,37,0,37,5,9,5,8,0,0,0,2,0,8
26,68,155,10,145,1,144,4,29,43,9,3,10,0,16,4,26
26,69,122,16,106,1,105,4,9,17,31,4,0,1,10,2,27
26,70,458,76,382,11,371,10,100,109,36,4,3,0,32,12,65
26,71,841,100,741,14,727,23,151,213,45,9,6,3,78,19,180
26,72,817,127,690,12,678,17,137,164,74,13,4,1,63,15,190
26,73,197,6,191,8,183,5,38,54,26,0,3,1,18,4,34
26,74,561,79,482,11,471,25,80,113,86,2,2,0,51,15,97
26,75,51,6,45,1,44,1,11,5,2,1,0,0,6,3,15
26,76,40,4,36,1,35,2,2,2,6,2,0,0,2,0,19
26,77,630,84,546,14,532,14,112,137,61,5,11,1,50,8,133
26,78,531,59,472,8,464,10,92,101,79,3,3,1,35,19,121
26,79,898,94,804,17,787,22,227,234,69,11,7,1,65,12,139
26,80,44,3,41,1,40,4,2,5,5,2,0,0,4,0,18
26,81,427,42,385,8,377,14,67,87,36,3,2,0,45,10,113
26,82,83,14,69,3,66,9,12,14,8,0,0,0,3,2,18
26,83,1137,133,1004,14,990,26,195,325,96,6,8,2,113,26,193
26,84,2715,374,2341,43,2298,39,587,733,212,14,14,6,215,42,436
26,85,1894,258,1636,31,1605,27,461,390,168,20,8,5,134,36,356
26,86,489,91,398,11,387,12,38,115,70,4,0,0,34,11,103
26,87,907,125,782,11,771,18,177,218,84,7,8,6,71,14,168
26,88,3931,630,3301,52,3249,49,816,996,228,31,27,9,322,65,706
26,89,60,12,48,0,48,3,8,9,7,2,1,0,6,1,11
26,90,31,6,25,1,24,3,5,7,3,0,0,0,2,0,4
26,91,46,5,41,1,40,0,9,12,3,1,1,0,2,0,12
26,92,393,43,350,8,342,11,87,97,35,4,3,3,28,9,65
26,93,464,70,394,7,387,16,93,123,26,1,2,0,42,8,76
26,94,578,64,514,8,506,12,134,121,63,5,5,4,44,17,101
26,95,675,88,587,16,571,8,141,165,51,12,6,1,54,8,125
26,96,1474,236,1238,18,1220,21,332,314,142,13,18,0,101,31,248
26,97,525,64,461,9,452,13,103,124,52,3,2,1,37,8,109
26,98,142,19,123,3,120,12,18,21,14,1,0,0,12,5,37
26,99,423,44,379,6,373,11,89,119,41,7,1,1,23,4,77
26,100,360,60,300,4,296,8,51,79,30,4,2,0,32,5,85
26,101,148,25,123,3,120,5,14,32,22,0,0,0,9,6,32
26,102,122,16,106,2,104,1,22,32,8,0,1,0,11,2,27
26,103,298,55,243,3,240,14,66,68,29,6,2,0,17,4,34
26,104,68,4,64,3,61,3,9,10,19,1,0,1,4,1,13
26,105,68,10,58,1,57,3,16,10,10,2,1,0,5,1,9
26,106,686,79,607,7,600,9,211,136,79,6,7,0,38,20,94
26,107,421,67,354,6,348,5,80,86,42,6,10,1,38,7,73
26,108,5974,1114,4860,75,4785,256,751,1165,753,49,29,12,402,81,1287
26,110,404,30,374,9,365,5,69,118,45,4,1,1,35,3,84
26,111,71,6,65,2,63,2,13,7,20,0,1,0,8,0,12
26,112,161,23,138,2,136,6,30,32,18,4,0,0,18,1,27
26,113,3335,638,2697,35,2662,174,287,546,614,42,19,1,236,34,709
26,114,2438,395,2043,29,2014,143,193,451,367,33,10,8,180,18,611
26,115,422,56,366,11,355,12,68,69,46,4,2,0,45,12,97
26,116,3843,719,3124,63,3061,40,937,706,320,36,12,8,225,51,726
26,117,50,7,43,1,42,3,3,13,12,2,0,0,2,0,7
26,118,983,176,807,18,789,6,231,185,97,7,4,1,77,20,161
26,119,582,67,515,14,501,10,111,115,70,6,8,2,60,10,109
26,121,830,105,725,13,712,15,194,185,77,4,6,2,68,18,143
26,122,106,11,95,2,93,4,8,7,41,1,1,0,9,0,22
26,123,41,6,35,0,35,5,7,4,6,1,0,0,2,1,9
26,124,3673,559,3114,59,3055,96,607,955,312,31,9,12,257,64,712
26,125,945,98,847,16,831,30,157,180,126,8,6,2,94,18,210
26,126,80,12,68,0,68,4,10,13,13,1,0,0,4,1,22
26,127,93,20,73,4,69,3,10,12,16,3,0,0,6,1,18
26,128,64,10,54,2,52,9,5,10,7,0,1,0,3,1,16
26,129,646,99,547,11,536,6,165,151,52,8,5,2,38,13,96
26,130,35,5,30,0,30,0,16,2,9,0,0,0,2,0,1
26,131,119,12,107,2,105,6,23,22,20,1,1,0,5,2,25
26,133,139,15,124,2,122,6,23,23,19,0,1,1,10,0,39
26,134,63,6,57,1,56,13,3,14,7,1,1,0,3,3,11
26,135,114,11,103,6,97,3,43,14,11,0,0,0,7,1,18
26,136,53,3,50,1,49,6,3,4,6,2,1,0,5,2,20
26,137,137,17,120,4,116,15,21,18,23,1,0,0,8,2,28
26,138,1010,146,864,10,854,13,194,254,94,10,3,3,80,20,183
26,139,1610,187,1423,27,1396,39,255,465,119,12,19,2,146,29,310
26,140,463,67,396,5,391,16,91,102,32,5,5,2,31,6,101
26,141,154,13,141,3,138,26,10,19,33,0,0,1,11,3,35
26,142,123,12,111,2,109,7,16,12,40,0,0,1,8,0,25
26,143,630,97,533,6,527,16,128,148,63,12,4,2,26,6,122
26,144,1422,193,1229,30,1199,49,236,258,195,10,10,6,118,25,292
26,145,436,46,390,4,386,11,83,103,39,2,0,1,45,11,91
26,146,1357,189,1168,24,1144,31,243,330,137,9,4,2,113,15,260
26,147,35,6,29,0,29,0,8,6,0,0,0,0,6,0,9
26,148,1383,233,1150,26,1124,19,288,319,114,12,12,5,107,29,219
26,149,694,79,615,14,601,12,138,169,54,5,6,1,63,4,149
26,150,10,2,8,0,8,0,1,4,1,0,0,0,0,0,2
26,152,32,5,27,0,27,1,0,8,4,0,0,0,3,0,11
26,153,81,17,64,1,63,4,10,3,16,2,0,1,5,0,22
26,154,218,31,187,3,184,9,40,41,45,1,1,1,8,1,37
26,155,839,135,704,18,686,9,231,148,120,8,0,2,35,10,123
26,156,727,62,665,13,652,27,112,199,46,6,7,0,99,18,138
26,157,479,54,425,7,418,6,121,87,48,2,1,3,45,11,94
26,159,97,9,88,1,87,5,9,10,20,2,0,1,11,1,28
26,160,695,74,621,6,615,10,117,131,109,6,4,1,44,13,180
26,161,38,5,33,0,33,2,8,7,5,0,0,0,0,1,10
26,162,636,105,531,12,519,14,167,113,53,4,2,1,42,12,111
26,163,59,10,49,1,48,0,11,19,5,0,0,0,3,2,8
26,164,75,2,73,0,73,2,7,19,6,2,0,2,7,0,28
26,165,6493,1292,5201,105,5096,89,1348,1287,572,65,39,9,393,86,1208
26,166,4163,815,3348,58,3290,44,892,725,390,38,20,6,274,58,843
26,167,389,60,329,6,323,17,33,77,55,3,3,0,41,4,90
26,168,447,57,390,10,380,18,66,107,77,3,4,0,22,11,72
26,169,1387,162,1225,28,1197,28,337,240,162,11,6,1,114,25,273
26,170,2778,381,2397,45,2352,70,416,653,223,26,7,5,301,42,609
26,171,142,15,127,1,126,4,24,31,22,3,2,0,8,3,29
26,172,454,62,392,9,383,3,112,98,45,2,2,0,25,14,82
26,173,590,91,499,7,492,17,123,147,50,13,4,0,45,16,77
26,174,687,92,595,18,577,14,144,151,82,6,19,1,52,19,89
26,175,149,19,130,3,127,9,23,9,29,3,3,0,12,1,38
26,176,1048,158,890,12,878,33,159,250,98,11,4,2,111,16,194
26,177,496,63,433,5,428,15,84,106,65,2,1,2,43,5,105
26,178,397,45,352,9,343,24,41,49,92,7,2,1,29,9,89
26,179,1643,244,1399,21,1378,24,291,468,121,8,8,3,130,28,297
26,180,178,17,161,3,158,7,28,42,16,1,1,1,12,5,45
26,181,195,23,172,4,168,11,39,43,30,5,2,0,5,2,31
26,182,1211,200,1011,24,987,28,214,247,164,12,7,4,86,22,203
26,183,746,101,645,9,636,35,100,119,105,7,7,2,80,17,164
26,184,218,35,183,3,180,5,54,40,21,2,5,1,15,5,32
26,185,435,68,367,2,365,15,42,93,39,3,1,3,44,11,114
26,186,53,2,51,0,51,6,3,17,10,1,1,1,5,0,7
26,187,92,18,74,2,72,0,9,16,14,0,0,0,9,0,24
26,188,878,154,724,10,714,23,142,195,111,8,2,2,65,14,152
26,189,113,15,98,1,97,6,24,5,21,2,0,2,10,1,26
26,190,86,17,69,1,68,10,4,9,20,4,1,0,10,0,10
26,191,1615,192,1423,27,1396,38,320,455,131,6,7,5,116,31,287
26,192,243,34,209,4,205,10,53,56,29,0,0,1,16,4,36
26,193,357,44,313,11,302,18,61,47,76,2,0,0,18,8,72
26,194,465,57,408,10,398,13,78,114,44,7,10,0,41,8,83
26,195,163,22,141,0,141,8,39,21,19,2,2,0,13,1,36
26,196,1208,157,1051,12,1039,37,154,346,86,7,6,7,102,23,271
26,197,2941,369,2572,35,2537,68,460,861,206,32,9,14,297,65,525
26,198,25379,5498,19881,337,19544,420,4108,5447,2042,188,102,58,1704,364,5111
26,199,34,3,31,2,29,2,6,1,12,0,1,0,0,0,7
26,200,84,19,65,0,65,5,13,14,15,0,0,0,2,2,14
26,201,49,11,38,0,38,0,0,7,11,0,2,0,8,1,9
26,202,272,38,234,6,228,13,31,44,53,6,1,2,12,3,63
26,203,225,35,190,1,189,1,47,62,19,1,2,0,16,3,38
26,204,136,15,121,3,118,11,16,42,13,0,0,0,17,1,18
26,205,65,4,61,0,61,2,10,9,12,1,0,0,8,1,18
26,206,2151,258,1893,18,1875,67,337,469,244,13,7,9,212,35,482
26,207,437,59,378,5,373,16,94,117,36,4,5,2,34,6,59
26,208,1418,187,1231,24,1207,36,240,355,103,14,6,4,116,41,292
26,209,39,11,28,0,28,2,10,3,4,0,1,0,0,1,7
26,210,386,74,312,4,308,8,59,91,41,1,7,2,21,6,72
26,211,899,105,794,21,773,22,174,217,79,16,3,0,76,22,164
26,212,820,116,704,9,695,31,114,213,57,5,0,1,94,19,161
26,213,497,67,430,6,424,6,78,87,67,5,0,0,38,17,126
26,214,67,8,59,0,59,13,6,5,8,0,0,0,6,0,21
26,215,325,46,279,2,277,10,46,68,51,3,2,0,24,6,67
26,216,510,53,457,13,444,8,88,100,42,3,8,0,49,12,134
26,217,130,22,108,2,106,5,12,28,14,4,0,0,9,2,32
26,218,1971,217,1754,29,1725,43,361,507,165,9,21,6,168,49,396
26,219,288,38,250,2,248,3,54,53,38,2,0,1,32,17,48
26,220,5256,1155,4101,76,4025,132,734,1078,550,40,31,7,333,53,1067
26,221,90,12,78,0,78,3,15,27,6,1,0,0,5,2,19
26,222,33,5,28,2,26,2,3,4,9,1,0,0,2,0,5
26,223,450,79,371,7,364,14,84,91,54,1,4,0,33,8,75
26,224,173,15,158,4,154,9,17,39,31,1,1,0,16,4,36
26,225,424,57,367,6,361,11,97,100,35,2,5,0,29,5,77
26,226,338,50,288,7,281,10,73,63,41,4,1,0,25,4,60
26,227,17,0,17,0,17,1,0,1,5,0,0,0,3,0,7
26,228,16,5,11,1,10,1,2,3,3,1,0,0,0,0,0
26,229,85,11,74,1,73,1,18,14,12,0,0,0,14,0,14
26,231,1950,362,1588,34,1554,45,295,506,134,9,69,5,136,32,323
26,232,518,44,474,4,470,14,107,118,57,5,5,1,58,6,99
26,233,216,33,183,5,178,5,31,57,24,4,0,1,20,7,29
26,234,724,129,595,9,586,41,112,115,106,10,1,0,53,9,139
26,235,8979,1654,7325,119,7206,72,2121,1961,711,68,29,25,466,105,1648
26,236,121,22,99,1,98,6,17,15,24,2,0,0,3,3,28
26,238,165,16,149,3,146,13,25,18,38,2,1,0,11,3,35
26,239,167,23,144,3,141,11,38,38,16,2,0,0,10,6,20
26,240,141,17,124,0,124,14,14,34,21,1,0,0,17,0,23
26,241,97,14,83,0,83,0,18,9,23,1,0,0,8,3,21
26,242,26,0,26,0,26,3,0,0,12,0,0,0,1,0,10
26,243,698,93,605,9,596,52,79,145,94,2,9,0,39,14,162
26,244,95,18,77,1,76,9,3,16,19,1,1,0,11,3,13
26,245,25,2,23,0,23,0,5,4,0,0,0,0,4,0,10
26,246,106,10,96,3,93,9,14,11,23,0,1,0,4,1,30
26,247,362,51,311,6,305,7,61,72,42,5,2,0,23,7,86
26,248,152,27,125,2,123,3,25,20,15,5,0,1,11,7,36
26,249,453,56,397,7,390,25,74,84,61,5,4,2,34,4,97
26,250,2170,312,1858,25,1833,16,406,557,175,16,12,2,153,40,456
26,251,327,35,292,7,285,16,41,76,37,4,3,1,22,8,77
26,252,7185,1190,5995,116,5879,89,1373,1160,999,61,30,16,429,97,1625
26,253,66,19,47,0,47,1,7,8,6,0,1,0,2,1,21
26,254,30,7,23,0,23,4,4,5,4,1,0,0,1,0,4
26,255,31,4,27,1,26,0,1,6,5,0,0,0,0,0,14
26,256,69,5,64,0,64,0,9,10,17,1,1,1,1,1,23
26,257,327,40,287,7,280,11,65,78,25,2,0,1,22,4,72
26,258,652,80,572,18,554,17,103,112,90,9,2,0,61,11,149
26,259,231,36,195,1,194,8,31,53,19,2,1,0,32,5,43
26,261,326,44,282,7,275,7,41,79,48,4,1,1,26,5,63
26,262,183,24,159,3,156,6,19,34,34,3,0,1,12,3,44
26,263,120,25,95,5,90,5,15,23,18,2,0,0,9,1,17
26,264,268,37,231,8,223,3,58,65,29,2,4,1,16,3,42
26,266,35,8,27,0,27,0,1,6,5,0,0,0,5,0,10
26,267,20,2,18,0,18,8,0,1,6,2,0,0,1,0,0
26,268,103,18,85,0,85,5,19,9,19,0,1,2,11,0,19
26,269,87,25,62,1,61,3,13,10,6,3,0,0,8,0,18
26,270,127,13,114,3,111,7,14,33,14,1,2,0,20,4,16
26,271,2414,346,2068,45,2023,37,411,666,157,17,14,3,226,39,453
26,272,274,41,233,5,228,12,35,56,28,5,1,3,23,2,63
26,273,747,81,666,9,657,12,142,147,95,15,5,0,75,23,143
26,274,10,1,9,0,9,0,1,6,0,0,0,0,0,0,2
26,275,1177,164,1013,17,996,13,342,293,85,11,4,4,82,19,143
26,276,327,48,279,4,275,13,58,57,44,7,0,3,28,7,58
26,277,143,23,120,5,115,6,32,6,14,2,1,0,21,4,29
26,278,240,36,204,3,201,20,29,29,50,4,4,0,13,1,51
26,279,71,18,53,2,51,4,13,8,8,0,1,0,7,0,10
26,281,21071,4685,16386,262,16124,459,3115,4013,2013,172,171,34,1260,266,4621
26,282,180,14,166,2,164,12,20,43,32,1,3,0,13,1,39
26,283,27,5,22,2,20,0,5,2,3,0,2,0,0,0,8
26,284,323,55,268,4,264,10,56,92,22,2,0,0,23,6,53
26,285,253,23,230,7,223,4,44,63,31,2,0,0,27,2,50
26,286,32,12,20,0,20,1,3,0,8,0,1,0,1,0,6
26,287,339,43,296,7,289,12,73,84,30,4,2,1,35,3,45
26,288,261,51,210,2,208,7,41,51,32,3,2,0,16,4,52
26,289,999,136,863,18,845,63,108,136,178,25,10,4,65,18,238
26,290,336,61,275,14,261,18,66,68,42,3,2,4,23,4,31
26,291,56,11,45,0,45,7,9,7,14,1,0,0,2,0,5
26,292,187,31,156,2,154,7,23,35,16,3,0,1,19,5,45
26,293,212,31,181,7,174,6,38,47,20,2,4,0,15,6,36
26,294,492,53,439,9,430,16,89,128,42,7,1,1,51,7,88
26,295,1486,205,1281,27,1254,26,335,249,182,19,17,1,94,30,301
26,296,39,3,36,1,35,6,0,2,5,1,1,0,4,0,16
26,297,199,30,169,3,166,1,59,38,11,2,5,0,12,8,30
26,298,302,65,237,5,232,9,72,40,19,4,6,1,22,8,51
26,299,107,22,85,1,84,7,17,17,20,5,0,0,2,1,15
26,300,43,8,35,0,35,1,5,1,14,1,0,1,3,0,9
26,301,2764,495,2269,50,2219,65,476,598,234,22,27,3,244,56,494
26,302,409,88,321,10,311,7,55,103,42,7,1,1,34,3,58
26,303,80,14,66,0,66,4,8,9,9,6,0,0,4,1,25
26,304,198,35,163,3,160,5,33,41,27,1,4,0,13,8,28
26,305,599,95,504,7,497,24,126,127,55,2,4,0,40,17,102
26,306,202,33,169,3,166,6,35,42,27,1,2,0,10,1,42
26,307,2114,290,1824,30,1794,55,322,524,220,35,14,2,165,33,424
26,308,147,19,128,1,127,4,16,19,41,5,0,0,14,1,27
26,309,199,30,169,2,167,16,29,36,26,5,2,0,15,3,35
26,310,117,19,98,3,95,6,19,25,11,3,2,1,8,2,18
26,311,870,131,739,10,729,35,148,177,109,8,13,2,43,17,177
26,312,979,151,828,12,816,16,213,223,78,10,8,3,79,17,169
26,313,4044,657,3387,48,3339,70,656,1038,323,24,27,3,338,88,772
26,314,273,29,244,2,242,2,64,47,28,3,2,0,43,7,46
26,315,325,39,286,8,278,20,35,62,62,12,1,0,39,2,45
26,316,149,12,137,5,132,4,36,51,8,3,2,1,8,0,19
26,317,517,73,444,7,437,12,115,102,57,1,1,0,28,7,114
26,318,54,6,48,2,46,1,5,11,9,1,0,0,4,2,13
26,319,387,43,344,4,340,14,84,90,34,5,9,1,23,10,70
26,320,465,73,392,9,383,8,86,97,46,8,4,0,25,6,103
26,321,178,20,158,2,156,4,30,29,26,3,0,0,22,4,38
26,322,361,50,311,14,297,9,93,77,21,1,2,1,28,5,60
26,323,1245,152,1093,19,1074,28,308,292,75,10,13,6,104,22,216
26,324,6634,1045,5589,105,5484,85,1240,1556,612,47,24,17,470,124,1309
26,325,3634,665,2969,55,2914,38,781,625,288,35,22,8,222,63,832
26,326,1228,144,1084,12,1072,22,259,339,128,13,4,1,91,18,197
26,327,132,19,113,2,111,12,5,15,14,2,0,0,16,1,46
26,328,48,4,44,1,43,1,4,16,2,0,0,0,9,0,11
26,329,179,35,144,0,144,9,32,19,28,4,1,0,19,0,32
26,330,1531,251,1280,26,1254,12,363,272,150,13,8,1,114,24,297
26,331,366,44,322,6,316,16,76,90,35,3,1,2,25,9,59
26,332,1169,168,1001,13,988,10,205,221,155,19,11,2,71,22,272
26,333,2231,468,1763,30,1733,33,313,397,239,20,12,9,123,38,549
26,334,100,13,87,0,87,6,18,19,10,0,2,0,15,0,17
26,335,176,29,147,4,143,7,34,36,15,2,1,0,14,4,30
26,336,418,51,367,11,356,21,35,65,95,5,1,1,33,4,96
26,337,1243,188,1055,21,1034,26,284,237,150,11,9,2,65,16,234
26,338,1526,171,1355,31,1324,45,260,322,183,14,5,8,147,22,318
26,339,1117,202,915,18,897,18,240,274,83,8,2,5,74,10,183
26,340,249,43,206,8,198,2,34,75,20,4,2,0,17,2,42
26,341,494,57,437,10,427,4,119,119,60,9,6,4,26,4,76
26,342,241,24,217,1,216,8,47,82,32,1,2,1,9,4,30
26,343,79,4,75,1,74,5,16,14,8,1,1,0,5,2,22
26,344,306,45,261,2,259,9,35,64,55,4,0,0,34,1,57
26,345,1463,168,1295,27,1268,19,343,372,133,17,8,1,127,24,224
26,346,239,32,207,3,204,14,32,47,40,3,2,0,26,3,37
26,347,3903,606,3297,79,3218,88,634,878,366,28,23,10,311,69,811
26,348,1201,141,1060,13,1047,45,256,210,157,20,6,2,82,15,254
26,349,234,29,205,4,201,2,61,62,16,2,4,0,14,3,37
26,350,69,12,57,1,56,2,3,22,10,0,0,0,5,0,14
26,351,21,1,20,0,20,1,2,4,3,1,1,0,1,0,7
26,352,199,16,183,1,182,12,31,35,24,2,1,0,22,6,49
26,353,648,97,551,7,544,8,161,106,64,6,2,1,45,12,139
26,354,172,34,138,3,135,2,6,41,17,0,2,0,33,0,34
26,355,462,36,426,16,410,8,91,111,43,7,14,1,40,12,83
26,356,104,14,90,3,87,4,9,7,22,2,1,0,6,2,34
26,357,1381,194,1187,24,1163,22,349,268,142,10,9,2,80,15,266
26,358,1123,145,978,13,965,43,192,245,136,4,3,1,112,22,207
26,359,29,9,20,1,19,4,0,3,10,0,1,0,1,0,0
26,360,479,61,418,7,411,15,83,101,42,2,1,1,37,8,121
26,361,153,27,126,2,124,11,8,16,33,2,0,1,10,2,41
26,362,38941,8144,30797,553,30244,945,4795,8152,3507,279,135,69,2653,470,9239
26,363,34,3,31,0,31,3,0,3,14,0,0,0,3,1,7
26,364,289,52,237,3,234,15,32,68,56,0,3,2,14,6,38
26,365,493,62,431,5,426,18,72,111,61,7,4,0,56,12,85
26,366,231,24,207,3,204,1,51,53,25,1,2,1,22,3,45
26,367,572,71,501,7,494,23,123,91,80,8,2,0,55,12,100
26,368,266,37,229,1,228,14,31,33,55,3,0,0,16,6,70
26,369,59,8,51,0,51,2,3,4,14,1,0,1,4,0,22
26,370,121,15,106,2,104,6,27,25,5,2,0,1,9,3,26
26,371,44,1,43,0,43,4,6,20,6,0,0,0,1,0,6
26,372,44,7,37,0,37,2,9,14,6,0,0,0,1,0,5
26,373,209,37,172,3,169,4,26,40,35,2,2,0,18,1,41
26,374,29,6,23,0,23,2,3,7,2,1,0,0,3,0,5
26,375,18,3,15,0,15,0,4,5,2,0,0,0,0,1,3
26,376,96,10,86,2,84,7,21,21,10,1,0,0,6,2,16
26,377,933,117,816,11,805,21,143,223,130,10,1,1,51,17,208
26,378,41,5,36,0,36,0,3,16,1,0,0,0,3,0,13
26,379,772,114,658,15,643,11,166,211,56,3,7,5,65,13,106
26,380,385,43,342,7,335,8,74,76,41,4,4,4,32,6,86
26,381,580,59,521,7,514,16,118,182,46,2,4,1,31,19,95
26,382,373,49,324,6,318,15,93,76,29,3,2,0,18,5,77
27,1,195,32,163,0,163,8,35,43,17,1,1,1,12,3,42
27,2,356,72,284,7,277,1,73,94,14,3,4,0,29,7,52
27,3,1238,262,976,11,965,19,202,320,90,15,5,4,59,25,226
27,4,225,39,186,1,185,3,38,56,20,4,3,2,16,4,39
27,5,837,124,713,10,703,12,218,256,43,7,6,1,53,15,92
27,6,93,6,87,0,87,3,10,24,7,1,0,1,11,2,28
27,7,236,51,185,5,180,1,70,57,7,2,0,0,11,7,25
27,8,1103,116,987,12,975,9,210,136,347,15,3,0,56,15,184
27,9,423,98,325,10,315,2,82,102,39,3,2,0,19,7,59
27,10,157,29,128,0,128,1,39,28,15,0,0,0,13,1,31
27,11,677,99,578,10,568,8,146,146,61,4,5,4,37,15,142
27,12,315,48,267,6,261,3,80,60,18,2,0,0,26,9,63
27,13,401,59,342,6,336,6,67,77,52,8,3,1,29,6,87
27,14,603,111,492,8,484,9,122,143,43,10,3,1,41,7,105
27,15,815,121,694,15,679,15,177,185,66,2,5,1,54,15,159
27,16,5389,1209,4180,78,4102,46,975,1106,475,64,43,11,242,92,1048
27,17,954,165,789,14,775,17,129,228,68,12,8,0,92,14,207
27,18,743,145,598,7,591,4,117,165,76,11,2,2,52,24,138
27,19,135,15,120,4,116,0,29,47,11,2,0,0,10,3,14
27,20,1206,211,995,17,978,13,190,303,85,11,4,2,105,20,245
27,21,227,19,208,2,206,0,55,70,12,5,2,0,18,5,39
27,22,3116,548,2568,57,2511,42,640,463,324,38,23,7,174,61,739
27,23,568,70,498,5,493,11,114,152,40,4,4,2,66,3,97
27,24,251,44,207,3,204,8,66,59,16,1,3,1,14,6,30
27,25,662,99,563,11,552,18,110,203,56,2,1,1,44,23,94
27,26,279,40,239,3,236,1,75,76,27,1,0,1,15,9,31
27,27,220,32,188,1,187,2,58,50,18,8,0,0,12,5,34
27,28,267,46,221,8,213,2,51,36,32,6,3,2,15,3,63
27,31,929,117,812,10,802,16,131,214,81,11,2,1,107,17,222
27,32,312,23,289,11,278,2,39,92,23,3,0,1,25,9,84
27,33,254,38,216,4,212,3,38,80,14,4,0,0,7,3,63
27,34,386,38,348,5,343,2,108,83,41,0,4,1,17,7,80
27,35,120,29,91,2,89,2,21,40,1,1,0,1,4,3,16
27,36,378,48,330,6,324,5,86,102,22,5,1,0,35,5,63
27,37,791,109,682,6,676,14,185,156,65,11,4,1,60,16,164
27,38,174,23,151,7,144,3,31,56,21,2,0,0,10,3,18
27,39,371,49,322,4,318,8,77,90,28,3,2,1,34,5,70
27,40,335,47,288,1,287,1,77,91,28,2,0,2,15,11,60
27,41,649,128,521,3,518,12,132,199,32,4,5,0,49,10,75
27,42,67,17,50,0,50,9,8,15,4,0,0,0,5,1,8
27,43,501,88,413,7,406,9,91,163,34,7,1,0,17,16,68
27,44,804,145,659,13,646,19,104,201,58,11,6,3,68,15,161
27,45,527,81,446,10,436,5,123,93,34,7,4,0,35,9,126
27,46,121,24,97,0,97,4,23,37,8,2,0,0,7,3,13
27,47,244,32,212,3,209,4,59,56,18,3,1,1,14,0,53
27,48,183,29,154,2,152,1,29,60,9,3,0,0,14,3,33
27,49,491,118,373,12,361,3,96,108,23,1,2,2,38,6,82
27,50,547,96,451,8,443,0,103,144,51,3,2,0,40,7,93
27,51,2009,344,1665,31,1634,17,366,473,147,22,4,5,118,57,425
27,52,325,38,287,4,283,6,41,124,20,2,2,1,34,3,50
27,53,192,25,167,2,165,4,38,39,26,2,1,2,9,5,39
27,54,381,52,329,12,317,6,84,75,22,6,1,2,20,9,92
27,55,222,41,181,2,179,3,47,75,4,3,0,0,19,6,22
27,56,7198,1467,5731,102,5629,117,911,1506,601,75,35,13,538,114,1719
27,57,201,31,170,4,166,1,34,58,14,3,3,0,13,4,36
27,58,277,49,228,4,224,5,70,70,15,3,0,1,19,4,37
27,59,257,63,194,4,190,2,68,51,13,1,2,1,15,5,32
27,60,212,27,185,0,185,3,48,70,13,2,0,0,19,4,26
27,61,237,42,195,5,190,2,49,58,20,1,0,0,10,5,45
27,62,640,105,535,7,528,13,130,130,52,2,5,1,52,21,122
27,63,129,14,115,5,110,0,24,39,11,2,0,1,13,1,19
27,64,435,67,368,4,364,4,102,68,34,7,8,1,38,2,100
27,65,2880,551,2329,46,2283,35,522,708,195,38,11,7,198,72,497
27,66,188,30,158,4,154,1,59,37,17,3,0,0,11,1,25
27,67,1020,194,826,12,814,11,225,196,103,6,7,2,59,18,187
27,68,150,22,128,0,128,1,30,48,10,0,0,0,2,9,28
27,69,574,94,480,8,472,7,120,142,46,7,6,1,44,11,88
27,70,579,89,490,6,484,4,141,149,49,7,3,0,25,8,98
27,71,190,28,162,8,154,0,43,69,5,2,2,0,15,4,14
27,72,623,93,530,11,519,6,133,146,65,4,4,1,41,20,99
27,73,838,194,644,9,635,4,163,177,71,7,7,4,44,17,141
27,74,259,50,209,5,204,1,39,74,24,1,1,0,16,5,43
27,75,298,63,235,2,233,3,68,79,9,5,2,1,16,5,45
27,76,351,62,289,5,284,7,63,99,20,7,1,0,23,13,51
27,77,564,88,476,6,470,8,109,99,63,9,4,0,44,6,128
27,78,193,31,162,3,159,2,37,57,18,2,0,0,15,1,27
27,79,256,43,213,1,212,1,52,53,32,4,0,2,18,4,46
27,81,128,15,113,2,111,1,21,41,12,0,0,0,10,2,24
27,82,1531,216,1315,19,1296,23,300,258,129,26,11,8,101,33,407
27,83,169,21,148,6,142,3,25,42,23,2,0,1,10,4,32
27,84,228,44,184,2,182,1,42,48,23,1,2,1,22,8,34
27,85,305,50,255,6,249,1,59,55,28,3,3,1,24,6,69
27,88,113,22,91,3,88,5,24,31,5,1,0,0,5,1,16
27,89,347,62,285,5,280,8,61,80,31,4,1,0,24,5,66
27,90,2597,386,2211,41,2170,28,457,520,268,22,13,7,208,54,593
27,91,485,63,422,10,412,6,113,118,36,0,4,0,29,7,99
27,92,445,53,392,2,390,6,89,86,54,4,3,2,32,16,98
27,93,270,37,233,4,229,3,40,70,24,4,0,0,21,11,56
27,94,105,16,89,3,86,1,33,23,7,0,0,0,7,1,14
27,95,376,50,326,5,321,3,65,103,37,5,4,0,26,11,67
27,96,271,58,213,3,210,3,57,80,13,2,1,1,11,4,38
27,97,586,112,474,8,466,4,97,94,55,8,1,0,29,13,165
27,98,72,10,62,0,62,0,12,26,5,0,0,0,6,3,10
27,99,480,66,414,7,407,10,85,121,22,4,2,2,44,9,108
27,100,708,122,586,18,568,13,131,137,64,8,4,1,43,14,153
27,101,307,49,258,4,254,7,67,78,20,1,1,0,15,9,56
27,102,770,78,692,9,683,5,132,207,71,7,4,2,60,18,177
27,103,2280,397,1883,38,1845,25,410,501,174,23,7,3,182,54,466
27,104,538,96,442,13,429,8,108,109,45,2,9,3,27,5,113
27,105,2229,347,1882,32,1850,33,384,450,250,33,9,6,138,37,510
27,106,335,35,300,2,298,3,91,89,20,5,2,0,24,4,60
27,107,708,92,616,13,603,9,128,167,65,9,1,0,54,16,154
27,108,899,134,765,13,752,6,191,241,67,7,4,3,70,22,141
27,109,255,34,221,6,215,5,74,41,17,4,2,0,13,6,53
27,110,421,66,355,10,345,8,100,84,34,2,2,1,39,10,65
27,111,131,17,114,4,110,0,19,55,9,0,1,0,2,3,21
27,112,2072,406,1666,27,1639,23,445,470,132,33,5,3,91,37,400
27,113,142,15,127,1,126,0,35,28,15,3,1,0,9,5,30
27,114,889,161,728,16,712,18,172,216,39,4,5,5,83,12,158
27,115,283,41,242,5,237,3,51,100,20,3,3,0,17,2,38
27,116,3060,683,2377,32,2345,51,511,524,332,48,22,2,125,48,682
27,117,765,137,628,16,612,11,153,180,55,4,8,2,32,11,156
27,118,471,80,391,10,381,4,94,110,26,5,3,2,40,11,86
27,119,1103,195,908,17,891,12,217,259,87,10,8,1,84,26,187
27,120,276,34,242,4,238,5,71,44,23,5,0,0,18,2,70
27,121,273,43,230,1,229,6,61,75,23,1,2,1,12,1,47
27,122,250,43,207,1,206,4,71,62,10,5,1,1,21,3,28
27,123,315,65,250,3,247,3,76,84,11,6,0,0,27,5,35
27,124,197,37,160,1,159,4,36,61,6,0,0,0,17,1,34
27,125,505,80,425,6,419,4,87,126,46,9,4,0,30,8,105
27,126,836,138,698,10,688,11,148,155,84,19,4,2,64,21,180
27,127,492,62,430,2,428,8,140,104,30,6,2,0,33,14,91
27,128,178,29,149,2,147,1,38,32,19,3,1,1,10,3,39
27,129,465,64,401,6,395,5,99,140,21,0,2,1,30,16,81
27,130,320,38,282,4,278,4,74,94,13,7,3,1,26,2,54
27,131,186,27,159,3,156,0,34,55,15,1,1,0,15,3,32
27,132,662,79,583,14,569,3,104,155,59,8,2,2,67,12,157
27,133,800,100,700,13,687,22,119,201,75,4,3,1,69,8,185
27,134,145,13,132,3,129,0,46,22,22,2,0,0,12,4,21
27,135,314,39,275,5,270,1,72,84,18,3,1,1,23,10,57
27,136,225,40,185,0,185,3,30,76,16,2,0,0,16,5,37
27,137,237,33,204,1,203,6,56,61,16,4,0,0,24,10,26
27,138,323,73,250,1,249,4,63,94,20,0,0,1,12,13,42
27,139,133,22,111,0,111,0,23,49,4,1,1,2,15,1,15
27,140,333,55,278,2,276,14,39,86,31,2,1,0,36,3,64
27,141,65,10,55,0,55,2,11,25,3,2,1,1,2,0,8
27,142,139,16,123,3,120,0,36,37,8,0,0,0,21,4,14
27,143,37,4,33,1,32,0,9,12,3,2,0,0,1,1,4
27,144,202,23,179,3,176,9,45,50,13,0,0,0,12,6,41
27,145,79,11,68,1,67,0,22,25,5,0,0,0,11,1,3
27,146,246,24,222,5,217,2,66,65,12,2,4,0,30,4,32
27,147,425,55,370,5,365,2,87,101,21,6,1,1,32,15,99
27,148,308,50,258,7,251,5,80,82,11,2,0,0,30,2,39
27,149,67,7,60,0,60,0,24,16,3,0,0,1,5,1,10
27,150,833,174,659,19,640,17,186,171,54,5,3,1,51,14,138
27,151,1507,320,1187,19,1168,9,294,248,173,21,10,4,76,23,310
27,152,469,80,389,7,382,3,113,94,28,13,4,2,19,9,97
27,153,253,41,212,5,207,2,77,49,13,8,5,0,11,2,40
27,154,383,66,317,7,310,0,76,90,25,10,9,0,31,7,62
27,155,89,15,74,1,73,1,21,24,2,0,1,1,4,2,17
27,156,356,53,303,2,301,0,86,72,24,6,6,1,24,11,71
27,157,402,56,346,3,343,5,123,109,20,3,3,0,26,2,52
27,158,598,126,472,8,464,7,93,150,38,6,3,0,43,9,115
27,159,349,61,288,9,279,3,54,83,15,1,1,0,33,6,83
27,160,154,21,133,2,131,2,33,43,11,2,0,0,13,5,22
27,161,821,110,711,18,693,14,148,207,57,9,6,3,60,13,176
27,162,158,15,143,1,142,4,37,43,12,2,0,0,11,7,26
27,163,130,22,108,0,108,0,24,28,10,0,0,0,8,0,38
27,164,586,96,490,13,477,4,118,157,39,8,4,0,28,11,108
27,165,3299,666,2633,53,2580,35,599,665,232,40,21,14,169,49,756
27,166,668,106,562,6,556,5,140,155,53,12,2,2,51,13,123
27,167,441,67,374,4,370,3,95,92,49,6,1,0,29,3,92
27,168,161,25,136,5,131,3,39,47,11,2,1,0,5,10,13
27,169,676,111,565,13,552,7,119,149,82,8,8,0,35,9,135
27,170,851,196,655,14,641,7,131,203,67,5,6,2,62,9,149
27,171,317,38,279,4,275,2,50,117,19,4,0,0,28,7,48
27,172,382,59,323,5,318,4,75,112,28,4,0,0,28,11,56
27,173,66,8,58,2,56,1,12,22,4,1,0,0,2,2,12
27,174,998,135,863,13,850,11,185,212,87,10,4,2,100,28,211
27,175,262,36,226,5,221,0,53,65,17,4,0,0,23,10,49
27,176,142,33,109,1,108,0,37,19,6,1,1,0,14,1,29
27,177,432,84,348,8,340,1,91,98,37,6,3,1,31,12,60
27,179,525,107,418,10,408,3,108,132,28,5,1,2,33,11,85
27,180,1307,185,1122,27,1095,13,308,272,105,17,11,5,73,27,264
27,181,434,78,356,9,347,6,82,123,30,8,2,2,23,7,64
27,182,150,32,118,0,118,2,21,44,13,2,0,0,14,2,20
27,183,1614,336,1278,28,1250,17,327,327,110,17,7,0,107,31,307
27,184,117,18,99,1,98,2,22,32,9,0,0,1,12,5,15
27,185,304,46,258,3,255,1,62,90,18,4,1,2,29,7,41
27,187,192,29,163,4,159,1,45,57,9,1,4,0,21,2,19
27,188,932,136,796,16,780,3,172,242,79,5,0,1,69,11,198
27,189,349,36,313,7,306,3,96,101,25,4,1,1,18,9,48
27,190,194,26,168,2,166,3,39,69,11,1,2,1,14,3,23
27,191,788,127,661,15,646,17,131,204,66,8,3,2,60,16,139
27,192,447,53,394,3,391,2,84,98,43,6,4,1,42,9,102
27,193,1024,277,747,17,730,14,214,173,94,7,2,4,44,19,159
27,194,175,27,148,1,147,7,61,30,8,2,1,0,2,3,33
27,195,83,16,67,2,65,3,14,25,3,0,1,1,9,1,8
27,196,901,114,787,15,772,8,184,198,78,10,5,1,70,8,210
27,197,198,32,166,4,162,4,30,77,9,0,2,1,9,2,28
27,198,1348,278,1070,16,1054,11,259,345,91,14,6,6,96,25,201
27,199,460,83,377,7,370,3,105,92,55,4,3,2,26,5,75
27,200,122,22,100,1,99,3,24,30,6,2,0,0,10,2,22
27,201,174,25,149,0,149,1,23,46,14,2,1,0,16,4,42
27,202,368,59,309,3,306,7,81,72,30,5,3,0,38,9,61
27,203,411,79,332,7,325,4,65,110,34,2,1,3,51,4,51
27,204,223,34,189,6,183,2,54,41,25,4,3,0,16,3,35
27,205,297,56,241,5,236,4,54,42,37,2,0,1,13,3,80
27,206,310,56,254,4,250,3,57,85,25,3,0,0,22,7,48
27,207,469,67,402,3,399,3,100,126,31,7,2,1,48,12,69
27,208,134,20,114,1,113,8,26,47,6,1,0,0,8,1,16
27,209,433,56,377,8,369,4,112,94,32,3,3,0,23,8,90
27,210,313,58,255,6,249,2,86,70,17,5,2,0,20,3,44
27,211,449,72,377,9,368,6,80,122,38,3,0,1,42,11,65
27,212,85,15,70,3,67,0,21,16,8,0,1,0,4,1,16
27,213,751,100,651,12,639,8,142,189,63,10,4,3,58,18,144
27,214,507,92,415,4,411,1,126,117,36,1,2,0,30,12,86
27,215,268,37,231,5,226,2,71,49,17,1,4,1,29,3,49
27,216,396,39,357,9,348,5,77,92,34,4,2,2,45,6,81
27,217,408,52,356,6,350,5,82,115,22,4,5,1,36,9,71
27,218,988,149,839,16,823,10,199,259,81,11,5,2,79,24,153
27,219,351,37,314,5,309,4,100,76,25,0,5,1,16,4,78
27,220,250,50,200,2,198,5,62,74,9,2,3,0,14,3,26
27,221,256,36,220,7,213,2,62,70,6,2,3,0,21,2,45
27,222,172,27,145,7,138,4,33,50,14,1,1,1,7,4,23
27,223,296,42,254,1,253,2,72,53,29,1,0,2,22,4,68
27,224,367,69,298,2,296,2,82,72,28,5,8,0,26,6,67
27,225,293,50,243,3,240,7,82,50,28,5,0,2,16,5,45
27,226,2783,591,2192,56,2136,21,537,546,245,39,15,1,121,44,567
27,227,457,75,382,7,375,2,129,95,40,2,0,1,21,4,81
27,228,222,24,198,2,196,2,38,54,24,4,0,0,21,5,48
27,229,27704,6858,20846,369,20477,536,3408,5033,2529,287,140,55,1792,311,6386
27,230,2457,531,1926,36,1890,19,528,544,165,30,10,6,136,39,413
27,231,330,47,283,5,278,4,64,122,17,0,0,1,20,6,44
27,232,222,43,179,3,176,2,54,62,20,1,3,1,9,3,21
27,233,579,79,500,9,491,6,126,147,48,17,3,0,41,7,96
27,234,239,26,213,4,209,4,36,63,28,3,4,1,26,3,41
27,235,124,20,104,2,102,1,38,27,7,0,0,0,7,4,18
27,237,142,24,118,5,113,0,38,34,5,7,1,0,6,5,17
27,238,762,89,673,19,654,8,159,191,66,8,5,0,61,11,145
27,239,333,45,288,5,283,5,42,115,24,0,2,1,29,10,55
27,240,219,42,177,2,175,5,53,54,20,0,0,0,5,3,35
27,241,153,28,125,0,125,2,25,43,10,0,0,0,12,5,28
27,242,736,120,616,12,604,12,182,167,56,11,2,2,50,12,110
27,243,526,101,425,5,420,9,103,128,42,5,5,0,28,11,89
27,244,337,48,289,6,283,6,53,79,28,12,1,0,28,2,74
27,245,245,27,218,3,215,2,76,60,20,1,1,0,20,6,29
27,246,1274,254,1020,19,1001,15,237,250,111,20,6,4,54,30,274
27,247,267,47,220,5,215,4,39,55,22,8,3,0,35,5,44
27,248,143,30,113,1,112,2,25,41,12,2,1,0,8,1,20
27,249,775,96,679,18,661,14,195,173,59,11,1,3,61,10,134
27,250,534,69,465,8,457,3,145,103,45,9,0,1,42,5,104
27,251,422,65,357,9,348,8,84,88,39,2,4,0,31,14,78
27,252,264,45,219,2,217,3,47,74,14,1,0,0,20,9,49
27,253,326,59,267,3,264,3,40,83,29,9,2,0,29,2,67
27,254,673,124,549,8,541,10,106,189,52,3,2,0,54,22,103
27,255,206,29,177,6,171,1,41,49,19,1,2,1,14,3,40
27,256,408,55,353,8,345,4,105,100,32,6,3,1,21,12,61
27,257,317,49,268,9,259,1,74,68,20,4,3,2,19,8,60
27,258,344,53,291,6,285,5,72,100,11,3,3,5,34,6,46
27,259,65,5,60,1,59,1,13,16,3,1,1,0,10,0,14
27,260,422,66,356,5,351,6,103,90,22,5,2,2,24,2,95
27,261,365,51,314,4,310,1,61,99,25,4,1,0,27,15,77
27,262,680,152,528,3,525,12,167,169,33,5,1,1,40,7,90
27,263,500,63,437,5,432,11,87,126,52,11,3,0,35,7,100
27,264,131,18,113,2,111,4,32,45,6,0,0,0,12,3,9
27,265,851,126,725,9,716,12,223,200,44,13,10,1,42,27,144
27,266,242,43,199,5,194,4,53,38,23,2,0,1,12,6,55
27,267,309,37,272,4,268,5,65,52,38,7,4,1,25,9,62
27,268,275,38,237,3,234,5,33,76,21,4,2,1,23,7,62
27,269,167,14,153,0,153,1,39,47,13,4,1,0,14,6,28
27,270,398,69,329,8,321,5,88,94,33,6,2,1,25,10,57
27,271,233,49,184,6,178,2,46,65,13,2,0,0,16,12,22
27,273,304,55,249,3,246,4,46,102,14,3,2,0,20,4,51
27,274,299,49,250,1,249,1,66,78,22,3,3,0,19,0,57
27,275,4245,987,3258,42,3216,54,730,714,397,36,16,20,240,51,958
27,276,268,33,235,3,232,4,66,53,26,4,1,2,18,3,55
27,277,428,72,356,7,349,2,88,87,44,6,2,0,53,5,62
27,278,1239,223,1016,22,994,12,243,287,96,9,5,3,77,17,245
27,279,2521,613,1908,34,1874,16,606,467,171,31,16,7,129,43,388
27,280,360,44,316,11,305,4,83,92,25,3,3,0,28,4,63
27,281,211,29,182,3,179,3,39,59,15,4,0,0,17,0,42
27,282,435,52,383,9,374,6,70,126,40,10,0,0,28,6,88
27,283,213,38,175,2,173,4,43,70,10,3,1,0,11,1,30
27,284,7687,1857,5830,119,5711,85,1372,1381,856,90,56,15,372,116,1368
27,285,412,57,355,6,349,20,44,135,42,2,2,1,34,9,60
27,286,236,37,199,3,196,5,53,76,21,0,0,0,12,1,28
27,287,687,122,565,9,556,18,104,154,53,12,3,3,39,6,164
27,288,379,56,323,7,316,6,55,73,48,2,4,2,21,8,97
27,289,149,22,127,4,123,4,29,47,11,3,0,0,13,1,15
27,290,585,68,517,15,502,7,162,122,54,8,3,0,30,7,109
27,291,127,14,113,2,111,1,23,48,9,0,0,0,9,3,18
27,292,187,32,155,4,151,3,41,49,15,2,0,1,12,0,28
27,293,254,40,214,2,212,6,61,64,16,4,1,0,12,5,43
27,294,409,65,344,7,337,4,101,71,28,9,3,1,27,8,85
27,295,375,58,317,2,315,0,70,114,25,4,0,1,26,2,73
27,296,170,23,147,3,144,3,35,47,7,2,0,1,11,5,33
27,297,278,42,236,1,235,1,90,69,15,1,0,1,14,6,38
27,298,240,35,205,2,203,7,67,52,17,3,1,1,22,4,29
27,299,2676,427,2249,35,2214,32,465,527,294,36,21,10,188,46,595
27,300,392,71,321,6,315,3,79,96,41,5,3,0,20,4,64
27,301,777,89,688,11,677,8,159,216,51,9,7,4,61,24,138
27,302,720,123,597,11,586,3,167,155,63,4,4,1,56,11,122
27,303,67,5,62,1,61,2,21,16,1,2,2,0,3,0,14
27,304,171,31,140,3,137,1,36,43,20,0,2,0,12,2,21
27,305,566,83,483,7,476,9,115,140,35,17,3,1,38,9,109
27,306,2142,408,1734,32,1702,36,303,446,181,24,8,4,186,28,486
27,307,320,37,283,5,278,5,100,65,19,4,4,0,21,6,54
27,308,191,30,161,2,159,2,50,54,13,4,0,0,11,0,25
27,309,352,50,302,5,297,8,66,117,22,2,2,0,19,7,54
27,310,335,52,283,9,274,9,93,77,20,3,1,1,14,4,52
27,311,655,107,548,5,543,4,119,157,65,9,5,0,57,7,120
27,312,228,29,199,1,198,6,44,63,12,3,1,0,25,3,41
27,313,403,60,343,6,337,5,78,82,48,5,7,0,35,12,65
27,315,219,41,178,3,175,1,47,54,18,6,1,1,16,1,30
27,316,992,130,862,17,845,17,206,215,83,10,1,1,89,12,211
27,317,349,55,294,7,287,2,87,69,23,2,0,0,30,8,66
27,318,216,23,193,3,190,3,49,47,24,1,2,1,15,3,45
27,319,220,18,202,4,198,9,48,36,22,1,0,0,16,4,62
27,320,225,51,174,3,171,3,48,52,10,3,4,0,9,2,40
27,321,123,28,95,0,95,2,7,40,8,0,1,1,15,2,19
27,322,1138,175,963,14,949,18,217,225,131,6,4,4,78,18,248
27,323,199,30,169,2,167,1,51,60,9,1,1,1,15,6,22
27,324,413,64,349,5,344,6,81,99,34,4,2,0,42,6,70
27,325,93,13,80,5,75,0,19,30,7,0,0,0,2,2,15
27,326,300,54,246,5,241,7,45,113,9,5,1,0,20,6,35
27,327,196,27,169,3,166,2,56,40,14,5,0,3,15,10,21
27,329,631,112,519,14,505,9,173,133,57,4,5,0,42,6,76
27,330,121,27,94,1,93,0,21,18,6,5,0,2,9,6,26
27,331,357,61,296,5,291,8,85,94,17,5,3,1,13,7,58
27,332,626,88,538,14,524,10,96,174,53,14,3,0,51,8,115
27,333,468,80,388,4,384,7,133,94,24,2,10,0,28,10,76
27,334,86,12,74,0,74,1,11,26,8,0,0,1,12,1,14
27,335,789,116,673,12,661,6,147,225,57,11,4,1,63,9,138
27,336,210,23,187,4,183,1,41,69,13,1,1,0,28,0,29
27,337,338,63,275,2,273,7,65,91,23,6,3,3,14,3,58
27,338,493,87,406,9,397,3,94,100,43,8,3,0,35,4,107
27,339,619,75,544,7,537,12,125,169,51,9,5,2,51,9,104
27,340,494,76,418,10,408,9,90,110,39,4,1,0,46,5,104
27,341,81,26,55,0,55,0,14,21,4,1,1,0,4,1,9
27,342,160,32,128,1,127,0,40,40,12,2,0,0,6,2,25
27,343,1041,168,873,14,859,15,149,331,58,3,2,4,95,16,186
27,344,93,10,83,0,83,0,41,19,9,0,0,0,2,1,11
27,345,203,34,169,2,167,1,32,57,8,1,2,0,20,4,42
27,346,165,21,144,1,143,1,65,28,16,0,2,0,8,1,22
27,347,574,93,481,8,473,9,76,162,46,1,2,0,51,2,124
27,348,1097,125,972,15,957,15,222,238,123,14,7,5,71,29,233
27,349,663,89,574,12,562,14,144,128,92,7,3,2,44,15,113
27,350,709,121,588,5,583,10,164,166,64,10,5,2,37,13,112
27,351,1107,165,942,16,926,19,194,261,105,11,1,0,72,20,243
27,353,332,37,295,5,290,6,87,83,21,1,0,4,17,7,64
27,354,387,76,311,1,310,2,64,91,37,6,3,0,34,3,70
27,355,1728,364,1364,26,1338,16,315,433,126,17,9,3,107,36,276
27,356,224,25,199,4,195,3,46,41,26,5,0,0,17,5,52
27,358,461,73,388,6,382,6,80,163,29,3,0,0,49,3,49
27,359,157,40,117,3,114,0,38,39,6,3,1,0,8,0,19
27,360,224,44,180,1,179,4,65,36,19,1,0,0,16,4,34
27,361,234,30,204,2,202,0,38,78,15,3,0,1,23,6,38
27,362,259,37,222,4,218,7,48,57,18,5,1,1,27,2,52
27,363,150,24,126,2,124,3,18,50,11,1,1,0,5,0,35
27,364,175,29,146,1,145,4,48,35,15,2,0,1,12,2,26
27,365,1549,353,1196,20,1176,32,230,248,179,15,9,4,89,18,352
27,366,163,23,140,3,137,5,25,31,24,3,1,0,14,6,28
27,367,1051,188,863,23,840,8,227,277,72,12,10,6,78,12,138
27,368,237,46,191,7,184,1,47,72,13,1,1,0,14,3,32
27,369,71,11,60,2,58,1,12,26,2,3,1,0,3,1,9
27,370,269,39,230,4,226,5,67,64,38,1,3,1,11,2,34
27,371,138,23,115,0,115,0,28,39,2,5,0,1,9,4,27
27,372,426,94,332,11,321,3,114,62,42,4,2,0,19,1,74
27,373,120,13,107,0,107,0,31,49,4,0,0,0,4,1,18
27,374,414,79,335,8,327,5,71,95,40,10,1,1,18,10,76
27,375,11348,3066,8282,158,8124,176,1495,2015,970,163,65,18,626,137,2459
27,376,198,30,168,2,166,7,29,67,10,2,0,2,19,4,26
27,377,650,89,561,11,550,9,106,212,41,4,2,4,44,13,115
27,378,998,201,797,8,789,8,182,246,54,14,4,2,79,27,173
27,379,321,65,256,5,251,8,52,79,33,6,3,0,13,7,50
27,380,175,24,151,0,151,0,40,40,7,2,0,0,7,5,50
27,381,117,17,100,1,99,6,33,16,2,5,1,1,10,6,19
27,382,237,24,213,6,207,3,41,56,14,3,4,0,23,9,54
27,383,330,44,286,3,283,5,78,76,31,3,2,0,23,5,60
27,384,409,60,349,6,343,6,73,114,33,4,0,1,31,5,76
27,385,1112,233,879,12,867,20,163,222,94,17,6,2,87,17,239
27,386,780,154,626,8,618,11,164,98,79,12,7,0,36,15,196
27,387,238,36,202,4,198,1,41,73,16,0,1,2,24,5,35
27,388,391,64,327,9,318,0,72,124,27,5,0,0,24,8,58
27,389,283,44,239,3,236,5,66,76,21,0,1,0,19,4,44
27,390,664,67,597,13,584,4,182,179,39,7,1,1,52,16,103
27,391,1049,173,876,19,857,8,243,255,82,9,2,2,73,19,164
27,392,115,20,95,0,95,3,19,39,5,3,0,0,4,2,20
27,393,289,57,232,8,224,3,54,62,26,2,0,0,26,4,47
27,394,336,46,290,6,284,6,83,92,17,2,1,0,21,1,61
27,395,81,12,69,1,68,0,20,20,6,0,0,0,6,1,15
27,396,336,47,289,5,284,5,96,60,45,4,2,0,14,1,57
27,397,1213,251,962,22,940,14,237,303,98,12,5,3,75,20,173
27,398,993,147,846,16,830,13,179,263,65,5,6,2,96,11,190
27,399,41,5,36,0,36,0,6,18,2,0,0,0,0,0,10
27,400,280,39,241,3,238,5,47,101,14,1,2,0,14,4,50
27,401,146,8,138,0,138,3,27,45,15,0,0,0,7,1,40
27,402,48,2,46,1,45,0,7,21,5,0,0,0,1,4,7
27,403,230,32,198,2,196,7,48,60,24,3,0,2,18,4,30
27,404,82,11,71,1,70,0,17,26,8,1,1,1,6,1,9
27,405,135,29,106,2,104,4,32,31,3,0,0,0,6,4,24
27,406,778,160,618,14,604,7,119,155,55,10,4,2,53,11,188
27,407,234,31,203,4,199,1,64,86,8,3,1,0,5,3,28
27,408,471,55,416,13,403,1,128,125,18,9,4,1,28,16,73
27,410,367,62,305,6,299,4,74,106,22,1,3,3,29,8,49
27,411,158,19,139,1,138,3,35,41,17,1,0,0,11,5,25
27,412,813,97,716,13,703,13,162,141,106,9,3,2,66,12,189
27,413,611,120,491,8,483,4,94,129,77,14,3,0,33,5,124
27,414,586,129,457,10,447,8,95,143,33,4,4,0,43,13,104
27,415,343,65,278,7,271,7,48,98,20,1,0,3,32,12,50
27,416,707,137,570,9,561,6,141,193,51,4,3,2,53,11,97
27,417,466,79,387,4,383,4,112,103,28,2,4,2,33,10,85
27,418,88,14,74,1,73,2,15,36,8,0,0,0,2,5,5
27,419,531,101,430,0,430,4,137,107,36,6,6,2,21,15,96
27,420,119,11,108,2,106,0,34,34,7,1,3,0,7,4,16
27,421,465,87,378,3,375,7,114,101,32,3,5,2,17,11,83
27,422,735,115,620,18,602,15,147,166,52,5,1,3,42,20,151
27,423,682,118,564,5,559,12,152,141,58,4,1,2,57,12,120
27,424,274,43,231,3,228,0,73,76,14,3,4,0,15,2,41
27,425,936,158,778,16,762,4,187,153,95,11,4,4,58,9,237
27,426,996,181,815,21,794,9,209,262,72,5,2,2,57,20,156
27,427,363,67,296,0,296,4,84,90,20,4,1,0,24,4,65
27,428,2881,682,2199,36,2163,30,512,693,193,25,7,8,197,32,466
27,429,115,13,102,2,100,3,21,42,6,1,1,0,9,2,15
27,430,228,32,196,4,192,2,68,47,15,1,0,0,11,6,42
27,431,410,65,345,3,342,3,77,111,28,6,1,0,23,5,88
27,432,424,75,349,4,345,5,82,61,46,4,7,2,29,6,103
27,433,132,26,106,1,105,1,31,26,9,1,3,0,12,2,20
27,434,46,7,39,2,37,0,8,16,6,2,0,0,1,0,4
27,435,152,20,132,2,130,0,30,38,9,1,1,0,12,6,33
27,436,316,67,249,10,239,4,62,68,24,1,1,0,20,0,59
27,437,248,46,202,2,200,1,82,35,20,4,3,0,13,2,40
27,438,1393,305,1088,17,1071,9,238,312,108,18,11,3,93,22,257
27,439,886,116,770,9,761,16,153,245,62,12,3,1,74,17,178
27,440,598,85,513,12,501,13,111,162,47,4,0,0,29,12,123
27,441,64,11,53,0,53,0,18,14,3,0,1,0,5,3,9
27,442,189,37,152,2,150,3,31,62,10,3,1,1,13,3,23
27,444,203,35,168,3,165,3,25,79,5,2,1,0,16,4,30
27,445,142,35,107,0,107,2,26,31,14,2,0,0,8,3,21
27,446,359,56,303,5,298,6,83,69,30,5,4,1,33,5,62
27,447,358,50,308,8,300,3,71,88,25,7,0,0,19,3,84
27,448,3307,621,2686,48,2638,37,586,916,206,27,14,4,195,68,585
27,449,337,29,308,5,303,10,58,97,33,4,0,2,31,2,66
27,451,261,48,213,3,210,7,37,53,14,2,1,1,27,6,62
27,452,313,37,276,7,269,2,54,53,45,1,1,1,23,9,80
27,453,1386,277,1109,18,1091,6,263,260,133,16,11,3,56,25,318
27,454,330,49,281,2,279,2,70,73,42,6,0,2,22,2,60
27,455,138,26,112,2,110,1,29,32,9,1,1,0,14,1,22
27,456,684,111,573,7,566,6,137,165,51,11,3,2,38,13,140
27,457,540,87,453,8,445,5,132,152,39,6,7,0,35,4,65
27,458,1646,284,1362,25,1337,21,250,228,236,26,16,6,81,31,442
27,459,64,2,62,1,61,1,13,26,7,0,0,0,4,3,7
27,460,151,11,140,3,137,0,29,54,10,3,0,0,15,3,23
27,462,107,13,94,1,93,0,34,28,1,1,0,0,11,2,16
27,463,533,78,455,9,446,6,121,127,48,4,1,1,36,9,93
27,464,640,76,564,4,560,14,96,170,57,4,3,0,58,14,144
27,465,332,54,278,5,273,2,72,82,21,4,0,1,29,5,57
27,466,216,42,174,1,173,5,38,45,16,2,0,0,13,3,51
27,467,5797,1554,4243,73,4170,66,782,961,502,66,29,11,339,64,1350
27,468,431,74,357,5,352,7,86,76,59,2,5,5,23,6,83
27,469,3003,558,2445,48,2397,31,466,595,298,57,12,3,200,46,689
27,470,748,119,629,12,617,6,145,145,72,9,5,2,37,15,181
27,471,117,20,97,0,97,0,15,44,5,0,0,0,4,1,28
27,472,190,23,167,4,163,2,51,43,17,7,0,0,11,2,30
27,473,751,98,653,13,640,12,117,192,79,9,4,6,52,18,151
27,474,866,107,759,11,748,30,183,203,74,7,0,0,54,19,178
27,475,145,24,121,0,121,1,28,38,13,1,0,0,19,4,17
27,476,328,23,305,6,299,5,48,80,29,0,2,0,29,4,102
27,477,611,99,512,7,505,8,109,158,51,2,0,0,42,7,128
27,478,730,109,621,13,608,6,102,187,46,3,6,1,78,19,160
27,480,417,63,354,4,350,1,89,105,30,5,4,0,27,5,84
27,481,301,41,260,1,259,6,50,109,14,2,0,1,29,10,38
27,482,110,20,90,1,89,0,32,29,3,0,0,0,14,1,10
27,483,318,63,255,2,253,5,62,90,23,5,1,2,15,5,45
27,484,93,15,78,1,77,1,32,17,5,0,0,2,3,5,12
27,485,685,126,559,5,554,4,168,91,56,17,8,1,50,17,142
27,486,481,83,398,6,392,12,109,116,36,7,1,3,34,11,63
27,487,470,79,391,9,382,6,96,93,39,2,2,2,25,8,109
27,488,161,25,136,2,134,3,21,46,13,2,0,1,10,2,36
27,489,415,91,324,9,315,5,68,100,36,3,2,1,36,6,58
27,490,164,26,138,5,133,3,46,31,8,1,1,2,7,3,31
27,491,228,40,188,5,183,1,47,91,10,2,1,0,13,3,15
27,492,254,52,202,4,198,0,58,54,13,1,1,0,10,8,53
27,493,2227,400,1827,32,1795,21,411,376,274,26,18,5,158,35,471
27,495,190,33,157,0,157,3,51,54,13,3,1,0,4,4,24
27,496,411,56,355,7,348,5,109,101,25,6,1,1,27,8,65
27,497,731,110,621,7,614,7,155,162,71,7,6,0,49,17,140
27,498,235,34,201,8,193,2,41,58,14,3,0,0,16,4,55
27,499,159,22,137,3,134,2,33,50,14,1,0,2,9,1,22
27,500,952,166,786,15,771,12,198,220,101,6,6,3,61,10,154
27,501,204,36,168,3,165,5,44,48,22,1,1,0,8,6,30
27,502,1642,413,1229,21,1208,13,271,279,110,13,5,3,115,27,372
27,503,223,31,192,4,188,3,45,59,15,3,0,0,24,5,34
27,504,754,83,671,20,651,19,128,202,53,7,7,2,75,18,140
27,505,124,19,105,1,104,0,17,46,13,1,0,0,11,2,14
27,506,258,56,202,1,201,0,51,52,17,3,0,1,20,6,51
27,507,2380,551,1829,37,1792,15,474,475,161,28,19,1,125,30,464
27,508,138,19,119,3,116,4,26,43,11,1,1,0,4,2,24
27,510,373,52,321,4,317,5,72,116,24,4,4,0,29,8,55
27,511,531,97,434,6,428,9,92,136,35,7,2,0,29,8,110
27,512,271,41,230,5,225,5,45,92,18,1,0,1,30,4,29
27,513,107,17,90,2,88,1,29,32,5,2,0,0,7,6,6
27,514,312,45,267,5,262,6,58,98,20,5,3,0,27,8,37
27,515,223,37,186,3,183,2,33,72,22,1,0,0,18,5,30
27,516,687,114,573,6,567,6,109,179,62,4,3,2,55,17,130
27,517,1381,176,1205,17,1188,14,328,340,114,6,6,4,92,23,261
27,518,443,59,384,1,383,2,125,87,60,12,6,1,15,11,64
27,519,222,41,181,0,181,2,33,75,15,2,1,0,17,6,30
27,520,98,10,88,0,88,0,18,35,7,0,1,0,6,1,20
27,521,125,12,113,2,111,1,27,38,12,3,0,0,15,0,15
27,522,307,50,257,5,252,7,56,69,18,0,1,0,23,4,74
27,523,298,51,247,9,238,6,49,60,27,7,4,1,20,3,61
27,524,524,1,523,109,414,14,117,119,32,4,0,2,38,14,74
27,525,229,44,185,4,181,4,33,61,16,1,0,0,20,9,37
27,526,197,24,173,5,168,3,37,60,9,1,1,1,15,3,38
27,527,173,27,146,2,144,3,40,33,16,3,1,0,13,2,33
27,528,2726,546,2180,39,2141,39,360,616,202,35,16,3,230,45,595
27,529,348,49,299,2,297,5,36,85,38,0,0,1,38,5,89
27,530,91,12,79,4,75,0,16,37,8,0,0,2,6,1,5
27,531,170,17,153,1,152,0,41,38,12,1,1,1,21,3,34
27,532,140,23,117,2,115,0,46,42,7,1,1,0,5,1,12
27,533,446,103,343,4,339,2,72,140,34,4,0,0,25,4,58
27,534,629,74,555,10,545,4,125,113,74,6,0,1,59,10,153
27,535,383,70,313,4,309,3,80,81,29,10,3,0,21,9,73
27,536,369,45,324,3,321,5,92,92,34,0,2,0,25,8,63
27,537,552,88,464,7,457,16,102,112,44,7,0,3,34,5,134
27,538,402,56,346,10,336,2,70,71,37,4,5,2,39,11,95
27,539,310,56,254,5,249,0,58,73,25,5,0,3,24,5,56
27,540,491,107,384,5,379,4,110,112,35,3,3,1,36,11,64
27,541,96,11,85,1,84,3,14,23,11,2,2,0,8,6,15
27,542,571,91,480,11,469,4,131,108,47,5,3,1,42,4,124
27,543,653,125,528,9,519,7,114,176,59,3,6,2,38,11,103
27,544,157,26,131,0,131,3,22,48,10,2,2,1,11,2,30
27,545,118,22,96,0,96,3,24,43,7,0,0,0,5,1,13
27,546,168,24,144,1,143,3,30,45,12,2,0,0,13,2,36
27,547,610,106,504,13,491,1,119,177,42,9,4,0,40,22,77
27,548,954,195,759,18,741,19,174,201,74,12,5,3,65,23,165
27,549,1207,218,989,14,975,15,206,235,98,21,5,3,80,22,290
27,550,256,26,230,2,228,2,63,56,23,1,3,1,21,5,53
27,551,60,5,55,2,53,3,10,27,1,0,0,0,4,0,8
27,552,181,32,149,1,148,1,43,48,11,4,2,1,13,3,22
27,553,321,51,270,6,264,2,70,94,18,4,0,0,30,3,43
27,554,1057,213,844,19,825,9,148,274,79,3,8,1,90,23,190
27,555,185,24,161,3,158,2,57,54,10,0,0,0,12,5,18
27,556,61,15,46,0,46,0,10,14,2,2,2,0,1,0,15
27,557,383,55,328,7,321,4,55,99,36,6,1,0,37,6,77
27,558,105,13,92,0,92,0,18,25,15,2,2,0,4,0,26
27,560,216,26,190,2,188,3,37,85,15,3,1,0,12,4,28
27,561,444,98,346,6,340,7,70,121,22,5,1,0,35,8,71
27,562,3320,503,2817,52,2765,61,505,809,263,35,20,8,263,65,736
27,563,612,110,502,11,491,9,94,141,60,7,3,1,35,12,129
27,564,283,51,232,3,229,2,77,69,16,5,2,0,18,4,36
27,565,348,47,301,5,296,5,92,79,27,5,2,1,35,7,43
27,566,102,21,81,4,77,1,10,32,7,1,0,0,7,1,18
27,567,174,24,150,2,148,1,30,48,6,2,1,0,11,5,44
27,568,358,41,317,4,313,4,58,88,30,5,2,2,32,8,84
27,569,209,26,183,1,182,7,48,52,9,2,0,0,10,9,45
27,570,77,3,74,2,72,0,28,22,1,0,0,0,9,1,11
27,571,223,18,205,1,204,7,55,48,15,8,0,1,24,1,45
27,572,192,35,157,4,153,3,60,25,17,0,2,0,9,4,33
27,573,131,17,114,1,113,1,27,48,2,2,1,0,15,5,12
27,574,249,47,202,3,199,1,54,49,30,6,1,1,21,4,32
27,576,424,55,369,7,362,6,89,110,33,7,6,3,17,12,79
27,577,354,42,312,7,305,6,79,85,32,2,2,1,38,8,52
27,578,188,24,164,0,164,4,41,57,11,2,3,0,12,3,31
27,579,74,9,65,0,65,0,8,17,9,1,0,0,6,3,21
27,580,1698,225,1473,18,1455,20,310,369,190,17,7,2,112,41,387
27,581,274,36,238,4,234,3,54,70,30,10,1,0,19,4,43
27,582,1241,183,1058,27,1031,12,216,294,103,11,7,5,87,28,268
27,584,187,19,168,2,166,1,45,37,23,2,3,0,8,6,41
27,586,127,15,112,1,111,2,30,25,10,2,1,0,13,1,27
27,587,624,86,538,2,536,8,118,105,95,6,7,1,37,12,147
27,588,832,110,722,8,714,16,124,239,58,8,2,1,80,10,176
27,589,793,141,652,15,637,17,138,195,47,12,4,1,57,18,148
27,590,156,32,124,0,124,0,28,40,18,2,0,0,16,2,18
27,591,489,66,423,9,414,8,106,139,26,6,1,0,55,6,67
27,592,213,37,176,2,174,2,44,42,24,5,0,0,11,7,39
27,593,1028,126,902,13,889,7,212,218,89,6,6,0,59,24,268
27,594,202,31,171,4,167,3,39,39,21,0,2,0,10,5,48
27,595,651,81,570,6,564,10,122,135,63,8,7,1,53,9,156
27,596,106,20,86,2,84,1,10,43,10,1,0,0,7,1,11
27,597,406,64,342,5,337,5,64,97,30,4,1,1,31,8,96
27,598,918,145,773,7,766,20,168,178,70,11,7,4,65,20,223
27,599,727,137,590,9,581,6,175,185,40,7,3,1,34,16,114
27,600,202,47,155,3,152,2,30,52,14,4,0,0,10,4,36
27,601,278,49,229,3,226,5,61,65,21,4,3,0,23,3,41
27,602,3356,562,2794,58,2736,62,434,763,323,18,17,5,349,56,709
27,603,236,32,204,3,201,6,49,45,23,5,1,1,23,4,44
27,604,124,6,118,2,116,0,24,33,21,1,2,0,4,3,28
27,605,198,26,172,0,172,5,39,68,7,3,2,0,26,1,21
27,606,304,30,274,4,270,4,85,55,24,7,1,0,18,4,72
27,607,186,30,156,5,151,5,41,50,14,0,1,2,5,3,30
27,608,356,57,299,4,295,3,75,96,23,9,1,0,28,4,56
27,609,245,36,209,5,204,3,69,56,20,1,0,1,16,1,37
27,610,57,10,47,1,46,0,11,18,1,0,1,0,7,3,5
27,611,208,25,183,4,179,2,27,62,16,4,3,1,16,3,45
27,612,256,41,215,6,209,3,50,87,14,5,1,1,21,3,24
27,613,231,43,188,5,183,2,52,64,13,4,0,1,11,3,33
27,614,107,16,91,3,88,1,23,26,11,0,2,0,11,1,13
27,615,153,27,126,2,124,3,17,42,7,1,0,0,11,2,41
27,616,1518,216,1302,14,1288,20,223,392,125,12,4,3,160,22,327
27,617,326,52,274,1,273,3,113,75,18,2,0,0,14,1,47
27,618,303,52,251,4,247,2,93,73,16,2,2,2,16,5,36
27,620,356,57,299,8,291,8,76,67,32,3,1,0,28,6,70
27,621,106,12,94,1,93,1,22,42,5,0,0,0,5,5,13
27,622,1523,261,1262,17,1245,15,259,215,189,19,9,1,85,20,433
27,623,310,34,276,4,272,4,82,70,30,5,4,0,16,9,52
27,624,673,84,589,15,574,5,143,154,58,4,3,1,63,21,122
27,625,200,35,165,0,165,2,66,33,13,1,1,0,13,4,32
27,626,277,35,242,4,238,4,40,53,45,4,1,2,19,10,60
27,627,184,26,158,5,153,3,40,54,12,2,2,0,12,2,26
27,628,233,48,185,4,181,5,43,67,11,0,0,0,12,4,39
27,629,1302,243,1059,25,1034,6,263,340,78,20,3,3,100,9,212
27,630,202,23,179,3,176,1,42,65,13,0,0,0,20,2,33
27,631,225,23,202,5,197,4,49,45,23,2,1,0,9,7,57
27,632,260,24,236,3,233,0,82,64,14,1,3,0,15,4,50
27,633,393,93,300,4,296,2,104,68,25,5,2,1,19,7,63
27,634,230,36,194,2,192,3,53,67,15,2,0,0,19,4,29
27,635,113,20,93,1,92,2,25,37,6,2,0,0,8,1,11
27,636,465,43,422,12,410,3,85,96,58,5,3,5,38,7,110
27,637,256,50,206,2,204,1,32,64,23,1,2,1,22,1,57
27,638,1631,169,1462,27,1435,10,334,377,149,21,9,5,106,33,391
27,639,364,52,312,4,308,10,62,66,39,3,0,3,23,13,89
27,640,152,20,132,3,129,2,40,31,11,1,1,0,9,2,32
27,641,163,23,140,3,137,1,37,37,16,2,0,1,14,3,26
27,642,271,38,233,4,229,3,48,69,21,2,2,0,13,5,66
27,643,868,196,672,13,659,11,138,195,63,7,3,0,63,16,163
27,644,366,40,326,5,321,9,85,95,28,4,0,4,30,6,60
27,645,102,9,93,0,93,4,33,22,10,2,0,0,5,0,17
27,646,294,49,245,4,241,2,69,74,17,5,0,0,19,6,49
27,647,461,89,372,9,363,4,101,114,18,13,3,2,22,9,77
27,648,323,35,288,9,279,11,48,75,36,6,4,1,30,6,62
27,649,261,48,213,5,208,1,77,45,24,2,3,0,14,3,39
27,650,288,47,241,4,237,3,71,70,20,3,1,1,25,6,37
27,651,127,13,114,4,110,3,14,56,4,0,0,1,5,4,23
27,652,256,32,224,2,222,6,52,53,34,5,1,0,18,1,52
27,653,672,132,540,8,532,14,146,159,57,6,8,0,33,8,101
27,654,712,92,620,11,609,14,154,140,62,9,6,0,47,14,163
27,655,520,86,434,5,429,9,82,122,50,2,2,0,42,9,111
27,656,958,153,805,23,782,7,204,185,77,21,11,3,68,19,187
27,657,118,14,104,0,104,2,23,30,14,1,0,0,12,3,19
27,658,230,31,199,3,196,3,56,53,7,4,2,1,29,1,40
27,659,75,8,67,1,66,1,6,25,5,0,0,0,14,0,15
27,660,201,24,177,3,174,4,36,51,10,2,0,0,16,2,53
27,661,358,41,317,9,308,9,52,93,39,1,1,0,25,7,81
27,662,258,40,218,3,215,3,39,72,21,0,0,1,32,4,43
27,663,117,10,107,1,106,4,16,35,11,1,3,0,13,2,21
27,664,411,67,344,4,340,13,81,112,28,1,1,1,34,3,66
27,665,606,119,487,6,481,6,115,123,58,5,3,0,41,16,114
27,666,429,51,378,6,372,2,102,98,40,5,4,2,25,7,87
27,667,270,33,237,7,230,4,52,77,19,2,5,0,13,4,54
27,668,613,124,489,7,482,14,107,144,49,5,2,0,42,12,107
27,669,242,38,204,6,198,4,62,43,17,3,1,2,15,6,45
27,670,789,127,662,13,649,8,158,113,87,10,8,2,47,15,201
27,671,109,14,95,0,95,2,16,34,9,1,0,0,13,0,20
27,672,244,36,208,7,201,7,38,60,17,2,3,0,16,4,54
27,673,155,24,131,1,130,1,22,46,9,2,3,0,19,3,25
27,674,209,30,179,4,175,1,36,89,14,3,0,0,8,3,21
27,676,687,125,562,13,549,10,140,134,55,10,4,1,52,12,131
27,677,234,31,203,6,197,7,49,53,15,5,1,0,27,5,35
27,678,856,143,713,7,706,16,158,177,42,6,5,4,72,20,206
27,679,4545,1109,3436,57,3379,64,661,1087,263,42,15,15,306,55,871
27,680,177,44,133,5,128,2,32,55,6,1,1,0,8,1,22
27,681,14984,3509,11475,168,11307,260,1826,3289,1155,105,48,26,1087,193,3318
27,682,485,75,410,8,402,6,99,121,39,2,1,0,34,15,85
27,683,165,22,143,0,143,3,30,46,14,1,2,2,4,5,36
27,684,542,72,470,7,463,7,101,137,47,4,1,2,52,7,105
27,685,477,89,388,15,373,2,105,140,22,7,1,0,23,6,67
27,686,60,8,52,0,52,1,9,16,9,0,0,0,5,0,12
27,687,138,15,123,4,119,2,39,29,16,1,0,0,12,0,20
27,688,77,11,66,2,64,2,8,30,3,0,0,0,6,1,14
27,689,223,29,194,5,189,2,40,57,22,7,3,0,20,5,33
27,690,218,55,163,4,159,2,55,38,24,6,1,0,6,4,23
27,691,589,86,503,11,492,11,123,129,35,6,7,1,47,20,113
27,692,141,19,122,0,122,0,35,31,16,1,3,0,7,3,26
27,693,860,118,742,15,727,20,150,257,49,8,4,5,67,14,153
27,694,283,52,231,0,231,4,55,65,27,3,0,3,15,6,53
27,695,186,27,159,3,156,2,36,64,7,0,1,0,8,2,36
27,696,684,118,566,4,562,11,107,182,44,8,3,0,70,11,126
27,697,260,25,235,7,228,1,56,89,17,4,0,1,25,7,28
27,698,379,50,329,7,322,5,72,82,28,3,3,1,27,8,93
27,699,97,16,81,3,78,1,14,19,11,3,1,3,7,2,17
27,700,402,55,347,5,342,2,94,93,33,8,1,1,30,7,73
27,701,7329,2316,5013,100,4913,98,892,615,690,95,42,16,278,79,2108
28,1,1471,185,1286,19,1267,20,287,393,103,19,2,4,124,34,281
28,2,239,36,203,0,203,2,54,70,19,5,1,0,14,3,35
28,3,110,15,95,1,94,1,21,32,16,2,0,1,5,4,12
28,4,229,48,181,3,178,7,49,39,14,5,1,0,9,7,47
28,5,539,75,464,4,460,6,103,107,58,2,3,1,35,12,133
28,6,1425,213,1212,16,1196,7,219,335,97,14,11,3,120,26,364
28,7,2055,458,1597,24,1573,25,366,529,116,18,6,5,147,28,333
28,8,132,23,109,0,109,0,30,40,4,0,0,0,11,7,17
28,9,56,5,51,1,50,1,10,20,3,1,0,1,5,0,9
28,10,281,45,236,7,229,2,55,78,16,6,2,0,17,4,49
28,12,1353,246,1107,19,1088,12,279,338,60,11,6,3,118,28,233
28,13,1023,195,828,8,820,11,198,200,83,12,7,4,84,29,192
28,14,442,73,369,7,362,3,88,104,29,5,1,0,23,9,100
28,15,2467,491,1976,27,1949,18,439,527,200,35,14,4,131,46,535
28,16,122,22,100,0,100,0,31,31,13,1,2,0,6,1,15
28,17,197,26,171,3,168,4,47,66,9,0,1,0,17,5,19
28,18,929,167,762,21,741,10,168,294,53,10,9,0,53,21,123
28,19,144,25,119,2,117,1,32,52,7,5,0,0,5,0,15
28,20,109,16,93,0,93,2,27,27,9,0,0,0,3,3,22
28,21,1121,187,934,28,906,18,219,260,74,13,11,2,67,17,225
28,22,906,155,751,11,740,13,187,242,61,4,4,3,68,12,146
28,23,977,156,821,19,802,11,166,249,63,8,5,4,101,24,171
28,24,1214,174,1040,16,1024,17,180,287,89,11,7,2,126,19,286
28,25,80,21,59,2,57,1,14,19,3,0,1,0,5,2,12
28,26,188,24,164,5,159,0,61,52,10,0,1,0,10,7,18
28,27,1006,156,850,19,831,5,223,329,53,5,7,6,70,15,118
28,28,177,29,148,2,146,1,22,69,7,2,1,1,10,4,29
28,29,246,24,222,3,219,3,68,73,11,3,5,0,14,4,38
28,30,241,41,200,3,197,5,63,49,8,4,2,1,15,6,44
28,31,348,62,286,1,285,4,66,119,11,4,2,0,19,9,51
28,32,223,22,201,2,199,3,47,62,21,2,1,1,19,2,41
28,33,558,85,473,10,463,4,124,127,33,3,3,1,36,18,114
28,34,571,89,482,6,476,8,103,138,47,1,3,2,50,11,113
28,35,710,85,625,12,613,12,110,185,61,10,8,4,53,22,148
28,36,600,68,532,9,523,14,89,208,38,11,1,2,54,18,88
28,37,270,42,228,7,221,6,62,48,15,4,4,2,19,5,56
28,38,119,6,113,1,112,3,22,31,5,2,2,0,14,1,32
28,39,1073,170,903,10,893,15,234,230,74,19,9,8,88,21,195
28,40,215,35,180,1,179,1,30,46,22,4,4,0,14,6,52
28,41,150,11,139,2,137,0,28,28,16,3,0,0,19,2,41
28,44,90,17,73,5,68,2,18,23,3,3,1,1,4,4,9
28,45,194,23,171,2,169,2,45,53,16,2,1,0,10,5,35
28,46,407,56,351,4,347,5,65,146,27,4,0,0,18,16,66
28,47,504,86,418,9,409,6,109,109,17,9,7,1,44,7,100
28,48,433,63,370,10,360,8,88,110,27,6,4,0,32,7,78
28,49,178,23,155,7,148,1,34,48,14,5,1,0,15,5,25
28,50,219,23,196,4,192,11,30,66,19,5,0,1,22,3,35
28,51,3141,481,2660,58,2602,39,540,713,217,24,22,3,233,49,762
28,52,589,76,513,6,507,10,112,147,46,7,4,4,47,13,117
28,53,178,23,155,6,149,2,46,55,7,0,0,0,13,5,21
28,54,305,55,250,7,243,5,55,84,19,5,1,1,25,8,40
28,55,369,47,322,10,312,7,68,95,29,3,0,3,26,6,75
28,56,1299,227,1072,26,1046,22,177,402,96,14,4,4,105,21,201
28,57,395,70,325,7,318,5,86,93,35,9,1,1,22,6,60
28,58,278,34,244,2,242,7,46,89,19,1,4,0,19,8,49
28,59,1040,199,841,12,829,14,259,252,58,8,7,0,51,14,166
28,60,121,15,106,2,104,2,28,18,14,1,1,0,7,2,31
28,61,2597,548,2049,45,2004,14,442,663,131,33,21,9,194,51,446
28,62,654,115,539,12,527,18,111,163,54,11,6,2,51,16,95
28,63,397,57,340,10,330,6,60,90,26,9,4,3,28,18,86
28,64,1395,210,1185,23,1162,13,275,391,93,7,8,1,103,20,251
28,65,106,15,91,1,90,0,18,27,2,0,1,0,18,3,21
28,66,170,17,153,6,147,3,43,37,18,4,0,1,13,2,26
28,67,69,11,58,0,58,0,20,22,4,1,0,0,0,0,11
28,68,305,35,270,3,267,3,68,51,24,10,4,1,21,8,77
28,69,183,28,155,3,152,4,41,43,8,1,0,0,15,3,37
28,70,2688,391,2297,50,2247,42,351,596,204,23,12,5,249,40,725
28,71,409,66,343,4,339,6,116,98,26,8,0,2,9,4,70
28,72,354,46,308,9,299,5,72,91,18,2,0,1,39,6,65
28,73,255,52,203,3,200,1,56,72,17,0,1,0,18,1,34
28,74,191,25,166,4,162,4,25,50,26,3,0,1,19,5,29
28,75,782,116,666,13,653,4,157,182,47,15,8,4,57,13,166
28,76,125,12,113,0,113,1,28,44,3,1,0,0,16,4,16
28,77,147,19,128,4,124,0,32,54,6,1,0,0,8,6,17
28,78,158,17,141,5,136,6,42,46,5,3,0,0,13,6,15
28,79,276,47,229,4,225,4,54,82,19,2,1,1,24,3,35
28,80,220,38,182,4,178,1,42,68,16,6,1,0,22,6,16
28,81,213,31,182,6,176,1,52,53,19,5,2,0,9,3,32
28,82,375,46,329,5,324,5,83,109,28,3,0,3,33,11,49
28,83,100,14,86,0,86,0,27,27,8,0,3,0,6,1,14
28,84,539,68,471,22,449,14,93,126,50,6,2,1,45,7,105
28,85,25064,6103,18961,287,18674,503,2545,5512,2018,209,87,44,1870,318,5568
28,86,252,44,208,4,204,1,46,70,15,7,3,0,17,2,43
28,87,204,30,174,2,172,1,45,71,6,0,2,0,15,1,31
28,88,8251,1828,6423,139,6284,100,1191,1753,581,76,51,16,571,135,1810
28,89,1625,286,1339,20,1319,21,324,411,66,19,7,4,111,23,333
28,90,90,16,74,0,74,0,12,32,8,1,0,0,5,2,14
28,91,112,13,99,5,94,0,25,27,4,0,0,1,11,1,25
28,92,160,27,133,1,132,0,36,52,17,1,1,0,7,2,16
28,93,586,113,473,9,464,8,126,130,35,6,5,4,48,7,95
28,94,1083,145,938,20,918,11,220,265,64,9,6,2,75,24,242
28,95,207,22,185,3,182,1,44,56,13,5,1,0,18,3,41
28,96,768,184,584,5,579,9,181,162,34,7,2,2,56,12,114
28,98,1312,225,1087,30,1057,16,253,313,99,14,3,1,89,38,231
28,99,762,147,615,14,601,7,160,148,55,4,3,2,50,12,160
28,100,300,45,255,7,248,4,61,90,12,2,1,0,26,2,50
28,101,263,50,213,3,210,1,46,47,22,1,2,1,23,7,60
28,102,518,103,415,9,406,11,114,104,47,8,0,1,36,14,71
28,103,2149,380,1769,20,1749,28,392,574,105,22,15,5,203,55,350
28,104,648,109,539,14,525,9,103,162,46,4,1,2,71,13,114
28,105,365,49,316,7,309,1,78,77,37,3,1,0,28,4,80
28,106,324,47,277,7,270,5,69,74,25,2,0,0,33,14,48
28,107,339,54,285,5,280,2,63,79,18,3,0,3,28,10,74
28,108,148,21,127,1,126,2,24,37,11,3,2,0,19,0,28
28,109,225,44,181,3,178,4,48,55,11,2,0,1,12,6,39
28,110,2949,544,2405,57,2348,36,408,692,215,18,17,9,272,66,615
28,111,284,55,229,1,228,2,55,83,13,4,1,3,22,3,42
28,112,291,45,246,3,243,2,70,81,16,3,2,0,8,4,57
28,113,1100,242,858,19,839,14,155,265,93,10,1,1,86,26,188
28,114,112,8,104,0,104,0,15,45,9,1,1,0,16,0,17
28,115,376,63,313,10,303,1,89,71,39,6,1,1,24,6,65
28,116,1760,305,1455,24,1431,19,291,442,125,21,10,3,112,44,364
28,117,209,24,185,1,184,5,28,68,16,0,0,0,17,3,47
28,118,368,71,297,3,294,2,77,103,24,4,0,0,23,1,60
28,119,152,19,133,3,130,2,26,38,13,3,1,1,10,1,35
28,120,464,86,378,3,375,9,111,131,17,5,1,0,33,4,64
28,121,71,9,62,2,60,1,15,18,9,0,0,0,10,1,6
28,122,1199,196,1003,17,986,13,186,305,92,19,6,3,103,14,245
28,123,409,62,347,9,338,2,83,124,29,5,3,1,29,5,57
28,124,551,95,456,2,454,2,109,162,36,9,3,3,33,9,88
28,126,167,17,150,3,147,2,36,55,9,2,3,0,8,4,28
28,127,721,144,577,13,564,8,165,199,23,6,5,1,40,14,103
28,128,305,32,273,5,268,6,50,65,19,5,3,1,40,3,76
28,129,538,93,445,3,442,3,106,95,57,9,2,2,32,11,125
28,130,731,109,622,8,614,10,166,205,40,13,3,0,47,12,118
28,132,486,62,424,10,414,2,120,72,37,2,3,0,36,11,131
28,133,389,32,357,8,349,3,86,86,26,4,4,1,34,6,99
28,134,16696,5002,11694,171,11523,178,1692,2505,1377,136,73,28,810,182,4542
28,135,900,120,780,10,770,27,100,247,65,9,3,2,95,11,211
28,136,148,28,120,0,120,4,18,37,9,4,0,0,7,2,39
28,137,578,96,482,5,477,8,124,125,39,12,2,3,41,10,113
28,139,131,14,117,0,117,3,25,27,15,3,3,0,17,2,22
28,140,3634,794,2840,67,2773,59,510,684,302,37,10,7,288,66,810
28,141,209,32,177,5,172,5,30,48,19,5,0,1,16,2,46
28,142,129,13,116,2,114,3,30,22,11,1,1,3,5,5,33
28,143,187,25,162,1,161,3,49,49,12,0,5,0,20,5,18
28,144,163,22,141,0,141,9,36,42,10,3,2,1,12,4,22
28,145,246,30,216,6,210,4,70,73,20,0,0,0,13,4,26
28,146,647,125,522,10,512,16,80,189,43,6,5,1,61,6,105
28,147,420,83,337,8,329,4,79,117,22,3,2,0,23,11,68
28,148,266,49,217,3,214,1,42,88,11,3,1,0,19,5,44
28,149,578,111,467,12,455,5,111,149,36,5,5,4,48,10,82
28,150,301,58,243,5,238,1,33,88,18,4,1,0,40,7,46
28,151,113,20,93,1,92,2,16,42,5,1,0,0,6,6,14
28,153,178,21,157,11,146,4,30,32,11,4,4,0,14,4,43
28,154,1042,145,897,16,881,9,175,297,66,12,5,5,79,16,217
28,155,185,33,152,1,151,2,39,49,16,1,0,0,14,2,28
28,156,723,107,616,13,603,3,143,186,57,4,4,0,42,10,154
28,157,140,11,129,3,126,1,18,51,9,1,2,0,17,0,27
28,158,707,98,609,13,596,16,111,196,42,5,6,2,85,14,119
28,159,301,60,241,4,237,4,72,61,19,4,1,0,19,3,54
28,160,545,82,463,11,452,3,120,120,38,7,2,0,39,7,116
28,161,428,52,376,10,366,12,83,135,29,4,5,1,27,12,58
28,162,264,42,222,6,216,0,48,65,10,4,0,0,24,13,52
28,163,167,30,137,3,134,1,32,53,7,1,1,0,18,4,17
28,164,514,98,416,3,413,4,114,126,33,1,0,2,26,2,105
28,165,410,85,325,8,317,7,92,83,30,4,1,0,37,5,58
28,166,189,28,161,3,158,2,50,33,17,2,0,2,10,5,37
28,167,271,46,225,2,223,1,60,80,10,6,1,1,23,6,35
28,168,2398,536,1862,30,1832,27,361,505,197,26,9,7,180,33,487
28,169,169,23,146,3,143,4,23,58,11,2,2,0,16,2,25
28,170,218,42,176,8,168,7,31,37,14,1,2,0,26,1,49
28,171,676,81,595,12,583,6,116,176,32,3,5,5,63,12,165
28,172,563,82,481,9,472,3,114,134,30,10,7,1,42,16,115
28,173,918,127,791,10,781,13,144,248,61,10,2,2,80,18,203
28,175,141,24,117,5,112,3,16,26,13,0,0,0,15,6,33
28,176,453,61,392,5,387,3,83,118,39,7,4,2,25,9,97
28,177,412,76,336,6,330,3,79,135,18,4,1,0,24,6,60
28,178,227,39,188,8,180,5,51,57,9,2,0,3,22,4,27
28,179,193,31,162,0,162,1,23,80,9,3,0,1,11,3,31
28,180,386,50,336,8,328,9,85,83,31,4,9,4,33,11,59
28,182,228,28,200,5,195,2,67,53,21,2,2,0,16,6,26
28,183,376,45,331,3,328,10,80,109,31,8,2,0,27,7,54
28,184,221,26,195,4,191,0,43,52,15,1,4,3,16,4,53
28,185,658,117,541,10,531,4,134,155,56,6,4,3,40,13,116
28,187,482,75,407,4,403,13,103,113,45,4,1,1,36,7,80
28,188,614,118,496,8,488,1,137,135,49,5,4,0,37,13,107
28,189,148,24,124,0,124,2,29,40,9,0,1,0,14,5,24
28,190,337,56,281,1,280,0,74,90,16,6,0,0,22,9,63
28,191,1923,270,1653,28,1625,34,305,438,166,22,7,6,183,47,417
28,192,218,20,198,2,196,3,60,58,18,3,2,0,16,4,32
28,193,101,16,85,0,85,2,18,32,7,0,0,0,5,3,18
28,194,370,72,298,5,293,8,44,103,32,4,4,0,36,4,58
28,195,565,88,477,4,473,12,92,112,47,7,2,4,56,14,127
28,196,2432,572,1860,25,1835,15,417,487,187,30,15,3,165,45,471
28,197,100,12,88,1,87,0,20,33,3,0,0,0,5,6,20
28,198,603,81,522,10,512,4,98,144,43,5,5,2,48,13,150
28,199,1125,213,912,21,891,9,216,310,56,15,2,3,87,20,173
28,200,246,46,200,0,200,2,50,74,16,2,2,0,12,6,36
28,201,1453,233,1220,16,1204,23,205,376,110,18,4,4,130,33,301
28,202,289,51,238,5,233,7,55,88,13,1,4,1,22,9,33
28,203,466,91,375,8,367,5,73,109,31,7,3,1,33,5,100
28,204,255,33,222,7,215,3,52,62,12,5,3,0,22,6,50
28,205,427,69,358,9,349,5,90,134,22,5,2,0,20,8,63
28,206,490,78,412,10,402,10,98,124,37,10,9,1,32,4,77
28,207,142,23,119,2,117,2,29,35,10,3,0,0,11,4,23
28,208,304,46,258,4,254,6,52,91,19,4,3,0,22,12,45
28,209,3738,666,3072,54,3018,50,545,810,268,40,10,9,313,61,912
28,210,169,27,142,1,141,6,27,56,7,3,1,1,12,2,26
28,211,438,57,381,5,376,4,71,129,38,7,0,2,44,6,75
28,212,159,15,144,0,144,0,34,65,6,0,1,0,9,3,26
28,213,392,65,327,8,319,5,57,129,19,4,0,2,25,13,65
28,214,2172,482,1690,22,1668,18,349,514,130,27,17,4,135,28,446
28,215,226,27,199,3,196,2,54,48,23,0,1,0,21,3,44
28,216,152,19,133,1,132,5,29,44,8,1,0,0,10,4,31
28,217,141,31,110,0,110,0,29,46,7,0,4,0,8,2,14
28,218,10611,2839,7772,161,7611,84,1600,1701,787,92,46,15,655,155,2476
28,219,311,58,253,3,250,1,63,105,9,3,3,0,27,8,31
28,220,5090,875,4215,81,4134,73,592,1362,361,39,24,13,473,85,1112
28,221,152,28,124,0,124,0,36,52,10,2,1,0,4,5,14
28,222,292,34,258,7,251,3,63,60,28,3,3,0,23,4,64
28,223,1052,146,906,16,890,12,163,225,117,8,6,0,63,18,278
28,224,320,44,276,6,270,7,62,67,23,7,2,0,30,8,64
28,225,491,95,396,8,388,5,93,108,37,5,0,1,29,10,100
28,226,734,123,611,12,599,16,135,188,49,5,2,2,53,23,126
28,227,3340,738,2602,47,2555,47,461,684,271,22,16,13,250,41,750
28,229,6749,1735,5014,84,4930,86,852,1160,442,44,25,10,447,95,1769
28,230,235,35,200,3,197,2,45,43,12,3,2,2,23,13,52
28,231,130,26,104,2,102,6,30,32,5,0,1,0,8,1,19
28,232,434,72,362,2,360,4,87,126,34,0,3,0,30,9,67
28,233,858,119,739,14,725,8,182,185,48,17,8,2,59,20,196
28,234,357,60,297,4,293,9,76,87,31,1,4,2,23,6,54
28,235,223,35,188,2,186,4,32,72,15,2,1,0,24,5,31
28,236,1054,172,882,29,853,6,142,318,74,11,8,2,76,22,194
28,237,210,24,186,4,182,6,26,76,15,1,2,0,17,2,37
28,239,683,122,561,8,553,6,149,170,48,4,1,0,59,7,109
28,240,396,50,346,6,340,1,102,95,25,4,0,1,27,8,77
28,241,203,36,167,1,166,3,33,65,8,1,2,2,9,10,33
28,242,76,11,65,3,62,0,13,25,6,0,2,0,2,1,13
28,243,164,21,143,5,138,3,44,35,11,4,2,0,12,4,23
28,245,258,23,235,3,232,4,46,79,22,1,0,0,24,5,51
28,246,349,57,292,6,286,5,61,99,19,9,3,2,36,8,44
28,247,396,57,339,4,335,4,98,104,23,4,0,0,23,7,72
28,248,257,44,213,3,210,5,57,68,12,1,0,0,17,10,40
28,249,471,49,422,7,415,12,77,105,41,5,2,2,42,8,121
28,250,103,19,84,0,84,0,20,25,7,2,0,1,8,2,19
28,251,785,140,645,14,631,11,123,204,62,11,3,1,72,22,122
28,252,186,34,152,3,149,3,40,42,14,2,3,1,16,1,27
28,253,652,85,567,9,558,8,111,170,34,5,1,1,67,17,144
28,254,364,75,289,3,286,9,69,70,19,5,5,0,26,7,76
28,255,100,22,78,1,77,1,23,22,7,1,1,0,7,1,14
28,256,392,61,331,6,325,3,67,80,23,9,4,0,25,8,106
28,257,65,9,56,0,56,2,8,31,4,2,0,0,1,1,7
28,258,284,45,239,5,234,3,49,72,16,2,0,1,24,7,60
28,259,233,31,202,1,201,2,43,81,22,3,1,1,11,2,35
28,260,82,1,81,0,81,0,17,21,5,1,3,0,5,0,29
28,261,460,87,373,8,365,1,111,110,24,1,0,1,30,4,83
28,262,412,68,344,7,337,4,96,86,41,2,2,3,30,12,61
28,263,206,36,170,3,167,2,50,46,7,2,0,0,21,7,32
28,264,122,28,94,3,91,1,21,26,6,0,0,0,11,4,22
28,265,213,34,179,4,175,0,38,61,16,1,2,0,8,1,48
28,267,383,59,324,6,318,4,66,111,27,1,1,0,34,7,67
28,268,28,4,24,0,24,0,3,7,5,0,0,0,1,0,8
28,269,1393,267,1126,27,1099,20,207,380,77,13,5,4,121,25,247
28,270,167,21,146,2,144,4,26,48,18,3,3,0,11,3,28
28,271,114,14,100,0,100,0,19,40,6,0,1,0,19,4,11
28,272,130,10,120,3,117,1,18,41,10,0,0,0,12,3,32
28,273,134,25,109,2,107,2,16,53,4,0,1,0,9,4,18
28,274,181,28,153,3,150,1,43,45,10,1,0,4,19,3,24
28,275,524,93,431,3,428,13,61,142,63,2,3,1,40,7,96
28,276,130,15,115,0,115,3,23,39,9,0,1,1,10,5,24
28,277,280,43,237,3,234,1,44,91,16,1,0,0,27,10,44
28,278,965,143,822,17,805,6,148,269,68,8,4,1,86,22,193
28,279,2570,541,2029,31,1998,31,399,591,186,18,13,0,202,29,529
28,280,7063,1259,5804,125,5679,67,1020,1800,471,56,39,10,495,130,1591
28,281,382,71,311,4,307,3,62,101,26,2,1,1,39,7,65
28,282,328,29,299,0,299,4,76,85,32,1,0,1,29,6,65
28,283,232,31,201,6,195,2,45,64,16,0,4,0,9,7,48
28,284,227,31,196,1,195,3,43,71,21,2,1,1,23,3,27
28,285,258,39,219,2,217,0,44,94,23,0,0,1,11,3,41
28,286,409,55,354,7,347,4,87,96,41,6,1,1,34,9,68
28,287,686,106,580,17,563,6,143,210,43,6,4,0,37,8,106
28,288,32,6,26,0,26,0,7,16,0,0,0,0,2,0,1
28,289,180,19,161,6,155,4,36,49,22,1,0,0,8,2,33
28,290,188,22,166,0,166,3,40,46,8,0,2,0,20,7,40
28,291,420,77,343,8,335,2,70,91,36,7,2,0,25,8,94
28,292,593,93,500,6,494,13,108,158,41,9,0,0,54,17,94
28,293,782,131,651,12,639,16,189,156,62,5,6,4,54,14,133
28,294,338,54,284,6,278,5,82,82,24,2,3,1,13,7,59
28,295,287,48,239,4,235,1,58,63,18,3,6,0,25,10,51
28,296,231,19,212,9,203,8,43,63,21,1,2,0,14,4,47
28,297,181,37,144,3,141,0,30,44,19,1,1,0,12,5,29
28,298,2023,351,1672,28,1644,23,297,447,167,19,14,2,178,46,451
28,299,117,15,102,1,101,3,26,22,9,1,1,0,12,4,23
28,300,99,18,81,0,81,1,17,34,6,1,0,1,8,1,12
28,301,282,32,250,4,246,3,57,68,26,1,2,1,20,9,59
28,302,724,130,594,11,583,10,165,135,63,10,4,5,51,12,128
28,303,89,15,74,2,72,0,19,25,0,0,0,1,8,3,16
28,304,288,40,248,6,242,3,71,68,17,4,1,0,18,4,56
28,305,242,26,216,8,208,3,32,69,24,3,1,2,15,6,53
28,306,129,10,119,1,118,4,31,45,9,1,4,0,8,0,16
28,308,166,23,143,6,137,2,34,39,7,0,2,0,24,0,29
28,309,779,137,642,15,627,12,126,183,51,12,3,2,63,19,156
28,310,235,32,203,2,201,6,40,73,12,1,0,1,21,5,42
28,311,283,56,227,7,220,2,45,82,12,5,3,0,29,6,36
28,312,88,12,76,0,76,1,31,27,3,1,0,0,2,3,8
28,313,112,10,102,3,99,0,22,29,6,1,0,1,18,4,18
28,314,135,19,116,1,115,0,22,49,8,4,1,0,16,4,11
28,315,37,3,34,0,34,1,4,20,1,0,0,0,2,0,6
28,316,134,18,116,1,115,4,34,46,4,1,2,0,10,1,13
28,317,308,43,265,3,262,5,63,71,16,7,2,1,25,9,63
28,318,305,45,260,6,254,4,63,58,23,6,4,1,30,10,55
28,319,313,39,274,4,270,5,75,80,22,4,1,0,18,4,61
28,320,165,29,136,1,135,5,31,41,7,6,3,0,10,5,27
28,321,641,93,548,6,542,17,124,142,59,4,1,0,55,11,129
28,322,362,50,312,1,311,7,58,107,23,6,6,0,26,13,65
28,323,238,43,195,4,191,5,47,67,14,0,1,0,22,2,33
28,324,657,106,551,16,535,8,119,153,74,6,2,2,47,9,115
28,325,699,93,606,8,598,11,122,158,54,12,5,1,53,14,168
28,326,253,24,229,2,227,4,56,77,17,2,3,0,24,3,41
28,327,157,22,135,1,134,1,33,46,12,1,0,0,20,4,17
28,329,142,12,130,2,128,1,37,40,6,0,1,0,13,7,23
28,330,176,33,143,3,140,1,34,41,12,3,0,1,18,5,25
28,331,463,79,384,3,381,8,84,134,35,5,4,1,37,8,65
28,332,684,103,581,12,569,6,104,188,58,4,3,1,46,15,144
28,333,109,16,93,1,92,0,23,27,2,0,0,1,12,7,20
28,334,1406,204,1202,26,1176,14,236,368,79,10,8,5,117,25,314
28,335,711,106,605,17,588,13,134,174,49,7,9,1,64,16,121
28,336,91,11,80,0,80,0,29,15,10,2,0,0,5,5,14
28,337,1837,244,1593,33,1560,30,335,398,145,28,8,3,146,47,420
28,339,247,46,201,5,196,0,47,52,17,3,2,0,19,1,55
28,340,469,66,403,6,397,5,104,111,34,4,3,1,36,15,84
28,341,185,26,159,2,157,4,51,32,11,2,1,0,18,8,30
28,342,257,30,227,2,225,3,58,75,8,3,1,0,26,7,44
28,343,366,63,303,0,303,7,56,92,21,2,2,2,35,9,77
28,344,204,29,175,2,173,7,33,47,16,1,4,1,15,4,45
28,346,61,7,54,1,53,0,10,20,6,1,0,0,3,0,13
28,347,612,84,528,5,523,12,97,171,46,6,3,1,48,22,117
28,348,2732,574,2158,36,2122,29,545,483,213,31,22,10,167,54,568
28,349,224,23,201,3,198,8,39,72,20,0,1,0,25,4,29
28,350,706,95,611,14,597,7,124,174,57,14,3,0,48,15,155
28,351,344,52,292,5,287,2,59,123,10,3,0,0,19,9,62
28,352,1077,167,910,15,895,23,144,289,61,10,8,1,113,35,211
28,353,322,50,272,5,267,6,39,73,21,1,1,2,39,4,81
28,354,251,40,211,2,209,2,57,68,17,4,2,2,15,5,37
28,355,263,37,226,3,223,8,26,105,11,0,1,2,17,5,48
28,356,277,46,231,6,225,1,72,44,25,6,1,0,9,9,58
28,357,877,119,758,12,746,19,137,214,78,6,2,4,85,23,178
28,358,1706,272,1434,18,1416,25,209,436,142,18,9,4,168,26,379
28,359,2404,553,1851,31,1820,20,472,443,184,28,18,3,125,37,490
28,360,734,131,603,13,590,12,154,159,44,6,5,0,48,23,139
28,361,956,199,757,9,748,9,124,224,86,13,2,2,74,17,197
28,362,398,65,333,6,327,6,82,124,23,2,1,1,39,6,43
28,363,710,117,593,8,585,6,125,174,57,9,7,4,49,17,137
28,364,588,99,489,25,464,3,122,139,34,8,4,0,47,11,96
28,365,272,33,239,7,232,7,68,81,11,2,1,0,17,6,39
28,366,190,34,156,5,151,1,38,26,17,0,1,0,19,3,46
28,367,271,58,213,5,208,1,55,81,11,1,2,0,17,11,29
28,368,151,27,124,4,120,2,22,52,7,6,0,1,8,1,21
28,369,435,85,350,7,343,5,92,105,32,3,1,0,31,5,69
28,370,329,44,285,5,280,1,74,107,23,2,1,2,21,7,42
28,371,799,152,647,14,633,6,178,177,57,6,5,1,46,10,147
28,372,461,64,397,2,395,7,76,138,27,5,2,0,42,6,92
28,373,2350,462,1888,33,1855,19,479,565,152,19,21,3,155,33,409
28,374,344,63,281,5,276,7,88,77,10,2,2,0,28,7,55
28,375,226,29,197,1,196,5,73,47,11,3,2,1,17,2,35
28,376,275,63,212,8,204,2,36,79,10,4,1,2,18,5,47
28,377,1274,177,1097,15,1082,16,273,361,122,12,5,4,85,27,177
28,378,420,59,361,5,356,2,75,146,14,7,8,3,33,11,57
28,379,342,37,305,6,299,3,64,83,36,4,4,1,25,10,69
28,380,1324,231,1093,21,1072,13,201,341,87,18,5,3,102,21,281
28,382,660,80,580,12,568,4,148,199,39,4,2,1,61,18,92
28,383,348,55,293,3,290,6,71,86,37,3,2,3,16,6,60
28,385,295,34,261,3,258,7,74,65,22,6,0,1,9,8,66
28,386,718,94,624,15,609,14,152,201,53,4,4,1,68,4,108
28,387,772,141,631,12,619,3,164,206,36,10,5,0,50,6,139
28,388,779,89,690,18,672,9,112,219,51,7,6,1,97,10,160
28,389,315,50,265,9,256,1,58,91,20,4,4,0,24,3,51
28,390,256,39,217,1,216,3,38,86,18,1,1,1,21,8,39
28,391,1901,367,1534,36,1498,10,399,470,80,23,18,3,113,34,348
28,392,145,17,128,3,125,2,32,43,9,3,3,0,9,1,23
28,393,1548,260,1288,30,1258,21,322,398,116,16,10,3,115,25,232
28,394,1000,172,828,25,803,10,196,230,76,7,5,1,61,21,196
28,395,388,49,339,6,333,3,74,96,42,3,1,0,40,7,67
28,396,246,36,210,2,208,2,43,57,20,3,0,0,16,8,59
28,397,288,55,233,4,229,7,49,80,24,3,1,0,23,0,42
28,398,914,159,755,17,738,6,202,279,37,4,6,0,70,22,112
28,400,155,12,143,1,142,0,32,52,11,0,0,0,11,8,28
28,401,337,63,274,4,270,1,83,92,16,5,5,0,12,8,48
28,402,228,34,194,4,190,3,35,70,19,4,0,0,21,3,35
28,403,669,78,591,10,581,11,93,236,31,1,2,2,61,20,124
28,404,7005,1706,5299,107,5192,66,925,1062,635,49,32,7,329,98,1989
28,405,845,129,716,13,703,17,147,238,52,11,7,0,80,19,132
28,406,279,38,241,0,241,6,39,79,14,4,2,1,24,13,59
28,407,250,34,216,3,213,6,45,65,15,6,0,0,29,4,43
28,408,70,14,56,1,55,0,12,18,5,2,0,0,8,2,8
28,409,317,54,263,4,259,4,70,81,18,3,3,1,24,8,47
28,410,212,26,186,3,183,2,45,50,11,1,2,0,25,4,43
28,411,112,22,90,1,89,2,33,22,4,1,1,0,3,1,22
28,412,119,11,108,2,106,0,24,34,7,1,2,0,15,5,18
28,414,68,15,53,2,51,1,18,10,3,1,1,0,1,0,16
28,415,1115,197,918,17,901,18,211,289,68,17,7,1,80,20,190
28,416,94,12,82,2,80,0,16,29,7,0,1,0,10,3,14
28,417,1042,171,871,7,864,19,140,289,88,4,7,3,82,23,209
28,418,152,22,130,5,125,0,28,34,16,0,0,2,15,0,30
28,419,223,30,193,3,190,4,46,46,23,1,2,2,24,9,33
28,421,206,37,169,2,167,5,42,55,12,0,4,0,17,5,27
28,422,2009,326,1683,35,1648,17,397,463,139,22,18,3,125,38,426
28,423,449,51,398,6,392,9,73,129,37,2,1,1,33,12,95
28,424,1446,259,1187,37,1150,10,288,389,58,10,7,2,120,18,248
28,425,494,105,389,11,378,7,109,110,25,3,4,1,32,6,81
28,426,357,33,324,5,319,4,80,117,11,1,3,0,24,7,72
29,1,741,123,618,13,605,16,96,148,67,18,3,4,62,14,177
29,2,981,100,881,14,867,58,113,208,89,7,3,3,93,18,275
29,3,1781,356,1425,21,1404,38,145,389,158,16,7,4,136,34,477
29,4,4188,614,3574,73,3501,115,516,617,431,68,36,10,350,62,1296
29,5,930,123,807,14,793,20,109,193,94,9,8,3,76,12,269
29,6,2981,426,2555,28,2527,42,300,1031,145,20,9,6,315,63,596
29,7,744,114,630,5,625,25,67,63,161,11,5,0,58,10,225
29,8,863,106,757,13,744,15,116,234,75,13,8,0,102,14,167
29,10,999,120,879,9,870,10,102,265,62,10,6,2,158,24,231
29,11,2632,325,2307,34,2273,66,214,599,205,25,4,6,301,29,824
29,12,175,22,153,1,152,1,14,13,39,0,2,0,7,2,74
29,13,196,31,165,8,157,14,16,14,22,5,1,1,10,2,72
29,14,379,48,331,5,326,4,52,39,51,5,8,2,27,4,134
29,15,2418,304,2114,36,2078,43,264,493,218,26,19,9,302,39,665
29,16,824,141,683,11,672,40,81,149,92,10,1,2,66,15,216
29,17,645,69,576,6,570,13,82,157,68,6,1,1,88,13,141
29,18,364,75,289,6,283,10,51,35,52,10,4,0,22,5,94
29,19,86079,18857,67222,1323,65899,2081,7656,14415,8249,847,328,178,6527,965,24653
29,20,3821,543,3278,60,3218,99,395,727,325,71,36,7,466,57,1035
29,21,761,130,631,4,627,24,60,217,57,8,2,2,70,5,182
29,22,2369,442,1927,36,1891,38,339,511,217,36,7,9,191,58,485
29,23,2994,434,2560,20,2540,70,193,1007,179,15,3,9,313,42,709
29,24,5755,1008,4747,90,4657,142,539,933,627,96,36,13,384,65,1822
29,25,1246,177,1069,17,1052,21,168,246,119,23,7,2,140,26,300
29,26,3711,570,3141,55,3086,83,419,776,349,60,26,9,326,69,969
29,27,2775,459,2316,36,2280,37,342,582,241,42,15,8,274,43,696
29,28,897,164,733,11,722,17,102,177,72,15,6,1,71,14,247
29,29,836,106,730,10,720,9,121,147,84,15,3,3,64,11,263
29,30,3072,481,2591,54,2537,54,343,837,201,37,13,5,295,47,705
29,31,3837,617,3220,51,3169,145,429,909,352,50,11,3,305,47,918
29,32,1617,216,1401,25,1376,34,179,467,114,17,5,7,164,26,363
29,33,432,60,372,9,363,11,52,85,44,6,3,1,39,6,116
29,34,472,68,404,3,401,14,41,54,77,10,3,1,41,3,157
29,35,670,64,606,9,597,11,84,146,49,11,3,1,88,15,189
29,36,448,101,347,2,345,8,44,77,48,5,5,0,45,5,108
29,37,3191,459,2732,34,2698,92,206,837,252,38,15,9,306,47,896
29,38,829,142,687,8,679,34,98,142,108,15,5,0,69,7,201
29,39,16530,3485,13045,214,12831,421,1651,3347,1549,170,89,38,1193,192,4181
29,40,2232,338,1894,14,1880,31,222,694,150,20,4,4,236,35,484
29,41,1408,201,1207,18,1189,22,189,262,115,25,9,4,153,28,382
29,42,6797,1157,5640,86,5554,157,795,1707,548,95,36,17,559,116,1524
29,43,1417,193,1224,20,1204,46,94,245,129,19,5,4,136,19,507
29,44,1080,132,948,16,932,23,152,243,107,14,6,2,117,12,256
29,45,1710,156,1554,23,1531,64,162,359,152,19,5,5,220,39,506
29,46,12589,2756,9833,159,9674,418,1020,2376,1469,166,68,20,875,164,3098
29,47,1276,106,1170,24,1146,21,160,282,95,16,6,6,178,24,358
29,48,1579,203,1376,29,1347,25,187,277,158,33,15,2,157,34,459
29,49,2388,335,2053,55,1998,77,286,438,237,21,16,9,224,34,656
29,51,6173,706,5467,99,5368,146,615,1080,594,74,34,14,636,98,2077
29,52,1500,241,1259,12,1247,27,158,345,117,16,7,7,169,20,381
29,53,1350,210,1140,13,1127,36,127,255,136,13,7,2,129,18,404
29,54,512,89,423,1,422,29,48,45,79,11,2,0,41,9,158
29,55,2453,278,2175,32,2143,40,241,613,199,33,9,3,315,36,654
29,56,1397,158,1239,22,1217,50,104,258,145,15,4,7,146,13,475
29,57,2782,381,2401,43,2358,71,256,873,240,19,12,5,284,36,562
29,58,8206,1089,7117,129,6988,252,847,2208,613,83,28,21,832,121,1983
29,59,720,95,625,10,615,13,73,102,88,12,5,2,68,8,244
29,60,2200,279,1921,37,1884,44,244,473,206,22,19,6,230,26,614
29,61,4943,662,4281,73,4208,90,488,1138,403,57,20,5,492,69,1446
29,62,853,132,721,16,705,21,102,157,76,19,1,5,121,11,192
29,63,360,55,305,7,298,12,45,80,17,9,1,0,52,5,77
29,64,378,74,304,5,299,6,31,101,24,5,3,0,39,4,86
29,65,670,70,600,11,589,17,88,109,70,13,10,3,73,19,187
29,66,1324,144,1180,16,1164,36,177,246,142,20,10,2,135,24,372
29,67,1002,136,866,16,850,5,115,205,114,4,11,1,73,7,315
29,68,1710,225,1485,25,1460,25,185,376,123,21,12,7,174,28,509
29,69,6065,851,5214,106,5108,102,645,1253,445,63,21,13,615,74,1877
29,70,398,59,339,4,335,14,35,90,33,10,4,3,39,10,97
29,71,575,71,504,15,489,16,96,97,77,7,1,2,65,7,121
29,72,2483,427,2056,40,2016,42,290,545,265,32,13,4,165,27,633
29,73,788,120,668,4,664,24,76,116,95,3,3,1,63,8,275
29,74,710,97,613,15,598,9,71,129,69,12,3,1,72,14,218
29,75,10010,1232,8778,122,8656,180,869,2260,841,104,39,22,1091,136,3114
29,76,612,80,532,4,528,7,60,132,59,5,1,0,80,12,172
29,77,1653,225,1428,15,1413,37,193,415,135,21,4,2,164,23,419
29,78,1488,179,1309,17,1292,46,179,269,178,21,7,7,131,21,433
29,79,1089,146,943,16,927,23,90,250,90,13,4,2,114,16,325
29,80,1644,194,1450,24,1426,54,185,276,186,25,7,4,178,22,489
29,81,1137,168,969,9,960,29,102,182,173,22,4,3,68,12,365
29,82,568,146,422,11,411,16,43,125,47,13,1,1,35,4,126
29,83,253,84,169,1,168,4,13,68,15,2,1,1,14,3,47
29,84,296,76,220,3,217,0,27,64,29,7,1,0,20,2,67
29,85,694,97,597,4,593,13,58,182,74,2,2,0,47,9,206
29,86,1005,111,894,13,881,39,97,223,105,15,6,7,102,16,271
29,87,563,56,507,12,495,22,57,119,73,5,3,1,69,7,139
29,89,741,100,641,15,626,13,87,145,68,14,6,1,53,14,225
29,90,661,99,562,3,559,10,70,135,79,8,3,1,70,10,173
29,91,1899,297,1602,15,1587,31,265,584,130,19,7,3,167,28,353
29,93,930,99,831,13,818,15,144,236,63,5,5,2,108,22,218
29,94,555,67,488,6,482,4,53,148,38,4,4,0,84,6,141
29,95,919,94,825,13,812,25,105,215,80,8,3,0,113,22,241
29,97,1581,219,1362,13,1349,30,180,273,131,15,8,9,187,32,484
29,98,1702,221,1481,20,1461,58,150,326,159,37,7,3,170,33,518
29,99,596,76,520,6,514,21,84,124,54,4,2,0,68,4,153
29,100,305,29,276,7,269,14,31,78,24,8,1,1,34,5,73
29,101,2825,378,2447,30,2417,86,313,599,300,30,20,4,250,43,772
29,102,763,117,646,5,641,21,95,108,89,7,7,0,65,6,243
29,103,11012,1882,9130,139,8991,248,880,2068,913,129,51,30,1151,128,3393
29,104,332,49,283,5,278,6,37,78,30,1,1,0,34,3,88
29,105,6505,1051,5454,90,5364,102,671,1471,424,79,33,13,747,129,1695
29,106,1213,116,1097,18,1079,36,149,202,83,26,9,8,182,24,360
29,107,694,92,602,6,596,22,87,99,62,10,7,2,64,20,223
29,108,1037,147,890,24,866,21,125,211,80,14,5,6,151,25,228
29,109,1345,182,1163,15,1148,32,110,398,99,12,7,2,150,19,319
29,110,617,69,548,18,530,19,92,100,68,9,6,0,57,7,172
29,111,881,119,762,19,743,13,120,223,74,14,3,1,140,21,134
29,112,825,102,723,7,716,30,80,223,72,6,6,2,89,10,198
29,113,1686,267,1419,32,1387,40,145,253,255,22,16,8,108,18,522
29,114,284,47,237,2,235,3,34,48,38,1,0,0,23,5,83
29,115,254,32,222,6,216,5,27,50,29,2,2,0,37,3,61
29,116,99,10,89,2,87,1,13,20,12,3,1,0,11,2,24
29,117,3877,617,3260,57,3203,88,344,982,299,40,20,10,416,58,946
29,119,1113,151,962,14,948,21,143,237,100,11,3,1,127,19,286
29,120,1435,235,1200,29,1171,27,223,330,107,19,8,2,126,27,302
29,122,541,81,460,10,450,14,67,83,60,7,5,0,54,7,153
29,123,553,70,483,7,476,16,67,125,54,7,8,2,62,2,133
29,124,5247,936,4311,75,4236,102,469,1124,406,54,29,15,483,81,1473
29,125,647,118,529,2,527,10,101,134,72,10,8,7,51,6,128
29,126,158,12,146,2,144,1,21,48,20,2,1,0,8,3,40
29,127,236,24,212,4,208,7,34,54,27,1,4,0,25,4,52
29,128,239,23,216,6,210,3,30,76,5,4,0,0,35,6,51
29,129,202,26,176,1,175,5,18,29,57,2,1,0,15,1,47
29,130,3863,485,3378,46,3332,116,323,860,359,39,16,9,438,73,1099
29,131,364,41,323,5,318,14,23,84,34,5,2,0,42,5,109
29,132,640,77,563,10,553,37,31,137,55,11,1,5,53,14,209
29,133,1386,212,1174,13,1161,32,132,337,164,8,6,3,87,15,377
29,134,666,69,597,7,590,38,62,145,70,13,4,4,81,11,162
29,135,3642,513,3129,72,3057,101,314,858,393,36,21,11,357,51,915
29,136,835,83,752,25,727,18,101,140,114,16,5,1,85,17,230
29,137,1591,149,1442,15,1427,67,132,267,211,22,2,2,146,24,554
29,139,612,86,526,7,519,30,60,104,66,7,5,3,76,17,151
29,140,2728,278,2450,43,2407,95,228,580,288,41,7,8,296,39,825
29,141,317,69,248,4,244,12,41,48,34,2,4,0,28,5,70
29,142,366,36,330,4,326,5,42,82,44,4,1,0,42,12,94
29,143,713,117,596,10,586,25,100,115,81,11,7,0,67,8,172
29,144,541,75,466,6,460,7,45,123,48,13,5,3,53,5,158
29,145,715,87,628,12,616,24,89,117,91,13,7,1,70,11,193
29,146,2697,404,2293,42,2251,64,376,526,244,39,19,4,217,52,710
29,147,2216,280,1936,52,1884,53,244,330,230,45,19,4,150,28,781
29,148,677,106,571,8,563,11,73,148,48,5,1,3,69,13,192
29,149,2346,266,2080,25,2055,48,251,517,174,30,15,3,255,29,733
29,150,5972,1060,4912,90,4822,157,767,1182,613,78,25,15,482,93,1410
29,151,10766,2096,8670,121,8549,317,704,1752,1322,98,34,19,810,110,3383
29,152,533,64,469,9,460,10,84,71,75,11,7,1,28,4,169
29,153,2487,406,2081,31,2050,57,327,638,180,33,13,3,181,40,578
29,155,926,181,745,6,739,27,82,174,104,18,14,4,70,7,239
29,156,1315,158,1157,17,1140,35,117,229,119,20,9,2,151,19,439
29,158,4783,886,3897,77,3820,96,526,960,478,70,27,15,327,82,1239
29,159,639,86,553,10,543,25,79,75,84,6,2,4,68,9,191
29,160,5762,624,5138,82,5056,102,645,1366,443,52,31,12,667,110,1628
29,161,2162,254,1908,31,1877,50,220,465,205,27,9,7,225,50,619
29,162,2549,384,2165,37,2128,52,332,607,190,34,14,6,241,36,616
29,163,2336,316,2020,22,1998,38,224,413,267,11,17,6,175,35,812
29,165,2995,405,2590,50,2540,82,303,539,388,51,9,7,298,54,809
29,166,409,42,367,2,365,13,47,76,38,3,2,3,49,5,129
29,167,1477,195,1282,16,1266,56,143,286,134,12,3,5,161,35,431
29,168,1300,239,1061,17,1044,19,128,241,109,14,2,2,62,22,445
29,169,2356,298,2058,33,2025,75,225,462,232,39,11,6,287,61,627
29,170,3217,397,2820,47,2773,95,277,701,304,43,16,6,370,54,907
29,171,3144,469,2675,51,2624,81,410,601,333,51,20,8,275,52,793
29,172,1881,295,1586,27,1559,36,209,444,179,24,8,7,202,49,401
29,173,1464,130,1334,30,1304,25,173,275,139,31,7,6,194,25,429
29,174,4430,548,3882,64,3818,147,414,797,449,63,27,5,573,107,1236
29,175,1677,264,1413,18,1395,32,221,331,139,21,14,2,169,25,441
29,176,1464,204,1260,18,1242,26,188,315,153,11,9,11,192,28,309
29,177,2780,372,2408,36,2372,55,292,645,263,39,9,9,312,41,707
29,178,4881,637,4244,62,4182,100,622,1215,355,52,32,14,498,82,1212
29,179,2751,314,2437,48,2389,44,283,677,207,34,20,7,354,50,713
29,180,653,83,570,11,559,21,82,128,84,12,2,3,63,12,152
29,181,2022,216,1806,25,1781,58,197,430,169,23,9,2,212,34,647
29,182,829,108,721,7,714,23,61,91,150,7,8,3,88,10,273
29,183,474,56,418,7,411,8,75,67,68,7,6,1,27,4,148
29,184,1988,298,1690,40,1650,35,196,503,172,39,9,4,177,31,484
29,185,2987,543,2444,31,2413,49,273,811,173,40,15,4,247,45,756
29,186,1401,156,1245,9,1236,42,110,251,144,20,7,2,140,15,505
29,187,594,66,528,9,519,9,63,185,43,8,1,0,72,16,122
29,188,2964,417,2547,36,2511,84,203,560,354,28,13,8,232,39,990
29,189,10464,1544,8920,122,8798,337,732,2393,986,115,38,22,1100,134,2941
29,190,3139,449,2690,47,2643,99,247,878,218,21,5,6,354,42,773
29,191,2586,326,2260,23,2237,59,210,351,391,34,14,5,181,29,963
29,192,1336,201,1135,17,1118,18,135,293,102,15,8,7,151,25,364
29,193,883,116,767,13,754,5,115,184,66,11,7,3,117,15,231
29,195,5314,826,4488,75,4413,138,611,1393,373,54,41,9,484,72,1238
29,196,1581,147,1434,24,1410,25,220,398,125,21,5,6,171,33,406
29,197,3645,666,2979,39,2940,76,478,719,280,36,11,5,313,68,954
29,198,1477,186,1291,23,1268,36,163,351,128,13,10,5,184,11,367
29,199,3630,472,3158,51,3107,53,338,594,406,44,15,4,321,50,1282
29,201,1474,204,1270,17,1253,29,156,371,110,15,10,4,193,27,338
29,202,923,138,785,13,772,62,106,99,118,11,6,2,78,7,283
29,203,1016,121,895,19,876,23,131,299,62,5,6,2,105,9,234
29,204,1495,192,1303,23,1280,20,178,342,132,17,5,2,178,27,379
29,205,897,93,804,14,790,16,88,164,112,17,3,2,71,21,296
29,206,1895,299,1596,21,1575,28,196,596,120,25,7,1,221,28,353
29,207,3318,405,2913,49,2864,68,254,535,407,36,12,6,274,31,1241
29,208,860,107,753,13,740,19,124,235,70,9,7,2,91,22,161
29,209,2660,281,2379,45,2334,45,327,649,256,58,15,5,271,59,649
29,210,2131,306,1825,43,1782,38,204,567,134,17,12,10,252,37,511
29,211,544,99,445,9,436,11,57,87,67,7,1,1,40,9,156
29,212,9563,1451,8112,117,7995,214,983,1809,892,107,38,25,888,146,2893
29,213,1228,147,1081,24,1057,19,143,372,85,13,7,1,145,21,251
29,214,647,100,547,4,543,13,52,108,62,8,4,0,88,10,198
29,215,2573,403,2170,36,2134,56,273,391,258,37,9,3,205,37,865
29,216,2830,327,2503,45,2458,83,286,561,269,34,20,10,328,43,824
29,217,2221,351,1870,34,1836,62,294,592,163,28,14,10,180,31,462
29,218,1257,199,1058,16,1042,38,120,231,133,14,3,0,106,13,384
29,219,117,22,95,5,90,2,5,23,11,1,2,0,11,2,33
29,220,6486,1141,5345,103,5242,185,574,1308,669,83,30,24,540,108,1721
29,221,1504,199,1305,21,1284,19,156,376,96,10,8,2,181,21,415
29,222,331,52,279,8,271,8,43,49,29,10,1,1,31,11,88
29,224,969,106,863,20,843,23,125,185,102,17,3,1,114,17,256
29,225,1666,234,1432,28,1404,36,167,312,154,25,10,6,214,27,453
29,226,1245,183,1062,18,1044,29,138,272,110,10,8,4,153,21,299
29,227,1113,149,964,8,956,24,118,207,109,18,13,5,105,14,343
29,228,712,114,598,7,591,12,86,176,58,11,3,2,52,3,188
29,229,911,118,793,5,788,23,100,185,91,28,5,4,98,27,227
29,230,1357,177,1180,23,1157,52,159,243,146,26,10,7,146,26,342
29,232,42936,7113,35823,623,35200,1262,3245,7910,4242,591,188,88,4055,579,13040
29,233,8812,1763,7049,155,6894,206,794,1415,988,127,46,15,716,144,2443
29,234,2132,249,1883,23,1860,40,290,440,229,31,5,7,216,43,559
29,235,8756,1338,7418,99,7319,224,631,1635,927,75,31,19,821,136,2820
29,236,3627,595,3032,61,2971,120,497,657,405,37,28,4,278,55,890
29,237,1386,171,1215,15,1200,34,108,241,127,22,10,2,130,25,501
29,238,769,109,660,10,650,12,85,205,73,9,4,4,71,16,171
29,239,2910,484,2426,32,2394,69,204,919,222,35,6,7,254,42,636
29,240,771,113,658,14,644,19,77,171,80,7,3,2,74,24,187
29,241,5596,863,4733,100,4633,119,618,891,748,76,37,11,421,74,1638
29,243,332,35,297,6,291,5,39,59,32,4,4,0,31,8,109
29,244,549,75,474,10,464,3,58,122,58,12,5,1,60,16,129
29,245,1106,94,1012,15,997,31,83,246,98,12,8,0,145,11,363
29,246,141,7,134,3,131,4,11,23,18,4,2,1,14,0,54
29,247,2810,337,2473,46,2427,48,331,569,272,28,16,7,304,61,791
29,248,523,62,461,4,457,6,68,126,56,13,1,0,58,8,121
29,249,619,118,501,8,493,22,78,118,60,5,2,0,51,7,150
29,250,641,99,542,6,536,24,86,94,64,12,3,2,47,13,191
29,251,510,52,458,5,453,18,38,95,71,8,5,0,34,8,176
29,252,732,93,639,12,627,35,79,109,98,8,3,2,71,10,212
29,254,3633,564,3069,34,3035,69,309,619,379,38,12,3,286,53,1267
29,255,540,57,483,10,473,11,78,121,44,8,6,0,70,10,125
29,256,631,74,557,6,551,10,71,158,55,6,3,1,68,18,161
29,257,1621,218,1403,25,1378,36,185,414,113,23,8,7,141,15,436
29,259,5434,951,4483,85,4398,114,463,1249,439,55,16,13,540,88,1421
29,260,5829,805,5024,75,4949,124,562,1263,513,57,35,9,641,88,1657
29,261,137,23,114,1,113,9,18,16,26,2,0,0,9,2,31
29,262,580,108,472,4,468,7,83,84,57,9,6,2,42,12,166
29,263,744,78,666,9,657,15,94,117,82,11,8,1,82,11,236
29,264,508,62,446,4,442,12,93,106,37,10,3,1,46,5,129
29,265,710,76,634,6,628,20,64,114,80,7,4,1,73,8,257
29,266,1933,259,1674,25,1649,37,173,392,174,24,11,4,204,33,597
29,267,549,86,463,4,459,16,62,86,76,8,4,0,60,12,135
29,268,1015,88,927,12,915,28,106,203,96,14,4,3,112,19,330
29,269,777,104,673,7,666,28,101,132,77,11,8,0,63,17,229
29,270,1134,123,1011,20,991,37,108,196,120,16,5,2,109,24,374
29,271,680,88,592,9,583,7,65,183,72,9,4,1,94,14,134
29,272,2211,330,1881,41,1840,50,250,307,250,48,14,2,209,34,676
29,273,1850,241,1609,27,1582,48,136,498,150,10,8,2,131,24,575
29,274,4217,642,3575,67,3508,103,536,645,524,72,28,13,333,65,1189
29,275,629,119,510,6,504,15,52,92,119,10,2,1,44,5,164
29,276,1007,139,868,13,855,13,105,221,108,16,6,1,95,15,275
29,277,1582,179,1403,24,1379,74,209,318,149,27,4,2,162,22,412
29,278,1516,242,1274,15,1259,34,187,281,162,30,16,3,106,17,423
29,279,2224,277,1947,34,1913,32,207,513,209,20,7,3,233,35,654
29,280,1678,230,1448,23,1425,30,204,389,148,28,11,7,136,24,448
29,281,748,76,672,11,661,18,106,137,69,8,7,0,72,14,230
29,282,281,40,241,6,235,9,38,54,17,6,1,0,32,6,72
29,284,1940,277,1663,26,1637,43,221,386,212,23,9,2,169,28,544
29,285,408,54,354,8,346,6,42,118,35,10,1,0,37,8,89
29,286,205,22,183,5,178,11,23,35,17,1,2,1,23,1,64
29,287,752,80,672,6,666,12,89,247,49,4,4,2,92,4,163
29,288,408,32,376,5,371,11,40,114,35,2,3,0,40,4,122
29,289,158,22,136,3,133,8,12,32,16,4,0,0,16,3,42
29,290,454,48,406,4,402,15,63,91,49,13,3,0,37,9,122
29,291,779,128,651,5,646,10,89,114,93,19,8,1,68,12,232
29,292,277,28,249,4,245,18,24,44,42,5,1,1,20,3,87
29,293,6150,1068,5082,74,5008,145,776,1298,528,69,32,18,496,84,1562
29,294,430,57,373,2,371,9,40,103,49,4,3,2,36,5,120
29,295,353,36,317,6,311,15,34,63,30,4,1,1,37,7,119
29,296,912,84,828,16,812,40,65,146,115,13,5,4,111,17,296
29,297,1760,242,1518,26,1492,34,209,256,208,31,16,3,158,20,557
29,298,429,39,390,11,379,11,40,66,65,5,1,1,56,3,131
29,299,245,21,224,3,221,18,24,57,23,2,1,0,55,2,39
29,300,1166,174,992,33,959,29,127,191,136,26,4,4,100,13,329
29,301,201,17,184,3,181,5,24,54,20,0,2,4,19,5,48
29,302,2675,393,2282,28,2254,52,353,382,325,42,26,7,226,49,792
30,1,365,56,309,0,309,13,75,73,39,1,1,0,23,9,75
30,2,506,53,453,6,447,11,144,81,57,4,1,0,47,9,93
30,3,6596,1122,5474,116,5358,85,1520,1590,632,41,20,18,307,59,1086
30,4,2115,271,1844,31,1813,35,442,485,248,18,10,4,106,30,435
30,5,176,13,163,2,161,2,41,50,12,5,2,0,14,3,32
30,6,3490,614,2876,50,2826,30,1012,641,314,36,10,8,164,51,560
30,7,26522,5761,20761,361,20400,331,4263,4827,3190,194,97,47,1262,290,5899
30,8,651,108,543,12,531,12,145,104,80,7,1,1,41,15,125
30,9,217,30,187,4,183,4,34,45,25,3,1,0,15,1,55
30,10,2386,384,2002,30,1972,66,399,498,304,30,13,5,151,20,486
30,11,6680,1013,5667,100,5567,113,1189,1933,458,54,12,13,475,87,1233
30,12,3123,483,2640,40,2600,49,719,607,345,27,14,5,173,43,618
30,13,249,28,221,3,218,7,58,58,29,6,0,0,12,4,44
30,14,843,124,719,13,706,22,164,168,90,8,4,2,57,8,183
30,15,137,17,120,3,117,9,20,15,24,1,0,0,11,3,34
30,16,240,36,204,4,200,2,65,24,37,1,2,0,12,1,56
30,17,215,31,184,7,177,13,35,29,37,1,0,1,10,1,50
30,18,376,51,325,5,320,7,54,106,49,4,2,2,26,5,65
30,19,1847,296,1551,20,1531,62,363,404,204,15,7,4,133,17,322
30,20,1734,205,1529,19,1510,28,462,437,154,9,4,5,100,24,287
30,21,254,31,223,4,219,3,47,56,36,5,0,2,13,2,55
30,22,187,30,157,5,152,13,38,33,23,0,0,3,14,3,25
30,23,632,82,550,4,546,20,165,113,64,6,2,2,41,7,126
30,24,366,49,317,8,309,7,66,59,57,5,0,2,18,4,91
30,25,255,38,217,5,212,10,26,35,42,4,2,0,17,4,72
30,26,831,138,693,21,672,24,143,144,133,16,6,3,45,10,148
30,27,1827,277,1550,30,1520,31,408,337,241,22,12,4,96,26,343
30,28,13352,3276,10076,166,9910,126,2518,2409,1060,98,59,34,625,126,2855
30,29,1299,162,1137,28,1109,25,191,303,209,14,7,0,105,17,238
30,30,262,30,232,6,226,3,65,50,38,2,2,0,17,2,47
30,31,169,31,138,3,135,0,32,42,13,3,1,1,3,2,38
30,32,9946,2050,7896,153,7743,110,2642,1671,901,70,36,19,362,107,1825
30,33,2777,395,2382,39,2343,35,753,573,276,20,14,10,161,43,458
30,34,4696,703,3993,69,3924,56,1371,956,303,28,25,8,322,54,801
30,35,204,27,177,5,172,12,28,52,33,3,2,0,12,0,30
30,36,2245,275,1970,25,1945,32,660,492,157,12,6,5,124,38,419
30,37,2210,539,1671,42,1629,33,432,313,244,22,10,4,81,21,469
30,38,265,38,227,1,226,9,49,40,56,2,1,0,7,0,62
30,39,1651,257,1394,32,1362,15,464,327,163,15,4,3,66,20,285
30,40,135,24,111,5,106,3,16,23,24,0,1,1,8,1,29
30,41,888,112,776,16,760,17,163,195,88,10,3,1,58,15,210
30,42,1778,273,1505,28,1477,41,369,371,208,19,2,7,99,33,328
30,43,414,47,367,6,361,9,96,113,27,2,2,0,29,6,77
30,44,94,21,73,0,73,13,0,8,20,5,0,0,4,1,22
30,45,353,49,304,4,300,6,79,50,64,0,3,0,16,1,81
30,46,483,87,396,7,389,5,128,103,46,4,5,0,23,8,67
30,47,4802,699,4103,64,4039,48,1121,1216,367,27,10,7,286,68,889
30,48,160,13,147,1,146,8,46,36,23,1,0,1,11,0,20
30,49,276,27,249,10,239,2,60,68,30,7,1,0,33,3,35
30,50,111,2,109,2,107,2,30,25,24,1,0,0,7,1,17
30,51,1093,139,954,23,931,16,244,167,217,5,5,2,66,8,201
30,52,368,59,309,8,301,19,60,54,56,2,0,0,16,2,92
30,53,496,56,440,13,427,13,115,97,44,3,1,2,33,6,113
30,54,189,16,173,1,172,4,47,37,18,5,1,0,17,2,41
30,55,460,51,409,9,400,12,98,89,52,5,2,1,25,6,110
30,56,226,33,193,2,191,0,35,45,29,2,0,2,20,2,56
30,57,1119,145,974,12,962,26,321,227,116,10,6,1,53,20,182
30,58,179,24,155,4,151,15,32,23,21,5,0,0,14,4,37
30,59,1816,250,1566,35,1531,12,524,357,164,10,6,3,96,32,327
30,60,3030,352,2678,44,2634,33,681,909,207,27,10,6,181,51,529
30,61,1624,278,1346,39,1307,17,420,301,154,17,8,0,90,16,284
30,62,3731,623,3108,46,3062,53,659,879,361,36,16,8,257,44,749
30,64,151,25,126,1,125,9,17,24,19,3,4,0,15,3,31
30,65,303,31,272,7,265,13,71,48,42,5,0,1,19,3,63
30,66,356,41,315,1,314,13,58,72,59,7,1,2,16,11,75
30,67,308,37,271,6,265,11,59,84,37,0,3,2,26,1,42
30,68,627,63,564,13,551,11,153,122,72,9,3,0,34,5,142
30,69,352,49,303,4,299,11,61,58,48,5,2,1,25,2,86
30,70,529,69,460,11,449,10,112,102,64,6,2,1,37,6,109
30,71,287,40,247,1,246,8,52,58,48,3,0,0,25,3,49
30,72,301,36,265,11,254,1,81,85,22,4,0,0,12,4,45
30,73,1131,131,1000,14,986,29,250,327,82,9,5,1,70,20,193
30,74,21,3,18,0,18,0,4,6,1,0,2,0,1,0,4
30,75,3157,393,2764,25,2739,58,687,771,285,17,12,2,211,37,659
30,76,659,90,569,11,558,10,115,113,70,4,2,4,60,11,169
30,77,1418,231,1187,23,1164,28,225,171,368,8,5,3,57,9,290
30,79,261,36,225,1,224,7,38,56,58,3,2,1,12,2,45
30,80,597,111,486,9,477,5,99,81,110,9,4,0,23,9,137
30,81,795,107,688,11,677,5,198,214,65,5,1,0,50,15,124
30,82,3120,482,2638,43,2595,48,647,673,327,23,8,8,204,26,631
30,83,1922,290,1632,30,1602,34,484,398,179,13,10,3,111,31,339
30,84,464,46,418,4,414,2,151,90,41,5,0,0,35,7,83
30,85,856,135,721,16,705,18,173,165,96,3,5,1,66,9,169
30,86,405,55,350,11,339,8,90,61,50,3,4,0,29,11,83
30,87,201,17,184,3,181,2,11,26,50,0,0,0,19,0,73
30,88,439,61,378,10,368,14,101,87,53,6,1,0,26,3,77
30,89,1180,133,1047,19,1028,8,333,213,179,9,5,5,57,17,202
30,90,214,28,186,3,183,11,44,40,20,4,0,1,18,1,44
30,91,1172,118,1054,17,1037,33,216,202,152,14,7,2,80,22,309
30,92,1281,151,1130,15,1115,14,348,257,118,11,4,2,106,21,234
30,93,119,19,100,2,98,1,15,38,15,0,0,1,5,0,23
30,94,121,10,111,1,110,5,8,21,33,1,1,0,8,3,30
30,95,421,55,366,8,358,20,66,58,80,2,0,2,19,7,104
30,96,669,71,598,13,585,10,136,147,66,7,3,4,46,15,151
30,97,275,30,245,4,241,10,26,47,65,5,0,2,15,7,64
30,98,249,35,214,3,211,3,49,61,32,2,0,0,23,7,34
30,99,229,27,202,2,200,24,40,29,32,3,3,1,12,3,53
30,100,463,57,406,10,396,7,121,92,51,7,0,0,28,10,80
30,101,493,45,448,13,435,18,129,77,71,7,4,3,38,10,78
30,102,404,50,354,2,352,9,104,80,44,6,1,0,22,4,82
30,103,724,106,618,7,611,17,176,191,54,5,1,2,53,12,100
30,104,517,58,459,11,448,14,145,80,111,6,2,0,17,5,68
30,105,272,48,224,2,222,4,34,53,48,4,1,1,26,0,51
30,106,556,81,475,6,469,24,83,72,102,11,0,2,32,6,137
30,107,353,41,312,4,308,8,69,110,26,6,1,1,34,7,46
30,108,170,29,141,4,137,2,28,20,18,2,0,0,16,0,51
30,109,319,45,274,4,270,8,67,78,26,1,2,0,25,5,58
30,110,248,25,223,1,222,6,51,62,33,1,0,1,8,4,56
30,111,271,37,234,4,230,11,73,56,21,1,0,0,14,5,49
30,112,843,86,757,11,746,7,219,162,103,3,4,1,59,13,175
30,113,219,25,194,4,190,5,29,41,29,0,1,1,11,0,73
30,114,490,51,439,9,430,6,147,105,42,5,0,0,31,10,84
30,115,187,32,155,2,153,9,26,37,15,4,0,0,14,0,48
30,116,678,130,548,8,540,8,142,117,71,7,4,1,42,16,132
30,117,2111,282,1829,35,1794,29,562,426,221,22,9,2,113,28,382
30,119,127,13,114,0,114,7,26,26,22,0,0,0,8,0,25
30,120,857,158,699,9,690,18,162,111,122,19,5,1,35,9,208
30,121,169,16,153,1,152,8,35,48,15,2,0,1,8,4,31
30,122,510,52,458,4,454,17,150,88,69,3,1,0,24,6,96
30,123,2430,444,1986,30,1956,33,525,492,297,18,9,3,128,26,425
30,124,193,28,165,4,161,5,48,21,19,2,1,0,17,5,43
30,125,3465,713,2752,44,2708,24,823,763,257,15,7,7,191,35,586
30,126,546,62,484,7,477,16,100,135,59,3,5,1,39,7,112
30,127,734,78,656,13,643,7,190,138,87,2,3,0,39,7,170
30,128,2799,367,2432,38,2394,45,721,710,202,19,7,7,176,37,470
30,129,541,87,454,7,447,28,61,122,70,5,0,2,34,4,121
30,130,689,100,589,14,575,27,106,107,134,2,3,1,39,5,151
30,131,814,96,718,20,698,22,201,141,103,12,5,2,56,13,143
30,132,3405,870,2535,40,2495,24,508,384,582,18,8,4,107,28,832
30,133,7711,1151,6560,88,6472,83,1739,2359,463,58,39,9,327,90,1305
30,134,195,26,169,2,167,18,26,41,32,3,3,0,17,2,25
30,135,2363,348,2015,27,1988,19,691,460,211,19,5,3,139,29,412
30,136,810,86,724,18,706,21,171,149,107,7,1,2,41,18,189
30,137,116,13,103,3,100,8,9,14,29,1,0,0,2,1,36
30,138,1761,214,1547,24,1523,44,348,432,171,7,5,4,136,23,353
30,139,329,47,282,3,279,5,85,67,20,3,3,1,38,6,51
30,140,886,147,739,10,729,48,126,148,151,5,4,1,40,10,196
30,141,3972,577,3395,52,3343,68,888,730,471,39,25,9,227,32,854
30,142,960,125,835,10,825,11,250,137,176,7,5,4,49,11,175
30,143,186,22,164,5,159,5,28,42,23,2,0,0,18,1,40
30,144,246,33,213,5,208,3,37,38,40,3,1,0,26,5,55
30,145,1097,147,950,12,938,19,333,245,96,10,4,1,67,8,155
30,146,996,137,859,12,847,19,255,177,128,7,5,0,56,10,190
30,147,1005,167,838,18,820,20,163,175,159,11,2,1,46,18,225
30,148,161,13,148,1,147,4,26,39,28,1,1,0,10,2,36
30,149,643,79,564,15,549,14,163,128,67,10,3,1,23,7,133
30,150,207,21,186,1,185,7,43,33,42,1,0,0,19,0,40
30,151,429,62,367,3,364,13,86,83,59,1,0,0,32,7,83
30,152,1598,212,1386,25,1361,21,383,221,312,8,8,5,74,30,299
30,153,154,29,125,3,122,14,13,16,41,8,0,0,8,2,20
30,154,345,50,295,10,285,21,27,56,60,8,1,2,22,2,86
30,155,4828,847,3981,68,3913,60,1219,1025,395,30,18,7,274,67,818
30,156,6995,1317,5678,98,5580,81,1784,1384,530,57,26,10,369,67,1272
30,157,135,9,126,2,124,4,24,22,20,0,1,1,6,0,46
30,158,305,41,264,5,259,3,60,49,56,10,3,0,21,1,56
30,159,558,86,472,11,461,8,102,48,169,10,4,1,12,6,101
30,160,145,17,128,1,127,5,21,39,17,2,1,0,5,1,36
30,161,148,15,133,2,131,0,43,25,21,3,0,0,15,0,24
30,162,544,56,488,14,474,34,96,104,82,3,2,0,29,7,117
30,163,120,13,107,4,103,5,28,27,25,1,2,0,2,0,13
30,164,420,49,371,12,359,10,87,83,29,9,4,1,28,9,99
30,165,798,94,704,8,696,13,191,172,117,11,3,0,52,7,130
30,166,1794,298,1496,31,1465,21,449,333,189,13,7,6,118,21,308
30,167,697,96,601,7,594,6,160,129,123,10,9,2,41,4,110
30,168,596,73,523,3,520,21,69,100,117,5,4,0,26,4,174
30,169,4046,663,3383,49,3334,34,1188,841,332,24,10,3,197,54,651
30,170,732,109,623,10,613,13,139,116,103,9,1,4,41,9,178
30,171,972,184,788,14,774,13,201,94,168,7,6,2,34,3,246
30,172,509,72,437,9,428,32,53,52,102,6,1,3,24,5,150
30,173,1147,147,1000,21,979,24,275,238,117,7,1,2,92,19,204
30,174,1045,147,898,16,882,27,199,254,124,10,3,2,62,4,197
30,175,175,36,139,1,138,9,30,36,20,1,0,0,6,2,34
30,176,199,35,164,2,162,7,46,29,22,3,1,0,17,1,36
30,177,499,51,448,12,436,8,145,103,47,5,3,2,43,3,77
30,178,1131,161,970,22,948,13,296,268,95,7,7,4,69,28,161
30,179,2187,369,1818,27,1791,26,542,467,198,21,6,7,107,32,385
30,180,417,41,376,6,370,8,114,59,64,3,5,0,29,3,85
30,181,231,30,201,2,199,3,60,43,26,5,2,2,15,3,40
30,182,755,93,662,8,654,17,162,159,99,12,3,2,31,6,163
30,183,398,65,333,10,323,6,75,92,46,6,5,1,17,4,71
30,184,856,110,746,8,738,16,251,154,70,14,6,1,46,8,172
30,185,980,148,832,23,809,20,163,212,115,9,8,0,71,22,189
30,186,1299,129,1170,23,1147,32,243,371,94,4,6,1,131,18,247
30,187,249,40,209,2,207,1,78,47,10,3,0,0,12,3,53
30,188,550,61,489,13,476,12,113,102,68,10,2,0,37,10,122
30,189,84674,18146,66528,962,65566,1539,13512,17608,8774,557,197,129,4642,804,17804
30,190,349,55,294,4,290,17,56,64,41,5,2,1,23,3,78
30,191,854,72,782,21,761,10,230,213,66,9,2,0,74,13,144
30,192,320,43,277,5,272,15,54,69,47,1,0,1,27,1,57
30,193,408,50,358,6,352,12,107,64,51,1,0,0,24,5,88
30,194,257,33,224,8,216,12,31,39,56,3,1,1,8,3,62
30,195,44,7,37,1,36,4,2,5,8,0,0,0,4,3,10
30,196,334,37,297,6,291,2,97,47,45,6,1,1,23,2,67
30,197,159,15,144,4,140,0,31,42,21,1,1,0,13,3,28
30,198,232,28,204,4,200,9,19,16,52,1,0,1,17,3,82
30,199,71,17,54,2,52,1,16,10,9,0,0,0,2,1,13
30,200,562,54,508,12,496,20,99,99,87,9,2,3,34,8,135
30,201,304,48,256,5,251,23,45,51,28,7,0,0,19,2,76
30,202,7367,1318,6049,113,5936,73,1852,1323,660,82,39,14,415,107,1371
30,203,304,44,260,6,254,7,55,30,94,8,1,0,11,1,47
30,204,258,27,231,3,228,6,77,54,28,5,0,2,19,5,32
30,205,172,22,150,2,148,1,32,45,13,0,3,0,13,3,38
30,206,3243,457,2786,56,2730,48,751,804,250,29,9,7,229,46,557
30,207,490,75,415,8,407,8,128,94,40,5,3,1,25,10,93
30,208,32,2,30,0,30,6,2,3,6,0,0,0,4,0,9
30,209,3115,457,2658,42,2616,78,603,794,246,23,5,3,224,50,590
30,210,2044,332,1712,17,1695,51,477,331,245,13,15,4,101,23,435
30,211,2732,498,2234,42,2192,27,744,549,238,22,15,4,147,25,421
30,212,1553,250,1303,27,1276,25,363,307,156,12,10,1,86,11,305
30,213,43,3,40,2,38,1,5,10,1,0,1,0,6,2,12
30,214,1267,146,1121,24,1097,30,394,220,135,11,3,4,63,22,215
30,215,264,43,221,5,216,4,37,57,45,1,2,0,19,5,46
30,216,686,123,563,11,552,12,154,92,127,7,4,5,21,8,122
30,217,5437,729,4708,72,4636,91,1302,1385,434,42,23,10,401,76,872
30,218,201,27,174,3,171,5,15,36,51,3,1,0,16,3,41
30,219,87,16,71,0,71,3,15,18,6,1,1,0,6,0,21
30,220,189,26,163,1,162,11,19,21,38,5,1,0,12,2,53
30,221,3660,694,2966,48,2918,43,934,688,353,33,16,7,200,48,596
30,222,162,19,143,1,142,2,28,46,11,0,2,0,19,4,30
30,223,3116,508,2608,50,2558,24,690,388,561,23,12,8,165,34,653
30,224,371,43,328,3,325,4,109,81,28,1,1,0,27,6,68
30,225,1424,187,1237,20,1217,21,309,342,135,14,8,0,101,24,263
30,226,922,136,786,14,772,14,217,186,99,8,5,3,77,12,151
30,227,2637,607,2030,25,2005,37,537,459,325,23,13,7,120,37,447
30,228,1314,177,1137,25,1112,41,301,281,159,12,5,3,88,20,202
30,229,504,104,400,5,395,25,97,78,63,15,3,1,35,13,65
30,230,380,59,321,3,318,10,60,90,43,3,0,2,22,7,81
30,231,449,83,366,5,361,17,90,63,47,10,3,2,23,5,101
30,232,304,54,250,4,246,7,47,62,39,8,2,1,22,7,51
30,233,362,52,310,4,306,9,78,74,43,3,1,1,29,6,62
30,234,202,34,168,5,163,1,42,38,34,2,1,1,17,2,25
30,235,567,101,466,5,461,2,157,113,69,8,4,1,27,2,78
30,236,77,12,65,0,65,3,17,17,12,2,0,0,2,1,11
30,237,475,88,387,6,381,8,106,61,76,4,4,5,18,8,91
30,238,80,10,70,1,69,3,23,18,6,3,2,0,1,1,12
30,239,474,79,395,10,385,9,132,53,52,3,4,2,28,10,92
30,240,237,40,197,5,192,6,50,39,28,1,1,2,10,3,52
30,241,1207,154,1053,13,1040,17,301,259,120,14,3,2,88,12,224
30,242,144,22,122,4,118,7,18,20,22,2,1,0,10,0,38
30,243,5300,860,4440,96,4344,74,1058,969,685,36,23,6,301,59,1133
30,244,217,22,195,2,193,8,50,63,14,2,0,0,18,3,35
30,245,526,53,473,12,461,17,103,96,65,2,3,0,39,15,121
30,246,101,16,85,2,83,12,9,12,21,1,2,1,6,1,18
30,247,224,36,188,7,181,6,37,25,37,7,2,1,15,5,46
30,248,281,21,260,2,258,7,78,51,26,6,1,0,12,3,74
30,249,643,58,585,10,575,15,152,139,73,3,3,0,46,10,134
30,250,267,43,224,3,221,12,60,41,38,4,2,0,16,1,47
30,251,386,56,330,10,320,4,98,70,37,2,7,0,21,10,71
30,252,189,17,172,2,170,15,22,26,49,3,1,0,11,0,43
30,253,903,176,727,11,716,15,216,108,163,12,2,5,27,4,164
30,254,1297,162,1135,27,1108,22,319,246,165,9,7,8,69,15,248
30,255,1908,344,1564,26,1538,38,461,289,241,8,8,4,102,15,372
30,256,524,67,457,7,450,14,90,96,57,8,2,2,47,20,114
30,257,1281,195,1086,18,1068,11,398,281,95,10,4,2,79,13,175
30,258,8834,1800,7034,104,6930,72,2451,1746,626,57,32,14,299,84,1549
30,259,3537,629,2908,38,2870,45,766,740,359,25,20,4,224,55,632
30,260,585,44,541,7,534,13,152,145,51,9,2,2,42,10,108
30,261,182,28,154,4,150,2,32,34,20,1,2,0,20,2,37
30,262,186,31,155,6,149,3,37,49,17,2,0,0,9,0,32
30,263,2834,510,2324,43,2281,76,599,453,404,40,15,5,161,32,496
30,264,141,21,120,5,115,1,25,35,11,0,0,0,10,1,32
30,265,162,20,142,3,139,4,39,38,18,0,2,0,11,0,27
30,266,738,92,646,6,640,12,157,112,123,5,5,0,47,6,173
30,267,358,64,294,7,287,4,91,62,43,3,0,1,36,6,41
30,268,487,91,396,4,392,9,107,69,94,6,2,1,14,7,83
30,269,2158,390,1768,41,1727,63,280,390,306,21,7,3,136,24,497
30,270,1163,164,999,13,986,17,259,207,210,12,6,4,63,17,191
30,271,504,82,422,9,413,2,109,89,56,3,2,1,34,11,106
30,272,152,19,133,4,129,8,25,22,24,7,2,1,8,3,29
30,273,1033,162,871,29,842,7,242,207,97,10,8,3,54,10,204
30,274,2568,318,2250,42,2208,25,607,430,459,23,15,5,129,24,491
30,275,233,25,208,5,203,5,65,41,26,0,0,1,23,1,41
30,276,2503,278,2225,30,2195,47,671,561,301,18,13,2,127,27,428
30,277,350,26,324,6,318,4,87,70,33,3,4,3,31,9,74
30,278,1813,268,1545,21,1524,21,378,389,178,12,5,4,136,23,378
30,279,538,62,476,11,465,9,98,119,47,4,4,1,40,10,133
30,280,321,39,282,8,274,16,53,36,73,3,2,0,16,2,73
30,281,1064,113,951,10,941,19,243,209,159,13,5,4,62,10,217
30,282,604,101,503,6,497,10,111,106,62,10,4,0,54,8,132
30,283,184,24,160,4,156,10,28,28,26,2,0,0,11,4,47
30,284,3067,468,2599,35,2564,41,594,505,543,26,14,3,148,28,662
30,285,459,58,401,7,394,13,100,123,39,6,0,0,23,4,86
30,286,512,75,437,9,428,10,111,117,44,11,0,0,40,6,89
30,287,469,57,412,6,406,7,90,115,43,8,3,1,32,8,99
30,288,859,120,739,8,731,10,186,123,109,5,5,1,52,16,224
30,289,57,7,50,3,47,1,7,12,4,1,1,0,5,3,13
30,290,1465,167,1298,39,1259,16,340,275,148,16,7,3,117,25,312
30,291,307,38,269,6,263,11,64,39,48,6,2,1,22,5,65
30,292,379,53,326,7,319,3,107,84,27,1,4,0,31,2,60
30,293,286,36,250,5,245,8,69,70,29,0,1,0,16,4,48
30,294,3957,565,3392,51,3341,50,896,853,422,20,13,7,257,70,753
30,295,2441,418,2023,36,1987,71,400,509,329,29,6,5,139,26,473
30,296,192,31,161,4,157,13,20,13,50,2,0,0,4,2,53
30,297,341,65,276,3,273,2,55,78,28,4,0,0,19,2,85
30,298,403,50,353,9,344,17,58,75,78,0,2,0,10,5,99
30,299,825,114,711,10,701,13,138,222,71,9,2,1,72,17,156
30,300,327,48,279,6,273,3,72,48,53,2,2,0,15,8,70
30,301,223,20,203,4,199,2,51,45,31,4,3,0,22,4,37
30,302,1484,187,1297,21,1276,30,285,298,187,18,6,7,95,30,320
30,303,579,81,498,6,492,16,128,79,94,6,6,0,39,8,116
30,304,142,20,122,5,117,7,30,24,18,3,1,1,9,4,20
30,305,2586,515,2071,38,2033,24,618,357,350,24,11,5,107,14,523
30,306,372,51,321,8,313,10,58,72,42,2,0,1,36,7,85
30,307,1932,333,1599,23,1576,22,356,216,442,15,6,2,58,19,440
30,308,687,111,576,7,569,16,138,110,83,9,2,2,61,12,136
30,309,183,27,156,1,155,8,39,38,21,1,1,0,15,2,30
30,310,217,31,186,5,181,6,33,33,43,6,5,2,7,2,44
30,311,1374,246,1128,17,1111,39,275,211,165,9,3,5,47,9,348
30,312,1523,231,1292,25,1267,30,313,356,184,14,6,2,102,23,237
30,313,515,56,459,9,450,12,160,98,39,3,4,0,23,4,107
30,314,150,18,132,1,131,2,29,23,26,2,1,2,9,2,35
30,315,1443,179,1264,26,1238,36,403,315,98,13,5,0,97,15,256
30,316,246,22,224,4,220,13,41,25,50,4,2,0,22,5,58
30,317,1183,198,985,22,963,11,346,210,124,10,7,0,47,14,194
30,318,149,21,128,3,125,2,43,28,16,1,2,0,11,3,19
30,319,364,51,313,4,309,11,76,93,31,4,5,0,23,2,64
30,320,125,10,115,1,114,1,19,33,19,2,1,0,9,2,28
30,321,3021,617,2404,38,2366,74,574,519,337,22,13,5,166,34,622
30,322,244,37,207,2,205,22,20,24,61,4,4,3,8,5,54
30,323,129,18,111,1,110,2,28,22,23,1,0,0,5,1,28
30,324,626,74,552,8,544,8,123,141,67,3,3,1,37,14,147
30,325,1358,203,1155,18,1137,44,235,212,182,14,4,3,103,18,322
30,326,1372,173,1199,21,1178,24,240,350,144,17,5,1,83,23,291
30,327,66,4,62,1,61,4,3,9,21,1,0,0,6,0,17
30,328,824,145,679,10,669,22,215,134,79,11,4,1,27,11,165
30,329,345,37,308,5,303,18,40,72,84,7,2,1,12,4,63
30,330,674,75,599,6,593,12,111,180,99,12,1,3,34,5,136
30,331,1544,241,1303,15,1288,14,352,327,141,9,8,6,96,32,303
30,332,95,9,86,2,84,0,23,12,15,3,1,0,9,1,20
30,333,2822,438,2384,34,2350,26,773,629,219,26,20,8,129,35,485
30,334,6534,1434,5100,89,5011,149,868,1487,647,53,13,9,369,67,1349
30,335,80,11,69,0,69,6,13,11,14,1,0,1,6,3,14
30,336,937,121,816,10,806,18,245,206,95,3,5,2,54,13,165
30,337,288,35,253,3,250,8,54,47,50,4,1,1,27,12,46
30,338,114,13,101,2,99,3,21,20,17,0,1,0,9,0,28
30,339,943,151,792,10,782,26,120,165,122,5,3,1,62,7,271
30,340,399,46,353,11,342,10,97,74,55,6,4,1,25,8,62
30,341,8327,1505,6822,106,6716,89,2078,1510,843,62,35,17,342,85,1655
30,342,946,99,847,13,834,15,238,187,118,6,1,2,67,17,183
30,343,474,78,396,5,391,6,102,73,53,4,3,2,22,4,122
30,344,3409,533,2876,49,2827,60,763,625,388,24,15,4,231,47,670
30,345,340,64,276,3,273,6,47,20,118,2,1,2,7,4,66
30,346,1332,130,1202,25,1177,35,315,307,148,13,0,6,76,25,252
30,347,976,158,818,8,810,13,288,196,73,8,4,2,29,17,180
30,348,1346,238,1108,14,1094,34,235,286,150,10,11,3,86,20,259
30,349,287,41,246,8,238,9,66,52,41,8,0,0,17,1,44
30,350,3104,608,2496,63,2433,109,404,459,473,40,13,3,149,36,747
30,351,10149,1797,8352,113,8239,207,1407,2976,781,59,29,15,776,97,1892
30,352,1172,138,1034,16,1018,38,222,328,89,8,4,3,87,13,226
30,353,67,3,64,0,64,3,19,5,11,1,0,0,6,1,18
30,354,142,10,132,2,130,6,31,35,19,1,1,0,9,2,26
30,355,679,108,571,10,561,5,165,168,45,5,4,1,42,14,112
30,356,2213,350,1863,33,1830,25,512,489,174,13,7,4,114,34,458
31,1,108,14,94,1,93,1,9,22,10,2,1,0,8,1,39
31,2,192,14,178,1,177,2,38,39,35,3,0,1,14,3,42
31,3,858,77,781,15,766,26,86,199,77,9,3,3,109,23,231
31,4,1808,190,1618,20,1598,64,218,272,244,23,8,4,166,22,577
31,5,255,44,211,4,207,6,34,34,34,1,1,0,18,3,76
31,6,153,24,129,4,125,4,24,29,10,2,0,1,15,3,37
31,7,57,8,49,0,49,4,14,19,4,0,0,0,1,0,7
31,8,189,22,167,2,165,6,29,30,11,6,0,0,19,4,60
31,9,88,15,73,2,71,2,13,26,7,0,0,0,6,1,16
31,10,99,5,94,1,93,2,13,22,10,2,0,0,11,0,33
31,11,232,25,207,3,204,23,24,29,42,3,2,0,7,3,71
31,12,86,6,80,2,78,2,4,16,22,0,0,0,4,1,29
31,13,291,35,256,5,251,6,44,50,22,3,1,1,30,3,91
31,14,78,15,63,2,61,0,9,19,5,1,0,0,6,1,20
31,15,37,5,32,0,32,1,5,0,9,0,0,0,0,1,16
31,17,79,16,63,0,63,1,15,4,17,3,0,0,4,0,19
31,18,200,35,165,4,161,3,37,27,23,1,1,0,13,3,53
31,19,44,9,35,0,35,0,3,17,1,0,0,0,5,1,8
31,20,881,171,710,13,697,30,106,131,115,14,9,0,50,11,231
31,21,114,9,105,3,102,4,19,32,10,1,1,0,6,1,28
31,22,5400,1025,4375,69,4306,101,806,971,574,47,14,6,361,69,1357
31,23,304,62,242,4,238,9,47,33,25,2,1,1,18,0,102
31,24,308,30,278,5,273,13,27,61,42,4,0,1,24,2,99
31,25,579,61,518,7,511,15,55,149,70,2,1,0,65,5,149
31,26,838,97,741,14,727,23,127,152,121,11,9,3,58,11,212
31,27,181,24,157,2,155,4,37,39,23,5,0,1,11,1,34
31,28,834,132,702,18,684,18,84,145,79,16,6,2,60,9,265
31,29,228,15,213,4,209,8,46,68,23,1,1,1,10,5,46
31,30,72,8,64,0,64,7,15,6,9,4,1,0,3,0,19
31,31,415,62,353,8,345,6,63,62,35,7,1,1,29,6,135
31,32,4574,605,3969,70,3899,85,648,970,484,38,17,5,386,58,1208
31,33,6463,1195,5268,116,5152,107,1123,1160,668,61,34,18,421,106,1454
31,34,167,26,141,6,135,8,17,21,25,1,2,0,9,2,50
31,35,2031,201,1830,21,1809,75,140,464,196,10,5,3,221,29,666
31,36,998,84,914,19,895,33,88,221,112,11,1,2,106,20,301
31,37,1036,124,912,20,892,24,150,169,130,13,0,3,72,24,307
31,38,415,23,392,7,385,13,70,102,37,4,2,0,34,7,116
31,39,65,10,55,0,55,1,7,7,15,1,0,0,2,0,22
31,40,45,10,35,2,33,0,2,0,11,0,0,0,3,0,17
31,41,99,28,71,2,69,1,17,10,8,3,0,1,9,0,20
31,42,2458,485,1973,32,1941,50,251,630,185,17,9,10,156,30,603
31,43,172,26,146,3,143,1,28,22,22,2,0,0,18,6,44
31,44,10321,1321,9000,126,8874,247,976,2906,750,67,23,20,1001,113,2771
31,45,326,56,270,6,264,3,47,47,49,6,0,1,27,9,75
31,46,20,9,11,0,11,0,2,1,2,0,0,0,0,0,6
31,47,86,16,70,0,70,8,4,7,26,0,0,0,3,5,17
31,48,2236,226,2010,36,1974,47,355,381,258,27,6,2,183,37,678
31,49,476,50,426,5,421,9,70,107,67,5,2,1,42,10,108
31,50,400,46,354,15,339,6,85,59,40,3,3,2,21,4,116
31,51,251,19,232,5,227,5,48,46,24,4,2,0,19,3,76
31,52,1117,108,1009,11,998,24,197,235,158,17,2,0,87,13,265
31,53,861,79,782,13,769,19,108,227,82,7,3,4,81,9,229
31,54,145,18,127,8,119,3,25,29,11,4,3,0,15,0,29
31,55,105,9,96,3,93,1,13,8,9,1,0,1,6,3,51
31,56,4159,556,3603,62,3541,84,601,687,458,54,14,6,422,60,1155
31,57,1005,123,882,11,871,33,112,202,105,9,2,2,105,14,287
31,58,76,9,67,1,66,3,16,12,8,5,1,1,9,1,10
31,59,117,19,98,1,97,6,12,20,12,1,0,0,12,1,33
31,60,90,25,65,2,63,6,12,8,12,1,0,0,7,3,14
31,61,154,20,134,1,133,2,24,30,16,0,0,0,23,4,34
31,62,65,3,62,4,58,2,16,14,2,0,1,0,4,0,19
31,63,152,30,122,1,121,0,29,21,5,2,0,0,22,1,41
31,64,32,5,27,0,27,0,1,4,2,1,0,0,3,0,16
31,65,1830,224,1606,24,1582,49,393,282,223,18,6,3,147,26,435
31,66,2277,331,1946,37,1909,36,374,496,192,31,14,3,154,40,569
31,67,46,3,43,1,42,0,7,8,11,0,1,0,3,1,11
31,68,27,5,22,0,22,1,1,5,0,0,0,0,3,0,12
31,69,14891,2294,12597,183,12414,412,1657,2680,1633,154,51,36,1202,177,4412
31,70,346,51,295,2,293,4,59,61,25,1,2,0,39,8,94
31,71,245,37,208,7,201,2,61,31,24,0,0,1,23,2,57
31,72,73,10,63,4,59,3,7,18,2,0,0,0,9,0,20
31,73,369,44,325,7,318,8,62,72,34,5,2,1,16,7,111
31,74,230,16,214,5,209,5,38,56,31,4,0,2,16,5,52
31,75,677,67,610,7,603,19,104,139,56,2,3,3,74,15,188
31,76,400,62,338,7,331,2,74,62,54,6,1,1,29,13,89
31,77,342,34,308,6,302,5,70,90,31,5,2,3,30,4,62
31,78,111,16,95,0,95,3,12,25,12,0,0,0,8,2,33
31,79,2991,366,2625,44,2581,55,463,599,334,36,17,2,278,35,762
31,80,1106,163,943,31,912,20,168,252,73,13,3,2,77,16,288
31,81,21,1,20,20,0,0,0,0,0,0,0,0,0,0,0
31,82,664,66,598,9,589,20,119,136,59,4,2,0,57,14,178
31,83,201,27,174,2,172,5,19,23,31,2,4,2,10,1,75
31,84,777,101,676,9,667,11,136,95,110,12,0,4,59,8,232
31,85,340,59,281,7,274,7,37,50,38,5,2,0,28,2,105
31,86,72,5,67,0,67,2,10,6,10,0,0,0,3,1,35
31,87,243,34,209,7,202,6,51,20,29,3,3,1,11,6,72
31,88,1905,183,1722,36,1686,76,187,352,184,18,3,3,198,28,637
31,89,391,44,347,6,341,12,75,84,26,8,3,1,30,8,94
31,90,322,53,269,9,260,5,62,39,33,5,1,1,24,7,83
31,91,3596,359,3237,81,3156,56,579,836,347,30,11,13,318,54,912
31,92,131,14,117,2,115,2,29,21,12,4,2,1,9,1,34
31,93,536,67,469,8,461,15,84,83,80,8,4,1,49,11,126
31,94,1711,252,1459,20,1439,37,276,327,163,15,5,3,125,26,462
31,95,110,21,89,1,88,2,12,16,15,1,0,0,7,0,35
31,96,136,14,122,2,120,4,33,28,8,0,0,0,14,5,28
31,97,242,18,224,7,217,2,33,32,40,5,0,0,11,2,92
31,98,678,88,590,13,577,13,145,101,51,6,3,1,54,15,188
31,99,233,24,209,6,203,2,25,32,33,5,0,1,35,7,63
31,100,1495,195,1300,19,1281,19,252,258,169,24,3,4,98,16,438
31,101,349,29,320,6,314,5,68,41,42,2,3,0,28,11,114
31,102,157,17,140,5,135,5,17,15,24,1,0,0,8,0,65
31,103,53,13,40,0,40,1,8,12,6,0,0,1,2,1,9
31,104,410,25,385,6,379,8,107,51,53,3,7,0,18,1,131
31,105,182,21,161,3,158,7,17,38,33,1,1,1,14,2,44
31,106,1767,179,1588,24,1564,57,311,354,191,18,3,2,139,23,466
31,107,3879,701,3178,69,3109,71,620,672,446,36,21,7,195,51,990
31,108,231,30,201,3,198,0,54,35,14,2,2,0,20,2,69
31,109,350,67,283,7,276,6,42,57,24,3,2,0,24,3,115
31,110,557,82,475,9,466,6,94,58,73,7,1,1,35,15,176
31,111,215,29,186,3,183,3,35,30,33,6,1,0,13,3,59
31,112,151,28,123,8,115,1,37,22,14,1,1,0,15,1,23
31,113,8669,1243,7426,150,7276,276,786,1409,1086,85,19,15,778,99,2723
31,114,201,26,175,2,173,4,41,32,17,1,1,0,14,0,63
31,115,59,9,50,3,47,1,17,14,1,0,0,0,6,0,8
31,116,6467,708,5759,83,5676,113,1016,1369,648,46,25,14,547,97,1801
31,117,3011,385,2626,53,2573,61,416,693,275,25,8,5,256,35,799
31,118,3600,559,3041,58,2983,61,647,707,379,23,4,11,279,50,822
31,119,178,27,151,8,143,3,32,12,18,1,1,0,16,6,54
31,120,541,56,485,8,477,10,102,98,55,6,1,2,43,11,149
31,121,60,7,53,1,52,0,15,9,5,1,0,0,1,1,20
31,122,93,14,79,2,77,1,18,11,14,2,0,1,9,0,21
31,123,70,11,59,2,57,1,4,9,6,0,1,1,13,0,22
31,124,296,39,257,7,250,10,60,26,45,4,0,1,27,3,74
31,125,41,6,35,2,33,1,4,3,6,0,0,0,3,0,16
31,126,222,32,190,6,184,8,48,28,29,0,1,0,20,4,46
31,127,18,8,10,0,10,0,0,0,6,0,0,0,0,0,4
31,128,513,41,472,10,462,6,95,86,71,5,3,3,37,7,149
31,129,28,2,26,0,26,0,0,7,2,0,0,0,5,1,11
31,130,81,11,70,5,65,1,14,10,8,0,2,0,5,2,23
31,131,74,14,60,0,60,3,8,15,10,2,0,0,3,0,19
31,132,66,9,57,1,56,5,5,10,9,0,0,0,1,2,24
31,133,81,5,76,1,75,3,1,24,8,4,2,1,11,0,21
31,134,60,9,51,0,51,2,6,2,19,1,2,0,0,0,19
31,135,3356,630,2726,46,2680,54,552,633,366,41,12,7,175,48,792
31,136,1057,141,916,14,902,28,191,168,130,12,3,1,95,19,255
31,137,126,20,106,0,106,0,20,37,10,3,1,0,11,4,20
31,138,199,30,169,3,166,2,38,34,10,0,0,0,14,4,64
31,139,172,20,152,2,150,1,34,32,19,4,2,0,11,3,44
31,140,189,34,155,0,155,6,33,33,19,2,2,0,14,0,46
31,141,204,21,183,0,183,3,25,24,28,3,0,0,15,1,84
31,142,211,42,169,0,169,2,27,41,22,1,2,2,8,1,63
31,143,239,45,194,5,189,4,44,35,26,2,0,0,27,1,50
31,144,667,103,564,13,551,7,107,95,81,8,2,2,41,9,199
31,145,2236,314,1922,36,1886,58,426,351,227,34,2,7,132,33,616
31,146,28,4,24,0,24,1,2,9,3,0,0,0,1,0,8
31,147,503,74,429,10,419,1,120,60,47,4,1,1,16,5,164
31,148,399,48,351,7,344,11,36,94,46,5,0,1,27,7,117
31,149,23857,4081,19776,391,19385,573,2961,3713,2597,192,102,49,1742,273,7183
31,150,3763,493,3270,65,3205,90,575,799,359,29,18,9,348,54,924
31,151,562,73,489,9,480,12,31,101,66,6,5,2,59,6,192
31,152,84,8,76,2,74,3,6,13,11,0,1,0,12,2,26
31,153,338,73,265,6,259,10,54,48,30,4,1,1,12,3,96
31,155,184,18,166,2,164,11,28,33,15,4,1,0,11,4,57
31,156,239,37,202,3,199,4,43,53,20,0,1,0,16,5,57
31,157,11220,1672,9548,151,9397,272,1425,2297,1081,73,40,22,985,142,3060
31,158,196,47,149,2,147,0,24,33,35,2,0,0,6,3,44
31,159,286,48,238,3,235,2,54,51,18,5,2,0,17,1,85
31,160,1298,81,1217,23,1194,35,232,267,142,9,6,7,119,16,361
31,161,691,78,613,7,606,14,80,109,86,12,3,2,63,5,232
31,162,775,75,700,12,688,23,93,125,99,7,1,1,78,10,251
31,163,1904,189,1715,36,1679,45,236,428,195,13,5,4,190,22,541
31,164,154,14,140,1,139,5,21,36,18,3,0,0,10,2,44
31,165,3584,438,3146,61,3085,68,691,676,330,30,20,2,319,43,906
31,166,178,19,159,4,155,2,29,32,27,4,0,0,12,1,48
31,167,503,66,437,9,428,19,88,90,53,6,2,0,27,9,134
31,168,112,22,90,2,88,2,13,18,13,3,1,0,8,1,29
31,169,4900,584,4316,78,4238,134,540,941,537,34,13,9,470,63,1497
31,170,186,26,160,4,156,6,20,22,27,1,0,0,20,1,59
31,171,208,13,195,10,185,8,18,45,32,2,0,1,18,6,55
31,172,44,6,38,1,37,1,17,4,3,1,1,0,1,0,9
31,173,209,27,182,3,179,10,32,31,40,2,0,1,10,0,53
31,174,418,70,348,6,342,14,61,44,39,1,1,0,26,6,150
31,175,469,65,404,9,395,4,86,76,43,7,1,1,36,6,135
31,176,160,37,123,0,123,0,22,42,13,3,1,0,10,2,30
31,177,130,22,108,2,106,4,18,25,11,1,0,0,3,1,43
31,178,173,37,136,4,132,0,28,10,13,2,0,0,11,5,63
31,179,276,24,252,4,248,21,33,35,41,7,3,0,21,3,84
31,180,92,13,79,1,78,3,14,28,4,0,0,0,7,1,21
31,181,1233,96,1137,20,1117,30,256,255,131,12,3,2,102,18,308
31,182,3581,495,3086,54,3032,60,610,702,380,36,15,5,212,40,972
31,183,231,47,184,7,177,2,43,29,27,0,1,0,13,6,56
31,184,1315,122,1193,21,1172,33,139,322,128,9,1,4,120,18,398
31,185,98,5,93,3,90,3,10,20,7,0,1,0,11,2,36
31,186,2251,430,1821,40,1781,33,364,374,228,26,5,3,112,31,605
31,187,7691,953,6738,119,6619,140,1198,1333,853,73,29,13,673,126,2181
31,188,3178,303,2875,40,2835,52,519,612,325,28,16,10,330,50,893
31,189,151,19,132,3,129,7,14,28,25,3,1,2,19,0,30
31,190,240,41,199,2,197,8,31,51,23,1,1,0,18,3,61
31,191,97,20,77,3,74,3,15,18,12,1,0,0,1,1,23
31,192,615,66,549,7,542,28,72,126,66,2,3,2,56,3,184
31,193,1279,170,1109,12,1097,28,252,188,133,17,3,2,125,12,337
31,194,116,11,105,0,105,7,27,18,9,5,0,1,12,4,22
31,195,26,0,26,1,25,4,3,5,5,0,0,0,3,1,4
31,196,198,24,174,2,172,5,67,30,15,1,0,0,18,2,34
31,197,323,51,272,6,266,3,72,35,29,4,1,0,28,4,90
31,198,105,15,90,2,88,2,19,11,14,1,0,1,8,1,31
31,199,189,33,156,3,153,2,14,38,27,0,1,0,18,1,52
31,200,77,10,67,2,65,3,18,6,11,0,0,1,4,1,21
31,201,50,7,43,1,42,0,11,7,6,0,0,0,2,2,14
31,202,3998,538,3460,58,3402,73,771,778,417,48,19,9,298,55,934
31,203,5875,670,5205,98,5107,119,929,1086,634,65,22,14,537,89,1612
31,204,59,6,53,3,50,2,8,4,5,1,0,0,6,0,24
31,205,1989,299,1690,32,1658,21,332,398,234,18,10,3,137,21,484
31,206,790,116,674,15,659,9,168,162,96,15,2,3,51,9,144
31,207,79,12,67,0,67,2,11,11,15,3,0,0,3,0,22
31,208,249,49,200,1,199,12,43,25,25,2,1,1,14,1,75
31,209,134,15,119,2,117,1,33,19,10,3,0,1,10,1,39
31,210,947,103,844,26,818,28,124,149,123,7,2,4,66,13,302
31,211,550,53,497,14,483,7,118,111,64,5,3,1,41,8,125
31,212,1081,99,982,16,966,10,185,272,106,13,6,2,104,13,255
31,213,150,33,117,6,111,3,9,19,14,3,0,2,13,1,47
31,215,415,41,374,7,367,12,48,110,49,7,3,2,26,2,108
31,216,211,28,183,5,178,5,36,49,16,2,2,1,10,5,52
31,217,83,20,63,1,62,2,6,16,7,0,0,0,3,2,26
31,218,113,31,82,3,79,1,14,11,15,0,0,0,5,0,33
31,219,311,47,264,5,259,2,54,58,36,3,0,1,11,3,91
31,220,208,15,193,0,193,5,26,55,23,1,3,0,23,6,51
31,221,99,23,76,1,75,0,5,25,10,0,0,0,5,0,30
31,222,57,15,42,0,42,0,9,8,4,1,0,0,11,1,8
31,223,49,5,44,1,43,3,8,13,4,0,0,2,3,3,7
31,224,955,233,722,13,709,8,127,120,99,11,5,2,46,5,286
31,225,128,20,108,1,107,10,17,19,18,3,1,0,8,2,29
31,226,69,8,61,1,60,5,8,15,7,0,0,1,11,1,12
31,227,730,68,662,11,651,25,54,210,74,3,0,2,87,11,185
31,228,1375,145,1230,25,1205,31,174,293,196,19,5,4,128,21,334
31,229,495,67,428,6,422,6,89,87,55,9,3,2,35,12,124
31,230,2544,250,2294,36,2258,39,332,542,300,30,5,7,210,51,742
31,231,422,47,375,7,368,12,74,63,75,3,0,0,22,1,118
31,232,5352,765,4587,92,4495,87,875,1022,552,69,15,22,413,66,1374
31,233,720,63,657,7,650,10,123,133,68,6,5,0,76,8,221
31,234,273,29,244,4,240,4,39,58,28,5,2,1,30,8,65
31,235,70,17,53,1,52,1,12,14,6,1,0,0,1,1,16
31,236,78,11,67,2,65,1,11,12,8,3,1,0,8,0,21
31,237,187,37,150,5,145,1,40,27,19,1,2,0,16,2,37
31,238,392,61,331,6,325,10,65,50,59,3,0,2,27,6,103
31,239,1398,185,1213,27,1186,18,221,253,138,17,8,2,79,23,427
31,240,323,36,287,3,284,9,32,86,33,3,1,1,30,3,86
31,241,284,43,241,4,237,6,32,72,44,2,1,0,9,2,69
31,242,23,4,19,1,18,0,1,3,2,1,0,0,2,0,9
31,243,86,7,79,0,79,5,12,20,8,0,0,0,6,0,28
31,244,324,60,264,7,257,9,40,65,25,3,2,0,16,6,91
31,245,203,20,183,7,176,2,31,31,23,2,0,0,14,4,69
31,246,735,124,611,15,596,9,167,112,58,4,3,1,37,11,194
31,247,1080,206,874,22,852,15,154,179,110,11,3,1,78,14,287
31,248,3751,438,3313,65,3248,73,579,646,408,39,15,6,257,62,1163
31,249,730,77,653,7,646,29,108,115,83,10,1,1,68,8,223
31,250,488,102,386,8,378,12,109,67,68,7,1,0,33,4,77
31,251,115,20,95,3,92,0,25,22,5,1,0,2,5,0,32
31,252,1385,145,1240,20,1220,29,244,262,166,16,4,1,108,19,371
31,253,1545,175,1370,17,1353,26,330,235,156,19,7,5,149,32,394
31,254,2308,314,1994,36,1958,60,220,475,265,29,7,3,235,26,638
31,255,287,45,242,4,238,10,38,58,33,3,0,2,29,11,54
31,256,204,15,189,3,186,6,34,37,21,8,0,1,14,8,57
31,258,162,22,140,2,138,6,22,34,17,1,0,0,15,2,41
31,259,1375,124,1251,20,1231,51,123,349,142,14,1,3,140,13,395
31,260,79,15,64,0,64,4,14,8,13,2,0,0,5,0,18
31,261,705,86,619,10,609,15,139,148,74,7,2,0,61,14,149
31,262,294,38,256,2,254,8,44,42,38,4,1,0,24,7,86
31,263,1827,198,1629,35,1594,29,337,313,187,21,9,4,124,28,542
31,264,318,21,297,5,292,4,45,75,43,5,2,0,21,9,88
31,265,189,23,166,2,164,7,23,40,25,3,0,0,10,7,49
31,266,148,22,126,5,121,4,34,14,22,3,1,1,19,7,16
31,267,49,6,43,1,42,0,3,8,8,0,1,0,9,0,13
31,268,122,20,102,1,101,1,17,13,21,1,0,0,9,1,38
31,269,933,91,842,21,821,23,180,191,105,10,6,0,77,14,215
31,270,785,109,676,9,667,4,128,157,86,3,0,2,57,15,215
31,271,1362,179,1183,20,1163,47,183,257,149,10,5,5,146,23,338
31,272,56,7,49,0,49,2,6,8,16,3,0,0,7,0,7
31,273,2160,220,1940,39,1901,32,283,567,196,11,8,2,185,27,590
31,274,158,22,136,7,129,2,30,26,16,2,0,0,8,0,45
31,275,110,19,91,1,90,1,17,18,8,0,0,0,13,2,31
31,276,319,72,247,2,245,2,48,62,33,4,2,1,20,0,73
31,277,703,76,627,11,616,18,124,126,74,11,3,1,56,16,187
31,278,277,47,230,4,226,9,33,33,35,3,1,0,14,0,98
31,279,73,16,57,2,55,3,10,12,10,3,0,0,3,4,10
31,280,267,40,227,4,223,12,46,45,45,5,0,1,16,3,50
31,281,960,138,822,9,813,21,175,111,125,14,4,1,95,11,256
31,282,5335,906,4429,68,4361,92,732,1050,614,51,13,10,386,65,1348
31,283,236,35,201,3,198,8,46,50,22,3,2,0,21,2,44
31,284,1053,68,985,19,966,23,141,269,93,9,0,3,120,17,291
31,285,552,48,504,5,499,22,84,171,50,2,4,0,41,12,113
31,286,490,81,409,7,402,7,103,101,57,8,1,2,27,7,89
31,287,1925,225,1700,38,1662,39,356,370,205,16,7,3,133,37,496
31,288,288,46,242,1,241,2,59,57,21,2,0,0,24,3,73
31,289,197,45,152,2,150,3,23,25,17,1,0,0,10,4,67
31,290,42,3,39,1,38,0,2,7,8,0,0,0,2,1,18
31,291,5680,694,4986,69,4917,112,835,1077,593,48,30,18,507,89,1608
31,292,50,11,39,2,37,1,9,2,12,0,0,0,4,1,8
31,293,1739,263,1476,24,1452,14,334,284,186,19,7,3,110,22,473
31,294,87,20,67,0,67,1,17,14,8,0,0,0,5,2,20
31,295,81,9,72,1,71,0,14,24,4,3,0,0,6,4,16
31,296,346,50,296,4,292,6,62,43,50,7,5,1,15,3,100
31,297,1341,163,1178,15,1163,39,184,226,140,16,5,2,127,16,408
31,298,72,12,60,2,58,0,10,14,12,1,0,0,3,2,16
31,299,2534,376,2158,31,2127,38,487,449,278,24,7,7,189,44,604
31,300,121,22,99,3,96,0,18,31,8,0,0,1,7,1,30
31,301,103,10,93,5,88,3,8,26,9,0,0,0,13,2,27
31,302,218,38,180,1,179,1,38,43,18,0,4,1,12,3,59
31,303,1965,254,1711,32,1679,30,428,348,217,29,7,8,105,18,489
31,304,321,30,291,8,283,19,39,35,58,5,0,1,26,3,97
31,305,179,23,156,9,147,4,21,33,21,5,1,0,12,2,48
31,306,115,27,88,2,86,2,5,18,18,0,0,0,3,0,40
31,307,42,6,36,1,35,0,7,13,2,1,0,0,2,2,8
31,308,55,6,49,1,48,0,3,9,4,0,0,0,1,0,31
31,309,188,18,170,7,163,1,37,39,20,2,1,0,13,5,45
31,310,197,22,175,2,173,3,32,31,24,3,1,1,14,2,62
31,311,658,40,618,14,604,11,125,157,71,5,3,0,54,15,163
31,312,46,7,39,0,39,3,6,9,3,1,0,0,1,0,16
31,313,130,18,112,0,112,6,17,21,20,1,2,0,11,2,32
31,314,333,48,285,6,279,3,55,58,39,8,3,1,20,4,88
31,315,803,156,647,7,640,8,124,153,59,11,2,2,46,6,229
31,316,455,88,367,3,364,4,61,49,72,2,2,1,13,2,158
31,317,307,46,261,5,256,8,59,31,37,2,1,1,17,4,96
31,318,153,16,137,1,136,3,30,21,27,4,0,0,17,4,30
31,319,89,20,69,0,69,4,15,10,6,0,0,0,3,1,30
31,320,809,100,709,14,695,16,144,155,84,16,4,0,46,15,215
31,321,143,21,122,7,115,5,26,20,21,2,0,0,11,2,28
31,322,49,5,44,1,43,0,5,16,5,1,0,0,4,0,12
31,323,278,27,251,1,250,6,54,46,43,2,1,1,10,7,80
31,324,1855,349,1506,33,1473,29,330,311,154,16,5,1,121,26,480
31,325,159,14,145,3,142,2,21,33,16,3,0,0,25,4,38
31,326,73,9,64,4,60,3,14,8,6,0,1,0,7,0,21
31,327,150,22,128,4,124,4,28,20,21,2,1,0,11,0,37
31,328,206,19,187,3,184,8,26,52,16,1,0,0,19,6,56
31,329,147,20,127,3,124,0,28,27,12,3,1,1,12,1,39
31,330,298,26,272,5,267,13,64,41,30,1,0,2,24,3,89
31,331,242,23,219,6,213,7,39,46,29,2,0,1,23,2,64
31,332,182,26,156,5,151,6,18,55,28,1,0,0,11,1,31
31,333,52,4,48,3,45,0,16,11,2,0,1,0,1,0,14
31,334,871,98,773,16,757,13,138,169,115,7,5,1,68,22,219
31,335,42,8,34,0,34,2,6,2,7,2,0,0,2,0,13
31,336,502,57,445,9,436,13,61,76,69,2,0,0,36,1,178
31,337,180,43,137,2,135,2,25,44,28,0,2,0,11,3,20
31,338,431,56,375,6,369,13,49,67,47,3,4,2,37,10,137
31,339,349,37,312,3,309,16,50,66,51,7,1,0,36,5,77
31,340,203,16,187,4,183,1,17,83,12,1,0,1,30,1,37
31,341,3132,358,2774,53,2721,57,602,642,317,40,6,5,253,58,741
31,342,169,27,142,1,141,5,36,22,25,3,1,0,8,1,40
31,343,58,6,52,1,51,3,9,11,4,0,0,0,5,0,19
31,344,559,84,475,8,467,3,98,72,73,6,1,2,33,7,172
31,345,1507,253,1254,33,1221,22,313,256,169,15,11,4,71,18,342
31,346,539,64,475,20,455,8,110,76,68,7,4,1,38,8,135
31,347,142,17,125,6,119,0,38,29,10,0,1,1,3,0,37
31,348,58,11,47,1,46,0,9,10,9,0,0,0,1,0,17
31,349,640,74,566,13,553,9,139,78,85,8,2,0,36,10,186
31,350,67,16,51,0,51,3,6,5,10,0,1,0,5,0,21
31,351,2666,314,2352,49,2303,46,382,502,283,31,10,9,270,52,718
31,352,192,8,184,0,184,4,34,53,13,2,0,0,28,1,49
31,353,64,6,58,0,58,4,8,8,11,0,0,1,5,5,16
31,354,41,4,37,3,34,0,3,10,2,0,0,0,8,0,11
31,355,1205,108,1097,14,1083,24,142,318,99,9,4,1,162,15,309
31,356,1180,134,1046,26,1020,33,189,222,110,9,5,2,104,24,322
31,357,267,42,225,4,221,10,29,27,18,5,0,1,24,5,102
31,358,2364,318,2046,32,2014,52,288,564,229,17,12,4,207,39,602
31,359,58,4,54,3,51,2,10,14,2,0,0,0,4,5,14
31,360,380,109,271,7,264,9,47,65,31,3,0,1,18,4,86
31,361,381,35,346,8,338,8,77,61,49,4,0,1,17,6,115
31,362,182,23,159,3,156,4,30,26,29,3,0,0,16,7,41
31,363,171,17,154,4,150,3,29,16,19,2,0,0,20,6,55
31,364,1972,211,1761,30,1731,35,305,422,226,13,8,1,180,21,520
31,365,349,76,273,7,266,31,38,30,68,6,0,0,20,4,69
31,366,450,31,419,5,414,21,54,79,56,5,0,2,39,2,156
31,367,84,6,78,1,77,2,17,18,8,1,2,0,6,0,23
31,368,161,18,143,2,141,5,31,26,11,1,2,0,8,13,44
31,369,36,4,32,0,32,3,3,16,1,0,0,0,2,0,7
31,370,122,4,118,3,115,2,27,29,10,2,0,0,7,6,32
31,371,384,52,332,16,316,14,80,61,46,6,5,2,24,4,74
31,372,415,65,350,10,340,4,72,68,44,1,2,0,34,6,109
31,373,118,18,100,3,97,4,18,2,22,2,0,0,13,3,33
31,374,748,72,676,15,661,12,125,121,72,10,2,1,63,16,239
31,375,2285,320,1965,34,1931,65,333,318,284,29,12,6,165,31,688
31,376,93,10,83,2,81,3,21,16,9,0,0,0,4,1,27
31,377,464,35,429,8,421,11,68,75,60,5,1,2,34,7,158
31,378,57,4,53,3,50,6,9,6,7,0,0,0,3,0,19
31,379,119,10,109,4,105,2,20,31,12,0,0,0,8,3,29
31,380,326,40,286,7,279,11,30,57,34,6,6,2,23,2,108
31,381,1694,204,1490,20,1470,39,202,319,184,22,10,6,154,23,511
31,382,80,10,70,1,69,2,12,15,6,0,0,0,10,0,24
31,383,963,139,824,12,812,17,186,181,94,7,0,1,73,21,232
31,384,853,69,784,19,765,24,101,155,115,13,2,2,80,14,259
31,385,194,24,170,5,165,5,24,13,41,1,1,0,10,0,70
31,386,131,17,114,2,112,1,33,18,15,3,1,1,6,1,33
31,387,95,13,82,1,81,0,18,21,12,0,2,0,8,1,19
31,388,298,29,269,3,266,5,30,72,36,2,3,2,29,5,82
31,389,2980,330,2650,43,2607,77,389,646,271,32,7,2,260,61,862
31,390,2031,468,1563,20,1543,15,293,319,243,14,6,0,107,21,525
31,391,382,60,322,9,313,6,54,75,33,1,3,2,29,6,104
31,392,53,5,48,0,48,1,15,18,4,0,2,0,0,1,7
31,393,130,15,115,0,115,0,13,22,20,1,1,0,6,0,52
31,394,130,16,114,4,110,0,25,31,19,0,0,0,7,0,28
31,395,16096,2950,13146,220,12926,303,2531,3066,1534,144,66,26,1185,217,3854
31,396,1771,213,1558,23,1535,50,258,339,204,16,9,7,136,28,488
31,397,48,13,35,1,34,1,2,11,8,0,0,0,6,0,6
31,398,69,16,53,1,52,0,8,7,3,2,0,1,0,4,27
31,399,1965,277,1688,24,1664,31,374,390,203,23,9,4,107,31,492
31,400,70,8,62,4,58,4,15,7,6,0,0,0,9,6,11
31,401,258,31,227,4,223,12,34,35,40,5,2,1,19,2,73
31,402,620,58,562,10,552,12,57,158,53,4,1,2,68,9,188
31,403,503,73,430,3,427,8,92,97,61,4,1,0,45,11,108
31,404,99,13,86,2,84,0,10,15,12,0,0,0,14,0,33
31,405,100,9,91,1,90,4,11,17,14,0,0,0,9,2,33
31,406,619,87,532,7,525,7,101,102,65,3,6,0,41,13,187
31,407,891,95,796,23,773,20,140,174,106,7,4,1,89,18,214
31,408,70,8,62,2,60,0,11,19,4,1,1,0,6,0,18
31,409,1480,165,1315,19,1296,44,123,249,150,6,5,0,200,21,498
31,410,2854,361,2493,46,2447,56,397,556,326,32,8,5,247,35,785
31,411,653,79,574,5,569,20,44,168,51,5,1,3,88,9,180
31,412,212,31,181,7,174,2,38,37,32,2,0,0,23,2,38
31,413,379,55,324,4,320,9,75,62,29,10,0,0,33,7,95
31,414,75,10,65,2,63,0,20,7,9,1,1,0,5,1,19
31,415,78,3,75,1,74,1,11,13,8,0,0,0,6,1,34
31,416,368,30,338,7,331,9,84,49,56,7,0,0,21,5,100
31,417,6509,1013,5496,83,5413,190,647,1432,628,51,19,20,669,92,1665
31,418,810,111,699,12,687,14,93,306,47,4,1,1,66,8,147
31,419,144,28,116,3,113,0,26,31,19,0,1,0,9,1,26
31,420,2017,236,1781,35,1746,41,338,409,221,18,10,3,124,30,552
31,421,3532,552,2980,60,2920,63,578,522,372,30,10,3,244,29,1069
31,422,93,14,79,0,79,3,20,17,16,1,0,0,5,0,17
31,423,234,42,192,4,188,3,52,41,16,0,2,0,2,4,68
31,424,12206,1799,10407,185,10222,284,1541,2152,1383,103,46,31,1083,173,3426
31,425,385,50,335,9,326,8,68,35,66,5,5,0,29,5,105
31,426,565,89,476,10,466,3,110,55,59,7,1,0,30,7,194
31,427,724,109,615,16,599,9,139,94,70,12,3,3,50,11,208
31,428,56,11,45,0,45,3,9,3,4,1,0,0,3,0,22
31,429,1453,160,1293,32,1261,43,120,303,132,17,1,4,165,20,456
31,430,506,77,429,11,418,5,94,71,60,3,1,0,35,6,143
31,431,85,12,73,1,72,0,13,17,4,1,0,0,8,0,29
31,432,36,4,32,1,31,1,0,7,8,1,0,0,4,0,10
31,433,6504,901,5603,76,5527,109,1036,1194,768,62,26,11,369,70,1882
31,434,66,12,54,4,50,0,4,12,17,0,0,0,3,0,14
31,435,683,84,599,11,588,25,141,115,96,16,4,1,48,10,132
31,436,301,29,272,3,269,1,52,38,51,6,1,0,20,4,96
31,437,84,10,74,1,73,2,5,17,11,3,0,0,12,1,22
31,438,185,15,170,4,166,3,39,44,15,2,2,0,21,2,38
31,439,483,39,444,10,434,15,70,138,33,5,1,0,56,6,110
31,440,52,10,42,0,42,5,9,2,8,1,1,0,0,3,13
31,441,127,8,119,5,114,6,15,32,11,2,1,0,3,2,42
31,442,321,27,294,7,287,8,64,58,44,7,3,1,21,6,75
31,443,260,45,215,28,187,5,41,44,16,2,1,1,17,9,51
31,444,97,10,87,0,87,3,20,16,13,2,1,0,7,0,25
31,445,4012,386,3626,60,3566,70,503,1041,329,31,7,7,418,59,1101
31,446,9195,1673,7522,93,7429,359,669,1590,1034,80,26,24,729,117,2801
31,447,60,5,55,0,55,3,13,6,6,0,0,0,9,3,15
31,448,362,24,338,4,334,12,46,83,34,5,2,1,39,6,106
31,449,123,20,103,3,100,4,15,23,11,0,0,0,4,1,42
31,450,340,24,316,6,310,4,65,61,41,3,2,0,27,3,104
31,451,7144,1133,6011,140,5871,138,1072,1479,654,87,31,20,525,110,1755
31,452,41,8,33,1,32,2,3,2,3,0,0,0,4,0,18
31,453,110,5,105,2,103,4,22,19,12,1,2,0,9,1,33
31,454,2314,287,2027,35,1992,50,451,466,200,24,15,6,169,39,572
31,455,1768,255,1513,30,1483,34,313,298,198,21,9,10,113,23,464
31,456,37,4,33,1,32,0,2,4,4,0,0,0,2,0,20
31,457,649,109,540,12,528,10,109,100,87,7,1,1,36,10,167
31,458,2813,476,2337,36,2301,63,417,549,266,26,11,7,207,30,725
31,459,545,50,495,6,489,25,86,120,63,6,4,0,39,7,139
31,460,3116,374,2742,49,2693,32,469,618,311,27,7,5,232,49,943
31,461,232,36,196,2,194,5,40,20,36,4,1,0,22,2,64
31,462,1457,153,1304,27,1277,42,172,491,88,4,2,1,141,26,310
31,463,199,33,166,2,164,4,47,29,13,2,2,0,10,3,54
31,464,222,29,193,3,190,4,51,41,17,2,2,0,16,1,56
31,465,26,2,24,0,24,2,1,7,5,1,0,0,5,0,3
31,466,563,61,502,16,486,7,98,123,53,6,0,0,56,11,132
31,467,4351,668,3683,59,3624,63,720,784,507,47,23,11,270,59,1140
31,468,169,34,135,10,125,5,28,34,19,0,2,0,16,5,16
31,469,147,27,120,3,117,4,14,11,16,2,1,0,7,1,61
31,470,98,19,79,2,77,5,7,13,17,1,0,0,12,1,21
31,471,313,57,256,2,254,0,46,51,57,2,3,0,14,6,75
31,472,239,35,204,5,199,4,28,44,22,1,1,1,12,3,83
31,473,263,26,237,2,235,7,57,43,31,4,4,0,23,6,60
31,474,248,31,217,4,213,3,57,35,25,9,3,1,12,1,67
31,475,843,85,758,12,746,13,164,157,97,11,0,1,80,21,202
31,476,581,91,490,5,485,7,91,111,68,3,1,1,36,8,159
31,477,46,6,40,0,40,1,7,5,2,2,0,0,4,0,19
31,478,1085,169,916,21,895,28,160,208,124,18,6,3,65,14,269
31,479,56,15,41,3,38,0,7,13,5,0,0,0,9,0,4
31,480,1570,153,1417,20,1397,40,173,290,195,9,3,4,148,33,502
31,481,1456,184,1272,15,1257,34,300,243,167,20,3,5,96,23,366
31,482,174,21,153,2,151,9,12,26,31,2,1,2,16,1,51
31,483,8278,1860,6418,118,6300,101,1265,1574,656,69,27,12,512,88,1996
31,484,1624,155,1469,23,1446,35,228,364,140,16,2,2,180,20,459
31,485,82,20,62,1,61,2,8,12,11,4,0,0,6,1,17
31,486,734,81,653,13,640,16,135,127,98,5,2,2,51,13,191
31,487,196,25,171,2,169,1,29,41,16,1,0,0,7,5,69
31,488,7783,1230,6553,81,6472,166,840,1704,710,56,24,20,658,107,2187
31,489,270,33,237,2,235,6,28,67,32,1,1,0,25,9,66
31,490,3791,656,3135,56,3079,45,733,760,391,32,14,4,249,48,803
31,491,325,40,285,3,282,7,40,48,50,5,4,0,25,3,100
31,492,370,33,337,7,330,8,81,48,58,8,1,0,25,2,99
31,493,109,11,98,8,90,1,17,9,10,1,0,0,4,1,47
31,494,159,32,127,5,122,0,20,31,13,3,2,1,14,1,37
31,495,869,103,766,3,763,22,130,133,100,13,3,2,87,19,254
31,496,231,28,203,3,200,6,30,36,31,1,2,1,21,6,66
31,497,1349,144,1205,15,1190,22,219,308,142,16,4,0,120,25,334
31,498,35,4,31,0,31,2,5,10,3,1,0,0,1,0,9
31,499,5875,972,4903,88,4815,107,941,964,638,54,26,11,446,94,1534
31,500,473,85,388,12,376,5,78,101,41,2,2,1,36,7,103
31,501,372,33,339,3,336,9,64,115,47,5,0,0,34,7,55
31,502,329,46,283,9,274,6,38,45,51,3,0,1,21,7,102
31,503,683,105,578,9,569,12,141,80,79,12,7,1,32,8,197
31,504,184,32,152,5,147,1,31,27,23,4,2,0,9,2,48
31,505,280,54,226,4,222,2,43,48,40,4,0,0,14,6,65
31,506,8479,973,7506,118,7388,218,927,1991,936,77,21,22,796,90,2310
31,507,785,79,706,10,696,18,138,146,111,7,2,1,51,14,208
31,508,52,7,45,2,43,1,6,9,7,0,0,1,6,0,13
31,509,159,36,123,1,122,1,15,27,21,3,0,0,5,3,47
31,510,111,15,96,0,96,0,20,18,12,1,0,0,5,2,38
31,511,199,16,183,5,178,7,32,42,20,4,0,1,13,2,57
31,512,531,51,480,12,468,22,60,118,59,5,0,1,54,7,142
31,513,315,51,264,7,257,2,33,70,27,0,3,0,18,7,97
31,514,66,10,56,2,54,0,2,16,5,4,0,0,4,1,22
31,515,334,31,303,3,300,5,84,67,44,1,0,1,22,7,69
31,516,1237,116,1121,18,1103,17,221,287,124,15,5,4,98,33,299
31,517,1392,160,1232,22,1210,37,260,227,162,12,9,2,73,22,406
31,518,460,79,381,6,375,8,63,71,57,9,7,1,35,8,116
31,519,135,10,125,0,125,1,20,21,27,1,0,0,8,2,45
31,520,93,15,78,1,77,1,15,12,10,1,3,0,1,1,33
31,521,338,50,288,4,284,6,60,65,34,3,4,1,32,4,75
31,522,56,13,43,1,42,1,8,6,4,0,0,0,4,2,17
31,523,1382,342,1040,33,1007,24,183,226,142,16,2,2,64,21,327
31,524,104,11,93,5,88,0,6,18,15,0,1,0,12,3,33
31,525,414,67,347,8,339,6,86,46,70,2,4,0,24,9,92
31,526,5323,715,4608,65,4543,109,756,877,515,55,27,10,460,93,1641
31,527,106,12,94,2,92,4,15,13,8,1,1,1,10,2,37
31,528,123,9,114,0,114,5,16,14,21,2,1,0,9,5,41
31,529,93,14,79,1,78,1,13,14,13,1,1,0,7,3,25
31,530,160,16,144,4,140,3,32,21,22,2,2,1,10,0,47
31,531,71,10,61,4,57,4,9,17,7,0,0,0,4,0,16
31,532,67,14,53,0,53,4,7,4,4,3,0,0,3,0,28
31,533,1350,130,1220,16,1204,34,218,302,119,15,7,3,113,23,370
31,534,156,26,130,1,129,2,21,40,14,0,0,0,13,4,35
31,535,566,96,470,7,463,15,100,86,58,3,2,1,30,4,164
31,536,251,32,219,7,212,3,54,43,19,5,0,0,31,4,53
31,537,124,19,105,1,104,0,35,21,4,1,1,0,8,6,28
31,538,166,21,145,2,143,3,37,27,19,4,0,0,12,1,40
31,539,59,14,45,1,44,0,1,13,6,0,1,0,3,2,18
31,540,162,14,148,6,142,3,34,40,14,0,1,2,6,3,39
31,541,1863,230,1633,17,1616,38,253,508,163,7,7,5,177,16,442
31,542,185,36,149,1,148,2,34,40,9,0,1,0,10,1,51
31,543,88,9,79,3,76,0,12,14,12,2,0,0,6,1,29
31,544,204,23,181,2,179,9,31,36,29,4,1,0,17,0,52
31,545,187,31,156,3,153,1,26,17,21,0,0,2,21,3,62
31,546,88,7,81,1,80,2,17,18,16,1,1,0,8,0,17
31,547,4802,630,4172,77,4095,77,867,866,483,48,9,10,348,68,1319
31,548,54,6,48,1,47,0,6,14,11,0,1,0,1,0,14
31,549,23,6,17,1,16,0,0,1,1,1,0,0,3,1,9
31,550,468,65,403,8,395,6,59,62,47,4,2,4,23,5,183
31,551,287,24,263,5,258,12,37,63,33,0,3,0,17,2,91
31,552,129,30,99,2,97,3,23,11,16,4,2,0,17,0,21
31,553,791,102,689,14,675,16,134,124,90,9,1,5,76,14,206
31,554,192,36,156,3,153,2,41,36,17,2,2,0,10,5,38
31,555,249386,56033,193353,2642,190711,8241,19714,44092,30339,1932,672,460,17232,2340,65689
31,556,324,50,274,6,268,6,79,51,32,4,1,0,17,1,77
31,557,19345,2825,16520,254,16266,510,2074,4055,1737,147,42,47,1794,219,5641
31,558,164,15,149,3,146,3,24,20,23,7,1,0,11,1,56
31,559,18,3,15,0,15,0,0,4,2,0,0,0,4,0,5
31,560,327,27,300,5,295,8,48,60,39,4,1,1,33,2,99
31,561,10194,1511,8683,130,8553,218,1186,2373,898,70,30,22,804,133,2819
31,562,124,18,106,5,101,2,21,3,22,3,0,0,24,2,24
31,563,952,119,833,8,825,17,137,231,82,6,5,2,85,10,250
31,564,148,22,126,9,117,3,15,40,11,1,0,1,10,2,34
31,565,659,92,567,6,561,14,84,107,79,6,2,3,45,9,212
31,566,373,21,352,6,346,15,61,81,36,5,5,1,21,7,114
31,567,292,29,263,3,260,6,48,72,24,1,1,0,27,8,73
31,568,193,20,173,8,165,2,24,37,20,0,0,1,26,1,54
31,569,298,33,265,8,257,10,60,57,46,2,0,0,25,10,47
31,570,238,36,202,1,201,0,56,45,25,5,0,1,15,5,49
31,571,179,18,161,4,157,2,34,33,26,1,0,0,11,3,47
31,572,1960,221,1739,45,1694,49,250,377,286,17,7,6,154,27,521
31,573,2353,278,2075,38,2037,45,348,479,284,19,7,3,182,39,631
31,574,1640,181,1459,28,1431,24,259,259,207,20,3,2,115,35,507
31,575,923,97,826,7,819,17,54,402,47,6,0,0,79,8,206
31,576,208,26,182,5,177,11,29,36,20,3,1,0,18,5,54
31,577,114,25,89,1,88,3,10,13,11,0,0,0,7,1,43
31,578,858,116,742,5,737,32,60,266,57,7,0,2,102,8,203
31,579,562,65,497,5,492,9,96,121,69,7,3,3,55,3,126
31,580,640,75,565,11,554,8,107,124,63,5,6,4,48,12,177
31,581,1005,103,902,15,887,24,216,169,121,12,4,3,58,11,269
31,582,3077,447,2630,46,2584,52,453,544,275,27,17,5,192,39,980
31,583,790,91,699,10,689,11,182,191,58,4,5,3,44,13,178
31,584,4220,849,3371,70,3301,57,755,789,402,44,22,9,243,62,918
31,585,1303,153,1150,31,1119,24,225,306,95,9,4,0,122,14,320
31,586,485,102,383,6,377,3,92,70,44,2,2,0,23,3,138
31,587,922,104,818,14,804,21,168,179,101,11,4,3,63,11,243
31,588,6538,919,5619,103,5516,127,947,1306,655,57,16,16,492,84,1816
31,589,948,105,843,26,817,22,140,177,102,7,2,1,63,19,284
31,590,45,5,40,1,39,1,9,2,8,1,1,0,2,0,15
31,591,83,9,74,1,73,2,15,15,10,0,1,0,10,1,19
31,592,1182,173,1009,19,990,27,212,206,110,14,10,3,101,25,282
31,593,75,13,62,0,62,2,20,12,5,2,0,0,1,1,19
32,1,597,89,508,15,493,6,76,117,46,5,4,1,48,12,178
32,2,86,10,76,0,76,5,11,17,13,1,0,0,7,3,19
32,3,56,4,52,0,52,2,9,16,6,1,0,0,8,1,9
32,4,115,13,102,2,100,2,10,24,14,1,1,0,13,0,35
32,5,244,29,215,12,203,1,25,55,20,2,1,0,26,4,69
32,7,162,22,140,2,138,4,33,16,18,3,0,0,12,4,48
32,8,70,12,58,0,58,2,10,8,7,0,1,1,10,1,18
32,9,61,6,55,1,54,2,13,22,1,0,1,0,6,0,9
32,10,76,8,68,1,67,2,9,14,6,2,1,0,11,0,22
32,12,856,94,762,22,740,10,123,166,73,7,4,3,84,18,252
32,13,15393,2931,12462,262,12200,315,1458,2666,1690,149,59,22,1064,147,4630
32,14,89,10,79,0,79,2,14,11,10,2,0,0,11,2,27
32,15,82,9,73,3,70,0,12,16,11,0,0,0,8,1,22
32,16,498,52,446,10,436,12,70,108,56,10,5,0,50,4,121
32,17,107,10,97,6,91,0,5,37,4,0,0,0,8,3,34
32,18,146,14,132,2,130,8,18,17,21,3,0,0,9,4,50
32,19,442,44,398,13,385,9,45,82,33,7,2,1,48,4,154
32,20,184,21,163,2,161,2,26,63,11,3,1,0,11,1,43
32,21,43,3,40,2,38,0,3,12,13,0,0,0,4,0,6
32,22,124,15,109,2,107,0,12,30,16,1,0,0,13,6,29
32,23,63,7,56,1,55,1,8,18,6,0,0,0,6,0,16
32,24,133,19,114,2,112,0,24,39,15,2,0,0,5,3,24
32,25,122,26,96,2,94,4,13,21,14,4,0,0,11,0,27
32,26,103,17,86,4,82,1,8,22,18,3,0,0,6,1,23
32,27,1064,123,941,23,918,10,114,220,100,12,3,0,112,20,327
32,28,116,13,103,3,100,0,20,29,8,0,0,0,11,4,28
32,29,513,61,452,5,447,10,69,116,41,3,0,3,49,10,146
32,30,102,16,86,4,82,0,8,26,9,0,0,0,18,6,15
32,31,127,11,116,1,115,0,23,39,4,3,0,0,7,3,36
32,32,277,34,243,5,238,4,23,81,31,3,0,2,27,3,64
32,33,86,6,80,0,80,8,19,28,6,0,1,0,3,2,13
32,34,51,9,42,0,42,2,8,10,1,4,1,0,4,0,12
32,35,235,35,200,3,197,1,29,60,25,1,0,0,18,2,61
32,36,503,78,425,8,417,15,56,86,61,10,4,2,52,3,128
32,37,123,11,112,0,112,1,20,32,8,0,0,0,10,2,39
32,38,135,11,124,2,122,1,22,37,9,1,1,1,10,0,40
32,39,88,13,75,1,74,3,9,11,21,2,0,0,3,3,22
32,40,115,13,102,0,102,0,13,39,13,0,0,1,10,0,26
32,41,125,16,109,1,108,4,10,24,10,0,3,0,17,3,37
32,42,120,14,106,2,104,6,13,32,12,0,0,0,6,3,32
32,43,126,15,111,5,106,1,24,20,9,1,1,0,9,5,36
32,44,300,49,251,3,248,2,59,69,17,7,2,0,19,5,68
32,45,350,35,315,14,301,3,61,56,30,7,3,0,28,7,106
32,46,179,22,157,1,156,3,18,29,18,4,1,0,21,5,57
32,47,94,13,81,3,78,5,11,29,4,0,0,0,13,3,13
32,48,75,9,66,1,65,1,12,11,7,2,1,0,11,2,18
32,49,63,9,54,2,52,0,17,15,4,2,0,0,3,0,11
32,50,100,20,80,1,79,1,11,3,11,0,0,0,12,2,39
32,51,93,11,82,1,81,2,12,23,6,2,1,0,4,0,31
32,52,103,10,93,3,90,0,15,11,10,1,0,0,15,1,37
32,53,154,27,127,2,125,7,13,31,21,2,0,1,12,0,38
32,54,303,35,268,6,262,7,51,60,22,2,1,2,34,2,81
32,55,99,5,94,2,92,4,15,31,11,0,0,0,12,1,18
32,56,36,3,33,0,33,2,3,9,4,1,0,0,2,1,11
32,57,114,17,97,1,96,4,7,26,8,0,0,0,13,1,37
32,58,48,10,38,0,38,2,1,14,3,0,0,0,6,0,12
32,59,118,18,100,2,98,3,14,17,29,0,1,0,7,1,26
32,60,138,17,121,0,121,3,15,26,14,2,3,1,11,1,45
32,61,125,9,116,7,109,3,18,45,11,0,2,0,13,4,13
32,62,152,16,136,0,136,4,17,59,13,1,0,0,17,3,22
32,63,143,16,127,2,125,6,13,39,20,0,1,0,9,1,36
32,64,333,47,286,4,282,2,70,70,28,6,3,0,38,2,63
32,65,184,20,164,2,162,6,31,46,21,4,0,1,16,4,33
32,66,201,13,188,5,183,3,34,53,11,3,2,0,21,4,52
32,67,41,4,37,0,37,0,1,8,4,0,0,0,14,0,10
32,68,110,13,97,2,95,2,15,14,23,1,0,0,5,1,34
32,69,60,5,55,0,55,0,9,19,8,0,0,0,1,2,16
32,70,147,15,132,1,131,0,33,40,18,2,0,0,3,3,32
32,71,157,14,143,2,141,2,25,42,22,2,1,1,11,0,35
32,72,39,10,29,2,27,1,10,9,2,0,0,0,2,0,3
32,73,164,12,152,6,146,4,21,48,14,3,1,0,12,3,40
32,74,47,5,42,2,40,1,3,12,4,1,0,0,4,2,13
32,75,169,19,150,3,147,2,29,35,12,2,1,0,17,11,38
32,76,433,45,388,11,377,14,60,80,74,2,1,0,40,7,99
32,77,72,13,59,1,58,1,13,7,6,1,0,0,4,1,25
32,78,182,14,168,7,161,5,31,45,22,1,1,1,17,1,37
32,79,827,131,696,23,673,15,117,154,71,4,7,1,82,8,214
32,80,137,17,120,2,118,6,26,40,7,0,1,0,8,1,29
32,81,115,15,100,2,98,3,17,20,13,2,0,1,11,0,31
32,82,251,25,226,6,220,9,37,85,22,1,1,0,22,5,38
32,83,740,75,665,18,647,7,77,145,83,7,2,1,54,9,262
32,84,56,4,52,0,52,1,6,29,3,0,0,0,7,0,6
32,85,130,10,120,3,117,2,24,31,14,1,1,0,8,3,33
32,86,84,12,72,3,69,0,4,16,10,1,2,1,13,2,20
32,87,83,10,73,1,72,2,10,20,7,1,1,0,0,2,29
32,88,273,37,236,6,230,7,51,57,27,6,3,0,32,8,39
32,89,202,29,173,7,166,1,35,31,28,1,0,0,11,9,50
32,90,242,23,219,2,217,9,43,63,25,0,0,0,15,5,57
32,91,270,16,254,7,247,6,39,53,31,2,2,0,20,3,91
32,92,87,12,75,5,70,0,21,19,2,0,1,0,3,4,20
32,93,106,12,94,3,91,3,11,23,11,2,0,0,10,2,29
32,94,345,37,308,3,305,4,36,75,44,1,1,0,31,3,110
32,95,471,63,408,13,395,5,81,107,40,6,2,1,33,14,106
32,96,1309,208,1101,33,1068,25,197,243,112,23,8,5,109,18,328
32,97,88,11,77,0,77,1,14,6,14,1,0,0,2,1,38
32,98,180,17,163,1,162,6,14,41,27,1,0,1,18,5,49
32,99,71,19,52,0,52,3,5,5,8,1,1,1,11,2,15
32,100,109,11,98,0,98,1,21,26,10,2,0,0,10,1,27
32,101,141,20,121,4,117,1,17,35,11,2,3,0,13,7,28
32,102,142,25,117,3,114,3,30,21,18,5,2,0,8,5,22
32,103,129,22,107,4,103,1,16,11,25,2,0,0,16,2,30
32,104,143,15,128,3,125,2,17,24,21,2,0,1,17,6,35
32,105,188,19,169,2,167,8,49,37,10,3,0,0,24,2,34
32,106,523,61,462,8,454,15,86,105,50,3,1,0,55,8,131
32,107,4992,856,4136,79,4057,74,663,1129,466,35,13,13,329,53,1282
32,108,100,16,84,2,82,5,16,19,6,0,0,0,12,3,21
32,109,181,28,153,3,150,2,41,22,25,2,1,2,14,3,38
32,110,275,37,238,7,231,2,41,45,24,1,2,1,19,7,89
32,111,31,5,26,3,23,0,1,11,2,1,1,0,3,0,4
32,112,204,28,176,1,175,3,26,41,20,5,0,0,14,0,66
32,113,70,13,57,0,57,0,9,18,8,0,0,0,12,0,10
32,114,110,17,93,2,91,1,21,28,13,2,1,0,11,1,13
32,115,275,36,239,2,237,2,31,83,33,2,1,0,28,7,50
32,116,121,11,110,3,107,4,15,17,19,2,0,1,20,3,26
32,117,657,72,585,8,577,7,54,124,74,4,4,0,58,13,239
32,118,133,17,116,1,115,3,13,25,20,1,0,1,12,2,38
32,119,2929,540,2389,66,2323,42,390,715,202,20,15,6,182,54,697
32,120,304,42,262,3,259,6,36,39,46,5,1,0,27,10,89
32,121,444,69,375,11,364,17,64,71,37,5,2,1,50,6,111
32,122,247,26,221,8,213,12,21,59,25,2,0,0,26,6,62
32,123,445,50,395,7,388,11,68,100,45,3,6,1,33,9,112
32,124,150,14,136,1,135,6,19,52,10,4,1,0,13,2,28
32,125,93,17,76,1,75,1,12,17,8,0,0,1,8,1,27
32,126,143,19,124,3,121,0,20,32,18,1,0,0,11,3,36
32,127,568,81,487,17,470,6,65,104,59,2,3,1,67,10,153
32,128,167,24,143,5,138,3,20,33,22,1,0,1,17,1,40
32,129,125,15,110,2,108,0,22,30,10,0,1,3,8,0,34
32,130,162,21,141,1,140,11,9,16,29,2,1,1,12,1,58
32,131,108,13,95,1,94,1,15,21,21,4,0,0,8,4,20
32,132,4848,841,4007,88,3919,44,671,944,452,51,14,8,297,61,1377
32,133,261,32,229,5,224,5,35,55,33,2,2,1,23,4,64
32,134,254,32,222,0,222,3,47,56,31,2,0,3,21,5,54
32,135,104,14,90,2,88,0,17,26,14,1,0,1,9,1,19
32,136,144,26,118,1,117,0,25,24,20,1,2,0,13,1,31
32,138,131,23,108,0,108,2,25,34,9,0,1,0,12,1,24
32,139,83,9,74,1,73,2,12,20,3,2,1,0,9,0,24
32,140,51,5,46,4,42,0,5,21,3,0,0,1,4,0,8
32,141,97,14,83,1,82,4,15,15,7,3,0,0,8,3,27
32,142,111,8,103,2,101,1,21,25,7,2,0,0,10,0,35
32,143,271,39,232,4,228,6,37,81,11,5,0,0,32,3,53
32,144,74,16,58,1,57,3,10,15,13,1,1,0,4,2,8
32,145,39,5,34,3,31,0,0,8,11,3,2,0,2,0,5
32,146,244,24,220,4,216,2,54,64,27,4,4,1,13,6,41
32,147,2279,439,1840,38,1802,50,316,462,187,25,7,3,185,32,535
32,148,69,12,57,2,55,3,12,12,6,0,0,0,8,0,14
32,149,886,119,767,14,753,11,148,176,92,6,5,1,68,13,233
32,150,167,23,144,5,139,5,25,33,14,1,0,0,16,4,41
32,151,60,8,52,1,51,0,7,17,4,0,0,0,3,0,20
32,152,250,39,211,2,209,1,42,37,27,1,1,0,28,3,69
32,153,95,4,91,1,90,3,9,17,13,2,1,1,21,3,20
32,154,93,20,73,2,71,1,12,27,5,1,0,0,4,5,16
32,155,868,120,748,19,729,7,101,154,96,12,2,2,69,16,270
32,156,161,22,139,4,135,5,11,26,22,3,0,1,14,2,51
32,157,113,12,101,2,99,3,19,14,23,6,1,1,8,0,24
32,158,186,21,165,3,162,3,26,39,21,0,1,0,19,5,48
32,159,451,73,378,5,373,8,69,102,43,3,5,1,40,13,89
32,160,5439,877,4562,84,4478,131,709,1113,505,57,26,17,439,78,1403
32,161,84,10,74,3,71,0,11,4,5,2,1,1,11,1,35
32,162,861,91,770,20,750,13,114,143,105,5,1,1,81,7,280
32,163,242,36,206,1,205,2,38,29,29,3,1,0,16,6,81
32,164,121,27,94,3,91,3,12,24,11,0,0,0,15,0,26
32,165,175,17,158,4,154,3,36,36,18,1,1,1,16,2,40
32,166,76,5,71,5,66,2,10,13,10,0,0,0,7,0,24
32,167,232,32,200,6,194,6,35,37,27,2,0,0,24,0,63
32,168,174,22,152,4,148,1,36,24,15,1,0,0,22,1,48
32,169,115,22,93,3,90,2,16,11,10,0,1,1,4,4,41
32,170,142,17,125,1,124,1,22,17,13,2,0,1,19,1,48
32,171,127,10,117,0,117,0,25,29,23,0,0,0,5,3,32
32,172,259,29,230,2,228,7,40,34,33,0,1,0,26,3,84
32,173,174,24,150,5,145,6,23,40,22,5,1,0,15,2,31
32,174,195,43,152,6,146,4,15,19,32,3,2,0,20,5,46
32,175,154,20,134,1,133,2,15,29,26,2,0,0,16,5,38
32,176,118,16,102,1,101,1,10,41,5,1,0,1,7,2,33
32,177,120,22,98,3,95,2,12,18,14,1,2,1,11,1,33
32,178,63,10,53,2,51,0,8,13,1,1,1,0,10,1,16
32,180,363,54,309,6,303,5,49,103,29,2,2,1,23,2,87
32,181,246,46,200,2,198,3,29,63,18,0,3,0,18,5,59
32,182,146,17,129,2,127,4,23,22,12,2,1,0,19,2,42
32,183,207,16,191,6,185,5,17,30,36,5,0,0,12,6,74
32,184,96,9,87,3,84,1,19,24,8,0,1,0,7,2,22
32,185,123,17,106,2,104,0,9,30,18,2,0,1,10,2,32
32,186,66,5,61,1,60,7,6,7,12,0,2,0,6,0,20
32,187,98,25,73,3,70,3,6,14,11,2,2,0,11,1,20
32,188,71,8,63,0,63,0,11,13,8,0,0,0,6,0,25
32,189,87,17,70,1,69,2,14,23,8,0,0,0,7,2,13
32,190,457,63,394,8,386,6,95,111,34,4,1,0,54,8,73
32,191,104,12,92,2,90,1,14,14,11,2,1,0,14,4,29
32,192,167,23,144,4,140,5,23,35,18,1,0,0,20,3,35
32,193,177,22,155,3,152,1,24,44,16,0,1,0,14,4,48
32,194,175,15,160,3,157,0,26,49,19,1,2,2,13,5,40
32,195,53,9,44,0,44,2,5,11,5,1,0,0,5,2,13
32,196,126,22,104,4,100,3,19,20,23,1,2,0,8,0,24
32,197,197,11,186,5,181,3,27,79,12,2,0,1,16,8,33
32,198,137,26,111,1,110,5,21,29,19,1,0,0,4,5,26
32,199,155,18,137,6,131,1,19,30,15,1,1,0,23,2,39
32,200,283,33,250,4,246,12,35,47,31,3,2,0,26,2,88
32,201,246,17,229,12,217,3,31,41,29,3,1,0,21,6,82
32,202,191,21,170,3,167,0,25,61,18,3,1,1,9,3,46
32,203,206,32,174,2,172,6,33,30,27,1,3,0,5,4,63
32,204,335,26,309,9,300,8,34,78,37,4,2,0,49,5,83
32,205,96,18,78,2,76,4,18,9,13,1,2,0,11,0,18
32,206,183,12,171,2,169,6,29,31,24,2,2,0,16,10,49
32,207,254,34,220,4,216,8,30,70,27,0,0,0,21,1,59
32,208,2799,461,2338,47,2291,51,332,579,259,26,13,4,209,42,776
32,209,191,15,176,1,175,0,34,35,27,3,1,1,32,3,39
32,210,341,37,304,4,300,7,45,67,33,3,1,0,45,5,94
32,211,154,32,122,1,121,2,23,44,13,1,0,0,2,6,30
32,212,190,28,162,4,158,4,33,58,11,2,0,0,11,3,36
32,213,1371,179,1192,24,1168,20,216,261,131,15,10,2,99,19,395
32,214,117,15,102,3,99,3,22,28,11,0,0,0,11,1,23
32,215,154,18,136,3,133,1,28,32,24,8,0,0,15,4,21
32,216,107,11,96,4,92,3,6,15,14,3,1,0,8,3,39
32,217,47,14,33,0,33,4,7,11,5,1,0,0,1,0,4
32,218,61,10,51,1,50,1,7,7,3,2,1,0,5,2,22
32,219,253,31,222,6,216,0,27,65,19,3,0,0,25,3,74
32,220,116,20,96,2,94,2,19,24,9,0,0,0,12,0,28
32,221,206,24,182,4,178,4,16,45,15,3,2,0,41,3,49
32,222,182,22,160,5,155,2,30,47,12,4,2,1,10,1,46
32,223,52,1,51,1,50,2,4,9,12,0,0,0,2,0,21
32,224,180,22,158,2,156,0,29,31,25,1,2,1,17,1,49
32,225,77,9,68,1,67,1,6,0,12,0,0,0,2,0,46
32,226,77,15,62,2,60,1,13,15,1,1,2,0,7,3,17
32,227,629,100,529,12,517,10,96,108,58,9,3,2,53,19,159
32,228,81,17,64,6,58,3,10,7,2,0,1,1,6,1,27
32,229,61,7,54,0,54,0,5,20,4,1,0,0,6,1,17
32,230,58,9,49,3,46,1,6,11,3,0,1,0,10,0,14
32,231,346,41,305,8,297,3,53,66,31,5,2,0,38,7,92
32,232,42,4,38,1,37,0,3,8,5,0,0,0,8,3,10
32,233,919,129,790,24,766,18,111,166,97,4,3,2,67,17,281
32,234,179,25,154,4,150,6,26,43,15,1,1,2,19,1,36
32,235,156,18,138,2,136,2,12,40,12,1,1,3,21,1,43
32,236,55,6,49,1,48,0,4,15,4,1,0,0,1,0,23
32,237,399,50,349,10,339,9,60,115,36,6,1,0,22,5,85
32,238,72,5,67,1,66,2,26,12,6,0,1,0,8,1,10
32,239,374,56,318,5,313,9,49,75,49,1,1,0,29,9,91
32,240,45,5,40,1,39,2,2,7,5,1,0,0,3,0,19
32,241,138,13,125,2,123,1,17,30,19,3,0,0,20,0,33
32,242,1091,165,926,23,903,8,132,210,129,7,7,0,88,11,311
32,243,240,32,208,5,203,4,37,69,20,6,1,0,23,3,40
32,244,163,16,147,1,146,1,26,14,14,3,2,0,19,2,65
32,245,120,22,98,1,97,1,32,29,5,0,1,1,15,5,8
32,246,141,19,122,1,121,0,17,21,12,4,0,1,18,0,48
32,247,212,9,203,7,196,6,43,42,14,2,2,0,27,5,55
32,248,114,17,97,2,95,2,14,28,13,2,1,0,11,2,22
32,249,1567,218,1349,24,1325,42,207,276,201,21,3,3,129,29,414
32,250,75,9,66,2,64,3,12,27,3,1,1,0,2,3,12
32,251,51,4,47,0,47,0,7,9,5,0,0,0,10,2,14
32,252,928,159,769,14,755,12,130,177,85,6,3,7,58,9,268
32,253,393,63,330,5,325,0,66,88,37,4,2,0,26,4,98
32,254,283,39,244,5,239,7,20,62,32,1,0,1,31,10,75
32,255,124,13,111,2,109,1,28,16,26,2,1,0,10,1,24
32,256,2431,345,2086,32,2054,49,408,491,206,22,10,8,220,37,603
32,257,65,8,57,1,56,2,11,9,9,1,0,0,12,0,12
32,258,179,17,162,6,156,1,23,42,22,2,1,0,23,0,42
32,260,70,9,61,2,59,3,16,15,3,0,0,0,9,3,10
32,261,265,20,245,6,239,4,40,37,45,4,1,1,20,5,82
32,262,250,36,214,1,213,7,20,69,32,2,0,0,19,4,60
32,263,100,13,87,0,87,2,11,17,6,0,0,0,10,2,39
32,264,146,24,122,6,116,1,20,30,10,1,0,0,13,2,39
32,265,110,21,89,1,88,1,19,19,10,2,0,0,16,3,18
32,266,116,20,96,1,95,6,16,10,20,2,0,1,10,2,28
32,267,106,20,86,4,82,2,14,12,5,1,2,1,15,2,28
32,268,533,53,480,5,475,7,72,120,50,6,2,1,52,12,153
32,269,349,45,304,6,298,3,50,97,27,4,2,1,25,7,82
32,270,66,12,54,5,49,3,8,12,4,0,0,0,11,0,11
32,271,233,19,214,7,207,6,26,58,21,5,1,2,19,5,64
32,272,141,25,116,4,112,4,11,34,11,2,0,0,10,1,39
32,273,146,19,127,1,126,3,15,20,27,1,1,0,13,3,43
32,274,164,25,139,5,134,0,36,29,13,3,0,0,13,3,37
32,275,30,2,28,0,28,1,2,2,7,0,1,0,1,0,14
32,276,68,7,61,2,59,2,5,19,6,0,0,0,6,1,20
32,277,118,11,107,8,99,3,22,22,8,1,0,1,11,3,28
32,278,108,16,92,3,89,3,1,32,6,0,0,0,18,3,26
32,279,541,51,490,7,483,15,67,116,56,6,2,0,39,4,178
32,280,90,18,72,2,70,0,11,9,12,1,1,0,9,4,23
32,281,76,11,65,1,64,1,9,18,8,0,1,0,12,0,15
32,282,363,15,348,5,343,12,36,67,54,4,2,1,28,1,138
32,283,257,49,208,1,207,5,31,38,26,1,3,0,12,4,87
32,284,66,6,60,1,59,0,12,12,10,1,0,0,4,2,18
32,285,411,47,364,1,363,6,58,73,62,3,0,0,32,7,122
32,286,492,67,425,10,415,10,70,100,46,4,4,1,36,9,135
32,287,51,9,42,0,42,0,7,14,5,1,1,0,3,0,11
32,288,134,9,125,3,122,6,32,34,16,1,0,0,12,2,19
32,289,186,19,167,8,159,2,34,41,26,2,0,1,13,5,35
32,290,879,87,792,24,768,11,147,232,61,1,5,3,88,16,204
32,291,114,21,93,2,91,0,20,18,9,1,0,0,14,6,23
32,292,313,27,286,7,279,6,74,49,31,7,0,3,31,9,69
32,293,68,7,61,1,60,1,8,12,8,0,1,0,4,0,26
32,294,77,7,70,1,69,1,16,14,6,1,0,0,11,1,19
32,295,109,9,100,1,99,3,18,27,19,2,1,0,11,4,14
32,296,1366,221,1145,29,1116,19,128,253,166,17,5,2,90,17,419
32,297,256,22,234,7,227,13,29,62,20,1,1,1,42,2,56
32,298,265,27,238,6,232,8,51,57,26,3,0,1,18,2,66
32,299,92,7,85,2,83,1,10,26,10,3,0,0,5,0,28
32,300,196,31,165,3,162,3,27,35,21,0,1,1,18,4,52
32,301,637,73,564,7,557,22,92,127,70,5,2,1,72,17,149
32,302,210,25,185,5,180,7,24,41,20,2,0,0,19,1,66
32,303,44,9,35,1,34,0,4,1,8,2,0,0,5,0,14
32,304,197,27,170,9,161,3,17,40,18,1,0,4,18,2,58
32,305,296,35,261,3,258,3,49,53,27,3,1,1,24,0,97
32,306,459,56,403,4,399,9,90,75,45,6,2,2,35,6,129
32,307,2027,222,1805,43,1762,54,211,354,244,25,6,4,152,37,675
32,308,83,5,78,1,77,3,9,13,12,2,0,0,8,2,28
32,309,87,8,79,3,76,4,12,21,3,0,1,0,15,1,19
32,310,76,7,69,6,63,2,10,8,6,0,0,0,10,3,24
32,311,241,27,214,4,210,4,41,54,30,3,2,0,17,4,55
32,312,588,69,519,9,510,13,84,131,67,9,4,1,45,8,148
32,313,114,14,100,3,97,2,10,25,8,1,1,1,17,2,30
32,314,63,12,51,0,51,0,3,12,10,0,1,0,5,1,19
32,315,156,24,132,4,128,5,19,42,13,0,2,1,20,1,25
32,316,81,6,75,0,75,4,8,14,26,1,0,0,4,0,18
32,317,66,10,56,2,54,0,6,14,7,1,0,0,4,0,22
32,318,77,12,65,1,64,2,12,15,3,0,2,1,5,0,24
32,319,1165,192,973,18,955,22,139,217,106,10,5,0,87,15,354
32,320,126,14,112,0,112,2,23,31,15,2,0,0,12,5,22
32,321,177,18,159,4,155,7,26,33,26,2,2,0,23,3,33
32,322,155,18,137,1,136,3,21,35,11,2,3,0,13,2,46
32,323,98,16,82,0,82,0,12,15,8,1,1,0,16,0,29
32,324,90,8,82,1,81,1,12,22,12,0,0,0,11,1,22
32,325,108,20,88,0,88,3,6,18,16,3,0,0,11,3,28
32,326,133,32,101,2,99,6,20,27,9,2,0,0,17,3,15
32,327,70,10,60,0,60,4,14,14,0,0,1,0,6,3,18
32,328,116,16,100,3,97,2,16,41,12,3,0,1,8,4,10
32,329,145,24,121,6,115,7,25,20,3,1,4,0,15,1,39
32,330,164,22,142,3,139,10,30,20,20,3,3,0,8,0,45
32,331,854,78,776,14,762,18,99,143,89,8,1,4,59,13,328
32,332,112,17,95,4,91,2,12,40,9,2,0,0,11,4,11
32,333,118,13,105,1,104,4,17,29,10,3,0,0,19,4,18
32,334,1017,135,882,23,859,19,163,206,120,10,4,3,94,17,223
32,335,348,35,313,9,304,11,78,85,15,1,3,1,23,4,83
32,336,162,15,147,2,145,5,9,36,16,0,2,0,17,1,59
32,337,65,11,54,1,53,0,10,13,5,2,0,0,5,4,14
32,338,129,32,97,0,97,0,17,41,8,0,1,0,6,2,22
32,339,129,10,119,3,116,2,24,19,12,2,1,1,12,6,37
32,340,206,28,178,8,170,1,41,49,13,3,2,0,11,6,44
32,341,159,23,136,7,129,5,23,29,20,6,0,1,15,2,28
32,342,54,10,44,0,44,1,3,13,5,0,2,0,6,0,14
32,343,175,21,154,4,150,7,25,36,15,3,1,0,12,3,48
32,344,1280,191,1089,26,1063,17,146,304,108,11,8,2,100,13,354
32,345,419,60,359,10,349,12,69,99,38,4,2,0,34,8,83
32,346,160,19,141,3,138,1,27,44,15,0,0,1,12,3,35
32,347,228,27,201,4,197,5,45,29,26,2,1,0,16,4,69
32,348,474,55,419,12,407,6,70,102,54,5,2,1,50,10,107
32,349,100,19,81,1,80,1,9,21,6,3,1,1,7,0,31
32,350,41,4,37,2,35,4,4,4,7,3,1,0,1,1,10
32,351,98,9,89,1,88,2,15,38,10,0,0,0,8,1,14
32,352,94,8,86,2,84,1,10,30,4,1,0,0,9,0,29
32,353,131,23,108,7,101,3,16,15,17,4,0,1,20,0,25
32,354,117,12,105,3,102,1,17,29,13,3,0,0,14,2,23
32,355,63,6,57,2,55,5,15,6,5,0,1,1,11,0,11
32,356,91,10,81,0,81,1,14,19,15,1,0,0,10,6,15
32,357,88,15,73,5,68,0,12,15,8,2,0,0,7,1,23
32,358,152,23,129,3,126,4,21,34,17,2,0,0,18,5,25
32,359,125,12,113,3,110,6,23,20,15,2,0,0,5,3,36
32,360,97,11,86,1,85,8,8,13,9,0,0,0,17,2,28
32,361,112,14,98,4,94,4,13,22,20,1,0,0,10,6,18
32,362,129,19,110,2,108,3,17,47,8,0,0,0,7,2,24
32,363,100,17,83,6,77,3,11,15,17,3,1,0,4,1,22
32,364,75,4,71,1,70,1,14,28,7,0,0,0,5,1,14
32,365,180,25,155,4,151,0,37,55,12,0,1,0,15,2,29
32,366,80,11,69,1,68,0,5,21,9,0,0,0,11,2,20
32,367,73,12,61,0,61,1,4,8,7,0,0,3,10,4,24
32,368,426,38,388,5,383,10,102,64,52,9,5,3,22,7,109
32,369,283,38,245,2,243,5,48,61,24,1,3,1,29,4,67
32,370,715,76,639,13,626,19,80,162,89,13,4,2,44,7,206
32,371,79,5,74,1,73,3,6,17,4,0,0,0,11,2,30
32,372,188,15,173,0,173,3,40,45,13,0,1,0,10,9,52
32,373,195,33,162,5,157,8,23,28,24,0,1,2,24,2,45
32,374,132,19,113,1,112,4,31,19,16,4,1,0,8,0,29
32,375,90,21,69,2,67,1,3,14,16,1,0,0,12,1,19
32,376,110,13,97,2,95,2,10,32,14,1,0,0,15,2,19
32,377,146,21,125,4,121,5,16,25,23,3,0,1,15,1,32
32,378,304,42,262,4,258,4,51,40,39,2,2,1,28,6,85
32,379,150,17,133,1,132,10,27,28,18,2,0,0,21,3,23
32,380,105,12,93,1,92,2,8,19,12,0,2,0,11,2,36
32,381,336,39,297,7,290,7,45,67,47,7,1,1,35,6,74
32,382,257,28,229,11,218,4,24,68,19,3,2,0,31,4,63
32,383,111,20,91,3,88,4,15,14,15,1,0,0,17,0,22
32,384,161,8,153,2,151,3,21,38,20,0,0,0,21,4,44
32,385,143,17,126,1,125,2,23,27,11,4,0,0,16,4,38
32,386,104,7,97,2,95,4,21,33,9,1,0,0,2,0,25
32,387,78,7,71,0,71,0,8,12,12,0,1,1,3,3,31
32,388,287,36,251,3,248,6,44,75,31,5,1,0,24,7,55
32,389,344,35,309,7,302,8,58,56,42,7,0,1,28,3,99
32,390,185,26,159,5,154,4,33,32,17,1,0,0,13,0,54
32,391,110,8,102,2,100,2,23,18,8,0,0,1,18,0,30
32,392,74,19,55,3,52,0,10,21,7,0,2,0,4,1,7
32,393,97,16,81,1,80,2,16,25,2,1,0,1,10,1,22
32,394,275,29,246,6,240,4,27,49,35,8,2,1,21,3,90
32,395,165,10,155,4,151,3,30,42,28,0,0,0,12,2,34
32,396,168,24,144,4,140,7,18,45,12,0,0,1,16,4,37
32,397,229,43,186,7,179,10,16,30,25,3,0,0,14,5,76
32,398,221,19,202,4,198,1,26,36,12,3,0,0,28,4,88
32,399,63,8,55,1,54,0,10,17,6,1,0,0,7,1,12
32,400,130,8,122,1,121,2,8,31,19,0,0,0,12,3,46
32,401,82,7,75,6,69,1,9,13,6,1,0,0,11,0,28
32,402,91,18,73,2,71,1,11,31,7,1,1,0,4,1,14
32,403,64,7,57,1,56,2,3,30,7,0,0,1,3,1,9
32,404,455,49,406,5,401,14,73,110,39,6,4,2,34,8,111
32,405,144,14,130,3,127,3,29,40,17,0,2,0,10,1,25
32,406,281,32,249,4,245,7,36,74,20,5,2,0,16,4,81
32,407,118,16,102,4,98,2,19,27,14,1,2,0,6,1,26
32,408,87,19,68,3,65,1,8,23,4,1,1,0,14,1,12
32,409,75,15,60,2,58,0,3,17,11,0,1,0,4,2,20
32,410,1771,223,1548,24,1524,19,202,372,193,15,8,5,145,26,539
32,411,77,5,72,3,69,3,13,10,12,3,3,2,2,0,21
32,412,635,90,545,10,535,21,112,116,64,8,4,0,47,8,155
32,413,59,8,51,1,50,1,13,7,4,0,2,1,10,1,11
32,414,206,19,187,5,182,0,18,30,16,2,0,0,29,8,79
32,415,73,6,67,2,65,0,13,21,4,0,0,0,7,0,20
32,416,311,30,281,9,272,16,56,60,33,5,2,0,22,5,73
32,417,275,46,229,3,226,4,22,48,27,3,0,1,28,3,90
32,418,203,27,176,8,168,1,20,38,10,3,0,0,16,1,79
32,419,119,15,104,5,99,1,7,24,4,0,1,1,9,1,51
32,420,56,5,51,2,49,0,7,15,5,1,1,0,5,3,12
32,421,128,22,106,2,104,3,30,15,13,0,1,0,11,2,29
32,422,44,7,37,0,37,4,5,3,0,0,0,1,4,3,17
32,423,41,5,36,1,35,0,7,7,9,0,0,0,3,0,9
32,424,211,24,187,6,181,2,21,54,12,0,1,0,37,2,52
32,425,667,71,596,20,576,14,114,95,69,2,2,1,59,9,211
32,426,847,120,727,9,718,9,138,203,74,10,4,1,66,3,210
32,427,59,7,52,1,51,0,9,7,7,1,1,0,5,2,19
32,428,61,7,54,2,52,1,9,21,2,1,1,0,9,2,6
32,429,250,28,222,11,211,7,40,74,17,1,2,1,32,6,31
32,430,75,10,65,1,64,3,7,12,7,0,0,0,6,1,28
32,431,37,3,34,1,33,1,0,9,12,0,0,0,1,2,8
32,432,203,22,181,3,178,9,25,30,28,1,1,0,15,1,68
32,433,526,88,438,10,428,10,65,107,55,6,3,1,52,5,124
32,434,80,5,75,6,69,0,10,12,8,0,0,0,6,1,32
32,435,111,13,98,2,96,7,17,18,6,1,1,1,9,3,33
32,436,340,40,300,5,295,2,63,61,38,4,4,0,38,6,79
32,437,163,32,131,1,130,0,22,39,6,2,0,0,15,5,41
32,438,82,15,67,3,64,6,9,12,12,1,0,0,2,0,22
32,439,138,18,120,4,116,0,12,30,9,1,0,1,21,3,39
32,440,177,22,155,4,151,3,24,23,14,2,2,0,13,4,66
32,441,58,4,54,4,50,3,1,29,2,0,0,0,4,0,11
32,442,321,52,269,1,268,6,50,60,57,1,1,0,24,8,61
32,443,151,24,127,7,120,5,22,25,20,1,1,0,11,1,34
32,444,187,16,171,3,168,4,29,39,13,3,0,0,16,3,61
32,445,113,16,97,1,96,1,20,17,18,3,0,0,4,1,32
32,446,227,29,198,5,193,3,28,31,19,0,0,1,29,7,75
32,447,73,2,71,1,70,2,11,24,9,2,0,0,6,0,16
32,448,405,39,366,11,355,12,65,71,53,5,2,2,45,10,90
32,449,171,23,148,7,141,0,23,18,17,2,1,0,11,3,66
32,450,80,7,73,5,68,0,9,15,8,2,1,0,7,0,26
32,451,154,21,133,7,126,1,34,26,15,2,0,1,15,3,29
32,452,252,41,211,4,207,4,38,67,31,0,1,0,18,6,42
32,453,110,13,97,7,90,4,24,19,13,0,0,0,12,1,17
32,454,64,5,59,1,58,3,18,8,6,3,0,0,4,0,16
32,455,145,18,127,3,124,1,17,25,17,2,2,1,13,1,45
32,456,58,13,45,0,45,0,13,16,2,2,0,1,3,2,6
32,457,183,28,155,6,149,2,32,42,15,1,1,0,19,0,37
32,458,197,32,165,3,162,3,32,43,16,5,1,0,19,1,42
32,459,966,152,814,27,787,10,164,173,103,12,6,1,58,9,251
32,460,220,28,192,7,185,0,27,30,16,8,1,1,29,9,64
32,461,77,10,67,1,66,1,4,15,7,1,0,1,24,0,13
32,462,2665,327,2338,49,2289,49,347,652,202,28,9,8,191,52,751
32,463,416,58,358,6,352,6,43,91,49,0,0,0,49,6,108
32,464,583,71,512,5,507,5,81,64,87,8,1,0,51,12,198
32,465,117,25,92,0,92,3,14,9,13,1,0,0,7,1,44
32,466,91,10,81,9,72,1,7,24,5,0,0,0,8,1,26
32,467,102,12,90,2,88,5,8,15,14,3,0,0,9,1,33
32,468,52,7,45,1,44,1,5,13,8,0,0,0,5,0,12
33,1,1409,310,1099,15,1084,18,273,234,100,18,4,3,84,15,335
33,2,575,84,491,7,484,9,62,139,93,7,5,1,38,1,129
33,3,9122,1845,7277,114,7163,88,1494,1310,919,121,47,22,579,121,2462
33,4,2020,379,1641,17,1624,23,363,230,313,57,6,6,87,24,515
33,5,9681,1483,8198,146,8052,216,1087,2757,750,122,32,11,898,141,2038
33,6,672,110,562,11,551,7,144,121,58,13,3,1,31,15,158
33,7,740,100,640,11,629,9,115,165,64,12,3,4,63,17,177
33,8,195,28,167,3,164,2,31,39,18,6,0,0,12,5,51
33,9,10328,2049,8279,92,8187,188,908,4089,482,62,19,15,760,118,1546
33,10,297,40,257,8,249,7,54,55,31,5,1,2,21,3,70
33,11,4783,802,3981,58,3923,74,637,1284,377,46,12,4,371,75,1043
33,12,2584,399,2185,33,2152,48,336,515,252,55,13,4,274,31,624
33,13,5295,634,4661,84,4577,93,755,992,490,72,25,5,460,90,1595
33,14,758,105,653,9,644,9,149,178,56,11,3,0,60,6,172
33,15,1448,232,1216,24,1192,21,219,364,118,15,6,5,121,17,306
33,16,363,71,292,3,289,8,32,56,53,7,3,0,30,11,89
33,17,218,23,195,6,189,0,49,35,24,3,2,0,12,3,61
33,18,835,121,714,14,700,7,179,146,73,10,2,3,50,13,217
33,19,4836,763,4073,73,4000,82,701,999,477,90,21,10,368,80,1172
33,20,86,8,78,0,78,0,17,12,7,4,0,0,8,0,30
33,21,678,68,610,12,598,12,105,170,62,5,8,0,48,19,169
33,22,1641,235,1406,19,1387,23,284,287,191,39,5,1,123,22,412
33,23,783,82,701,12,689,13,127,156,69,17,2,0,48,11,246
33,24,183,21,162,4,158,8,31,45,16,3,3,0,10,4,38
33,25,254,42,212,3,209,5,53,45,27,5,3,0,14,9,48
33,26,339,35,304,2,302,14,58,53,34,5,4,2,20,6,106
33,27,208,30,178,4,174,11,31,23,40,7,0,0,7,2,53
33,28,761,95,666,17,649,6,106,133,104,22,1,1,46,1,229
33,29,3237,498,2739,58,2681,58,472,635,355,65,12,11,241,44,788
33,30,1560,245,1315,27,1288,20,189,273,195,18,9,4,181,13,386
33,31,79,6,73,1,72,0,11,11,11,3,0,0,9,0,27
33,32,4569,821,3748,61,3687,58,724,545,550,69,17,3,238,48,1435
33,33,598,111,487,10,477,13,78,118,75,9,1,0,44,6,133
33,34,393,65,328,5,323,3,89,96,27,3,1,1,22,5,76
33,35,559,73,486,16,470,17,125,95,68,4,0,0,36,7,118
33,36,3275,539,2736,50,2686,57,370,706,306,38,11,12,284,32,870
33,37,1680,257,1423,26,1397,32,226,243,175,27,12,3,131,25,523
33,38,747,133,614,8,606,1,209,172,31,5,0,1,40,9,138
33,39,17002,3519,13483,222,13261,476,1610,1917,2710,207,54,25,990,167,5105
33,40,732,100,632,12,620,11,90,157,71,7,8,3,65,9,199
33,42,2978,520,2458,44,2414,63,498,557,287,50,12,2,248,40,657
33,43,178,38,140,0,140,1,37,22,13,3,0,0,5,3,56
33,44,211,36,175,1,174,4,31,51,25,3,0,0,20,1,39
33,45,256,40,216,4,212,8,59,58,23,1,2,0,12,6,43
33,46,863,118,745,14,731,14,116,157,93,13,3,4,69,21,241
33,47,1333,198,1135,23,1112,11,243,267,144,19,7,3,86,37,295
33,48,170,17,153,5,148,3,27,34,19,2,0,1,12,4,46
33,49,1527,218,1309,21,1288,18,248,311,153,22,5,2,110,29,390
33,50,369,58,311,7,304,7,49,62,40,11,3,0,21,5,106
33,51,7366,1393,5973,124,5849,119,1154,1236,785,115,29,13,521,116,1761
33,52,748,95,653,9,644,10,137,162,69,8,2,1,54,7,194
33,53,181,17,164,7,157,4,18,48,22,2,0,2,19,2,40
33,54,225,17,208,5,203,4,34,52,30,1,0,0,12,4,66
33,55,182,46,136,4,132,0,38,56,6,3,0,1,5,1,22
33,56,10863,1639,9224,135,9089,211,1319,1884,1050,281,42,13,979,148,3162
33,57,635,84,551,7,544,8,141,108,86,12,1,1,32,11,144
33,58,3132,716,2416,59,2357,35,411,545,296,43,15,8,225,33,746
33,59,213,28,185,1,184,1,37,19,37,6,1,1,14,4,64
33,60,344,67,277,2,275,8,52,69,21,11,2,1,28,9,74
33,61,657,89,568,5,563,14,93,146,60,4,4,3,67,21,151
33,62,600,76,524,14,510,13,126,95,54,2,3,2,52,11,152
33,63,136177,28259,107918,1419,106499,4261,8757,30545,12955,1393,323,225,11619,1218,35203
33,64,48,12,36,2,34,1,5,12,2,1,1,0,1,1,10
33,65,2412,380,2032,41,1991,48,288,671,147,20,7,4,234,28,544
33,66,85,15,70,0,70,3,16,28,8,0,0,0,3,0,12
33,67,1429,291,1138,25,1113,18,231,280,133,23,7,0,92,19,310
33,68,93,12,81,1,80,3,12,32,5,1,0,0,8,1,18
33,69,16596,3088,13508,204,13304,353,1416,4622,1256,167,39,32,1422,211,3786
33,70,315,37,278,8,270,6,64,56,30,3,1,0,33,5,72
33,71,825,166,659,17,642,16,150,150,82,9,4,1,56,9,165
33,72,147,15,132,4,128,3,21,35,11,3,1,0,18,1,35
33,73,1089,189,900,16,884,5,270,193,79,10,8,5,80,16,218
33,74,143,9,134,3,131,2,22,32,14,3,2,0,8,1,47
33,75,10156,1504,8652,155,8497,222,1057,2292,886,154,21,14,983,129,2739
33,76,549,62,487,12,475,9,106,119,49,8,5,1,49,8,121
33,77,1401,185,1216,14,1202,39,225,251,152,21,6,5,118,18,367
33,78,274,28,246,2,244,5,51,42,38,4,1,1,18,9,75
33,79,242,29,213,3,210,2,33,64,22,4,0,0,14,4,67
33,80,3729,483,3246,54,3192,49,548,689,419,70,5,5,282,41,1084
33,81,1400,233,1167,19,1148,24,215,258,170,14,8,4,82,21,352
33,82,748,86,662,8,654,14,141,153,81,12,1,2,71,11,168
33,83,751,127,624,6,618,18,87,171,69,10,4,2,42,12,203
33,84,962,148,814,15,799,20,109,195,105,14,0,4,75,9,268
33,85,2042,280,1762,36,1726,43,191,465,203,22,11,4,203,19,565
33,86,246,32,214,3,211,5,53,44,27,1,0,0,20,4,57
33,87,343,67,276,7,269,8,54,39,40,3,4,2,31,5,83
33,88,424,87,337,6,331,7,79,62,44,3,2,1,23,3,107
33,89,335,50,285,6,279,1,82,49,24,7,0,2,19,3,92
33,90,3997,483,3514,70,3444,101,395,631,427,58,16,11,377,57,1371
33,91,851,138,713,15,698,13,163,155,64,19,1,1,62,14,206
33,92,164,19,145,3,142,1,27,52,8,4,0,0,21,4,25
33,93,497,52,445,8,437,9,75,104,67,8,1,2,35,9,127
33,94,172,23,149,6,143,5,38,44,10,1,2,2,9,6,26
33,95,1054,151,903,22,881,17,128,174,90,13,4,4,71,6,374
33,96,5281,914,4367,74,4293,70,683,830,529,77,21,8,360,63,1652
33,97,2002,306,1696,32,1664,37,266,463,174,29,12,3,153,29,498
33,98,358,47,311,8,303,3,62,62,42,4,4,1,25,8,92
33,99,2747,420,2327,44,2283,75,323,592,264,27,12,7,252,41,690
33,100,963,170,793,17,776,7,151,194,74,15,7,4,69,16,239
33,101,757,113,644,10,634,7,160,152,72,19,3,1,45,10,165
33,102,332,67,265,6,259,4,45,59,30,7,1,0,34,4,75
33,103,46,2,44,0,44,3,7,3,10,0,0,0,4,0,17
33,104,2718,460,2258,43,2215,39,435,479,262,39,9,1,190,30,731
33,105,145,22,123,1,122,1,32,42,13,3,0,0,10,4,17
33,106,835,135,700,20,680,13,134,141,105,8,5,3,64,12,195
33,107,228,30,198,3,195,3,26,58,26,1,3,0,20,3,55
33,108,2031,497,1534,27,1507,19,416,373,141,12,7,4,102,22,411
33,109,1408,249,1159,13,1146,23,195,217,139,19,3,3,126,28,393
33,111,674,93,581,12,569,10,121,149,55,8,0,0,43,10,173
33,112,108,15,93,3,90,2,19,14,13,3,1,0,4,1,33
33,113,119,14,105,2,103,2,17,38,13,1,0,0,8,1,23
33,114,956,134,822,17,805,9,207,222,60,7,6,3,62,22,207
33,115,212,38,174,3,171,3,38,37,24,3,3,0,10,4,49
33,116,240,23,217,6,211,5,57,42,25,2,1,0,16,2,61
33,117,161,21,140,3,137,3,33,35,10,5,4,0,8,1,38
33,118,1466,224,1242,17,1225,34,151,315,147,13,1,7,160,32,365
33,119,12832,3257,9575,162,9413,159,1332,1350,1312,147,38,19,608,105,4343
33,120,1326,198,1128,17,1111,22,197,223,161,20,9,1,74,20,384
33,121,170,28,142,2,140,3,30,27,21,3,0,0,8,4,44
33,122,13648,1719,11929,203,11726,314,1373,2605,1362,177,50,21,1348,188,4288
33,123,1588,239,1349,24,1325,13,350,268,155,33,7,6,89,23,381
33,124,464,56,408,3,405,3,97,74,46,10,2,3,27,10,133
33,125,1251,181,1070,15,1055,23,260,265,94,22,2,1,60,18,310
33,126,543,58,485,8,477,7,120,108,62,12,3,1,46,5,113
33,127,147,18,129,2,127,2,35,24,6,3,0,0,13,0,44
33,128,445,62,383,3,380,4,132,95,24,9,0,0,25,7,84
33,129,141,28,113,4,109,3,22,33,13,1,0,1,6,2,28
33,130,669,83,586,13,573,9,101,136,74,11,1,0,63,9,169
33,131,146,26,120,2,118,1,30,24,8,2,1,0,10,1,41
33,132,342,44,298,5,293,2,84,67,26,9,1,0,23,6,75
33,133,73,16,57,0,57,3,11,15,4,0,0,0,8,1,15
33,134,188,33,155,1,154,3,43,46,18,1,1,0,7,2,33
33,135,98,10,88,1,87,0,16,20,15,2,0,0,7,1,26
33,136,223,52,171,4,167,4,35,49,22,2,2,1,20,2,30
33,137,163,13,150,4,146,2,28,32,30,2,1,1,14,5,31
33,138,6066,1086,4980,93,4887,64,1172,1084,514,88,27,11,340,72,1515
33,139,61,8,53,1,52,0,11,15,8,0,0,0,7,1,10
33,140,2870,492,2378,48,2330,52,449,410,360,37,15,15,216,36,740
33,141,396,36,360,5,355,11,68,63,47,10,2,2,38,5,109
33,142,888,129,759,8,751,11,219,179,79,9,5,0,48,16,185
33,143,1586,265,1321,26,1295,26,254,238,192,31,7,5,114,18,410
33,144,568,77,491,11,480,11,97,107,71,10,3,3,39,10,129
33,145,389,39,350,3,347,7,58,67,53,7,2,1,37,11,104
33,146,1243,183,1060,27,1033,9,288,226,111,14,3,2,74,25,281
33,147,344,43,301,2,299,8,70,56,35,8,2,1,30,2,87
33,148,73,13,60,3,57,1,11,10,7,2,2,0,6,0,18
33,149,110,12,98,1,97,0,9,43,8,2,0,0,13,2,20
33,150,208,35,173,4,169,4,17,59,15,2,0,0,23,0,49
33,151,691,89,602,20,582,10,140,125,77,20,6,4,68,12,120
33,152,118,18,100,4,96,3,17,21,13,5,0,0,20,2,15
33,153,230,35,195,3,192,2,47,52,21,4,0,0,10,2,54
33,154,1382,263,1119,19,1100,12,297,224,107,21,7,2,50,13,367
33,155,127,15,112,0,112,4,11,18,23,3,1,0,13,3,36
33,156,227,32,195,4,191,5,44,33,19,4,4,0,32,2,48
33,157,474,66,408,9,399,8,111,64,44,5,1,0,25,9,132
33,158,211,28,183,3,180,8,47,46,14,6,2,0,17,5,35
33,159,1104,240,864,19,845,12,229,149,125,17,8,7,54,11,233
33,160,428,67,361,5,356,10,54,69,44,2,0,2,31,5,139
33,161,543,83,460,3,457,8,109,137,39,6,1,1,29,14,113
33,162,13080,2177,10903,192,10711,236,1359,2707,1189,160,52,23,1104,188,3693
33,163,330,47,283,5,278,3,68,71,40,4,1,0,16,8,67
33,164,1201,136,1065,21,1044,18,190,189,190,19,4,1,75,17,341
33,165,1834,249,1585,13,1572,28,226,432,180,20,8,4,193,27,454
33,166,337,42,295,5,290,4,95,53,30,8,1,0,13,7,79
33,167,11054,3022,8032,121,7911,150,1238,1143,1233,157,40,20,557,114,3259
33,168,400,60,340,5,335,6,81,78,33,3,1,2,26,5,100
33,169,71,10,61,3,58,2,10,7,10,4,0,0,7,0,18
33,170,590,104,486,8,478,11,111,108,45,8,1,0,29,8,157
33,171,153,35,118,3,115,6,29,21,24,1,0,2,9,2,21
33,172,242,38,204,3,201,5,39,61,25,1,1,3,17,6,43
33,173,157,24,133,2,131,2,25,31,21,5,1,0,7,5,34
33,174,813,87,726,5,721,15,126,245,57,4,2,1,72,7,192
33,175,543,125,418,7,411,7,86,60,72,10,5,0,36,5,130
33,176,233,33,200,3,197,5,38,45,18,9,0,0,28,3,51
33,177,1655,311,1344,15,1329,13,353,371,133,16,8,4,114,13,304
33,178,304,42,262,1,261,5,48,66,33,8,0,1,29,1,70
33,179,2075,294,1781,29,1752,18,361,415,165,31,17,2,146,51,546
33,180,158,22,136,2,134,2,24,22,12,5,2,1,16,1,49
33,181,221,36,185,8,177,1,59,51,10,1,0,0,17,5,33
33,182,660,102,558,8,550,12,120,121,102,9,4,2,32,8,140
33,183,828,130,698,13,685,7,161,102,99,16,6,0,58,16,220
33,184,436,83,353,14,339,4,84,100,39,10,4,0,16,5,77
33,185,1331,193,1138,13,1125,21,202,322,129,12,9,4,91,18,317
33,186,634,97,537,7,530,10,105,154,30,4,9,2,24,13,179
33,187,804,103,701,25,676,16,131,158,73,13,6,2,51,4,222
33,188,158,18,140,7,133,2,24,31,19,2,1,0,16,3,35
33,189,301,44,257,10,247,1,45,82,25,1,0,0,23,2,68
33,190,77,12,65,1,64,0,11,18,5,1,0,0,5,1,23
33,191,354,58,296,4,292,1,77,66,31,6,2,0,18,3,88
33,192,15738,2465,13273,218,13055,410,1279,3333,1564,163,47,36,1586,196,4441
33,193,1001,139,862,11,851,16,147,233,144,11,0,1,58,11,230
33,194,515,79,436,8,428,4,91,114,42,6,3,0,36,8,124
33,195,793,115,678,22,656,12,104,186,98,8,5,0,45,5,193
33,196,143,28,115,3,112,9,13,41,8,0,1,0,14,1,25
33,197,333,63,270,2,268,5,53,44,39,6,3,1,21,2,94
33,198,1098,212,886,28,858,16,189,175,98,14,9,1,72,15,269
33,199,15381,2714,12667,233,12434,267,2017,4187,1185,152,43,37,1214,249,3083
33,200,6912,1069,5843,95,5748,140,672,1348,629,96,24,16,593,87,2143
33,201,596,81,515,9,506,16,84,98,86,9,5,2,52,5,149
33,202,880,122,758,14,744,13,139,183,96,18,2,1,63,23,206
33,203,2595,397,2198,25,2173,39,462,573,216,41,8,6,188,33,607
33,204,356,42,314,3,311,3,85,67,43,4,2,2,14,7,84
33,205,1040,144,896,28,868,15,177,221,113,16,5,0,93,9,219
33,206,394,56,338,6,332,17,51,52,54,10,1,0,16,4,127
33,207,3918,715,3203,45,3158,47,690,655,331,64,19,10,256,57,1029
33,208,746,114,632,10,622,9,162,178,63,13,3,1,45,4,144
33,209,203,28,175,3,172,9,48,44,12,4,1,2,11,0,41
33,210,181,16,165,2,163,7,43,42,9,3,0,0,11,3,45
33,211,419,56,363,8,355,8,61,49,30,23,4,0,35,8,137
33,212,98,19,79,0,79,1,25,14,13,0,0,0,6,1,19
33,213,3139,441,2698,48,2650,57,304,808,243,40,10,6,332,45,805
33,214,4177,686,3491,54,3437,80,431,1066,348,63,16,13,382,74,964
33,215,173,27,146,1,145,2,24,54,12,6,1,0,16,4,26
33,216,126,9,117,5,112,5,13,31,15,0,2,0,7,3,36
33,218,1124,197,927,17,910,9,297,220,80,25,4,5,59,18,193
33,219,1705,252,1453,31,1422,24,320,261,169,33,8,2,118,28,459
33,220,764,120,644,7,637,7,175,128,59,15,3,2,55,12,181
33,221,743,108,635,18,617,19,141,169,61,14,6,2,36,16,153
33,222,487,69,418,9,409,9,97,135,41,10,3,1,16,9,88
33,223,127,12,115,3,112,1,22,32,12,2,0,0,22,4,17
33,224,97,12,85,0,85,2,20,28,10,0,1,0,4,0,20
33,225,1449,201,1248,26,1222,38,256,231,175,34,10,1,108,25,344
33,226,1490,237,1253,22,1231,40,204,255,178,23,8,6,133,31,353
33,227,4723,793,3930,74,3856,75,559,885,436,53,33,9,367,79,1360
33,228,520,78,442,8,434,14,93,91,57,10,2,0,41,6,120
33,229,5401,943,4458,80,4378,81,688,1418,481,66,22,8,421,84,1109
33,230,363,67,296,10,286,9,69,78,24,9,1,0,19,4,73
33,231,205,18,187,2,185,2,33,55,22,5,5,0,18,2,43
33,232,54,3,51,1,50,0,9,22,8,1,0,1,2,2,5
33,233,1725,365,1360,24,1336,15,386,324,161,33,10,3,104,24,276
33,234,2658,344,2314,38,2276,67,274,747,234,22,11,2,242,39,638
33,235,152,27,125,5,120,0,31,29,17,1,0,0,17,0,25
33,236,7830,1351,6479,89,6390,159,912,2833,428,73,10,21,621,99,1234
33,237,541,71,470,8,462,14,93,96,53,9,1,2,40,6,148
33,238,7662,1240,6422,119,6303,171,679,1557,809,108,17,11,705,79,2167
33,239,389,57,332,6,326,4,59,120,33,12,3,2,22,7,64
33,240,3785,887,2898,42,2856,34,731,731,288,42,21,8,181,33,787
33,241,362,45,317,4,313,10,48,60,51,9,2,1,24,1,107
33,242,453,66,387,6,381,7,90,96,56,6,1,0,24,6,95
33,243,15976,3219,12757,213,12544,268,2164,3191,1351,199,63,33,1104,201,3970
33,244,227,28,199,7,192,2,31,40,21,7,3,0,24,2,62
33,245,606,65,541,8,533,21,71,153,52,4,1,0,39,11,181
33,246,144,14,130,1,129,2,30,37,8,4,2,1,14,6,25
33,247,122,22,100,1,99,1,35,20,6,0,0,0,10,3,24
33,248,1689,270,1419,24,1395,16,338,281,162,46,11,3,139,25,374
33,249,10760,2581,8179,135,8044,125,1359,1293,1092,150,33,11,462,89,3430
33,250,262,42,220,9,211,7,39,51,21,6,0,0,19,5,63
33,251,497,85,412,8,404,15,73,76,54,15,3,0,27,11,130
33,252,445,49,396,3,393,4,104,82,45,8,1,1,30,6,112
33,253,777,89,688,7,681,19,111,167,113,10,7,1,48,13,192
33,254,296,34,262,9,253,6,55,61,31,4,1,2,20,0,73
33,255,211,16,195,1,194,6,41,13,29,3,0,0,12,3,87
33,256,3070,425,2645,47,2598,39,463,564,325,67,18,3,274,52,793
33,257,309,36,273,7,266,1,53,75,30,3,0,0,26,3,75
33,258,245,38,207,4,203,1,52,52,27,5,1,2,8,2,53
33,259,799,134,665,15,650,10,144,144,74,5,6,0,61,8,198
33,260,590,65,525,18,507,10,96,155,50,14,2,1,63,13,103
33,261,841,120,721,9,712,11,167,232,53,10,5,0,69,7,158
33,262,2388,355,2033,30,2003,33,459,396,253,63,9,5,167,22,596
33,263,160,17,143,2,141,8,33,23,14,4,1,0,15,4,39
33,264,751,111,640,17,623,11,165,107,62,22,7,1,54,11,183
33,266,558,53,505,7,498,17,106,98,61,12,8,3,45,7,141
33,267,910,184,726,21,705,5,175,217,60,6,3,2,48,11,178
33,268,976,181,795,10,785,13,141,183,82,20,3,2,76,12,253
33,269,285,38,247,4,243,7,67,66,20,3,2,0,23,1,54
33,270,129,9,120,3,117,3,35,27,11,2,1,0,5,1,32
33,271,157,26,131,2,129,2,27,35,21,1,3,2,10,0,28
33,272,771,124,647,9,638,6,139,112,98,20,4,2,41,9,207
33,273,5392,912,4480,63,4417,96,610,1183,436,63,13,12,453,76,1475
33,274,1783,209,1574,23,1551,47,207,378,205,27,8,4,162,32,481
33,275,128,16,112,2,110,4,25,20,11,2,1,0,13,1,33
33,276,105,13,92,3,89,1,13,28,9,0,1,0,11,2,24
33,277,203,32,171,7,164,4,50,31,15,3,1,0,14,5,41
33,278,195,22,173,4,169,2,34,43,18,1,2,0,10,0,59
33,279,500,67,433,14,419,7,66,98,40,4,4,0,38,13,149
33,280,345,50,295,6,289,5,71,92,23,4,1,2,26,7,58
33,281,44766,8207,36559,581,35978,1006,4339,8285,4313,541,131,75,3858,543,12887
33,282,260,48,212,3,209,4,34,62,17,2,2,2,26,2,58
33,283,131,34,97,2,95,3,19,21,14,4,4,0,10,1,19
33,284,5168,693,4475,91,4384,80,864,917,500,93,24,18,481,95,1312
33,285,318,47,271,6,265,9,56,63,24,5,2,0,25,4,77
33,287,428,77,351,13,338,9,76,75,35,11,5,2,25,4,96
33,288,220,36,184,2,182,2,40,53,23,7,1,0,16,7,33
33,289,1047,163,884,28,856,21,121,170,99,16,4,2,70,15,338
33,290,1074,173,901,17,884,13,180,318,70,4,5,1,84,9,200
33,291,153,11,142,1,141,2,26,35,17,1,0,1,6,2,51
33,292,113,10,103,0,103,3,13,27,11,1,0,0,6,2,40
33,293,2064,322,1742,27,1715,21,326,400,172,37,8,6,187,35,523
33,294,415,70,345,4,341,8,71,100,45,9,7,2,32,11,56
33,295,84,6,78,2,76,6,13,17,11,1,1,0,7,1,19
33,296,768,109,659,15,644,9,195,133,74,12,5,0,45,4,167
33,297,1201,175,1026,25,1001,17,204,207,155,26,2,0,90,20,280
33,298,746,89,657,13,644,15,108,132,107,14,6,2,49,8,203
33,299,300,48,252,5,247,4,70,62,26,3,4,1,27,4,46
33,300,782,133,649,18,631,13,148,157,74,20,4,2,57,11,145
33,301,433,38,395,9,386,9,93,114,29,7,0,1,35,6,92
33,302,280,43,237,8,229,3,35,79,18,4,1,0,25,4,60
33,303,700,116,584,16,568,18,136,118,61,7,2,2,48,12,164
33,304,127,21,106,4,102,4,18,16,17,1,1,1,13,4,27
33,305,335,31,304,3,301,6,44,78,40,9,4,0,25,3,92
33,306,308,44,264,13,251,3,62,48,39,1,2,0,30,6,60
33,307,1065,154,911,11,900,28,173,170,131,17,8,3,81,14,275
33,308,194,25,169,2,167,8,23,43,18,1,1,0,13,5,55
33,309,384,76,308,6,302,3,66,80,39,4,3,0,15,3,89
33,310,160,26,134,0,134,9,28,28,8,4,1,0,8,3,45
33,311,799,128,671,12,659,20,108,124,98,6,2,2,68,8,223
33,312,5735,870,4865,79,4786,90,892,942,594,126,17,13,430,85,1597
33,314,3403,852,2551,44,2507,27,691,597,249,43,14,2,160,32,692
33,315,1105,158,947,16,931,14,251,185,82,15,4,3,64,18,295
33,316,789,189,600,20,580,13,154,157,48,12,9,1,40,8,138
33,317,809,117,692,17,675,5,134,156,86,5,3,1,67,10,208
33,318,39237,7274,31963,534,31429,937,3377,6833,3854,543,122,71,3453,476,11763
33,319,343,51,292,6,286,3,64,77,27,4,3,1,26,4,77
33,320,471,72,399,7,392,7,105,104,33,6,4,0,28,4,101
33,321,1263,162,1101,24,1077,8,225,150,153,24,9,2,89,22,395
33,322,4533,630,3903,67,3836,90,626,898,420,92,9,3,429,56,1213
33,323,564,58,506,7,499,4,110,122,65,10,1,0,39,3,145
33,324,2953,471,2482,47,2435,45,552,710,215,43,12,5,174,46,633
33,325,624,76,548,8,540,13,87,157,53,8,7,1,43,13,158
33,326,167,21,146,4,142,2,42,39,16,2,1,0,12,0,28
33,327,1863,374,1489,22,1467,16,279,277,185,23,5,0,143,35,504
33,328,537,102,435,9,426,12,78,146,34,1,0,1,30,4,120
33,329,198,18,180,3,177,3,22,18,27,6,0,0,17,2,82
33,330,2206,273,1933,19,1914,32,242,522,159,28,2,3,216,39,671
33,331,338,33,305,6,299,7,53,63,34,6,1,0,34,4,97
33,332,666,93,573,17,556,10,147,115,46,9,3,1,55,8,162
33,333,1887,238,1649,37,1612,54,272,366,205,28,11,2,170,34,470
33,334,1730,269,1461,19,1442,34,268,299,171,29,3,2,140,29,467
33,335,376,29,347,2,345,4,59,75,50,6,2,3,37,13,96
33,336,793,85,708,12,696,16,101,184,82,18,4,1,50,12,228
33,337,1559,300,1259,29,1230,22,196,315,142,19,8,1,115,26,386
33,338,166,33,133,0,133,5,35,42,14,3,3,0,5,2,24
33,339,1026,140,886,15,871,18,175,139,108,22,1,2,88,18,300
33,341,1473,212,1261,23,1238,26,307,265,119,33,6,2,100,29,351
33,342,642,93,549,11,538,11,106,172,43,8,6,1,70,16,105
33,343,545,56,489,10,479,17,96,93,47,7,2,0,52,8,157
33,344,455,55,400,7,393,4,87,106,51,3,2,0,39,4,97
33,345,250,30,220,2,218,1,33,61,25,11,0,1,21,7,58
33,346,283,33,250,5,245,4,53,79,18,5,2,1,7,3,73
33,347,250,41,209,5,204,6,45,45,24,2,0,0,16,7,59
33,348,1088,175,913,19,894,12,223,219,89,17,4,1,68,19,242
33,349,1513,168,1345,27,1318,33,152,336,161,23,5,3,146,16,443
33,350,894,159,735,18,717,13,166,150,76,4,6,2,63,9,228
33,351,1136,212,924,18,906,7,256,240,75,18,4,4,75,19,208
33,352,2895,787,2108,54,2054,49,376,505,249,41,11,2,160,32,629
33,353,171,26,145,0,145,5,23,46,21,6,0,0,10,0,34
33,354,152,19,133,0,133,4,36,27,14,1,0,0,11,5,35
33,355,1086,142,944,12,932,19,184,180,122,18,6,3,89,7,304
33,356,279,45,234,10,224,1,46,65,16,3,2,0,23,0,68
33,357,975,77,898,26,872,19,136,207,94,11,5,1,73,21,305
33,358,262,25,237,5,232,6,64,38,25,1,2,0,11,9,76
33,359,177,26,151,2,149,1,34,40,11,5,0,0,15,5,38
33,360,249,31,218,2,216,2,61,54,29,2,2,0,25,0,41
33,361,403,42,361,4,357,8,78,63,60,12,1,1,21,8,105
33,362,945,159,786,21,765,11,218,162,84,14,9,0,55,18,194
33,363,2716,415,2301,45,2256,64,396,502,296,48,9,6,220,40,675
33,364,278,28,250,5,245,8,38,91,34,2,1,0,18,8,45
33,365,171,22,149,2,147,4,45,44,4,3,1,0,12,1,33
33,366,6387,1137,5250,83,5167,103,988,1102,695,101,25,14,454,73,1612
33,367,338,48,290,2,288,5,59,66,46,1,2,0,30,5,74
33,369,540,90,450,10,440,12,99,144,40,5,1,2,32,9,96
33,370,464,64,400,12,388,6,109,80,38,5,1,1,26,6,116
33,371,277,49,228,4,224,4,45,42,36,8,1,0,15,7,66
33,372,61,3,58,0,58,1,24,8,6,0,1,0,5,2,11
33,373,441,76,365,5,360,5,100,74,42,8,2,2,18,9,100
33,374,558,77,481,14,467,2,112,120,41,10,3,3,21,8,147
33,375,296,33,263,7,256,5,59,60,32,7,1,1,25,5,61
33,376,4766,635,4131,62,4069,84,454,1337,382,53,11,11,536,75,1126
33,377,62,8,54,1,53,2,12,10,5,0,1,1,4,4,14
33,378,1088,147,941,17,924,16,192,204,119,15,5,0,73,17,283
33,379,220,35,185,5,180,5,44,33,17,0,2,2,12,3,62
33,380,389,47,342,8,334,2,85,78,24,3,2,0,27,4,109
33,381,2220,358,1862,26,1836,44,308,391,294,24,7,4,164,30,570
33,382,1290,240,1050,14,1036,12,286,237,93,23,9,1,74,21,280
33,383,255,50,205,1,204,4,68,75,7,3,0,0,6,3,38
33,384,388,53,335,3,332,5,61,133,27,8,3,0,28,9,58
33,385,536,115,421,12,409,7,131,85,45,8,3,0,30,7,93
33,386,173,27,146,2,144,2,42,38,10,1,0,0,10,1,40
33,387,986,221,765,17,748,12,187,146,79,15,6,2,76,10,215
33,388,563,90,473,7,466,5,91,83,76,7,5,2,40,8,149
33,389,2338,404,1934,44,1890,22,424,439,224,31,12,4,140,41,553
33,390,347,75,272,4,268,6,81,74,20,3,0,1,24,6,53
33,391,250,37,213,6,207,0,25,35,41,3,0,0,20,4,79
33,392,632,96,536,11,525,11,91,99,70,11,4,3,39,12,185
33,393,3584,635,2949,63,2886,47,671,711,273,49,15,2,228,42,848
33,394,1542,232,1310,21,1289,30,220,515,95,22,3,3,138,14,249
33,395,1067,182,885,14,871,10,269,214,59,19,10,1,54,10,225
33,396,207,42,165,3,162,1,39,69,13,2,1,0,7,2,28
33,397,2994,448,2546,28,2518,29,486,568,266,41,14,9,212,33,860
33,398,123,15,108,5,103,4,27,12,21,2,0,0,8,5,24
33,399,240,50,190,5,185,2,49,43,16,4,0,2,15,3,51
33,400,243,31,212,7,205,7,42,63,20,3,3,1,22,3,41
33,401,111,10,101,0,101,0,32,28,11,2,0,0,7,2,19
33,402,1532,454,1078,18,1060,15,194,285,105,14,1,1,67,15,363
33,403,95,9,86,0,86,2,19,15,24,0,0,0,6,1,19
33,404,199,48,151,1,150,3,35,43,11,1,1,1,9,1,45
33,405,370,49,321,12,309,7,55,79,52,7,5,0,20,6,78
33,406,303,48,255,6,249,7,79,59,26,3,1,2,19,7,46
33,407,541,94,447,12,435,4,107,86,62,12,4,0,45,8,107
33,408,251,19,232,4,228,8,36,60,21,2,3,3,31,9,55
33,409,80,12,68,1,67,2,12,20,6,0,0,0,13,0,14
33,411,107,16,91,0,91,2,11,42,8,0,1,0,11,0,16
33,412,1036,216,820,9,811,6,256,160,77,22,6,1,46,11,226
33,413,1613,240,1373,29,1344,32,231,373,156,22,4,3,125,25,373
33,414,259,23,236,7,229,8,45,71,14,1,0,0,23,4,63
33,415,1188,158,1030,20,1010,16,173,207,106,18,3,4,121,21,341
33,416,676,109,567,5,562,5,158,102,64,13,2,0,45,11,162
33,417,1790,253,1537,32,1505,38,335,302,176,34,10,3,158,32,417
33,418,268,43,225,4,221,4,54,57,29,7,1,2,14,1,52
33,419,64,9,55,1,54,1,18,17,4,0,0,0,5,1,8
33,420,127,17,110,1,109,2,31,42,2,1,0,1,9,1,20
33,421,334,78,256,7,249,4,72,75,22,4,0,0,25,4,43
33,422,5063,733,4330,64,4266,112,593,1178,414,70,11,14,509,87,1278
33,423,411,75,336,10,326,5,85,97,21,3,2,1,32,3,77
33,424,3034,506,2528,30,2498,34,627,515,302,47,10,4,211,45,703
33,425,1060,199,861,15,846,14,197,187,77,30,7,3,84,20,227
33,426,204,32,172,4,168,1,36,68,5,4,1,0,16,3,34
33,427,171,22,149,3,146,6,30,31,18,0,2,0,22,4,33
33,428,80,11,69,2,67,1,9,30,13,0,0,1,6,1,6
33,429,245,26,219,9,210,4,47,35,28,9,3,0,13,2,69
33,431,226,21,205,5,200,3,45,42,23,4,2,0,27,0,54
33,432,148,21,127,2,125,2,20,29,17,2,0,0,12,2,41
33,433,6260,1085,5175,107,5068,93,880,1090,647,90,20,11,505,87,1645
33,434,1366,165,1201,9,1192,12,276,145,186,20,6,1,81,11,454
33,435,1274,288,986,17,969,33,180,215,159,23,10,1,78,12,258
33,436,723,104,619,17,602,6,119,123,59,12,1,2,59,14,207
33,437,1319,205,1114,14,1100,15,268,314,96,19,10,4,102,16,256
33,438,1168,153,1015,13,1002,18,185,175,136,19,8,5,86,21,349
33,439,1005,180,825,17,808,12,231,139,96,19,5,3,67,13,223
33,440,184,26,158,3,155,3,24,30,26,3,3,0,19,4,43
33,441,821,149,672,16,656,7,118,135,89,6,2,4,64,18,213
33,442,341,51,290,9,281,3,70,56,27,4,5,1,34,10,71
33,443,115,22,93,1,92,7,9,32,8,1,0,1,17,0,17
33,444,362,42,320,6,314,5,54,78,32,5,5,5,38,9,83
33,445,596,94,502,5,497,6,128,109,39,10,0,1,38,13,153
33,446,154,18,136,4,132,5,19,33,22,8,1,0,15,0,29
33,447,1688,400,1288,23,1265,8,304,332,131,22,11,5,95,19,338
33,448,2039,327,1712,28,1684,23,265,361,226,29,7,2,187,21,563
33,449,21285,2809,18476,307,18169,446,2426,4449,2008,336,66,55,1995,307,6081
33,450,189,18,171,6,165,3,40,23,24,4,0,0,7,5,59
33,451,379,47,332,8,324,5,76,66,34,4,3,0,35,6,95
33,452,416,48,368,7,361,6,78,79,45,7,2,2,38,9,95
33,453,176,26,150,7,143,2,31,31,18,5,1,0,20,1,34
33,454,1141,142,999,17,982,30,129,282,115,9,7,4,104,14,288
33,456,387,50,337,14,323,9,73,88,41,7,2,0,43,6,54
33,457,428,51,377,8,369,9,55,102,36,6,3,1,40,9,108
33,458,655,85,570,10,560,7,129,129,62,6,5,0,50,13,159
33,459,192,32,160,6,154,2,48,54,7,1,0,0,6,2,34
33,460,498,56,442,9,433,6,112,111,40,6,3,3,23,7,122
33,461,314,50,264,2,262,3,65,96,20,2,1,0,18,8,49
33,462,384,53,331,8,323,11,83,73,23,3,0,1,23,7,99
33,463,1025,145,880,18,862,13,102,116,273,11,4,0,73,7,263
33,464,250,36,214,4,210,9,33,34,17,6,0,1,26,4,80
33,465,821,111,710,14,696,19,111,120,70,22,7,3,77,11,256
33,466,1272,202,1070,21,1049,18,236,210,128,14,9,3,85,23,323
33,467,211,31,180,6,174,2,32,59,14,2,0,2,10,2,51
33,468,336,45,291,3,288,5,84,59,49,3,2,1,20,1,64
33,470,629,84,545,8,537,8,120,124,66,7,0,3,59,8,142
33,471,945,164,781,16,765,8,217,179,67,13,6,0,55,10,210
33,472,287,44,243,2,241,1,61,50,27,6,0,0,10,1,85
33,473,1851,323,1528,31,1497,16,398,337,136,29,5,3,123,39,411
33,474,1750,280,1470,21,1449,39,229,344,144,20,7,12,166,31,457
33,475,302,42,260,1,259,6,52,62,30,3,0,2,24,4,76
33,476,554,93,461,3,458,11,120,126,37,10,2,0,27,3,122
33,477,519,92,427,8,419,0,93,84,37,9,5,3,33,10,145
33,478,2187,426,1761,39,1722,30,426,368,185,22,16,4,116,28,527
33,479,167,22,145,6,139,1,36,38,21,2,4,1,7,1,28
33,480,1229,222,1007,22,985,21,225,261,97,17,7,2,74,15,266
33,481,170,31,139,3,136,4,23,39,12,2,0,0,12,6,38
33,482,203,40,163,3,160,2,55,33,14,2,1,0,11,2,40
33,483,3265,498,2767,39,2728,47,464,813,286,46,15,7,254,47,749
33,484,1298,245,1053,21,1032,27,205,196,153,17,8,2,78,19,327
33,485,1287,160,1127,26,1101,23,283,278,100,12,6,3,97,17,282
33,486,256,41,215,4,211,5,42,43,25,4,2,0,18,6,66
33,487,716,128,588,8,580,5,133,131,69,12,9,1,35,10,175
33,488,332,64,268,3,265,6,50,80,20,6,1,0,30,4,68
33,489,285,52,233,4,229,6,56,64,20,2,6,1,28,5,41
33,490,1333,225,1108,20,1088,16,305,236,95,16,3,0,75,16,326
33,491,265,40,225,7,218,5,54,54,19,5,2,0,25,4,50
33,492,1364,273,1091,12,1079,17,348,153,138,14,10,3,66,24,306
33,493,339,31,308,8,300,5,84,50,42,5,1,0,31,11,71
33,494,568,64,504,8,496,9,99,132,46,17,3,0,50,10,130
33,495,1085,128,957,21,936,9,214,173,109,15,3,3,81,19,310
33,496,1648,211,1437,22,1415,39,210,380,146,14,3,0,146,36,441
33,498,4411,614,3797,71,3726,79,655,874,474,66,16,9,347,79,1127
33,499,254,43,211,2,209,4,59,71,22,0,0,0,11,3,39
33,500,338,65,273,3,270,6,48,53,31,5,1,5,41,4,76
33,501,1699,210,1489,29,1460,24,252,381,176,22,8,1,137,21,438
33,502,278,46,232,5,227,3,58,46,31,2,3,2,21,2,59
33,503,369,49,320,6,314,6,44,78,35,3,3,1,44,5,95
33,504,485,48,437,14,423,7,76,108,45,6,4,1,43,2,131
33,505,926,141,785,19,766,8,123,164,122,11,4,3,65,15,251
33,506,1410,246,1164,26,1138,17,210,308,134,13,4,1,87,15,349
33,507,233,19,214,4,210,3,31,35,31,6,0,2,23,2,77
33,508,421,37,384,6,378,12,86,86,50,8,3,2,32,7,92
33,509,422,52,370,6,364,9,70,93,35,8,1,0,23,2,123
33,510,147,15,132,3,129,1,34,15,26,0,0,0,16,1,36
33,511,262,35,227,4,223,8,52,42,39,2,3,0,16,1,60
33,512,251,31,220,5,215,5,54,39,31,1,1,2,19,7,56
33,513,85,7,78,5,73,0,23,12,11,0,0,0,9,3,15
33,514,2604,506,2098,26,2072,40,392,738,196,36,8,3,157,25,477
33,515,331,58,273,2,271,15,53,72,23,3,0,0,31,2,72
33,516,125,13,112,3,109,1,31,29,5,1,0,0,12,0,30
33,517,1085,182,903,15,888,9,212,187,115,13,5,4,59,17,267
33,518,802,84,718,7,711,19,116,155,93,18,5,1,77,17,210
33,519,6999,1017,5982,99,5883,129,772,1473,617,97,25,13,692,116,1949
33,520,207,30,177,2,175,8,47,38,25,3,2,2,13,4,33
33,521,526,95,431,7,424,3,122,113,37,6,4,0,21,9,109
33,522,21872,3863,18009,254,17755,729,1552,3810,2309,273,66,39,2166,221,6590
33,523,1251,193,1058,9,1049,15,238,273,130,18,3,2,80,25,265
33,524,207,28,179,3,176,2,37,36,14,6,0,1,12,3,65
33,525,1056,188,868,14,854,17,205,146,115,20,4,3,70,17,257
33,526,120,9,111,5,106,4,31,32,8,1,1,1,5,3,20
33,527,4842,790,4052,79,3973,84,716,929,452,87,18,4,378,84,1221
33,528,387,37,350,4,346,6,67,120,32,4,1,0,28,14,74
33,529,19060,3339,15721,311,15410,297,2464,5682,1315,239,57,41,1523,318,3474
33,530,599,88,511,9,502,7,109,139,52,7,5,0,49,18,116
33,531,226,27,199,6,193,7,46,49,23,2,1,0,13,2,50
33,532,376,46,330,6,324,7,64,69,44,6,1,2,33,5,93
33,533,1584,264,1320,25,1295,17,238,237,167,23,8,3,130,25,447
33,534,556,107,449,8,441,20,54,84,62,7,3,3,56,5,147
33,535,3236,422,2814,52,2762,54,417,582,321,32,6,5,267,49,1029
33,536,190,23,167,7,160,4,40,25,24,4,3,0,12,9,39
33,537,361,35,326,3,323,14,29,59,72,3,1,2,18,8,117
33,538,361,64,297,6,291,3,97,82,24,4,0,0,21,1,59
33,539,2406,398,2008,49,1959,29,396,504,213,33,9,4,181,37,553
33,540,2006,337,1669,33,1636,46,319,461,150,25,4,4,152,27,448
33,541,743,134,609,9,600,6,156,136,58,6,2,1,44,11,180
33,542,548,69,479,5,474,9,96,106,52,15,3,1,33,19,140
33,543,645,148,497,6,491,6,75,130,54,9,1,1,50,5,160
33,544,1286,219,1067,19,1048,20,235,269,110,15,7,3,58,22,309
33,545,878,175,703,16,687,7,207,153,68,14,4,0,50,9,175
33,546,355,44,311,5,306,4,66,114,33,5,1,0,20,2,61
33,547,740,142,598,7,591,15,83,153,81,4,3,3,52,5,192
33,548,847,109,738,17,721,18,180,166,70,15,4,0,57,13,198
33,549,255,40,215,3,212,5,20,56,35,4,2,0,22,1,67
33,550,20437,3521,16916,302,16614,383,2051,3384,2399,299,73,49,1590,242,6144
33,551,296,44,252,6,246,4,62,49,24,3,0,1,15,4,84
33,552,724,83,641,17,624,6,136,118,70,4,3,1,58,15,213
33,553,805,180,625,14,611,7,151,104,77,8,3,3,46,7,205
33,554,1858,275,1583,25,1558,29,243,429,163,21,5,4,174,36,454
33,555,3138,479,2659,42,2617,41,531,519,308,65,15,4,230,51,853
34,1,1108,136,972,24,948,15,312,210,109,11,3,3,64,13,208
34,2,768,97,671,22,649,5,171,150,65,10,0,1,33,7,207
34,3,21439,4290,17149,288,16861,268,4651,5408,1508,167,51,34,868,212,3694
34,4,169,18,151,2,149,9,25,36,19,1,1,0,8,4,46
34,5,212,23,189,3,186,11,34,47,35,1,0,0,7,5,46
34,6,168,30,138,2,136,5,21,48,15,2,1,0,4,2,38
34,7,330,65,265,6,259,6,57,55,33,4,2,1,22,2,77
34,8,468,75,393,7,386,8,90,79,64,12,5,4,25,2,97
34,9,1223,161,1062,21,1041,13,284,224,151,16,4,1,60,16,272
34,10,2301,376,1925,40,1885,68,435,347,411,30,9,10,97,25,453
34,11,70,14,56,0,56,4,11,8,15,2,0,0,5,0,11
34,12,689,88,601,19,582,27,116,136,94,12,3,2,50,4,138
34,13,1100,167,933,15,918,21,242,192,115,12,2,1,48,15,270
34,14,1275,129,1146,19,1127,47,130,364,142,7,4,0,97,12,324
34,15,132,26,106,1,105,3,20,29,20,3,1,0,12,1,16
34,16,430,47,383,7,376,19,91,66,67,4,1,0,21,5,102
34,17,362,50,312,7,305,7,82,89,34,1,0,0,19,4,69
34,18,651,106,545,12,533,8,127,131,88,7,3,2,30,9,128
34,19,294,49,245,6,239,7,53,56,42,3,0,1,15,3,59
34,20,307,56,251,5,246,10,46,59,40,3,1,0,17,5,65
34,21,245,39,206,8,198,3,41,48,21,7,0,1,18,3,56
34,22,4867,756,4111,67,4044,72,878,1203,410,30,14,11,316,69,1041
34,23,5765,919,4846,82,4764,60,1348,1322,727,41,12,8,242,83,921
34,24,1852,277,1575,16,1559,35,477,401,213,22,10,3,63,26,309
34,25,1362,165,1197,14,1183,19,353,324,117,18,3,0,75,21,253
34,26,135,15,120,1,119,3,26,30,14,3,0,0,11,2,30
34,27,1263,175,1088,27,1061,31,216,290,112,8,7,2,90,19,286
34,28,4784,1233,3551,63,3488,82,669,684,778,48,27,15,198,33,954
34,29,367,75,292,3,289,7,65,52,35,2,3,0,18,6,101
34,30,173,31,142,4,138,4,19,28,19,3,3,0,20,2,40
34,31,3412,605,2807,54,2753,44,915,613,365,24,13,5,112,25,637
34,32,45538,9733,35805,504,35301,571,9072,9930,3807,284,130,62,2048,435,8962
34,33,1297,187,1110,17,1093,21,270,300,126,11,4,2,93,16,250
34,34,48,9,39,0,39,2,7,8,8,1,0,0,0,1,12
34,35,704,94,610,10,600,15,128,129,99,5,0,1,49,10,164
34,36,1055,180,875,12,863,21,228,195,125,9,4,5,56,16,204
34,37,2272,236,2036,35,2001,21,517,600,218,14,6,2,114,17,492
34,38,1196,194,1002,19,983,23,225,161,180,20,12,4,42,12,304
34,39,1380,180,1200,26,1174,23,336,398,125,9,1,1,69,31,181
34,40,48,9,39,2,37,8,3,8,9,0,0,0,2,1,6
34,41,527,40,487,4,483,15,109,98,93,7,0,3,29,7,122
34,42,509,55,454,6,448,9,86,86,102,7,3,2,39,5,109
34,43,222,26,196,3,193,9,39,53,29,3,1,0,18,2,39
34,44,263,36,227,3,224,6,56,56,31,3,1,0,10,5,56
34,45,361,48,313,4,309,7,50,66,69,3,1,0,18,6,89
34,46,94,13,81,4,77,0,15,17,10,2,0,0,8,0,25
34,47,450,90,360,7,353,7,78,65,82,4,0,1,26,6,84
34,48,221,29,192,2,190,1,62,49,20,2,2,0,12,4,38
34,49,203,23,180,3,177,4,32,22,42,3,0,0,11,2,61
34,50,969,120,849,29,820,22,218,236,85,11,8,1,62,14,163
34,51,2402,326,2076,29,2047,32,641,408,267,24,8,5,145,23,494
34,52,2322,388,1934,26,1908,32,525,341,294,16,12,7,112,29,540
34,53,82,12,70,1,69,1,23,10,12,1,1,0,3,4,14
34,54,81,28,53,0,53,3,4,3,23,0,1,0,6,1,12
34,55,157,24,133,1,132,1,37,14,29,1,0,1,6,0,43
34,56,907,152,755,11,744,20,144,192,136,12,4,4,62,8,162
34,57,12905,2323,10582,182,10400,358,1618,3287,1058,66,25,35,1047,160,2746
34,58,4465,675,3790,65,3725,93,730,1133,379,32,11,19,346,84,898
34,59,251,39,212,3,209,10,37,29,45,3,2,0,13,1,69
34,60,345,55,290,7,283,10,32,65,55,7,1,0,21,5,87
34,61,462,78,384,6,378,9,97,77,55,8,2,2,20,0,108
34,62,109,17,92,2,90,0,26,36,13,0,0,0,2,1,12
34,63,1866,290,1576,28,1548,24,379,421,186,12,7,3,91,30,395
34,64,381,41,340,14,326,15,46,92,50,9,3,2,14,6,89
34,65,386,52,334,4,330,8,88,67,39,8,0,3,31,4,82
34,66,193,37,156,5,151,1,26,61,14,3,0,0,15,1,30
34,67,1017,120,897,16,881,20,239,242,124,8,6,4,55,18,165
34,68,255,28,227,5,222,9,47,49,50,3,4,0,15,3,42
34,69,3139,448,2691,52,2639,38,734,515,326,34,15,5,159,38,775
34,70,391,79,312,7,305,6,80,55,38,3,1,1,19,3,99
34,71,266,38,228,7,221,14,42,57,30,3,0,2,18,5,50
34,72,22,2,20,2,18,5,1,1,3,0,0,0,0,0,8
34,73,1819,308,1511,24,1487,20,497,350,175,22,12,2,65,21,323
34,74,1581,218,1363,18,1345,19,354,269,220,18,3,1,62,19,380
34,75,291,52,239,4,235,6,46,55,36,3,0,1,24,8,56
34,76,857,120,737,15,722,21,163,155,105,7,4,2,56,12,197
34,77,3855,392,3463,52,3411,147,417,806,468,35,14,10,353,43,1118
34,78,1093,151,942,19,923,36,169,157,147,10,7,1,67,22,307
34,79,5723,1199,4524,53,4471,86,1011,940,620,49,32,9,323,55,1346
34,80,387,51,336,3,333,21,58,43,54,5,1,1,37,9,104
34,81,1829,250,1579,20,1559,22,521,367,148,16,5,4,99,18,359
34,82,1264,172,1092,18,1074,40,198,272,145,11,5,2,111,19,271
34,83,172,34,138,0,138,9,23,19,22,3,0,0,14,0,48
34,84,1227,140,1087,18,1069,18,293,251,116,12,1,1,73,14,290
34,85,266,31,235,2,233,4,73,58,27,2,3,0,18,2,46
34,86,512,65,447,11,436,9,104,73,69,13,5,0,34,6,123
34,87,1835,189,1646,38,1608,34,383,364,219,20,4,2,81,32,469
34,88,4377,693,3684,85,3599,70,1006,764,527,44,12,8,226,55,887
34,89,933,107,826,11,815,12,222,172,97,10,3,0,40,11,248
34,90,6507,1085,5422,112,5310,127,1086,1473,606,49,22,13,428,63,1443
34,91,81,10,71,2,69,2,7,25,10,0,0,0,3,0,22
34,92,727,80,647,12,635,8,137,138,110,13,5,1,37,4,182
34,93,172,32,140,2,138,3,25,33,25,0,0,1,8,0,43
34,94,745,84,661,18,643,8,190,177,55,9,1,1,56,9,137
34,95,5258,850,4408,80,4328,75,1197,1101,559,54,11,8,310,71,942
34,96,382,54,328,6,322,5,54,76,70,3,1,2,25,7,79
34,97,367,55,312,9,303,18,43,49,60,7,0,0,28,6,92
34,98,136,25,111,3,108,6,19,8,37,0,1,0,3,4,30
34,99,62,12,50,0,50,7,12,5,9,0,0,0,5,2,10
34,100,80,8,72,1,71,2,18,21,3,1,1,0,7,1,17
34,101,3560,547,3013,66,2947,27,852,662,391,39,14,6,144,40,772
34,102,271,51,220,2,218,9,38,74,24,1,0,0,17,1,54
34,103,767,159,608,9,599,13,128,153,84,5,5,1,38,13,159
34,104,89,10,79,3,76,1,17,8,18,1,1,0,3,0,27
34,105,201,41,160,0,160,5,54,21,19,3,0,0,4,3,51
34,106,165,26,139,1,138,7,14,39,31,2,0,0,7,2,36
34,107,299,52,247,9,238,11,42,52,56,7,2,0,8,0,60
34,108,17560,3491,14069,313,13756,223,3990,3162,1954,126,55,30,727,197,3292
34,109,644,108,536,7,529,3,130,149,56,1,4,0,26,5,155
34,110,462,52,410,3,407,15,107,113,44,6,0,0,24,3,95
34,111,3041,614,2427,60,2367,54,579,463,401,33,8,6,135,31,657
34,112,133,20,113,3,110,4,16,27,17,1,2,0,10,4,29
34,113,4033,729,3304,66,3238,57,928,667,446,31,10,5,198,66,830
34,114,3989,641,3348,53,3295,95,736,660,564,43,13,6,216,35,927
34,115,139,20,119,1,118,5,22,21,21,1,2,0,10,2,34
34,116,4329,588,3741,70,3671,118,606,997,582,22,6,7,348,41,944
34,117,490,63,427,1,426,13,82,61,85,6,4,1,19,5,150
34,118,394,47,347,1,346,11,69,116,31,1,1,2,35,4,76
34,119,1144,154,990,22,968,15,251,210,132,12,6,0,73,17,252
34,120,4138,413,3725,68,3657,107,642,761,537,30,10,6,288,54,1222
34,121,239,41,198,3,195,8,38,33,53,3,2,1,8,6,43
34,122,332,38,294,1,293,8,53,82,44,3,0,1,20,4,78
34,123,5792,953,4839,90,4749,97,972,1500,508,27,22,11,360,59,1193
34,124,217,30,187,9,178,9,38,51,30,0,0,0,12,3,35
34,125,119,10,109,6,103,5,28,23,14,0,0,0,6,2,25
34,126,1792,377,1415,32,1383,24,284,391,187,30,7,7,112,23,318
34,127,2204,281,1923,44,1879,42,441,481,229,25,5,5,117,27,507
34,128,1193,211,982,12,970,18,278,233,132,10,3,3,78,10,205
34,129,12617,2165,10452,164,10288,215,2243,3384,891,76,24,20,869,156,2410
34,130,1032,153,879,22,857,6,247,215,109,14,7,2,57,9,191
34,131,422,48,374,5,369,20,61,67,54,7,1,0,31,3,125
34,132,207,36,171,7,164,7,29,32,27,5,1,0,6,6,51
34,133,54,9,45,1,44,5,13,15,2,1,0,0,2,1,5
34,134,2067,248,1819,27,1792,40,416,430,245,16,4,2,104,24,511
34,135,2511,500,2011,29,1982,27,660,391,265,17,13,1,81,34,493
34,136,1017,121,896,15,881,15,260,166,100,13,1,1,42,21,262
34,137,142,27,115,2,113,5,24,43,6,4,0,1,9,5,16
34,138,212,19,193,4,189,12,46,27,26,1,1,0,14,2,60
34,139,1043,150,893,14,879,8,283,230,97,3,2,1,45,13,197
34,140,2318,342,1976,41,1935,28,563,569,216,14,4,1,103,28,409
34,141,396,67,329,12,317,5,86,67,45,7,2,0,15,6,84
34,142,5323,1182,4141,83,4058,119,946,914,592,49,16,14,221,42,1145
34,143,1684,287,1397,27,1370,29,379,306,155,18,8,5,95,22,353
34,144,553,110,443,7,436,9,68,81,81,3,3,1,55,6,129
34,145,16628,3328,13300,235,13065,240,3523,3173,1543,121,77,31,736,177,3444
34,146,2567,323,2244,47,2197,39,611,540,261,41,11,5,138,24,527
34,147,2152,345,1807,25,1782,22,527,404,230,16,5,5,121,42,410
34,148,2906,440,2466,41,2425,34,725,653,256,29,5,4,142,40,537
34,149,435,78,357,6,351,5,105,87,34,5,1,1,20,7,86
34,150,6262,1212,5050,101,4949,86,1347,1468,531,40,23,5,274,75,1100
34,151,4521,705,3816,72,3744,65,1074,909,472,40,19,9,203,53,900
34,152,346,32,314,3,311,19,37,89,53,6,0,4,24,6,73
34,153,1370,145,1225,20,1205,36,212,246,152,11,3,1,128,38,378
34,154,13647,2270,11377,187,11190,266,2703,3287,1208,91,19,20,815,159,2622
34,155,1487,254,1233,23,1210,18,358,304,113,11,8,0,73,22,303
34,156,56,5,51,3,48,0,7,14,6,3,0,0,8,3,7
34,157,8598,1627,6971,123,6848,149,2117,1771,721,73,33,19,336,78,1551
34,158,121,19,102,1,101,1,11,20,15,0,0,2,19,4,29
34,159,2557,374,2183,39,2144,30,603,532,242,19,14,6,126,37,535
34,160,471,77,394,10,384,21,62,67,69,9,1,1,42,5,107
34,161,2945,483,2462,50,2412,37,797,511,278,24,12,6,153,43,551
34,162,2871,578,2293,36,2257,44,532,528,420,30,10,5,123,28,537
34,163,2246,412,1834,36,1798,52,499,368,268,12,5,7,135,25,427
34,164,715,94,621,9,612,19,125,126,82,9,1,2,47,11,190
34,165,2201,414,1787,29,1758,48,462,388,249,20,11,2,127,20,431
34,166,1992,289,1703,28,1675,24,439,419,231,15,4,3,81,25,434
34,167,191,31,160,0,160,4,59,19,25,1,1,0,8,4,39
34,168,57,4,53,1,52,1,15,11,4,0,1,0,6,5,9
34,169,3115,439,2676,36,2640,96,283,1045,236,19,4,11,289,34,623
34,170,178,26,152,2,150,5,21,31,20,5,0,1,8,0,59
34,171,138,21,117,0,117,11,8,19,34,2,1,0,8,2,32
34,172,141433,31737,109696,1670,108026,4217,14751,23310,16948,1091,374,260,7961,1327,37787
34,173,1078,166,912,10,902,39,181,176,173,6,3,0,84,22,218
34,174,633,104,529,10,519,7,183,138,50,4,1,2,28,15,91
34,175,136,19,117,0,117,5,15,27,36,4,1,0,5,4,20
34,176,1858,221,1637,35,1602,31,351,387,183,19,9,2,132,20,468
34,177,255,22,233,4,229,9,40,50,47,1,0,0,25,7,50
34,178,2104,303,1801,36,1765,28,561,381,300,24,9,2,81,16,363
34,179,1339,142,1197,20,1177,40,212,182,227,12,3,2,99,26,374
34,180,1057,179,878,15,863,29,176,167,184,13,5,0,53,17,219
34,181,705,106,599,8,591,28,111,135,126,8,4,0,26,6,147
34,182,1123,129,994,14,980,18,235,279,130,14,2,3,75,12,212
34,183,2821,435,2386,29,2357,38,680,518,354,29,5,4,130,28,571
34,184,472,69,403,9,394,12,90,86,55,7,4,2,24,11,103
34,185,390,48,342,8,334,17,66,75,57,3,2,1,28,8,77
34,186,362,44,318,6,312,17,59,59,63,2,2,0,19,2,89
34,187,433,61,372,11,361,12,58,65,65,7,2,0,24,2,126
34,188,105,10,95,1,94,15,23,18,14,3,1,0,3,0,17
34,189,1213,263,950,13,937,18,256,217,116,17,9,1,58,12,233
34,190,225,42,183,5,178,3,51,26,11,6,1,0,22,3,55
34,191,398,41,357,6,351,5,94,93,52,9,4,0,18,7,69
34,192,5469,1054,4415,81,4334,93,1165,1547,385,33,6,10,252,64,779
34,193,145,20,125,2,123,7,14,22,19,3,0,0,14,2,42
34,194,2604,485,2119,26,2093,35,486,423,283,37,11,1,129,39,649
34,195,60,5,55,0,55,0,3,16,11,0,0,0,5,0,20
34,196,176,26,150,2,148,2,29,31,23,3,1,0,4,2,53
34,197,706,82,624,13,611,16,147,122,104,11,1,0,48,9,153
34,198,7170,1212,5958,105,5853,130,1396,1942,541,41,18,16,478,76,1215
34,199,5919,978,4941,79,4862,127,969,1251,687,57,19,13,334,76,1329
34,200,187,27,160,5,155,4,24,25,36,3,1,1,8,1,52
34,201,229,36,193,2,191,8,50,40,26,1,0,0,23,3,40
34,202,5100,752,4348,80,4268,101,1091,988,556,38,16,7,310,41,1120
34,203,981,139,842,18,824,13,248,225,78,8,2,1,33,7,209
34,204,744,114,630,7,623,12,155,163,57,9,2,3,35,7,180
34,205,236,41,195,2,193,4,46,45,27,3,0,1,17,6,44
34,206,424,58,366,10,356,2,108,81,36,6,1,0,22,4,96
34,207,1681,297,1384,17,1367,13,392,380,147,17,5,2,101,20,290
34,208,273,38,235,4,231,6,63,50,36,3,0,0,22,3,48
34,209,2528,435,2093,34,2059,20,568,621,221,22,14,5,114,23,451
34,210,1462,257,1205,22,1183,31,283,239,217,16,4,3,91,19,280
34,211,798,104,694,18,676,15,158,100,104,17,9,2,37,8,226
34,212,127,15,112,5,107,3,15,38,12,2,1,0,8,0,28
34,213,4399,970,3429,50,3379,75,832,792,498,45,19,18,225,48,827
34,214,819,114,705,11,694,10,187,155,114,7,3,1,45,10,162
34,215,689,112,577,11,566,34,121,125,70,7,2,1,41,9,156
34,216,212,33,179,2,177,2,46,29,24,3,0,0,19,2,52
34,217,3736,555,3181,56,3125,116,486,667,490,38,12,9,261,27,1019
34,218,205,29,176,6,170,2,41,29,23,2,1,0,19,3,50
34,219,393,54,339,5,334,13,63,60,67,10,0,4,21,3,93
34,220,172,20,152,5,147,3,45,42,13,1,0,0,9,4,30
34,221,389,49,340,3,337,31,47,51,79,8,3,3,25,4,86
34,222,262,21,241,2,239,4,51,51,25,2,0,0,16,0,90
34,223,811,108,703,11,692,5,184,180,100,10,5,3,43,16,146
34,224,885,115,770,3,767,13,217,173,101,4,5,2,45,10,197
34,225,2184,352,1832,27,1805,28,452,483,251,12,16,5,110,20,428
34,226,1257,250,1007,19,988,23,278,237,138,14,5,3,63,8,219
34,227,1185,155,1030,18,1012,27,236,255,110,14,2,1,85,15,267
34,228,79,9,70,2,68,3,10,17,7,0,0,0,4,1,26
34,229,614,111,503,14,489,30,79,77,99,8,0,2,30,5,159
34,230,117,18,99,3,96,0,13,38,6,1,1,0,9,4,24
34,231,20,6,14,2,12,1,4,2,0,0,0,0,1,0,4
34,232,481,89,392,11,381,17,50,101,67,2,0,0,28,7,109
34,233,116,15,101,2,99,7,13,28,13,2,0,0,15,0,21
34,234,98,31,67,0,67,1,21,17,12,0,0,0,4,0,12
34,235,275,35,240,4,236,4,48,44,51,2,2,1,9,2,73
34,236,60,9,51,0,51,4,8,11,6,1,0,0,7,2,12
34,237,1554,271,1283,21,1262,25,283,313,172,13,11,2,65,16,362
34,238,69,7,62,0,62,2,8,20,6,1,0,3,9,1,12
34,239,3900,626,3274,59,3215,70,778,749,504,42,21,6,239,40,766
34,240,2409,341,2068,44,2024,48,416,648,183,20,4,9,189,29,478
34,241,687,93,594,6,588,19,106,154,96,3,0,3,50,4,153
34,242,728,84,644,9,635,35,110,140,84,4,1,1,39,10,211
34,243,1300,181,1119,22,1097,26,243,246,189,15,5,1,79,19,274
34,244,1969,269,1700,28,1672,44,403,397,164,20,6,10,123,23,482
34,245,1427,245,1182,26,1156,11,247,279,143,18,7,3,84,17,347
34,246,1114,128,986,15,971,28,189,258,101,12,2,2,91,18,270
34,247,3557,387,3170,44,3126,93,396,1206,259,9,7,5,364,53,734
34,248,464,63,401,3,398,9,82,89,64,4,0,2,24,13,111
34,249,1692,210,1482,25,1457,39,254,393,166,10,7,1,138,18,431
34,250,233,43,190,6,184,3,29,40,52,4,2,0,7,6,41
34,251,346,42,304,6,298,18,55,49,61,1,2,1,12,3,96
34,252,241,55,186,2,184,2,52,34,27,4,1,0,7,1,56
34,253,40,8,32,0,32,0,4,19,3,0,1,0,0,1,4
34,254,819,82,737,16,721,17,152,163,114,7,5,0,67,9,187
34,255,7656,1073,6583,106,6477,210,993,1956,663,68,16,19,660,106,1786
34,256,1434,179,1255,19,1236,46,200,357,161,15,1,1,109,10,336
34,257,135,7,128,2,126,3,17,15,30,6,0,0,4,1,50
34,258,1034,154,880,20,860,14,212,219,122,7,2,1,62,13,208
34,259,4239,808,3431,54,3377,72,671,935,432,24,15,4,295,53,876
34,260,697,125,572,9,563,24,91,104,77,9,5,2,41,6,204
34,261,253,25,228,3,225,18,35,51,32,6,1,0,18,4,60
34,262,164,24,140,6,134,9,23,28,29,5,0,0,10,2,28
34,263,263,30,233,3,230,6,67,43,35,7,0,0,25,3,44
34,264,176,19,157,1,156,4,15,39,26,3,0,0,18,4,47
34,265,491,42,449,6,443,16,81,137,54,4,3,1,34,4,109
34,266,352,39,313,4,309,16,43,90,44,4,2,1,35,3,71
34,267,1223,181,1042,26,1016,35,216,229,159,16,6,0,75,22,258
34,268,429,67,362,13,349,10,77,72,50,13,4,1,15,4,103
34,269,109,21,88,2,86,5,20,16,11,3,1,1,5,2,22
34,270,7149,1039,6110,101,6009,154,1149,1792,612,44,22,7,567,97,1565
34,271,204,39,165,3,162,18,31,28,26,1,0,0,9,2,47
34,272,2176,360,1816,30,1786,28,527,492,159,18,9,4,129,29,391
34,273,127,34,93,1,92,6,12,11,24,1,0,1,5,2,30
34,274,1838,290,1548,40,1508,55,352,364,202,17,6,7,130,16,359
34,276,3308,450,2858,49,2809,97,461,530,462,44,17,11,231,65,891
34,277,176,20,156,3,153,9,9,33,38,1,0,0,7,5,51
34,278,65,11,54,3,51,1,5,22,12,0,0,0,5,0,6
34,279,279,43,236,3,233,6,46,56,31,6,3,0,8,4,73
34,280,434,31,403,11,392,7,126,122,35,5,0,2,24,1,70
34,281,1632,308,1324,18,1306,25,318,274,220,21,7,4,87,20,330
34,282,785,99,686,7,679,21,148,166,106,10,5,2,47,15,159
34,283,99,19,80,0,80,4,22,20,15,2,1,0,4,1,11
34,284,1508,330,1178,37,1141,37,213,245,154,21,14,3,70,14,370
34,285,472,67,405,7,398,11,93,99,53,9,2,0,36,12,83
34,286,326,64,262,4,258,16,58,62,48,3,2,0,22,6,41
34,287,208,28,180,9,171,7,33,41,29,6,2,0,11,2,40
34,288,595,76,519,8,511,19,88,142,61,6,4,0,28,11,152
34,289,1726,329,1397,23,1374,20,379,383,152,27,15,5,72,27,294
34,290,563,61,502,7,495,27,71,115,78,12,1,1,47,14,129
34,291,313,50,263,5,258,16,29,45,79,4,2,0,13,1,69
34,292,218,33,185,6,179,7,35,29,35,4,1,0,21,4,43
34,293,982,156,826,23,803,19,161,227,89,14,6,0,62,24,201
34,294,634,89,545,15,530,13,121,130,81,8,3,0,50,5,119
34,295,1130,140,990,21,969,45,185,230,110,16,2,2,83,12,284
34,296,685,95,590,9,581,14,132,141,67,5,1,3,40,9,169
34,297,286,38,248,2,246,11,42,63,55,4,2,1,15,5,48
34,298,3257,378,2879,59,2820,31,819,722,329,31,12,5,175,32,664
34,299,5670,983,4687,78,4609,68,1372,1228,574,39,15,8,257,65,983
34,300,3213,559,2654,55,2599,25,760,643,313,22,26,7,128,44,631
34,301,31118,5764,25354,408,24946,535,5997,6884,3888,226,102,47,1201,313,5753
34,302,538,102,436,4,432,7,95,82,55,9,2,3,38,6,135
34,303,71,5,66,1,65,4,13,15,11,0,0,0,1,2,19
34,304,643,81,562,14,548,21,105,105,66,16,1,1,47,12,174
34,305,152,26,126,5,121,1,27,34,14,0,0,0,18,2,25
34,306,147,39,108,1,107,7,20,17,26,0,0,0,7,3,27
34,307,1985,227,1758,41,1717,67,311,473,215,12,7,4,189,32,407
34,308,318,44,274,6,268,5,55,57,36,2,1,0,34,6,72
34,309,3878,473,3405,71,3334,87,609,979,308,30,19,5,339,62,896
34,310,1947,259,1688,34,1654,17,486,423,200,13,9,3,100,23,380
34,311,1183,137,1046,28,1018,14,208,253,177,10,4,3,82,15,252
34,312,997,141,856,17,839,22,183,136,162,21,6,0,56,12,241
34,313,411,49,362,6,356,9,51,60,99,4,3,3,18,1,108
34,314,306,30,276,3,273,10,66,68,34,0,1,3,15,4,72
34,315,259,49,210,3,207,4,39,62,18,2,0,0,21,6,55
34,316,113,12,101,2,99,5,17,20,11,0,2,0,12,2,30
34,317,165,29,136,7,129,6,17,19,26,1,1,0,16,2,41
34,318,313,35,278,1,277,5,56,72,45,3,1,2,17,7,69
34,319,121,20,101,1,100,4,15,20,22,5,0,0,12,1,21
34,320,1833,194,1639,30,1609,54,335,379,207,11,10,4,158,32,419
34,321,1484,199,1285,32,1253,13,341,313,135,14,6,4,108,19,300
34,322,572,82,490,3,487,20,82,101,72,5,1,5,39,8,154
34,323,54,7,47,1,46,3,17,3,4,0,0,0,2,0,17
34,324,4004,799,3205,48,3157,39,937,1117,259,20,18,5,121,45,596
34,325,1078,164,914,11,903,12,231,197,134,14,2,5,58,15,235
34,326,62,8,54,1,53,3,8,6,10,1,0,0,3,0,22
34,327,4738,726,4012,85,3927,81,861,1119,408,34,16,8,335,44,1021
34,328,814,105,709,17,692,14,170,134,117,6,5,4,44,7,191
34,329,1832,267,1565,43,1522,16,428,391,238,10,8,2,85,18,326
34,330,488,80,408,6,402,13,96,102,51,4,0,1,32,6,97
34,331,109,21,88,1,87,1,11,9,26,4,0,0,2,4,30
34,332,4237,704,3533,39,3494,42,1102,907,403,22,13,3,176,48,778
34,333,2388,464,1924,37,1887,49,564,404,264,19,8,3,122,30,424
34,334,239,35,204,7,197,26,21,27,39,7,0,2,14,2,59
34,335,367,38,329,6,323,5,66,59,60,7,2,0,29,7,88
34,336,2859,517,2342,42,2300,36,784,537,272,19,7,4,137,37,467
34,337,6454,967,5487,98,5389,123,1550,1119,816,53,15,15,316,81,1301
34,338,51,6,45,0,45,5,5,9,6,0,0,0,2,0,18
34,339,134,15,119,3,116,1,21,25,8,7,0,0,9,1,44
34,340,1062,147,915,24,891,15,252,293,90,4,5,1,74,20,137
34,341,2366,348,2018,34,1984,38,534,518,259,18,8,6,104,37,462
34,342,160,26,134,4,130,4,17,29,27,1,1,0,13,3,35
34,343,810,100,710,6,704,29,160,132,135,9,0,2,52,4,181
34,344,7750,1359,6391,73,6318,98,1401,2802,403,48,17,19,457,102,971
35,1,4672,520,4152,42,4110,164,310,872,474,57,11,6,551,58,1607
35,2,1191,148,1043,17,1026,31,154,274,102,13,8,2,161,8,273
35,3,515,70,445,10,435,9,56,118,52,4,3,0,58,10,125
35,4,1054,207,847,27,820,10,169,231,63,16,8,3,81,11,228
35,5,199,21,178,5,173,4,35,62,15,1,2,0,21,5,28
35,6,3258,463,2795,85,2710,47,336,914,218,34,27,7,467,69,591
35,7,279,23,256,6,250,8,32,56,40,4,1,1,20,5,83
35,8,405,62,343,11,332,0,67,106,35,8,8,2,38,7,61
35,9,1157,157,1000,20,980,18,193,284,95,15,5,1,103,21,245
35,10,972,111,861,22,839,14,153,194,90,12,5,1,78,22,270
35,11,219,25,194,2,192,1,29,40,26,3,0,0,31,1,61
35,12,4999,837,4162,77,4085,101,681,1091,357,62,35,11,516,88,1143
35,13,2676,411,2265,30,2235,73,326,552,236,22,17,6,253,48,702
35,14,1556,239,1317,31,1286,28,233,471,87,15,11,5,189,30,217
35,15,1671,230,1441,37,1404,20,192,486,102,28,14,2,260,36,264
35,16,1396,215,1181,21,1160,36,230,258,128,5,5,3,110,28,357
35,17,457,67,390,3,387,14,58,96,51,2,3,0,55,3,105
35,18,827,102,725,25,700,8,133,248,51,14,5,3,120,16,102
35,19,1362,189,1173,24,1149,21,149,406,93,15,7,1,113,25,319
35,21,987,87,900,12,888,13,115,281,103,15,3,0,114,24,220
35,22,474,79,395,6,389,22,48,122,52,5,5,0,30,7,98
35,23,2998,417,2581,38,2543,61,350,685,252,29,13,2,297,66,788
35,24,8016,974,7042,111,6931,334,505,1518,802,72,20,14,879,114,2673
35,25,770,85,685,17,668,21,114,191,46,12,5,0,120,15,144
35,26,85,15,70,0,70,0,14,17,5,0,0,0,12,2,20
35,27,1144,143,1001,27,974,23,157,241,113,18,7,1,109,22,283
35,28,419,47,372,5,367,13,67,113,26,9,7,0,50,6,76
35,29,994,132,862,21,841,24,137,232,82,12,3,3,77,15,256
35,30,417,44,373,7,366,15,65,85,31,6,2,4,51,12,95
35,31,2708,360,2348,50,2298,71,328,586,229,38,20,4,261,38,723
35,32,2511,342,2169,55,2114,60,293,434,208,41,16,4,243,45,770
35,33,1907,170,1737,24,1713,57,239,358,216,34,17,5,196,44,547
35,34,852,124,728,20,708,23,143,184,78,10,7,1,62,20,180
35,35,379,50,329,4,325,13,59,64,37,7,2,2,37,9,95
35,37,3706,432,3274,71,3203,84,451,784,329,40,19,7,421,58,1010
35,38,453,67,386,10,376,7,80,92,18,9,4,0,63,8,95
35,39,1388,176,1212,27,1185,28,140,253,121,14,10,1,200,27,391
35,40,2520,261,2259,35,2224,67,245,420,239,30,18,9,290,41,865
35,41,608,62,546,15,531,11,103,129,57,4,5,1,62,19,140
35,42,469,44,425,9,416,8,76,147,27,3,1,0,65,10,79
35,44,268,33,235,7,228,4,24,76,28,5,6,0,21,9,55
35,45,695,108,587,8,579,8,93,205,53,10,1,0,72,10,127
35,46,368,46,322,6,316,1,80,90,14,1,1,0,49,5,75
35,47,11305,1658,9647,182,9465,297,1009,2463,1003,116,43,27,1311,192,3004
35,48,408,74,334,4,330,8,58,96,34,9,0,0,27,8,90
35,49,4783,991,3792,74,3718,86,540,1330,298,31,16,5,391,65,956
35,50,402,36,366,2,364,16,51,84,43,7,4,1,40,3,115
35,51,12629,1776,10853,159,10694,394,761,3202,939,76,35,29,1719,137,3402
35,52,394,64,330,4,326,6,30,114,25,5,3,2,51,17,73
35,53,201,17,184,4,180,2,27,73,7,3,2,2,24,4,36
35,54,1103,103,1000,27,973,39,136,197,123,10,5,3,122,20,318
35,55,6808,970,5838,69,5769,222,512,1151,633,53,33,11,876,89,2189
35,56,529,58,471,8,463,20,66,101,61,9,5,0,42,5,154
35,57,804,89,715,14,701,34,130,163,92,8,8,1,62,8,195
35,58,828,88,740,12,728,20,98,185,86,8,4,1,99,12,215
35,59,3133,367,2766,39,2727,98,241,593,307,26,16,9,328,44,1065
35,60,495,50,445,5,440,10,81,106,61,9,3,1,58,16,95
35,61,481,59,422,7,415,10,75,145,27,8,4,0,56,7,83
35,62,1066,105,961,21,940,16,138,375,63,12,12,2,116,18,188
35,63,298,56,242,5,237,6,42,87,17,3,0,1,30,6,45
35,64,801,154,647,10,637,28,94,152,75,5,7,1,69,11,195
35,65,1546,154,1392,28,1364,33,177,238,165,14,10,1,141,29,556
35,66,5772,995,4777,83,4694,161,523,1003,460,66,27,8,590,74,1782
35,67,989,81,908,14,894,29,84,134,133,11,7,1,129,22,344
35,68,4324,537,3787,87,3700,121,363,910,382,44,37,8,576,78,1181
35,69,5199,738,4461,83,4378,138,327,1184,453,44,21,19,767,88,1337
35,70,760,106,654,13,641,11,116,159,58,9,4,2,88,18,176
35,71,314,37,277,6,271,6,46,95,20,1,1,1,46,6,49
35,72,1262,211,1051,26,1025,26,159,364,83,9,8,3,135,20,218
35,75,555,50,505,15,490,8,105,118,47,8,3,3,50,13,135
35,76,2956,435,2521,45,2476,64,294,555,259,25,12,7,320,56,884
35,77,216,31,185,7,178,3,45,69,7,1,0,0,20,5,28
35,78,891,141,750,14,736,5,135,231,58,11,5,1,60,8,222
35,79,1421,117,1304,23,1281,57,116,270,147,11,6,2,207,22,443
35,80,1511,169,1342,23,1319,47,155,274,153,9,13,1,167,17,483
35,81,474,49,425,5,420,18,37,87,51,9,3,0,53,10,152
35,82,904,141,763,14,749,11,150,226,68,15,7,3,79,15,175
35,83,478,61,417,14,403,6,66,117,41,2,4,1,48,5,113
35,84,465,46,419,10,409,6,92,139,28,7,1,1,45,4,86
35,85,4372,746,3626,60,3566,90,481,1031,316,39,25,3,434,68,1079
35,86,445,57,388,11,377,2,83,105,41,5,3,2,37,13,86
35,87,618,80,538,6,532,7,105,148,54,11,5,4,77,13,108
35,88,2235,286,1949,33,1916,78,262,378,222,19,17,8,247,39,646
35,89,333,39,294,2,292,12,45,75,37,7,2,1,36,6,71
35,90,1624,158,1466,25,1441,28,263,324,162,18,21,8,139,18,460
35,91,387,57,330,8,322,9,88,58,28,0,4,1,35,5,94
35,92,570,80,490,14,476,10,87,95,28,4,4,2,58,9,179
35,93,8521,1457,7064,119,6945,159,837,2608,584,53,28,21,697,112,1846
35,94,1173,147,1026,13,1013,26,112,229,132,11,7,2,99,15,380
35,95,3913,776,3137,68,3069,75,460,826,321,33,28,6,339,57,924
35,96,1572,210,1362,34,1328,48,163,407,138,14,11,1,194,29,323
35,97,1267,138,1129,32,1097,11,190,407,71,16,6,3,161,24,208
35,98,878,98,780,11,769,12,157,182,86,8,3,0,94,16,211
35,99,1988,208,1780,31,1749,47,189,442,185,20,7,6,241,49,563
35,100,383,39,344,12,332,2,49,107,37,5,5,1,40,5,81
35,101,663,60,603,16,587,12,119,109,83,5,7,5,69,12,166
35,102,364,49,315,9,306,9,46,129,19,4,3,3,30,9,54
35,103,288,28,260,6,254,8,37,85,20,2,1,3,57,2,39
35,104,1001,121,880,10,870,18,126,268,72,26,8,2,107,16,227
35,105,1370,209,1161,22,1139,32,185,394,71,20,10,0,172,34,221
35,106,1047,155,892,14,878,32,165,213,76,15,5,0,118,15,239
35,107,1239,135,1104,23,1081,43,114,231,129,15,6,4,129,25,385
35,108,792,124,668,5,663,14,110,210,54,4,6,0,101,17,147
35,109,1753,203,1550,25,1525,22,180,502,132,27,10,4,272,37,339
35,110,666,87,579,14,565,17,102,92,79,6,2,2,62,7,196
35,111,498,55,443,11,432,14,79,167,25,7,2,2,51,9,76
35,112,812,111,701,16,685,12,110,248,28,3,9,1,102,15,157
35,113,421,49,372,7,365,11,58,112,22,6,8,0,44,3,101
35,114,204,39,165,0,165,2,47,51,9,3,2,2,14,4,31
35,115,14990,3511,11479,194,11285,276,1381,3122,1116,153,96,27,1333,177,3604
35,116,1626,228,1398,38,1360,35,229,352,123,30,15,3,186,32,355
35,117,1206,215,991,22,969,16,197,292,105,19,8,4,99,18,211
35,118,960,127,833,17,816,32,127,171,93,10,12,0,108,17,246
35,119,598,82,516,14,502,14,93,172,53,4,9,1,57,14,85
35,120,3181,434,2747,61,2686,81,295,672,278,33,18,14,345,43,907
35,121,1255,132,1123,17,1106,28,183,278,101,12,7,3,140,35,319
35,122,1156,157,999,30,969,22,154,251,95,24,13,1,102,19,288
35,123,3216,509,2707,49,2658,76,381,605,284,38,18,4,332,48,872
35,124,1638,244,1394,38,1356,34,255,383,124,15,10,2,175,35,323
35,125,2938,530,2408,57,2351,44,267,1027,124,27,15,3,313,49,482
35,126,5578,737,4841,102,4739,151,600,977,585,61,30,10,588,110,1627
35,127,2351,289,2062,28,2034,49,326,419,226,35,32,3,209,60,675
35,128,1181,154,1027,13,1014,27,187,227,103,14,10,2,108,18,318
35,129,2589,381,2208,51,2157,35,414,580,242,29,19,5,215,33,585
35,130,1350,152,1198,31,1167,77,140,274,93,19,5,1,149,20,389
35,131,2859,414,2445,39,2406,55,312,481,232,26,13,6,285,40,956
35,132,1062,148,914,19,895,31,198,243,88,7,3,2,70,8,245
35,133,3026,394,2632,59,2573,84,415,630,269,43,29,12,297,49,745
35,134,205,16,189,4,185,12,27,60,10,0,0,0,29,5,42
35,135,1470,190,1280,29,1251,28,228,306,117,15,8,3,150,27,369
35,136,5558,743,4815,124,4691,74,661,1379,403,56,35,12,667,86,1318
35,137,1405,144,1261,39,1222,21,166,334,96,16,12,10,203,30,334
35,138,784,75,709,18,691,10,117,200,74,17,1,0,104,20,148
35,139,3377,393,2984,68,2916,114,345,641,310,31,19,9,444,60,943
35,140,424,58,366,6,360,14,84,77,36,7,6,0,43,11,82
35,141,449,47,402,23,379,8,71,101,24,7,5,0,75,14,74
35,142,966,115,851,11,840,13,156,294,54,14,4,4,121,16,164
35,143,671,85,586,6,580,23,99,157,44,6,1,2,82,10,156
35,144,712,103,609,8,601,17,88,143,67,9,3,0,58,16,200
35,145,1050,158,892,24,868,30,175,188,107,15,7,3,92,21,230
35,146,410,43,367,5,362,20,53,85,44,4,6,2,39,3,106
35,147,596,73,523,12,511,6,109,136,45,3,1,2,47,13,149
35,148,106,14,92,1,91,1,14,24,7,2,2,0,10,5,26
35,149,1005,100,905,17,888,24,114,196,107,14,6,2,99,19,307
35,150,2637,340,2297,55,2242,52,284,670,190,23,18,5,383,54,563
35,151,544,75,469,11,458,6,93,91,50,4,7,0,52,10,145
35,152,5234,635,4599,74,4525,126,502,985,555,48,25,10,584,69,1621
35,153,212,24,188,8,180,3,34,38,25,5,2,1,26,3,43
35,154,1090,152,938,23,915,27,141,240,89,14,3,3,119,25,254
35,155,508,58,450,9,441,15,57,120,44,6,4,2,49,5,139
35,156,407,51,356,9,347,12,46,85,37,8,2,0,45,4,108
35,157,426,61,365,5,360,6,58,137,30,7,4,0,60,5,53
35,158,89,18,71,3,68,9,8,20,5,0,0,0,14,3,9
35,159,238,39,199,5,194,7,33,68,17,1,1,0,18,3,46
35,160,185,25,160,1,159,9,30,49,14,3,2,0,15,3,34
35,161,1267,184,1083,19,1064,22,173,336,79,8,10,5,169,28,234
35,162,2883,494,2389,65,2324,20,396,817,146,32,17,8,324,54,510
35,163,993,105,888,29,859,12,109,380,69,13,3,1,99,25,148
35,164,541,94,447,14,433,10,66,115,44,6,7,1,51,14,119
35,165,643,98,545,18,527,15,83,188,39,11,6,1,92,4,88
35,166,755,97,658,22,636,12,88,187,61,18,11,3,80,16,160
35,167,2019,372,1647,28,1619,32,248,627,104,19,11,4,234,25,315
35,168,2410,424,1986,42,1944,42,383,544,172,26,21,2,209,43,502
35,169,960,123,837,10,827,27,130,200,94,17,6,3,121,16,213
35,170,440,62,378,14,364,10,69,93,36,6,4,1,55,13,77
35,171,1262,138,1124,30,1094,45,175,279,124,13,9,3,132,23,291
35,172,1209,119,1090,23,1067,25,173,234,112,18,5,1,139,14,346
35,173,4235,525,3710,83,3627,124,367,952,388,48,24,7,502,66,1149
35,174,479,72,407,6,401,1,107,128,26,4,6,0,29,7,93
35,175,690,96,594,7,587,8,86,180,69,9,4,2,55,15,159
35,176,2184,298,1886,32,1854,33,322,477,225,29,15,6,209,38,500
35,177,3039,348,2691,54,2637,73,290,608,265,40,14,10,349,50,938
35,178,1002,107,895,17,878,31,140,207,94,8,9,2,123,12,252
35,179,2537,366,2171,51,2120,30,372,566,217,37,28,3,229,40,598
35,180,514,65,449,8,441,12,82,104,40,2,0,1,59,8,133
35,181,1185,160,1025,12,1013,41,115,337,108,11,4,1,101,11,284
35,183,560,69,491,20,471,13,80,151,43,11,6,1,56,13,97
35,184,3690,619,3071,45,3026,68,366,872,261,34,17,7,385,43,973
35,185,199,26,173,8,165,2,28,62,16,3,4,0,26,3,21
35,186,906,138,768,16,752,25,119,211,78,10,11,0,77,12,209
35,187,926,108,818,12,806,30,110,148,97,10,10,1,111,19,270
35,188,4606,662,3944,53,3891,108,410,925,434,55,23,13,508,79,1336
35,189,2282,247,2035,35,2000,77,152,478,191,14,7,3,311,20,747
35,190,185,26,159,5,154,4,37,41,16,3,0,0,28,3,22
35,191,719,85,634,14,620,11,79,144,56,9,9,3,107,17,185
35,192,164,23,141,2,139,1,25,44,14,0,1,0,11,7,36
35,193,1379,163,1216,21,1195,35,153,244,131,22,5,5,158,26,416
35,194,885,115,770,16,754,10,73,219,63,5,7,1,158,11,207
35,195,1466,222,1244,22,1222,34,170,208,169,17,17,4,129,31,443
35,196,5625,769,4856,94,4762,141,548,1239,449,46,44,12,571,95,1617
35,197,839,85,754,11,743,19,114,125,104,10,2,2,82,19,266
35,198,512,60,452,9,443,16,55,147,33,3,2,1,48,10,128
35,199,187,16,171,2,169,2,36,66,9,2,0,0,24,3,27
35,200,616,81,535,17,518,3,87,201,37,8,4,0,81,14,83
35,201,573,87,486,8,478,18,86,121,59,5,4,1,60,6,118
35,202,728,115,613,13,600,9,189,162,36,11,3,1,50,11,128
35,203,231,27,204,3,201,12,24,47,30,1,0,1,20,1,65
35,204,2189,312,1877,31,1846,66,220,438,203,22,13,6,233,40,605
35,205,297,33,264,8,256,6,42,86,25,2,2,1,26,6,60
35,206,4741,615,4126,54,4072,135,449,910,432,52,26,10,493,74,1491
35,207,3964,414,3550,55,3495,118,369,913,297,45,13,13,472,60,1195
35,208,2729,279,2450,54,2396,92,309,576,194,35,15,11,282,58,824
35,209,830,98,732,13,719,22,98,235,65,8,6,1,76,17,191
35,210,7355,746,6609,111,6498,235,450,1993,573,59,22,19,971,102,2074
35,211,1231,158,1073,17,1056,57,149,244,134,16,2,2,96,28,328
35,212,821,79,742,15,727,26,107,205,71,14,7,1,96,19,181
35,214,470,63,407,16,391,5,62,166,25,7,1,1,55,9,60
35,215,929,101,828,18,810,29,116,253,66,8,13,1,140,18,166
35,216,938,123,815,17,798,29,103,163,87,7,2,1,108,15,283
35,217,1080,175,905,15,890,18,108,391,45,10,9,4,128,21,156
35,218,537,54,483,8,475,13,110,87,56,5,5,2,55,7,135
35,219,2444,387,2057,45,2012,30,385,539,167,28,19,3,242,33,566
35,220,1598,202,1396,21,1375,38,182,469,140,22,13,2,176,33,300
35,221,1877,218,1659,41,1618,42,313,382,187,28,14,6,188,49,409
35,222,1352,214,1138,30,1108,17,243,271,95,15,14,4,105,20,324
35,223,2630,326,2304,47,2257,48,374,686,234,23,17,5,246,36,588
35,224,1871,11,1860,342,1518,27,304,440,144,26,12,3,156,30,376
35,225,508,46,462,8,454,8,60,105,42,5,5,1,66,8,154
35,226,1235,161,1074,15,1059,27,175,215,104,22,13,5,99,21,378
35,227,2066,235,1831,43,1788,54,256,410,171,23,8,1,236,36,593
35,228,4650,788,3862,64,3798,68,570,1076,363,43,19,8,457,75,1119
35,229,867,88,779,28,751,16,92,235,61,8,3,1,117,22,196
35,230,309,66,243,9,234,2,31,101,15,4,1,0,46,4,30
35,231,771,78,693,16,677,12,100,152,76,9,5,2,87,24,210
35,232,258,18,240,6,234,6,30,96,13,5,0,2,33,7,42
35,233,1059,121,938,15,923,35,125,212,111,14,8,2,93,17,306
35,234,863,125,738,11,727,12,94,243,52,9,3,4,94,11,205
35,235,862,106,756,22,734,16,117,274,51,6,4,5,108,20,133
35,236,6723,1475,5248,79,5169,243,606,1261,576,64,25,4,541,94,1755
35,237,640,81,559,8,551,24,122,141,47,11,4,1,55,5,141
35,238,116983,23006,93977,1270,92707,4663,6800,19393,12464,925,517,203,9737,1106,36899
35,239,2847,455,2392,49,2343,42,347,731,194,29,19,5,331,52,593
35,240,5374,740,4634,77,4557,158,378,1029,505,45,26,22,570,72,1752
35,241,1933,273,1660,29,1631,50,205,461,175,17,9,0,176,39,499
35,242,281,45,236,8,228,6,43,56,25,3,1,1,19,2,72
35,243,1665,214,1451,38,1413,29,214,510,119,13,6,1,166,36,319
35,244,202,28,174,0,174,2,22,54,12,3,0,1,23,3,54
35,245,2601,342,2259,38,2221,62,262,550,249,24,14,8,298,37,717
35,246,949,124,825,24,801,17,142,214,87,13,7,1,90,19,211
35,247,735,111,624,16,608,9,113,171,48,4,4,0,60,13,186
35,248,401,67,334,3,331,9,72,78,33,7,3,3,25,7,94
35,249,689,84,605,10,595,13,102,164,71,12,9,1,75,17,131
35,250,1227,109,1118,18,1100,47,141,208,143,9,7,6,141,31,367
35,251,2403,333,2070,54,2016,64,293,455,192,31,13,4,234,44,686
35,252,667,76,591,13,578,14,94,213,40,12,5,0,83,20,97
35,253,2159,273,1886,55,1831,67,274,475,189,36,20,6,210,29,525
35,254,523,31,492,12,480,14,59,104,59,10,4,1,68,13,148
35,255,808,107,701,13,688,14,138,169,72,9,7,0,66,14,199
35,256,2250,370,1880,31,1849,70,157,814,140,15,9,6,173,20,445
35,257,2009,269,1740,45,1695,22,266,444,144,23,23,5,188,53,527
35,258,239,22,217,7,210,12,29,46,21,1,2,1,32,2,64
35,259,778,113,665,10,655,13,131,189,71,9,4,2,55,18,163
35,260,412,35,377,7,370,15,82,102,25,6,1,2,63,5,69
35,261,159,12,147,2,145,5,39,19,24,1,3,0,20,4,30
35,262,208,27,181,8,173,2,32,61,11,2,3,0,25,6,31
35,263,2172,308,1864,31,1833,43,274,615,156,14,18,4,205,33,471
35,264,1313,165,1148,32,1116,24,154,359,111,25,5,1,148,16,273
35,265,1574,166,1408,27,1381,32,217,332,126,16,10,4,126,23,495
35,266,1863,188,1675,22,1653,63,199,421,155,15,8,9,200,26,557
35,267,1292,190,1102,16,1086,19,196,308,85,13,9,3,123,32,298
35,268,338,63,275,8,267,10,74,57,30,6,4,0,20,7,59
35,269,432,47,385,10,375,5,60,143,27,7,3,1,36,9,84
35,270,307,37,270,5,265,2,69,93,12,6,2,1,15,10,55
35,271,1054,176,878,25,853,11,161,340,49,4,8,3,113,17,147
35,272,662,97,565,6,559,7,96,194,47,9,4,3,94,19,86
35,273,1551,160,1391,23,1368,40,211,454,100,18,13,2,195,41,294
35,274,626,74,552,11,541,39,51,90,80,8,4,2,59,16,192
35,275,2805,272,2533,46,2487,56,249,654,244,24,14,2,337,46,861
35,276,392,46,346,6,340,17,55,66,43,2,2,1,35,8,111
35,277,267,30,237,3,234,17,38,62,23,2,0,0,10,3,79
35,278,7093,936,6157,96,6061,190,343,2104,433,36,14,10,921,60,1950
35,279,709,72,637,18,619,10,99,158,90,8,7,3,69,15,160
35,280,702,76,626,12,614,8,112,152,48,9,6,2,91,11,175
35,281,6550,1171,5379,102,5277,187,577,919,718,58,55,14,556,84,2109
35,282,765,102,663,16,647,10,114,173,51,13,3,1,107,19,156
35,283,800,98,702,13,689,8,86,211,37,9,11,5,147,13,162
35,284,2271,311,1960,31,1929,47,275,550,192,24,9,1,192,23,616
35,285,872,127,745,8,737,23,133,171,77,10,4,3,75,16,225
35,286,188,19,169,2,167,5,23,28,17,5,1,0,28,4,56
35,287,2022,280,1742,33,1709,55,207,582,173,19,3,5,189,43,433
35,288,37186,8445,28741,489,28252,791,3214,8829,2680,377,166,62,3118,479,8536
35,289,645,68,577,8,569,9,96,133,61,7,9,3,64,22,165
35,290,422,77,345,10,335,19,69,81,37,2,1,2,33,10,81
35,291,330,41,289,6,283,4,80,77,23,4,0,1,21,3,70
35,292,987,109,878,20,858,13,131,232,83,11,11,2,85,25,265
35,293,396,60,336,9,327,7,58,82,30,4,3,3,48,6,86
35,294,1631,246,1385,21,1364,42,245,321,129,19,9,2,164,18,415
35,295,369,43,326,12,314,8,61,69,44,5,5,0,36,3,83
35,296,979,129,850,15,835,44,138,130,83,13,9,0,91,23,304
35,297,2957,502,2455,53,2402,26,397,713,195,29,14,6,296,37,689
35,299,2901,468,2433,60,2373,48,398,725,188,25,12,8,283,40,646
35,300,1019,134,885,29,856,18,154,310,47,9,11,1,126,26,154
35,301,307,21,286,5,281,2,58,68,13,7,0,0,37,7,89
35,302,826,93,733,10,723,10,159,181,68,17,3,4,99,11,171
35,303,601,82,519,11,508,6,87,199,46,8,7,0,39,11,105
35,304,929,131,798,19,779,29,161,177,74,11,9,2,71,5,240
35,305,285,49,236,8,228,11,39,61,19,2,1,0,22,3,70
35,306,1731,240,1491,29,1462,35,266,380,141,17,16,5,190,30,382
35,307,649,69,580,12,568,21,73,148,70,4,3,0,43,9,197
35,308,1932,264,1668,33,1635,47,280,416,192,27,11,4,191,28,439
35,309,569,79,490,10,480,7,116,106,47,6,5,0,45,8,140
35,310,941,120,821,20,801,14,119,239,51,19,5,2,102,23,227
35,311,368,53,315,6,309,7,65,95,37,3,2,1,24,3,72
35,312,1234,142,1092,14,1078,43,158,198,165,4,7,3,113,23,364
35,314,814,97,717,6,711,20,67,217,81,6,5,1,81,13,220
35,315,1047,108,939,10,929,34,69,169,112,11,1,2,133,17,381
35,316,493,52,441,10,431,5,94,111,40,6,5,1,60,10,99
35,317,384,30,354,6,348,7,29,93,44,9,5,1,52,9,99
35,318,544,58,486,8,478,15,79,112,61,9,3,2,41,14,142
35,319,1341,130,1211,17,1194,43,213,264,106,16,19,7,131,41,354
35,320,375,37,338,2,336,7,53,87,33,8,0,0,32,16,100
35,321,472,42,430,11,419,8,76,91,62,5,2,2,31,17,125
35,322,602,54,548,10,538,25,108,99,67,15,10,1,57,12,144
35,323,412,39,373,9,364,3,64,117,26,12,0,2,55,11,74
35,324,387,26,361,7,354,6,57,132,34,2,3,0,56,8,56
35,325,121,14,107,6,101,1,21,29,11,1,2,1,16,7,12
35,326,1539,228,1311,17,1294,16,243,349,128,9,10,5,159,25,350
35,327,2661,346,2315,30,2285,72,239,584,226,20,23,4,342,56,719
35,328,1582,214,1368,25,1343,20,287,375,94,26,12,5,119,29,376
35,329,444,52,392,12,380,5,98,112,30,3,6,0,44,6,76
35,330,647,63,584,11,573,11,91,163,58,7,4,2,100,15,122
35,331,1817,209,1608,32,1576,51,220,345,181,20,13,3,177,27,539
35,332,739,100,639,15,624,17,123,128,78,11,10,0,87,19,151
35,333,1088,121,967,25,942,15,157,261,77,16,11,0,152,27,226
35,334,5626,611,5015,71,4944,192,353,1105,456,54,8,11,701,74,1990
35,335,529,65,464,13,451,20,90,113,48,4,4,0,62,15,95
35,336,144,15,129,1,128,4,22,34,10,3,3,0,12,0,40
35,337,2308,302,2006,42,1964,60,244,523,185,31,14,3,223,30,651
35,338,786,84,702,13,689,12,122,252,46,8,5,1,99,16,128
35,339,434,68,366,7,359,9,69,96,34,5,6,1,39,4,96
35,340,834,84,750,13,737,18,139,196,73,14,5,1,99,13,179
35,341,1062,149,913,27,886,25,180,214,80,17,15,3,96,23,233
35,342,239,19,220,4,216,2,33,39,22,5,2,0,17,8,88
35,343,863,101,762,13,749,13,164,164,69,12,3,0,65,30,229
35,344,261,32,229,4,225,9,46,44,26,4,1,2,22,6,65
35,345,621,75,546,19,527,18,67,109,60,5,6,1,69,4,188
35,346,134,13,121,7,114,0,20,24,14,1,0,0,19,2,34
35,347,1739,167,1572,42,1530,36,241,465,95,26,9,5,303,41,309
35,348,293,43,250,6,244,5,48,94,10,1,2,1,30,6,47
35,350,541,57,484,18,466,11,106,133,38,7,3,0,72,19,77
35,351,1035,120,915,12,903,21,127,193,98,14,5,1,121,21,302
35,352,6353,881,5472,92,5380,180,516,1149,549,69,31,8,682,124,2072
35,353,3120,375,2745,36,2709,107,230,663,276,24,15,8,349,47,990
35,354,243,32,211,8,203,5,42,54,26,7,2,0,16,2,49
35,355,832,133,699,14,685,19,130,125,80,10,2,1,82,13,223
35,356,1121,128,993,28,965,21,115,225,82,9,3,3,153,24,330
35,357,258,27,231,3,228,5,37,71,24,5,1,1,39,8,37
35,358,731,94,637,15,622,24,102,157,48,14,4,0,72,15,186
35,359,614,96,518,8,510,12,123,178,32,5,8,0,51,15,86
35,360,12505,2435,10070,189,9881,254,992,3223,790,120,51,21,1580,182,2668
35,361,860,148,712,11,701,15,127,251,46,8,1,1,73,19,160
35,362,670,90,580,8,572,17,117,120,64,7,8,0,60,9,170
35,363,2822,397,2425,42,2383,72,284,466,267,19,13,2,319,42,899
36,1,1270,224,1046,29,1017,5,144,261,109,15,10,1,105,27,340
36,2,116,17,99,3,96,2,14,24,10,0,1,0,17,2,26
36,3,568,65,503,16,487,4,117,84,65,16,3,2,36,16,144
36,4,276,46,230,9,221,4,72,44,23,1,1,1,19,9,47
36,5,2805,409,2396,75,2321,18,430,590,257,35,19,3,236,46,687
36,6,3713,651,3062,63,2999,36,392,762,354,42,19,4,244,61,1085
36,7,501,70,431,14,417,4,95,107,45,10,3,0,45,7,101
36,8,212,29,183,3,180,2,47,58,10,5,1,0,25,6,26
36,9,855,123,732,20,712,11,169,137,77,13,3,2,86,14,200
36,10,742,140,602,21,581,7,125,159,58,6,5,2,42,8,169
36,11,150,16,134,3,131,4,35,37,17,2,1,0,9,5,21
36,12,278,39,239,5,234,4,37,26,26,8,5,0,25,3,100
36,13,391,70,321,13,308,2,81,63,44,3,6,0,33,2,74
36,14,203,36,167,2,165,4,33,29,22,0,0,1,29,1,46
36,15,55,10,45,0,45,0,7,20,2,0,0,0,5,0,11
36,16,866,133,733,17,716,8,142,215,65,4,2,5,53,9,213
36,17,361,60,301,14,287,3,64,108,28,4,1,0,19,6,54
36,18,4867,1024,3843,92,3751,69,663,971,369,51,35,7,328,80,1178
36,19,220,21,199,4,195,4,38,52,19,3,3,2,18,2,54
36,20,70,13,57,1,56,0,11,12,5,1,0,1,2,1,23
36,21,681,104,577,20,557,8,108,83,61,11,5,4,47,13,217
36,22,341,64,277,6,271,3,65,73,21,4,3,4,21,2,75
36,23,228,38,190,2,188,3,41,65,12,6,0,0,18,6,37
36,24,94,10,84,0,84,2,28,30,5,1,1,0,4,3,10
36,25,477,66,411,13,398,6,65,86,67,8,4,0,43,7,112
36,26,350,56,294,8,286,0,64,85,35,6,2,0,22,5,67
36,27,197,24,173,4,169,0,48,46,16,2,1,0,17,7,32
36,28,92,18,74,1,73,1,12,16,9,3,1,0,8,2,21
36,29,187,25,162,5,157,1,52,33,24,1,0,1,10,3,32
36,30,165,24,141,1,140,4,22,43,22,0,0,0,11,0,38
36,31,3499,605,2894,76,2818,31,619,786,268,40,25,7,234,72,736
36,32,617,72,545,12,533,13,86,114,65,5,4,0,38,13,195
36,33,288,35,253,6,247,10,71,53,20,4,6,0,15,5,63
36,34,2148,372,1776,35,1741,25,424,432,246,18,13,3,120,44,416
36,35,906,184,722,11,711,18,151,160,63,11,8,3,70,20,207
36,36,150,32,118,3,115,1,29,21,19,1,0,3,14,1,26
36,37,249,49,200,1,199,1,53,56,23,2,0,0,11,5,48
36,38,134,11,123,3,120,1,15,25,18,3,3,0,15,2,38
36,40,95,7,88,4,84,0,15,26,1,2,0,2,10,5,23
36,41,125,18,107,1,106,1,32,24,8,2,1,1,10,4,23
36,42,488,61,427,13,414,15,80,94,47,3,6,4,47,6,112
36,43,471,86,385,4,381,12,66,67,71,8,1,1,49,8,98
36,44,31119,7234,23885,507,23378,393,3798,5471,2682,308,183,61,2053,440,7989
36,45,2043,362,1681,35,1646,19,261,484,152,18,16,5,115,29,547
36,46,2977,559,2418,82,2336,35,344,719,259,22,25,11,253,43,625
36,47,463,70,393,6,387,4,69,63,80,5,4,0,26,6,130
36,48,245,53,192,2,190,2,44,36,24,8,1,0,22,4,49
36,49,105,22,83,1,82,3,15,13,10,1,0,0,7,1,32
36,50,328,50,278,12,266,2,62,65,16,3,1,0,28,12,77
36,51,145,24,121,0,121,5,23,30,11,1,1,1,23,2,24
36,52,123,8,115,3,112,0,23,34,9,1,0,0,16,6,23
36,53,426,65,361,11,350,4,51,117,26,9,6,2,27,8,100
36,54,249,23,226,3,223,2,28,72,34,5,3,2,30,3,44
36,55,815,127,688,20,668,5,158,165,64,7,3,1,47,11,207
36,56,760,129,631,13,618,12,112,138,74,18,6,1,60,11,186
36,57,690,82,608,17,591,14,163,136,55,18,5,1,44,11,144
36,58,505,82,423,11,412,8,70,96,55,3,4,1,37,11,127
36,59,196,32,164,6,158,2,27,50,17,3,2,0,15,6,36
36,60,598,136,462,14,448,8,88,88,52,3,5,2,64,13,125
36,61,331,72,259,12,247,5,50,66,23,8,4,0,27,4,60
36,62,406,45,361,3,358,5,57,77,59,6,1,2,23,2,126
36,63,6490,1469,5021,121,4900,71,989,1100,604,58,29,13,477,100,1459
36,64,555,66,489,14,475,0,97,112,58,12,4,7,52,11,122
36,65,216,31,185,1,184,2,37,45,28,5,4,0,19,4,40
36,66,373,55,318,4,314,3,74,99,27,2,2,0,33,6,68
36,67,79,13,66,3,63,0,9,13,7,0,1,0,5,1,27
36,68,359,54,305,5,300,3,88,79,51,7,1,1,21,4,45
36,69,1079,159,920,28,892,10,206,220,88,6,13,1,97,21,230
36,70,1084,169,915,26,889,14,161,196,125,16,3,2,63,19,290
36,71,692,71,621,18,603,7,122,145,69,5,5,1,75,6,168
36,72,312,63,249,3,246,11,46,81,20,2,1,1,13,5,66
36,73,174,27,147,4,143,2,38,35,10,2,2,0,15,0,39
36,74,441,68,373,12,361,2,70,115,19,7,3,0,32,8,105
36,75,82,7,75,0,75,2,18,19,7,0,0,0,14,0,15
36,76,242,38,204,6,198,5,34,80,13,6,0,0,11,3,46
36,77,187,21,166,4,162,1,49,40,15,2,4,4,10,4,33
36,78,260,37,223,8,215,4,57,49,21,4,1,0,19,6,54
36,79,65,10,55,1,54,0,11,13,8,0,2,0,5,0,15
36,80,60,10,50,3,47,1,12,13,6,1,2,0,6,0,6
36,81,271,37,234,3,231,4,22,46,45,5,3,4,29,2,71
36,82,225,41,184,7,177,2,43,55,12,5,1,0,19,3,37
36,83,108,15,93,0,93,0,18,36,4,0,0,0,10,5,20
36,84,239,58,181,3,178,4,47,44,17,5,2,0,21,4,34
36,85,188,35,153,3,150,2,36,50,9,2,0,0,14,5,32
36,86,335,36,299,11,288,6,57,85,15,5,1,1,41,8,69
36,87,275,52,223,5,218,1,35,65,24,5,3,1,19,6,59
36,88,9320,2248,7072,145,6927,98,1195,1347,927,95,56,17,501,124,2567
36,89,273,48,225,6,219,0,65,45,22,6,2,0,19,5,55
36,90,114,7,107,0,107,1,19,27,19,1,0,1,6,6,27
36,91,537,76,461,19,442,5,87,116,42,6,3,0,38,7,138
36,92,231,37,194,6,188,2,37,52,25,4,1,1,24,10,32
36,93,2130,369,1761,50,1711,17,376,460,188,27,24,6,155,37,421
36,94,397,74,323,6,317,6,83,74,24,3,0,0,41,11,75
36,95,100,12,88,1,87,2,22,15,10,0,1,0,12,1,24
36,96,190,33,157,4,153,0,40,39,19,5,1,0,16,3,30
36,97,259,29,230,9,221,3,41,55,19,4,2,0,16,3,78
36,98,93,13,80,3,77,0,13,42,1,1,1,0,10,0,9
36,99,294,66,228,6,222,0,44,53,28,2,0,0,27,2,66
36,100,246,35,211,5,206,3,41,53,26,3,4,0,28,8,40
36,101,1225,216,1009,29,980,16,210,217,117,19,11,1,84,13,292
36,102,111,26,85,1,84,0,29,22,9,2,0,0,9,1,12
36,103,1156,163,993,28,965,10,199,291,64,9,13,3,92,20,264
36,104,233,27,206,2,204,4,36,51,28,2,0,0,19,5,59
36,105,171,18,153,3,150,2,38,29,16,0,0,0,17,4,44
36,106,126,13,113,5,108,0,26,20,14,2,0,0,4,3,39
36,107,663,114,549,23,526,3,131,139,69,4,6,4,43,8,119
36,108,208,30,178,7,171,2,34,36,24,0,2,0,15,5,53
36,109,811,107,704,25,679,5,126,136,87,6,14,4,86,15,200
36,110,197,34,163,5,158,1,44,42,12,1,1,0,22,2,33
36,111,158,28,130,4,126,2,26,18,11,0,0,1,15,4,49
36,112,564,89,475,12,463,8,100,99,63,11,7,3,39,19,114
36,113,884,175,709,19,690,10,157,206,63,8,2,3,57,16,168
36,114,284,37,247,7,240,2,47,58,29,4,0,1,17,5,77
36,115,112,17,95,7,88,2,21,19,20,0,0,0,11,4,11
36,116,111,9,102,2,100,0,12,38,7,1,1,0,14,2,25
36,117,361,41,320,3,317,3,65,59,59,7,2,3,21,8,90
36,118,256,28,228,3,225,2,57,45,27,1,0,0,18,5,70
36,119,415,63,352,10,342,6,66,113,26,5,2,0,31,3,90
36,120,441,59,382,10,372,10,83,93,46,7,0,0,34,12,87
36,121,134,10,124,6,118,0,35,42,15,1,0,0,11,1,13
36,122,173,32,141,4,137,3,30,25,20,1,0,1,10,1,46
36,123,816,99,717,15,702,11,123,179,90,8,1,1,58,18,213
36,124,225,38,187,5,182,3,50,60,19,3,1,1,13,2,30
36,125,97,17,80,2,78,1,24,21,9,0,2,0,2,1,18
36,126,454,83,371,7,364,5,56,84,40,7,3,3,36,7,123
36,127,1435,226,1209,34,1175,20,215,257,128,17,6,4,141,21,366
36,128,1360,220,1140,37,1103,17,250,251,140,13,12,4,85,17,314
36,129,458,72,386,6,380,8,55,85,57,6,1,0,33,11,124
36,130,97,3,94,3,91,1,14,35,9,1,0,2,11,0,18
36,131,383,66,317,10,307,8,84,50,27,7,3,0,20,14,94
36,132,35,2,33,1,32,0,5,14,1,0,0,0,9,1,2
36,133,225,39,186,0,186,2,51,41,16,1,1,0,15,6,53
36,134,388,70,318,6,312,4,74,52,49,5,4,3,23,5,93
36,135,262,30,232,8,224,5,42,71,20,2,7,0,20,6,51
36,136,102,11,91,2,89,1,10,42,10,0,0,0,10,3,13
36,137,297,39,258,6,252,11,52,58,28,1,0,0,26,9,67
36,138,186,19,167,5,162,3,32,52,17,4,1,0,17,3,33
36,139,495,66,429,7,422,9,121,83,39,4,5,2,27,9,123
36,140,898,110,788,11,777,16,190,180,77,15,15,0,56,17,211
36,141,1286,238,1048,22,1026,15,215,251,81,18,15,5,105,29,292
36,142,1258,170,1088,28,1060,18,222,245,130,16,4,2,104,24,295
36,143,369,64,305,14,291,7,60,58,31,5,3,0,32,9,86
36,144,255,25,230,7,223,10,58,45,14,5,1,0,29,3,58
36,145,189,28,161,0,161,3,24,35,15,2,1,0,10,3,68
36,146,668,122,546,12,534,3,99,140,64,4,2,3,67,13,139
36,147,116,18,98,0,98,6,22,16,24,1,1,0,6,1,21
36,148,332,47,285,4,281,3,50,76,24,4,1,0,20,11,92
36,149,584,79,505,11,494,4,109,164,36,5,6,4,39,19,108
36,150,437,100,337,8,329,3,65,58,51,7,2,0,24,13,106
36,151,191,28,163,2,161,1,39,37,16,3,2,0,16,8,39
36,152,359,67,292,4,288,5,65,47,34,5,5,2,40,5,80
36,153,306,41,265,13,252,8,62,59,20,2,7,0,20,7,67
36,154,1498,232,1266,27,1239,20,206,237,133,14,12,2,103,29,483
36,155,594,82,512,14,498,2,117,149,45,7,2,0,40,12,124
36,156,313,74,239,3,236,8,46,31,43,3,1,1,15,6,82
36,157,313,42,271,4,267,2,60,60,36,5,3,0,22,2,77
36,158,530,79,451,13,438,5,94,95,58,3,2,0,32,13,136
36,159,4619,617,4002,95,3907,48,593,966,381,49,24,15,414,91,1326
36,160,219,29,190,4,186,1,39,36,22,0,0,0,20,4,64
36,161,711,111,600,14,586,9,101,101,77,7,5,1,34,14,237
36,162,775,102,673,22,651,5,168,150,58,9,8,3,56,20,174
36,163,479,101,378,20,358,3,74,66,32,15,5,2,37,6,118
36,164,191,32,159,10,149,0,24,38,14,3,2,1,22,0,45
36,165,899,149,750,17,733,15,121,199,89,10,7,0,69,21,202
36,166,156,23,133,3,130,4,34,45,13,1,1,0,10,2,20
36,167,130,16,114,5,109,0,23,39,7,4,0,1,13,2,20
36,168,594,117,477,14,463,8,75,127,53,8,8,0,43,9,132
36,169,428,79,349,14,335,2,95,68,47,0,5,1,22,11,84
36,170,86,13,73,1,72,0,12,19,3,1,2,0,11,3,21
36,171,1498,229,1269,28,1241,14,237,263,216,26,18,2,111,36,318
36,172,484,69,415,8,407,10,62,105,44,9,1,0,27,11,138
36,173,433,50,383,15,368,6,88,95,45,6,1,3,38,3,83
36,174,298,43,255,12,243,2,39,72,31,6,1,1,15,9,67
36,175,301,42,259,10,249,4,84,52,24,0,1,0,23,9,52
36,176,483,63,420,9,411,3,77,102,39,7,1,4,33,8,137
36,177,271,53,218,10,208,1,23,71,23,3,6,0,19,2,60
36,178,244,28,216,12,204,3,62,48,26,1,1,0,9,5,49
36,179,140,23,117,4,113,0,23,32,9,1,1,1,10,2,34
36,180,680,120,560,12,548,5,127,151,41,9,6,1,55,21,132
36,181,153,21,132,3,129,0,32,28,11,2,1,0,6,5,44
36,182,529,79,450,8,442,7,72,113,62,5,4,1,33,8,137
36,183,80,14,66,0,66,0,13,20,5,1,1,0,16,4,6
36,184,436,72,364,11,353,4,85,85,33,8,2,2,37,3,94
36,185,283,40,243,5,238,4,45,59,30,1,5,1,25,7,61
36,186,197,42,155,6,149,2,23,43,16,6,1,2,18,2,36
36,187,138,18,120,3,117,0,13,37,18,0,3,0,9,2,35
36,188,145,22,123,6,117,4,22,27,12,2,0,0,14,5,31
36,189,789,159,630,23,607,7,122,162,43,10,7,3,77,15,161
36,190,232,24,208,2,206,2,52,47,17,3,1,0,28,6,50
36,191,432,72,360,11,349,1,81,73,49,5,5,2,23,9,101
36,192,1296,216,1080,23,1057,11,180,232,125,8,5,4,90,19,383
36,193,224,31,193,7,186,3,44,51,9,1,1,0,13,2,62
36,194,748,138,610,13,597,5,199,118,52,9,9,3,41,12,149
36,195,418,39,379,14,365,5,76,71,78,7,4,1,28,5,90
36,196,86,11,75,1,74,3,18,12,11,2,1,0,3,1,23
36,197,280,41,239,3,236,3,63,64,14,3,2,0,19,9,59
36,198,321,32,289,5,284,1,57,79,32,11,2,1,26,10,65
36,199,970,152,818,22,796,6,138,192,123,8,11,2,69,22,225
36,200,1364,249,1115,15,1100,17,153,240,153,16,4,0,68,16,433
36,201,135,16,119,3,116,0,23,33,15,1,0,0,13,4,27
36,202,2151,386,1765,43,1722,26,363,486,162,17,9,7,163,35,454
36,203,50,14,36,4,32,0,5,13,4,0,0,0,4,0,6
36,204,269,34,235,1,234,2,60,70,12,2,3,0,9,15,61
36,205,113,17,96,2,94,1,21,23,4,1,3,0,13,3,25
36,206,35,6,29,1,28,0,8,12,0,0,0,0,2,0,6
36,207,464,77,387,5,382,3,58,72,69,1,5,2,33,5,134
36,208,650,135,515,14,501,1,89,130,41,3,6,0,53,5,173
36,209,238,32,206,4,202,1,32,66,12,4,2,3,24,4,54
36,210,270,38,232,6,226,6,51,51,18,4,6,1,18,7,64
36,211,389,59,330,7,323,6,83,79,20,6,6,2,27,17,77
36,212,139,15,124,2,122,6,34,19,27,1,0,1,6,3,25
36,213,211,25,186,1,185,8,45,49,14,4,4,0,6,4,51
36,214,283,75,208,6,202,1,45,38,24,2,1,0,32,5,54
36,215,356,40,316,3,313,5,56,86,42,7,2,0,24,4,87
36,216,59,9,50,2,48,4,7,10,2,0,1,0,13,2,9
36,217,93,9,84,1,83,0,13,20,9,2,0,1,14,1,23
36,218,149,26,123,4,119,6,27,36,9,4,0,0,15,2,20
36,219,422,54,368,7,361,5,85,99,37,10,2,0,26,9,88
36,220,669,133,536,14,522,8,66,114,60,6,3,1,42,7,215
36,221,342,61,281,8,273,6,52,78,22,5,2,1,42,12,53
36,222,205,33,172,3,169,2,38,42,11,3,1,0,21,3,48
36,223,147,33,114,3,111,2,21,34,15,2,0,0,7,0,30
36,224,958,160,798,36,762,12,117,224,76,6,7,3,53,9,255
36,225,141,16,125,3,122,0,34,28,13,0,2,0,11,7,27
36,226,294,45,249,3,246,12,47,47,30,12,1,2,17,4,74
36,227,197,52,145,3,142,2,33,43,17,1,2,0,5,3,36
36,228,1939,244,1695,52,1643,22,343,394,206,18,23,6,151,51,429
36,229,536,100,436,11,425,4,109,93,56,7,3,2,26,13,112
36,230,1455,261,1194,25,1169,19,242,302,131,23,12,6,90,26,318
36,231,693,93,600,14,586,14,117,135,73,6,0,2,59,19,161
36,232,861,117,744,16,728,11,182,167,81,11,5,1,54,12,204
36,233,556,113,443,9,434,1,145,104,55,5,4,0,21,1,98
36,234,272,38,234,6,228,4,36,52,19,4,3,1,32,7,70
36,235,325,58,267,7,260,3,73,55,26,6,4,0,27,8,58
36,236,306,49,257,2,255,6,48,67,27,5,3,2,40,10,47
36,237,642,117,525,18,507,11,147,120,53,5,7,1,52,16,95
36,238,101,26,75,2,73,0,17,16,8,4,1,1,5,3,18
36,239,383,65,318,4,314,3,76,40,41,9,0,1,21,7,116
36,240,272,45,227,3,224,8,51,51,38,4,2,0,17,1,52
36,241,1957,337,1620,38,1582,17,417,334,157,25,13,3,128,41,447
36,242,107,19,88,3,85,0,25,20,9,2,1,0,8,2,18
36,243,309,50,259,9,250,1,78,70,17,4,7,1,18,8,46
36,244,497,75,422,11,411,9,111,87,35,10,3,4,34,13,105
36,245,299,30,269,13,256,2,73,67,22,3,3,0,26,3,57
36,246,161,12,149,1,148,7,40,47,9,1,0,1,14,6,23
36,247,1030,170,860,25,835,8,242,186,70,20,6,1,80,19,203
36,248,197,33,164,0,164,4,33,31,23,6,2,0,8,5,52
37,1,864,110,754,23,731,9,163,200,56,10,3,3,94,22,171
37,2,1149,128,1021,17,1004,22,246,288,85,14,4,3,104,25,213
37,3,8187,1506,6681,117,6564,177,995,2033,614,73,31,15,627,135,1864
37,4,305,39,266,4,262,5,51,87,29,6,3,2,18,2,59
37,5,406,81,325,8,317,3,79,63,31,10,4,0,33,7,87
37,6,1941,284,1657,32,1625,34,297,427,185,17,15,7,182,42,419
37,7,143,22,121,3,118,0,31,41,8,3,0,0,5,6,24
37,8,1888,250,1638,35,1603,28,391,439,140,19,11,6,167,36,366
37,9,291,50,241,8,233,2,54,67,24,5,2,0,30,3,46
37,10,1300,152,1148,24,1124,16,292,275,92,13,8,2,126,34,266
37,11,1312,237,1075,30,1045,14,174,237,154,9,7,6,88,22,334
37,12,425,68,357,14,343,11,55,100,27,9,1,0,46,10,84
37,13,354,59,295,4,291,5,78,83,15,7,3,1,20,9,70
37,14,2591,482,2109,39,2070,53,289,663,231,32,22,6,200,40,534
37,15,2375,401,1974,29,1945,41,326,547,227,27,12,4,201,36,524
37,16,315,30,285,8,277,8,39,76,34,3,3,2,23,10,79
37,18,6135,896,5239,95,5144,109,671,1622,439,62,19,14,665,94,1449
37,19,369,37,332,7,325,8,53,95,24,5,3,0,25,8,104
37,20,1461,307,1154,37,1117,24,235,268,156,13,8,5,96,21,291
37,21,845,133,712,10,702,18,134,188,71,12,6,1,81,17,174
37,22,2335,398,1937,37,1900,26,281,355,327,23,22,3,195,39,629
37,23,241,27,214,2,212,3,34,78,16,3,3,0,24,5,46
37,24,744,107,637,7,630,10,141,161,68,8,4,3,53,16,166
37,25,583,108,475,5,470,8,74,131,53,9,2,1,42,13,137
37,26,493,71,422,7,415,8,96,114,38,5,2,1,57,6,88
37,27,3513,563,2950,55,2895,45,519,864,295,39,18,9,280,69,757
37,28,631,67,564,9,555,10,94,186,56,6,5,1,42,16,139
37,29,266,23,243,7,236,1,66,78,16,3,1,2,21,4,44
37,30,537,69,468,6,462,11,116,98,63,5,1,1,38,7,122
37,31,3012,546,2466,47,2419,24,318,709,279,16,19,7,281,53,713
37,32,200,24,176,0,176,3,32,52,24,1,1,0,25,3,35
37,33,220,39,181,3,178,5,24,43,21,2,1,0,23,9,50
37,34,264,40,224,4,220,5,44,72,15,3,2,0,30,7,42
37,35,264,55,209,5,204,2,53,48,21,5,1,1,20,6,47
37,36,175,33,142,4,138,0,31,54,11,1,0,1,15,4,21
37,37,201,38,163,3,160,5,37,37,12,1,1,0,30,3,34
37,38,596,73,523,17,506,12,94,131,67,3,8,2,38,6,145
37,39,362,51,311,9,302,6,95,65,23,7,5,0,22,9,70
37,40,241,30,211,5,206,2,39,71,23,5,1,0,21,4,40
37,41,256,47,209,4,205,3,36,65,16,5,3,0,15,5,57
37,42,212,27,185,2,183,9,35,46,25,2,4,0,22,4,36
37,43,779,118,661,14,647,14,187,159,63,15,8,0,69,10,122
37,44,240,40,200,2,198,4,34,66,15,3,0,2,18,5,51
37,45,845,121,724,14,710,6,167,187,67,9,4,2,56,14,198
37,46,350,45,305,7,298,6,51,98,18,3,1,1,40,3,77
37,47,881,130,751,12,739,7,135,236,62,5,6,4,82,24,178
37,48,251,25,226,5,221,7,49,58,20,1,2,1,30,5,48
37,49,1021,167,854,17,837,11,152,208,123,15,7,2,98,13,208
37,50,7441,1430,6011,112,5899,147,781,1915,561,46,21,9,686,110,1623
37,51,667,85,582,12,570,17,111,203,55,10,2,1,37,9,125
37,52,800,112,688,17,671,20,118,189,49,7,5,3,81,17,182
37,53,133,23,110,1,109,0,8,56,8,5,0,1,14,1,16
37,54,2669,401,2268,47,2221,41,419,624,235,25,13,11,252,49,552
37,55,536,95,441,11,430,8,104,125,35,5,4,0,47,8,94
37,56,434,60,374,12,362,8,81,96,43,7,2,0,25,7,93
37,57,502,75,427,8,419,7,80,136,40,5,1,0,35,12,103
37,58,1190,212,978,15,963,11,242,246,91,15,9,0,87,16,246
37,59,873,114,759,10,749,17,101,223,72,8,3,1,106,21,197
37,60,960,137,823,6,817,9,132,244,79,8,3,2,85,15,240
37,61,411,44,367,9,358,7,58,121,35,4,4,0,37,4,88
37,62,1215,252,963,26,937,13,207,316,70,11,8,3,79,19,211
37,63,3580,830,2750,72,2678,46,596,660,316,46,28,8,209,51,718
37,64,204,21,183,5,178,10,30,48,20,0,2,0,9,5,54
37,65,505,83,422,12,410,4,101,113,29,9,3,1,45,10,95
37,66,444,86,358,3,355,12,77,84,41,5,2,2,45,8,79
37,67,1168,152,1016,25,991,19,153,281,144,9,12,3,96,26,248
37,68,521,74,447,10,437,11,93,140,34,7,9,1,42,6,94
37,69,204,21,183,4,179,5,20,67,16,3,0,0,24,7,37
37,70,272,41,231,3,228,6,45,94,20,1,0,1,21,3,37
37,71,114,10,104,0,104,0,14,36,11,0,0,0,19,3,21
37,72,6089,1278,4811,81,4730,111,647,1216,636,70,33,12,439,101,1465
37,73,490,63,427,7,420,13,92,140,46,6,6,2,37,3,75
37,74,1463,276,1187,28,1159,16,259,319,95,17,3,3,101,32,314
37,75,250,34,216,8,208,3,42,71,20,1,1,2,23,6,39
37,76,320,36,284,11,273,3,38,62,51,4,4,1,22,3,85
37,77,2310,315,1995,47,1948,25,397,495,185,31,16,4,185,53,557
37,78,294,36,258,16,242,3,49,52,31,3,5,0,23,12,64
37,79,1473,255,1218,24,1194,22,231,312,140,22,11,1,111,21,323
37,80,175,29,146,3,143,1,38,34,15,4,0,1,12,4,34
37,81,955,132,823,14,809,11,194,217,78,11,2,5,68,14,209
37,82,349,59,290,4,286,6,66,85,22,3,1,0,19,5,79
37,83,1095,153,942,19,923,19,134,285,99,11,4,3,88,28,252
37,84,434,78,356,3,353,2,77,134,28,5,7,0,30,5,65
37,85,678,79,599,6,593,9,87,174,67,8,3,0,42,8,195
37,86,317,36,281,4,277,4,77,76,27,3,6,1,17,6,60
37,87,183,24,159,0,159,2,30,55,21,1,1,0,17,4,28
37,88,99,14,85,0,85,5,28,23,5,0,2,1,8,2,11
37,89,613,84,529,9,520,8,85,162,56,4,5,3,79,8,110
37,90,99,12,87,2,85,10,14,34,8,1,0,0,5,0,13
37,91,1712,242,1470,26,1444,31,256,402,156,25,16,4,136,38,380
37,92,505,86,419,10,409,5,91,100,41,6,1,1,49,15,100
37,93,438,60,378,10,368,3,81,115,25,7,3,1,28,14,91
37,94,453,49,404,7,397,6,91,116,39,4,4,0,37,7,93
37,95,243,36,207,7,200,3,39,50,27,0,5,0,19,3,54
37,96,414,74,340,14,326,5,59,93,48,6,3,2,27,14,69
37,97,455,56,399,9,390,11,82,87,49,7,4,1,32,10,107
37,98,533,69,464,5,459,6,106,103,41,10,3,2,42,11,135
37,99,595,90,505,7,498,7,111,147,56,4,2,2,53,16,100
37,100,302,46,256,7,249,4,56,65,24,3,2,0,24,3,68
37,101,138,27,111,2,109,5,20,37,11,5,0,0,17,0,14
37,102,126,28,98,6,92,0,21,25,12,2,1,1,3,4,23
37,103,123,14,109,1,108,1,30,19,12,0,3,1,15,4,23
37,104,3597,523,3074,52,3022,61,468,829,326,42,17,8,348,58,865
37,105,242,32,210,4,206,3,45,53,18,3,5,0,26,1,52
37,106,225,33,192,6,186,5,37,45,24,4,2,0,20,0,49
37,107,237,40,197,6,191,2,39,56,18,3,2,2,25,2,42
37,108,555,79,476,10,466,9,88,130,56,3,5,0,48,6,121
37,109,8108,1313,6795,107,6688,172,788,2326,535,55,28,18,872,133,1761
37,110,1085,184,901,17,884,18,187,238,105,14,9,3,99,15,196
37,111,1204,171,1033,15,1018,18,184,289,112,18,6,3,87,21,280
37,112,339,71,268,7,261,8,56,81,15,1,4,0,28,7,61
37,113,745,117,628,9,619,11,110,196,67,6,3,2,60,16,148
37,114,172,20,152,3,149,4,40,32,13,3,0,0,19,3,35
37,115,2869,466,2403,59,2344,24,449,642,201,26,21,6,188,55,732
37,116,410,60,350,6,344,3,73,132,36,3,4,0,28,12,53
37,117,619,108,511,2,509,11,138,133,52,3,6,3,46,9,108
37,118,1175,163,1012,13,999,21,154,227,134,21,5,9,108,22,298
37,119,1335,234,1101,27,1074,22,189,334,92,16,12,4,104,22,279
37,120,390,56,334,7,327,9,70,92,34,7,4,1,33,5,72
37,121,212,35,177,3,174,3,33,50,16,2,4,1,24,1,40
37,122,24268,4920,19348,356,18992,349,2637,5009,2224,211,122,40,1862,303,6235
37,123,2762,441,2321,45,2276,52,400,583,259,41,18,6,174,69,674
37,124,1829,219,1610,24,1586,37,233,447,162,11,3,0,191,23,479
37,125,339,41,298,6,292,4,56,73,32,4,6,0,30,6,81
37,126,244,34,210,7,203,3,35,64,27,1,1,0,22,4,46
37,127,219,38,181,4,177,3,44,41,18,2,0,1,15,7,46
37,128,886,107,779,21,758,19,171,215,69,8,7,3,78,26,162
37,129,807,110,697,12,685,12,112,213,62,12,6,1,72,3,192
37,130,1606,214,1392,36,1356,24,234,326,102,15,23,4,149,37,442
37,131,918,138,780,15,765,18,166,229,62,12,4,2,63,17,192
37,132,4784,994,3790,84,3706,85,595,1100,382,45,23,9,360,63,1044
37,133,410,80,330,4,326,8,59,122,28,1,4,1,26,13,64
37,134,471,58,413,18,395,6,88,129,36,7,0,0,39,16,74
37,135,207,24,183,2,181,1,46,48,28,0,2,0,13,5,38
37,136,355,36,319,9,310,10,59,77,44,4,4,3,27,7,75
37,137,117,13,104,4,100,1,15,42,7,2,1,0,5,4,23
37,138,598,100,498,11,487,18,81,141,51,7,3,0,56,10,120
37,139,3622,523,3099,62,3037,63,452,941,291,35,16,18,383,60,778
37,140,195,31,164,1,163,1,30,46,20,3,3,0,24,0,36
37,141,661,108,553,9,544,8,119,196,49,5,2,2,46,16,101
37,142,485,79,406,13,393,6,91,118,25,13,5,1,36,5,93
37,143,949,143,806,16,790,24,136,243,72,10,8,1,75,22,199
37,144,400,45,355,7,348,1,68,136,24,1,1,1,35,13,68
37,145,189,23,166,1,165,2,50,46,8,2,2,1,12,2,40
37,146,202,42,160,4,156,9,35,36,19,3,2,0,5,1,46
37,147,430,62,368,8,360,4,90,106,37,4,4,0,29,5,81
37,148,472,77,395,11,384,8,106,127,23,6,3,3,18,6,84
37,149,325,47,278,8,270,16,30,83,32,5,2,3,30,5,64
37,150,906,95,811,15,796,13,182,199,95,19,5,3,62,24,194
37,151,2231,301,1930,37,1893,31,266,622,153,11,9,3,227,44,527
37,152,1737,270,1467,22,1445,37,189,444,139,22,3,2,182,32,395
37,153,2800,432,2368,60,2308,35,441,642,189,33,18,5,326,53,566
37,154,2961,413,2548,34,2514,52,339,765,224,39,12,10,324,60,689
37,155,449,57,392,8,384,9,81,128,50,5,1,1,24,11,74
37,156,7986,1386,6600,116,6484,166,981,1503,841,79,34,18,675,130,2057
37,157,286,37,249,7,242,8,30,77,17,3,1,2,20,7,77
37,158,572,102,470,8,462,19,128,117,50,6,5,0,42,7,88
37,159,5647,1015,4632,84,4548,79,805,1133,473,58,26,14,506,120,1334
37,160,240,32,208,5,203,3,32,79,23,1,2,1,20,3,39
37,161,607,122,485,8,477,9,103,132,40,6,4,1,51,9,122
37,162,370,42,328,3,325,3,76,73,35,10,2,0,23,3,100
37,163,3049,590,2459,44,2415,51,505,614,270,33,15,9,180,49,689
37,165,324,52,272,9,263,7,59,49,25,2,1,1,41,7,71
37,166,492,64,428,12,416,18,85,109,41,8,5,0,50,14,86
37,167,1392,260,1132,21,1111,19,257,339,114,12,8,3,81,19,259
37,168,264,48,216,4,212,3,36,57,18,2,1,0,32,5,58
37,169,634,78,556,14,542,10,134,142,53,6,10,1,54,11,121
37,170,800,123,677,4,673,15,135,236,67,7,1,1,71,17,123
37,171,916,144,772,20,752,20,134,245,74,11,2,2,71,13,180
37,172,3137,506,2631,48,2583,48,360,674,251,44,7,8,282,51,858
37,173,619,73,546,4,542,14,120,159,51,6,5,0,33,11,143
37,174,615,91,524,13,511,5,94,158,49,12,6,0,35,6,146
37,175,919,93,826,20,806,25,138,226,73,11,5,2,103,19,204
37,176,698,76,622,16,606,1,142,187,57,8,10,2,56,17,126
37,177,548,79,469,19,450,11,91,146,50,2,2,2,30,5,111
37,178,470,60,410,5,405,8,90,127,33,3,3,1,39,12,89
37,179,1855,266,1589,26,1563,26,261,509,153,30,3,4,173,36,368
37,180,521,71,450,5,445,5,106,103,47,7,5,3,54,19,96
37,181,188,23,165,1,164,3,25,58,9,1,1,0,23,5,39
37,182,749,78,671,9,662,11,159,158,79,6,9,0,68,17,155
37,183,1077,142,935,20,915,9,178,298,90,14,5,2,80,19,220
37,184,313,45,268,13,255,3,24,91,28,5,6,1,26,2,69
37,185,1103,158,945,15,930,14,178,243,111,18,6,5,100,26,229
37,186,617,77,540,5,535,11,103,121,61,9,5,1,68,11,145
37,187,259,32,227,5,222,0,43,67,15,2,3,4,16,1,71
37,188,586,85,501,10,491,8,114,157,44,7,2,1,31,10,117
37,189,793,109,684,18,666,9,117,160,80,10,9,1,49,20,211
37,190,153,22,131,0,131,6,36,32,9,3,0,0,12,4,29
37,191,174,29,145,2,143,3,39,33,12,2,4,1,10,4,35
37,192,873,97,776,11,765,19,134,233,69,17,9,1,88,16,179
37,193,1035,166,869,17,852,14,173,272,67,9,12,2,87,20,196
37,194,1146,154,992,21,971,15,154,308,128,7,2,3,116,17,221
37,195,6259,1400,4859,71,4788,151,637,1042,664,63,28,14,486,90,1613
37,196,1400,244,1156,20,1136,10,189,387,62,23,12,2,95,28,328
37,197,344,52,292,3,289,7,46,94,31,1,4,0,30,4,72
37,198,238,36,202,3,199,2,48,41,20,0,2,0,23,6,57
37,199,371,51,320,4,316,3,50,101,28,6,3,1,19,12,93
37,200,662,85,577,9,568,5,118,128,77,12,5,3,51,10,159
37,201,577,80,497,13,484,6,105,134,50,5,3,0,39,9,133
37,202,409,50,359,12,347,6,61,99,50,5,1,1,32,7,85
37,203,2428,332,2096,24,2072,66,260,751,194,25,8,5,245,36,482
37,204,917,143,774,22,752,17,145,208,54,9,5,0,85,21,208
37,205,862,104,758,14,744,16,142,219,93,15,6,0,75,18,160
37,206,1145,174,971,16,955,18,129,301,94,6,5,2,109,23,268
37,207,254,45,209,5,204,1,47,66,19,1,2,1,11,12,44
37,208,11565,1681,9884,157,9727,220,1079,3122,847,94,48,33,1279,173,2832
37,209,166,19,147,2,145,2,38,39,15,4,3,0,8,6,30
37,210,477,69,408,12,396,7,72,86,47,8,7,2,51,7,109
37,211,1973,351,1622,31,1591,19,320,446,153,27,7,4,149,47,419
37,212,523,60,463,7,456,18,97,145,27,11,3,2,42,14,97
37,213,690,112,578,19,559,7,133,174,53,11,4,2,52,15,108
37,214,12471,2034,10437,157,10280,264,943,3980,797,76,45,26,1303,195,2651
37,216,1218,180,1038,33,1005,22,203,278,133,24,5,0,110,28,202
37,217,1062,147,915,20,895,26,148,199,137,13,4,5,102,21,240
37,218,465,76,389,6,383,5,69,140,23,6,3,1,39,18,79
37,219,716,85,631,14,617,12,108,163,68,11,5,4,74,14,158
37,220,310,45,265,5,260,4,56,49,32,5,2,0,22,3,87
37,221,567,113,454,7,447,9,107,122,45,7,6,3,33,8,107
37,222,536,68,468,10,458,6,116,124,52,7,3,0,43,11,96
37,223,227,25,202,4,198,4,48,51,25,1,3,1,20,7,38
37,224,651,77,574,8,566,6,105,181,65,7,3,0,63,20,116
37,225,2114,315,1799,42,1757,45,306,472,212,25,8,2,178,47,462
37,226,2995,572,2423,75,2348,32,439,707,195,30,21,3,243,63,615
37,227,507,69,438,17,421,5,109,102,40,7,8,0,33,7,110
37,228,932,133,799,16,783,9,168,271,61,10,5,2,73,13,171
37,229,191,28,163,4,159,1,32,55,13,4,0,1,17,3,33
37,230,716,75,641,14,627,10,129,161,76,15,2,1,64,14,155
37,231,1240,216,1024,19,1005,11,236,322,96,11,11,4,121,22,171
37,232,520,74,446,8,438,3,72,127,50,5,2,2,46,7,124
37,233,10598,2518,8080,131,7949,177,1141,1063,1909,118,69,17,477,112,2866
37,234,385,51,334,8,326,13,50,112,35,7,5,0,32,9,63
37,236,350,38,312,6,306,8,52,88,31,6,2,0,24,4,91
37,237,915,124,791,17,774,15,149,220,74,7,4,3,80,15,207
37,238,351,29,322,8,314,3,79,87,33,7,3,0,15,9,78
37,240,466,60,406,9,397,10,117,93,41,2,1,2,37,6,88
37,241,1031,176,855,14,841,10,229,254,69,7,2,0,47,24,199
37,242,1072,211,861,24,837,11,177,198,79,18,21,2,77,13,241
37,243,2149,253,1896,27,1869,37,265,598,193,9,11,3,200,48,505
37,244,234,32,202,0,202,3,45,63,18,4,1,0,21,5,42
37,245,1515,233,1282,22,1260,17,215,356,157,17,16,2,129,21,330
37,246,195,30,165,3,162,3,21,65,16,1,0,0,21,4,31
37,247,481,70,411,12,399,9,93,111,38,9,4,1,38,19,77
37,248,270,54,216,3,213,5,39,54,20,4,1,0,19,4,67
37,249,1014,191,823,15,808,16,178,196,95,13,12,0,99,26,173
37,250,1577,195,1382,34,1348,13,228,406,141,30,8,3,162,31,326
37,251,592,114,478,6,472,13,132,116,48,14,5,2,36,13,93
37,252,280,38,242,1,241,4,45,57,35,5,2,0,27,5,61
37,253,157,31,126,1,125,0,30,40,8,2,1,0,16,2,26
37,254,915,123,792,15,777,15,155,236,92,8,5,4,51,17,194
37,255,204,23,181,3,178,4,44,43,16,2,1,0,16,10,42
37,256,287,42,245,4,241,2,53,82,19,2,4,0,20,2,57
37,257,1121,184,937,24,913,16,198,268,63,13,4,6,117,18,210
37,258,240,34,206,4,202,3,37,36,26,3,3,0,21,9,64
37,259,406,54,352,10,342,7,81,86,19,6,0,1,37,7,98
37,260,418,68,350,12,338,2,67,105,19,8,2,0,35,9,91
37,261,76290,16410,59880,930,58950,1911,6839,15928,7262,728,365,171,5881,896,18969
37,262,266,37,229,7,222,3,62,67,15,4,2,1,21,6,41
37,263,1491,195,1296,13,1283,30,215,323,138,11,5,5,129,14,413
37,264,802,103,699,14,685,11,146,206,75,11,5,3,73,19,136
37,265,159,20,139,3,136,5,14,25,13,3,3,0,12,0,61
37,266,4548,593,3955,56,3899,79,552,1273,314,51,17,8,473,89,1043
37,267,2986,410,2576,56,2520,53,369,645,287,34,16,4,266,54,792
37,268,109,14,95,5,90,0,18,34,4,0,0,1,7,1,25
37,269,401,46,355,12,343,7,67,112,28,5,4,0,41,9,70
37,270,1880,275,1605,21,1584,47,309,510,150,20,16,2,152,39,339
37,271,711,81,630,12,618,15,124,131,85,21,2,1,61,17,161
37,272,747,83,664,24,640,15,123,203,73,6,1,3,67,12,137
37,273,3531,524,3007,48,2959,44,504,725,399,33,18,9,281,57,889
37,274,222,34,188,6,182,2,49,59,18,4,2,2,10,4,32
37,275,98,15,83,3,80,1,14,27,13,2,0,0,7,2,14
37,276,957,101,856,14,842,18,179,213,90,17,15,4,98,23,185
37,277,485,60,425,15,410,8,87,142,39,6,5,0,37,13,73
37,278,664,79,585,10,575,8,125,149,62,14,6,2,43,9,157
37,279,532,85,447,9,438,5,117,126,50,4,9,3,35,4,85
37,280,187,23,164,2,162,3,35,46,16,0,3,0,22,3,34
37,281,2420,394,2026,29,1997,54,260,717,198,22,9,5,203,38,491
37,282,1182,151,1031,27,1004,9,199,261,78,17,9,1,96,24,310
38,1,2150,508,1642,28,1614,31,394,498,151,20,7,2,108,26,377
38,2,721,103,618,14,604,36,77,136,84,3,3,3,58,16,188
38,3,736,85,651,7,644,11,149,175,82,7,4,3,63,8,142
38,4,800,131,669,14,655,22,151,136,83,10,6,1,63,12,171
38,5,860,187,673,13,660,16,97,173,89,10,1,2,64,23,185
38,6,2817,541,2276,43,2233,75,376,513,322,30,13,8,200,67,629
38,8,40,8,32,0,32,0,6,2,1,1,0,0,10,0,12
38,9,731,126,605,7,598,12,156,129,78,10,3,0,54,17,139
38,10,448,43,405,10,395,6,116,108,42,2,2,3,36,6,74
38,11,758,122,636,14,622,10,140,212,65,6,6,1,44,10,128
38,12,1554,305,1249,15,1234,17,391,309,109,11,5,3,109,26,254
38,13,2312,345,1967,40,1927,47,381,462,242,16,6,6,195,37,535
38,14,373,66,307,4,303,3,98,57,19,3,0,2,38,9,74
38,15,1204,167,1037,23,1014,16,272,273,90,16,9,2,100,21,215
38,16,170,22,148,3,145,3,47,38,10,0,2,1,22,2,20
38,17,934,117,817,9,808,13,214,180,100,7,2,2,75,11,204
38,18,286,31,255,8,247,5,61,57,30,5,7,0,36,7,39
38,19,1051,204,847,25,822,15,226,176,88,13,5,3,62,18,216
38,20,274,63,211,5,206,5,30,74,19,2,1,0,20,5,50
38,21,1373,195,1178,18,1160,52,96,322,199,14,6,4,93,17,357
38,22,3887,834,3053,71,2982,42,867,747,331,26,17,9,217,55,671
38,23,199,35,164,6,158,10,43,51,11,3,0,0,13,6,21
38,24,432,74,358,9,349,6,96,102,28,9,2,1,32,11,62
38,25,329,52,277,3,274,14,47,81,25,8,1,2,36,6,54
38,26,633,113,520,10,510,10,128,138,59,2,8,3,48,5,109
38,27,1382,173,1209,17,1192,49,232,320,137,11,5,2,131,23,282
38,28,693,131,562,15,547,18,159,170,41,8,8,5,42,11,85
38,29,1182,203,979,29,950,23,267,223,81,8,7,1,94,22,224
38,30,1113,201,912,21,891,18,193,201,92,10,6,4,79,24,264
38,31,35,6,29,0,29,1,6,5,3,1,1,0,1,0,11
38,32,431,66,365,11,354,8,113,107,20,8,1,1,29,3,64
38,33,485,62,423,5,418,6,116,108,33,5,5,1,33,9,102
38,34,2952,635,2317,46,2271,35,578,567,257,19,10,6,137,56,606
38,35,765,115,650,15,635,7,165,180,46,6,1,2,60,11,157
38,36,77,5,72,0,72,5,20,16,8,0,0,0,10,0,13
38,37,768,124,644,14,630,11,191,128,83,4,10,0,51,9,143
38,38,308,49,259,7,252,4,73,73,17,3,2,0,21,8,51
38,39,2438,289,2149,28,2121,91,211,641,193,12,4,7,290,32,640
38,40,175,42,133,2,131,1,21,45,8,1,0,1,14,2,38
38,41,101,15,86,1,85,6,24,19,9,2,0,0,10,3,12
38,42,703,82,621,4,617,17,129,152,69,9,2,0,50,15,174
38,43,999,123,876,12,864,19,166,184,108,7,7,0,95,24,254
38,44,1084,134,950,25,925,17,238,268,77,17,3,0,98,24,183
38,45,2069,254,1815,21,1794,67,142,728,122,6,3,5,260,33,428
38,46,666,85,581,7,574,13,169,156,62,7,2,1,43,14,107
38,47,114,10,104,1,103,2,21,37,12,0,3,0,10,2,16
38,48,866,135,731,19,712,21,159,186,59,11,5,5,62,13,191
38,49,247,36,211,6,205,1,74,53,15,0,3,0,26,1,32
38,50,424,61,363,7,356,7,130,85,46,8,2,0,22,5,51
38,51,865,98,767,25,742,13,186,215,74,6,2,0,67,25,154
38,52,2412,544,1868,36,1832,52,370,557,223,26,13,3,145,30,413
38,53,15486,3490,11996,188,11808,258,2202,3041,1286,94,53,23,1092,238,3521
38,54,972,179,793,18,775,9,195,166,125,9,12,2,51,16,190
38,55,427,63,364,5,359,7,93,95,49,2,8,6,27,11,61
38,56,69,10,59,2,57,1,3,19,8,1,0,0,9,3,13
38,57,568,61,507,9,498,23,65,172,45,2,0,1,62,3,125
38,58,1260,222,1038,22,1016,20,250,288,94,18,6,2,90,22,226
38,59,1814,211,1603,28,1575,47,276,564,116,6,7,5,156,33,365
38,60,112,14,98,1,97,1,24,31,6,3,0,0,13,4,15
38,61,2113,296,1817,38,1779,57,290,460,198,10,5,8,208,46,497
38,62,491,58,433,4,429,11,88,94,47,4,1,1,61,7,115
38,63,340,53,287,4,283,8,53,91,23,6,2,1,25,12,62
38,64,1861,316,1545,30,1515,28,397,426,116,19,13,5,133,53,325
38,65,1299,173,1126,18,1108,16,239,291,137,7,7,0,116,22,273
38,66,134,13,121,4,117,5,37,38,14,2,0,0,5,2,14
38,67,1037,122,915,20,895,12,193,331,66,6,4,0,83,16,184
38,68,914,86,828,9,819,14,125,241,105,7,1,3,98,11,214
38,69,871,148,723,8,715,9,178,201,65,10,7,1,66,14,164
38,70,953,120,833,16,817,15,157,192,91,9,5,3,70,17,258
38,71,2347,355,1992,25,1967,29,507,326,299,26,18,9,120,33,600
38,72,1618,320,1298,10,1288,26,345,400,120,13,3,5,108,15,253
38,73,109,16,93,1,92,4,17,33,7,0,0,1,5,6,19
38,74,230,24,206,7,199,13,39,60,23,3,2,0,19,0,40
38,75,1986,225,1761,23,1738,74,312,492,207,18,1,10,174,38,412
38,76,1234,184,1050,16,1034,23,262,288,80,10,5,1,103,29,233
38,77,501,46,455,8,447,10,134,87,53,5,1,0,40,7,110
38,78,429,50,379,6,373,22,63,71,70,2,5,0,29,6,105
38,80,564,73,491,9,482,6,103,159,45,4,2,3,40,8,112
38,81,1298,139,1159,16,1143,18,313,332,86,13,9,2,82,27,261
38,82,1372,292,1080,23,1057,21,213,272,128,18,8,3,129,23,242
38,83,298,44,254,11,243,4,69,66,26,1,5,0,16,0,56
38,84,1168,169,999,20,979,25,197,255,101,12,3,2,126,25,233
38,85,5616,1495,4121,57,4064,44,1168,917,431,35,29,4,263,86,1087
38,86,318,55,263,9,254,4,52,77,36,4,2,0,29,6,44
38,87,3177,548,2629,68,2561,34,622,594,308,23,16,5,155,44,760
38,89,179,40,139,1,138,0,28,45,10,3,1,0,7,4,40
38,90,273,47,226,4,222,18,25,56,31,5,1,0,21,8,57
38,91,488,54,434,5,429,3,107,115,26,0,1,2,47,11,117
38,92,84,17,67,2,65,2,22,11,13,3,1,0,2,5,6
38,93,314,31,283,6,277,4,57,66,43,3,2,0,26,7,69
38,94,1300,191,1109,40,1069,26,308,302,99,12,9,1,98,26,188
38,95,2019,360,1659,36,1623,33,387,452,150,15,3,6,178,52,347
38,97,2704,519,2185,28,2157,31,511,589,216,16,13,8,178,30,565
38,98,502,69,433,5,428,6,123,106,45,4,1,0,44,11,88
38,99,570,74,496,5,491,10,119,137,65,4,2,0,48,14,92
38,100,1834,337,1497,22,1475,38,294,261,219,41,8,3,111,26,474
38,101,757,149,608,14,594,13,145,142,48,6,6,4,41,11,178
38,102,383,43,340,7,333,9,87,94,26,6,1,2,39,8,61
38,103,285,28,257,4,253,4,40,72,44,1,2,0,24,6,60
38,104,1019,209,810,15,795,14,201,202,73,8,9,2,82,21,183
38,105,1725,285,1440,20,1420,54,261,342,173,15,6,2,160,33,374
38,106,270,35,235,2,233,10,57,54,29,6,0,0,16,8,53
38,107,1222,157,1065,29,1036,17,275,279,101,9,5,0,105,16,229
38,108,118,24,94,1,93,7,24,19,14,0,0,0,9,0,20
38,109,711,82,629,8,621,17,135,196,48,7,0,0,78,20,120
38,110,1602,203,1399,24,1375,41,319,430,114,9,7,8,134,25,288
38,111,6274,885,5389,80,5309,177,739,1592,581,43,12,15,593,84,1473
38,112,151,29,122,5,117,10,27,24,19,0,0,0,17,2,18
38,113,453,59,394,9,385,10,73,136,47,5,3,1,18,6,86
38,114,1121,169,952,26,926,12,188,198,165,11,5,4,95,25,223
38,115,476,71,405,4,401,18,75,86,54,7,2,3,39,13,104
38,116,46,13,33,2,31,1,9,0,6,0,0,0,1,0,14
38,117,470,48,422,3,419,12,100,83,62,3,4,1,35,5,114
38,118,1128,153,975,19,956,21,194,233,100,12,8,1,108,17,262
38,120,564,72,492,5,487,30,73,121,67,7,2,1,51,16,119
38,121,608,99,509,14,495,7,161,95,58,6,1,4,49,14,100
38,124,1666,296,1370,29,1341,18,341,401,121,13,12,3,118,38,276
38,125,203,31,172,3,169,15,22,45,26,1,3,0,17,1,39
38,126,3369,615,2754,38,2716,131,183,1135,207,16,3,3,351,36,651
38,127,150,17,133,1,132,11,19,28,24,0,0,0,7,2,41
38,128,408,59,349,7,342,5,61,118,21,2,0,2,20,8,105
38,129,345,55,290,3,287,19,31,124,19,1,0,0,40,6,47
38,130,2972,606,2366,44,2322,65,408,647,255,23,11,3,241,47,622
38,131,1515,175,1340,22,1318,37,305,412,108,11,6,2,117,18,302
38,132,108,18,90,1,89,9,10,31,11,0,0,1,6,1,20
38,133,3463,553,2910,50,2860,102,358,831,275,32,11,12,409,45,785
38,134,633,109,524,9,515,11,127,125,65,7,2,2,43,11,122
38,135,840,119,721,14,707,16,215,185,72,9,8,0,46,31,125
38,136,379,47,332,8,324,8,69,105,18,7,5,5,42,4,61
38,137,322,26,296,5,291,7,82,57,35,1,1,1,20,2,85
38,138,1991,335,1656,29,1627,54,308,498,147,16,6,6,154,28,410
38,139,1048,153,895,26,869,9,254,257,90,10,10,5,66,16,152
38,140,6138,741,5397,88,5309,228,636,1192,739,36,14,15,563,88,1798
38,141,472,56,416,5,411,4,104,138,42,5,5,0,43,9,61
38,144,1909,271,1638,25,1613,27,442,424,161,16,5,5,137,30,366
38,145,111,15,96,4,92,3,23,22,10,2,0,1,11,4,16
38,146,553,85,468,12,456,8,126,107,56,8,0,4,52,10,85
38,147,585,80,505,8,497,11,142,140,54,4,1,2,50,15,78
38,148,2329,389,1940,52,1888,49,462,533,178,18,20,11,174,45,398
38,149,1080,149,931,9,922,19,176,274,85,10,5,6,102,11,234
38,150,4671,784,3887,81,3806,96,762,820,566,26,36,12,285,51,1152
38,151,20600,3776,16824,274,16550,414,2866,3011,3037,158,97,24,1172,219,5552
38,152,543,95,448,9,439,7,129,106,40,8,5,1,42,13,88
38,153,381,33,348,2,346,19,38,68,61,7,2,1,27,14,109
38,154,234,44,190,6,184,8,41,38,23,0,3,1,12,5,53
38,155,1227,216,1011,12,999,29,237,247,109,20,9,7,123,26,192
38,156,723,166,557,6,551,14,180,99,56,5,7,2,57,17,114
38,157,2467,315,2152,50,2102,57,467,590,195,24,10,4,205,62,488
38,158,6461,918,5543,104,5439,167,812,1248,700,42,21,10,529,87,1823
38,159,327,29,298,7,291,1,90,75,24,4,3,1,26,4,63
38,160,1640,231,1409,24,1385,40,308,417,129,11,9,5,100,32,334
38,161,683,101,582,8,574,13,185,158,34,3,5,2,47,10,117
38,162,989,144,845,17,828,30,195,185,106,9,6,5,66,22,204
38,163,237,31,206,2,204,4,28,67,30,2,4,2,16,5,46
38,165,1278,211,1067,22,1045,14,287,259,100,23,6,5,97,22,232
38,166,328,29,299,5,294,10,58,56,45,8,3,0,29,5,80
38,167,351,42,309,5,304,4,101,75,29,3,3,0,31,6,52
38,169,13253,2693,10560,173,10387,307,1906,1742,1871,106,63,20,678,152,3542
38,170,2326,418,1908,33,1875,65,316,574,179,11,4,6,193,38,489
38,171,252,34,218,5,213,12,32,70,18,4,2,1,19,4,51
38,172,811,91,720,21,699,20,150,188,64,10,8,1,66,16,176
38,173,218,39,179,5,174,2,35,23,19,8,0,1,15,4,67
38,174,782,109,673,12,661,13,151,198,76,15,6,2,48,11,141
38,175,2508,419,2089,43,2046,52,400,411,310,29,9,4,162,40,629
38,176,1513,192,1321,21,1300,36,281,419,107,10,6,4,126,28,283
38,177,121,17,104,1,103,0,21,35,7,0,0,0,12,6,22
38,179,3955,633,3322,59,3263,122,483,802,363,30,9,4,320,71,1059
38,180,727,81,646,18,628,21,163,159,52,10,2,0,68,21,132
38,181,1711,278,1433,28,1405,44,247,335,198,16,2,3,119,42,399
38,182,1878,276,1602,22,1580,41,291,327,214,22,10,8,156,23,488
38,183,294,34,260,4,256,3,51,66,25,10,1,1,19,6,74
38,184,957,121,836,18,818,12,197,270,78,6,6,3,67,21,158
38,185,84536,17630,66906,944,65962,3277,7170,14067,10161,579,311,162,5466,827,23942
38,186,357,48,309,0,309,12,45,105,48,3,0,3,26,4,63
38,187,1445,225,1220,24,1196,48,262,240,194,16,1,5,97,17,316
38,188,1067,130,937,16,921,66,87,298,88,5,2,3,102,9,261
38,189,3484,649,2835,62,2773,44,689,808,238,24,18,4,233,58,657
38,190,754,141,613,13,600,11,163,150,63,8,3,1,29,8,164
38,191,1168,149,1019,19,1000,41,130,498,66,11,2,1,83,16,152
38,192,137,28,109,1,108,10,10,28,14,1,0,0,18,1,26
38,193,8794,2251,6543,123,6420,165,1414,1281,894,78,27,14,589,159,1799
38,194,1464,260,1204,23,1181,14,247,300,153,14,5,1,92,32,323
38,195,546,74,472,19,453,19,110,113,46,3,3,3,33,9,114
38,197,1036,187,849,13,836,12,192,291,67,4,7,2,67,18,176
38,198,758,116,642,14,628,10,154,156,77,10,7,2,51,13,148
38,199,1693,223,1470,35,1435,46,285,414,125,10,4,5,174,33,339
38,200,3036,462,2574,47,2527,82,461,587,325,31,15,6,249,39,732
38,203,344,67,277,6,271,17,53,95,25,1,1,0,20,6,53
38,204,193,23,170,4,166,7,31,37,31,1,2,0,9,4,44
38,205,2099,296,1803,21,1782,126,211,430,272,15,6,6,185,25,506
38,206,799,104,695,13,682,35,129,135,93,5,3,0,78,23,181
38,207,173,24,149,2,147,3,27,34,17,2,2,1,10,2,49
38,208,135,16,119,2,117,5,25,28,16,2,1,0,7,1,32
38,209,164,27,137,1,136,7,33,29,28,3,0,0,19,0,17
38,210,550,100,450,4,446,5,108,152,50,5,5,0,31,9,81
38,211,221,34,187,2,185,5,67,40,27,4,0,0,4,0,38
38,212,865,185,680,10,670,6,177,81,154,6,5,2,25,19,195
38,213,441,63,378,9,369,8,79,96,50,3,2,4,40,8,79
38,214,1564,208,1356,14,1342,52,199,404,148,15,5,5,147,21,346
38,215,1682,227,1455,34,1421,51,373,403,132,17,6,2,131,34,272
38,216,72,13,59,1,58,10,7,10,14,1,0,0,2,1,13
38,217,85,12,73,1,72,6,23,17,11,4,0,0,7,1,3
38,218,654,86,568,13,555,15,147,129,53,2,1,1,46,19,142
38,219,474,101,373,13,360,3,99,60,53,6,3,0,30,11,95
38,221,129,24,105,6,99,3,19,27,16,3,3,0,18,2,8
38,222,563,74,489,9,480,18,93,115,64,4,6,2,48,8,122
38,223,1298,181,1117,24,1093,37,201,373,96,6,2,4,135,22,217
38,224,98,15,83,2,81,3,14,14,16,0,1,0,12,3,18
38,225,1053,127,926,13,913,64,131,269,139,13,5,2,59,29,202
38,226,1143,166,977,21,956,71,134,257,124,16,4,2,67,20,261
38,228,398,77,321,8,313,10,77,85,40,3,3,0,40,1,54
38,229,13890,2106,11784,181,11603,500,1074,4133,1035,63,29,28,1311,163,3267
38,230,883,121,762,16,746,29,118,231,69,13,4,1,83,16,182
38,231,590,49,541,19,522,9,137,182,31,2,1,1,48,5,106
38,232,487,70,417,11,406,4,110,117,49,7,2,0,25,10,82
38,235,252,17,235,3,232,16,40,49,35,6,1,0,15,6,64
38,236,1457,253,1204,20,1184,45,235,316,144,14,7,4,135,24,260
38,237,187,29,158,7,151,8,28,26,40,3,2,0,3,1,40
38,238,1379,214,1165,29,1136,30,284,335,86,16,6,4,117,26,232
38,239,5507,1084,4423,71,4352,116,805,1014,578,43,18,9,398,86,1285
38,240,544,82,462,10,452,12,110,101,66,2,6,2,46,8,99
38,241,31,2,29,0,29,0,7,10,1,0,0,0,0,0,11
38,242,809,105,704,15,689,15,171,156,77,10,6,2,87,24,141
38,243,229,32,197,0,197,13,25,51,41,3,0,0,10,1,53
38,244,563,86,477,8,469,13,105,102,81,5,3,0,39,16,105
38,245,213,34,179,5,174,4,51,54,16,0,1,0,14,1,33
38,246,703,73,630,11,619,10,197,175,45,2,5,4,53,14,114
38,247,1845,433,1412,18,1394,17,388,316,193,20,7,5,95,26,327
38,248,427,64,363,11,352,21,37,109,42,5,2,2,32,14,88
38,249,3546,432,3114,42,3072,119,309,1080,193,17,6,6,457,46,839
38,250,344,25,319,7,312,7,55,85,46,3,3,2,39,6,66
38,252,269,23,246,7,239,9,26,56,38,1,1,3,18,5,82
38,253,923,245,678,11,667,18,97,277,55,8,5,4,60,10,133
38,254,429,74,355,9,346,6,112,57,39,2,2,3,22,4,99
38,255,98,8,90,1,89,1,19,21,15,1,2,0,8,5,17
38,256,1096,156,940,10,930,15,178,270,94,20,5,0,75,10,263
38,257,339,58,281,9,272,5,91,57,25,2,3,0,30,7,52
38,258,107,20,87,1,86,8,6,11,20,0,1,0,6,4,30
38,259,684,112,572,16,556,32,148,129,48,7,6,5,40,22,119
38,260,400,78,322,4,318,14,92,96,28,2,1,1,27,10,47
38,261,2448,435,2013,27,1986,33,497,589,171,16,10,5,180,41,444
38,262,323,41,282,2,280,16,50,66,43,6,1,1,23,12,62
38,263,320,34,286,5,281,9,60,54,42,0,0,1,23,4,88
38,264,186,37,149,5,144,0,27,34,22,2,0,1,11,5,42
38,265,1295,225,1070,22,1048,29,263,179,140,14,6,2,57,16,342
38,266,346,57,289,6,283,8,58,46,47,2,1,1,24,6,90
38,267,520,87,433,4,429,12,98,129,45,9,1,2,36,12,85
38,268,178,24,154,1,153,2,17,34,19,7,3,1,16,9,45
38,269,3443,747,2696,57,2639,53,537,609,367,40,17,3,165,76,772
38,270,1375,188,1187,16,1171,36,193,337,112,14,6,4,141,27,301
38,271,674,92,582,17,565,22,132,147,46,4,1,1,47,15,150
38,272,313,53,260,7,253,6,59,61,39,0,1,0,32,4,51
38,273,407,43,364,5,359,17,51,77,52,3,5,3,23,11,117
38,274,348,64,284,4,280,10,74,71,24,4,3,1,35,6,52
38,275,233,48,185,9,176,3,42,69,19,0,3,1,8,6,25
38,276,1621,225,1396,23,1373,25,303,407,125,15,8,7,123,24,336
38,277,350,59,291,5,286,6,83,61,43,3,3,0,18,2,67
38,278,342,49,293,5,288,14,42,55,40,3,2,1,37,3,91
38,279,889,111,778,14,764,15,130,176,113,5,7,0,61,21,236
38,280,489,67,422,2,420,23,62,70,76,7,5,1,24,4,148
38,281,1717,314,1403,29,1374,40,231,384,142,8,7,1,127,26,408
38,282,550,64,486,8,478,13,149,137,38,6,2,1,50,9,73
38,283,120,31,89,2,87,4,11,11,7,0,0,0,3,2,49
38,284,283,17,266,2,264,9,65,62,30,3,2,2,23,10,58
38,285,163,23,140,1,139,13,9,25,40,0,1,0,5,1,45
38,286,40,11,29,0,29,0,7,9,4,0,2,0,0,0,7
38,287,721,108,613,13,600,16,128,138,77,7,3,4,64,11,152
38,288,1211,194,1017,16,1001,31,251,272,91,17,11,4,88,23,213
38,289,284,53,231,6,225,13,29,61,27,2,1,1,13,10,68
38,290,587,93,494,9,485,11,160,102,61,7,1,3,36,17,87
38,291,698,108,590,17,573,11,168,170,66,2,7,4,50,22,73
38,292,883,162,721,11,710,26,166,189,76,8,5,3,52,16,169
38,293,313,39,274,5,269,9,66,63,32,2,1,1,33,5,57
38,294,423,50,373,2,371,4,91,101,36,4,1,0,44,24,66
38,295,461,61,400,9,391,7,86,103,45,5,2,1,32,5,105
38,296,595,60,535,16,519,12,118,168,51,2,4,1,51,9,103
38,297,706,86,620,10,610,6,202,169,58,5,1,0,55,18,96
38,298,4025,998,3027,53,2974,33,615,615,427,24,14,8,196,53,989
38,299,196,50,146,2,144,2,24,39,16,2,1,0,11,6,43
38,300,275,42,233,1,232,1,79,73,10,7,1,0,16,3,42
38,301,129,17,112,1,111,10,8,25,19,1,2,0,9,2,35
38,302,153,26,127,2,125,5,21,34,19,1,1,1,11,2,30
38,303,317,28,289,8,281,10,66,43,35,4,2,2,28,3,88
38,304,1015,152,863,14,849,38,201,129,129,15,5,1,44,23,264
38,305,974,107,867,26,841,27,171,229,93,19,6,3,92,13,188
38,306,185,30,155,2,153,1,22,21,41,4,0,0,9,2,53
38,307,426,78,348,8,340,14,92,67,33,13,2,2,37,9,71
38,308,178,22,156,3,153,4,30,25,11,4,0,0,31,3,45
38,309,1504,173,1331,15,1316,39,153,266,203,11,0,2,120,23,499
38,310,839,148,691,23,668,11,168,148,94,18,5,4,51,19,150
38,311,578,101,477,18,459,5,127,133,51,9,0,0,42,10,82
38,312,542,72,470,7,463,26,59,99,68,10,2,0,59,10,130
38,313,242,29,213,3,210,8,45,36,35,4,0,0,15,10,57
38,314,4751,880,3871,69,3802,123,758,807,507,54,21,10,348,78,1096
38,315,2062,332,1730,27,1703,29,385,439,227,15,8,5,158,31,406
38,316,2934,878,2056,32,2024,25,488,451,222,18,13,6,130,29,642
38,317,6582,1519,5063,94,4969,98,1024,900,863,48,37,14,297,80,1608
38,318,3284,771,2513,46,2467,37,479,594,261,11,11,3,185,32,854
38,319,630,128,502,3,499,17,89,100,93,9,5,3,22,4,157
38,320,1159,195,964,12,952,10,266,227,108,17,3,4,81,26,210
38,321,171,31,140,1,139,10,16,37,19,0,0,0,13,5,39
38,322,82,15,67,1,66,5,14,16,11,2,0,0,4,2,12
38,323,813,125,688,11,677,16,173,170,90,7,2,1,73,15,130
38,324,587,78,509,5,504,5,155,127,55,4,6,1,36,20,95
38,325,433,63,370,6,364,31,45,82,39,3,0,1,29,7,127
38,326,278,39,239,5,234,7,44,25,64,6,2,0,9,6,71
38,328,717,85,632,5,627,40,93,150,70,5,1,1,72,17,178
38,329,71,10,61,1,60,0,13,18,2,0,0,0,8,3,16
38,330,90,18,72,0,72,0,22,25,9,1,0,0,2,2,11
38,331,743,86,657,21,636,17,104,149,87,6,1,2,72,15,183
38,332,2344,411,1933,35,1898,20,379,354,303,28,15,7,148,29,615
38,333,276,46,230,6,224,7,33,55,56,4,2,1,24,1,41
38,334,1077,129,948,15,933,70,135,187,127,8,3,1,124,18,260
38,335,746,106,640,14,626,30,156,150,62,6,3,2,54,12,151
38,336,1420,187,1233,28,1205,23,275,351,114,9,8,2,103,29,291
38,337,3778,701,3077,55,3022,60,583,707,449,33,8,3,262,51,866
38,338,494,61,433,3,430,10,121,82,43,4,7,3,39,5,116
38,339,1458,202,1256,20,1236,25,349,381,87,16,7,4,105,30,232
38,340,1301,237,1064,20,1044,24,212,253,144,16,6,0,94,28,267
38,341,843,123,720,16,704,11,175,198,71,6,5,3,62,21,152
38,342,203,26,177,2,175,6,47,31,24,1,0,1,19,3,43
38,343,1238,186,1052,25,1027,22,287,269,91,8,5,1,120,27,197
38,344,5536,1258,4278,93,4185,65,876,892,724,50,22,9,310,83,1154
38,345,458,67,391,5,386,9,127,66,57,5,3,3,37,6,73
38,346,279,35,244,8,236,4,57,74,16,1,0,1,27,8,48
38,347,892,155,737,17,720,24,131,190,68,12,4,2,77,11,201
38,348,3583,611,2972,44,2928,59,651,910,220,25,8,13,304,63,675
38,349,1249,180,1069,17,1052,13,273,256,141,11,5,3,90,20,240
38,350,408,38,370,10,360,14,62,84,48,4,1,4,48,8,87
38,351,658,103,555,12,543,13,161,142,43,6,2,1,54,20,101
38,352,1455,183,1272,23,1249,30,216,406,117,9,3,4,156,28,280
38,353,610,81,529,14,515,8,165,93,69,7,3,0,35,11,124
38,354,286,30,256,6,250,7,65,67,25,2,0,0,22,9,53
38,355,118,17,101,1,100,3,6,16,22,2,2,1,10,1,37
38,356,313,48,265,5,260,11,40,63,40,5,3,1,27,3,67
38,357,1785,312,1473,25,1448,25,400,303,146,12,14,6,114,29,399
38,358,466,62,404,6,398,4,97,129,35,3,5,0,39,11,75
38,359,829,117,712,17,695,48,115,181,76,10,4,5,63,14,179
38,360,308,43,265,4,261,6,66,69,23,0,2,2,38,5,50
38,361,73,8,65,1,64,9,10,10,10,3,1,0,4,4,13
38,362,850,97,753,13,740,29,150,165,61,6,1,2,123,14,189
38,363,692,138,554,11,543,7,163,100,57,6,2,2,46,11,149
38,364,355,40,315,10,305,12,57,66,39,2,2,3,21,8,95
38,365,580,98,482,9,473,8,147,109,64,3,2,1,35,7,97
38,366,254,39,215,6,209,11,29,63,24,1,0,1,8,6,66
38,367,505,58,447,10,437,45,38,72,106,10,1,2,37,13,113
38,368,712,98,614,13,601,21,111,163,70,4,6,1,68,5,152
38,369,735,109,626,11,615,16,169,159,58,10,3,4,71,17,108
38,370,516,75,441,12,429,12,94,115,37,5,0,1,57,11,97
38,372,484,71,413,9,404,10,92,89,68,3,1,1,51,9,80
38,373,855,110,745,15,730,24,150,222,49,7,1,1,100,22,154
38,374,2443,418,2025,37,1988,40,527,580,167,22,13,7,213,44,375
38,375,134,40,94,3,91,4,9,24,14,1,0,1,9,3,26
38,376,611,93,518,4,514,16,127,105,52,7,6,3,54,17,127
38,377,2147,380,1767,33,1734,27,499,397,179,19,10,5,131,36,431
38,378,3027,675,2352,71,2281,34,628,524,264,25,12,6,193,49,546
38,379,224,34,190,6,184,5,45,55,10,4,0,0,25,3,37
38,380,193,28,165,2,163,0,55,37,16,2,3,0,10,7,33
38,381,1317,210,1107,15,1092,13,318,304,87,7,5,3,92,27,236
38,382,11782,2092,9690,160,9530,421,1270,2068,1244,99,30,18,996,173,3211
38,383,2156,311,1845,27,1818,81,272,421,220,13,5,4,257,42,503
38,384,1979,322,1657,43,1614,34,362,440,174,11,10,4,163,33,383
38,386,1497,268,1229,21,1208,44,271,314,144,15,1,4,118,35,262
38,387,360,61,299,5,294,5,53,98,21,2,1,0,38,10,66
38,388,1591,219,1372,24,1348,23,303,305,172,9,4,4,122,22,384
38,389,2437,380,2057,43,2014,34,489,611,187,17,5,2,207,54,408
38,390,400,64,336,8,328,5,87,82,54,7,3,1,21,5,63
38,391,217,29,188,1,187,1,25,50,32,0,3,1,24,4,47
38,392,427,66,361,8,353,5,77,109,40,2,3,1,22,11,83
38,393,1073,172,901,17,884,22,186,199,132,13,2,4,91,11,224
38,394,1556,278,1278,33,1245,35,301,319,156,12,17,0,108,33,264
38,395,887,117,770,9,761,89,88,100,130,12,1,2,59,9,271
38,396,630,81,549,10,539,19,126,106,67,7,3,2,52,12,145
38,397,5374,672,4702,66,4636,185,438,1823,275,22,10,15,653,92,1123
38,398,611,98,513,13,500,10,116,139,55,4,6,0,44,16,110
38,399,3073,407,2666,77,2589,40,621,777,231,19,18,4,225,66,588
38,400,2351,398,1953,36,1917,49,307,444,243,19,15,4,225,43,568
38,401,966,118,848,22,826,12,219,214,71,7,5,1,59,24,214
38,402,459,71,388,6,382,25,56,49,74,5,2,3,27,6,135
38,403,283,36,247,5,242,13,36,49,44,6,2,0,16,2,74
38,404,192,28,164,2,162,10,29,54,18,1,1,0,10,1,38
38,405,949,171,778,8,770,19,164,185,113,18,5,3,70,10,183
38,406,110,12,98,2,96,5,29,18,9,3,0,1,8,1,22
38,407,361,40,321,5,316,15,55,70,51,7,3,0,38,10,67
38,408,1943,330,1613,20,1593,23,360,565,126,12,7,3,144,42,311
38,409,862,169,693,22,671,14,189,144,78,12,6,1,50,10,167
38,410,907,118,789,25,764,15,186,212,69,8,6,3,74,21,170
38,412,2995,507,2488,66,2422,53,530,609,300,29,13,6,241,54,587
38,413,378,48,330,10,320,7,65,83,43,0,2,1,24,13,82
38,414,40,6,34,1,33,3,7,5,6,0,0,0,1,1,10
38,415,1021,111,910,29,881,27,169,250,95,13,5,4,92,19,207
38,416,5201,973,4228,79,4149,103,782,1107,519,47,25,5,389,82,1090
38,417,378,36,342,3,339,11,66,68,65,5,1,0,31,4,88
38,418,156,8,148,1,147,9,25,34,19,0,1,0,5,2,52
38,419,158,23,135,2,133,8,22,33,22,0,0,0,15,1,32
38,420,223,35,188,4,184,6,35,40,29,3,0,1,19,4,47
38,421,18119,3637,14482,254,14228,472,2179,2413,2619,160,81,30,1046,201,5027
38,422,4161,574,3587,45,3542,189,435,964,394,31,11,19,408,66,1025
38,423,3485,746,2739,30,2709,113,392,572,412,29,15,13,233,37,893
38,424,130,12,118,4,114,7,42,35,11,4,0,0,6,0,9
38,425,3939,850,3089,60,3029,42,719,526,544,45,26,2,208,53,864
38,426,572,67,505,11,494,11,120,104,52,9,4,2,58,9,125
38,427,222,37,185,4,181,7,20,55,25,3,0,0,20,2,49
38,428,64,17,47,0,47,1,7,11,9,1,0,0,4,0,14
38,429,215,22,193,6,187,14,25,51,33,2,1,1,16,1,43
38,430,252,31,221,1,220,8,44,41,45,1,0,2,20,5,54
38,431,2204,261,1943,19,1924,71,193,685,158,12,8,4,236,32,525
38,432,757,88,669,13,656,15,107,160,81,15,2,4,63,13,196
38,433,810,90,720,11,709,52,70,144,116,7,2,1,97,8,212
38,434,442,66,376,5,371,11,64,98,53,9,3,1,39,11,82
38,435,334,34,300,7,293,22,39,38,54,9,1,4,23,3,100
38,436,1752,205,1547,27,1520,57,246,437,184,10,4,6,153,26,397
38,437,277,65,212,4,208,5,39,39,36,3,3,0,27,5,51
38,438,220,30,190,3,187,12,24,45,30,0,0,0,21,3,52
38,439,1933,296,1637,21,1616,63,317,312,236,19,6,1,134,29,499
38,440,575,77,498,12,486,13,79,146,47,4,3,2,45,18,129
38,442,866,154,712,24,688,41,98,176,121,9,5,0,73,11,154
38,443,396,52,344,6,338,10,63,60,62,2,0,0,39,13,89
38,444,120,24,96,2,94,4,26,19,12,2,5,0,3,2,21
38,445,548,70,478,10,468,10,115,98,44,7,3,2,33,5,151
38,446,520,81,439,8,431,27,59,173,52,4,1,1,44,13,57
38,448,948,176,772,14,758,18,195,223,68,7,4,3,74,14,152
38,449,3520,632,2888,56,2832,48,663,616,375,48,21,9,220,66,766
38,450,925,129,796,16,780,22,183,208,81,4,2,2,67,16,195
38,451,2227,289,1938,34,1904,31,525,565,152,17,5,3,160,46,400
38,452,286,33,253,3,250,3,69,55,30,3,1,0,25,4,60
38,453,1216,169,1047,40,1007,18,220,293,108,11,5,1,101,21,229
38,454,1195,167,1028,13,1015,16,248,258,124,8,10,2,92,18,239
38,455,2808,462,2346,51,2295,56,563,710,197,16,6,6,199,59,483
38,456,225,31,194,2,192,12,22,26,47,2,0,0,13,3,67
38,457,2013,380,1633,33,1600,27,337,385,192,17,16,3,126,26,471
38,458,420,75,345,10,335,14,105,82,31,6,3,0,31,12,51
38,459,643,74,569,8,561,13,145,174,51,8,3,1,59,6,101
38,460,355,36,319,4,315,6,60,114,34,4,2,0,25,13,57
38,462,365,54,311,4,307,10,58,83,44,1,0,0,21,10,80
38,463,1386,196,1190,20,1170,32,270,311,137,13,8,4,141,19,235
38,464,1447,223,1224,24,1200,29,334,280,150,14,7,6,98,44,238
38,465,845,153,692,11,681,26,171,166,72,11,6,3,65,14,147
38,466,1133,158,975,17,958,39,126,273,114,13,2,2,117,15,257
38,467,921,169,752,15,737,10,182,169,92,6,4,3,79,25,167
38,468,3150,591,2559,46,2513,33,606,490,442,33,13,7,139,53,697
38,469,97,21,76,0,76,3,15,24,7,1,0,0,5,4,17
38,470,339,57,282,5,277,11,62,71,41,3,0,0,15,11,63
38,471,800,93,707,9,698,78,53,154,94,9,2,3,84,10,211
38,472,161,41,120,0,120,14,10,23,25,3,0,0,11,3,31
38,473,647,71,576,14,562,9,186,129,50,6,4,1,54,6,117
38,474,7812,1195,6617,101,6516,183,1217,1536,759,71,38,12,623,119,1958
38,475,1584,212,1372,31,1341,24,364,421,108,7,12,0,119,32,254
38,476,616,120,496,16,480,8,143,128,55,4,3,4,37,12,86
38,478,690,111,579,11,568,17,142,73,111,8,4,3,39,11,160
38,479,266,41,225,4,221,2,58,63,18,1,2,0,26,5,46
38,480,1353,203,1150,19,1131,16,331,309,85,10,6,1,122,25,226
38,481,638,84,554,13,541,10,130,158,51,5,2,2,70,11,102
38,483,1119,162,957,28,929,24,248,270,93,11,5,1,80,20,177
38,484,1145,128,1017,9,1008,25,260,244,83,8,6,4,92,18,268
38,485,8682,1590,7092,106,6986,240,1216,1631,803,64,38,12,635,142,2205
38,486,5267,578,4689,71,4618,145,654,1317,435,36,14,9,482,80,1446
38,487,1539,199,1340,24,1316,39,229,435,133,7,8,3,129,37,296
38,488,463,81,382,13,369,11,90,107,25,5,1,3,35,10,82
38,489,108,9,99,1,98,1,15,18,14,2,2,1,5,4,36
38,490,1380,214,1166,25,1141,13,295,255,140,13,10,3,96,19,297
38,492,471,39,432,2,430,19,47,77,76,4,1,1,45,9,151
38,494,527,76,451,6,445,11,116,141,34,2,2,2,46,3,88
38,495,456,101,355,6,349,5,79,94,43,5,1,1,30,8,83
38,496,990,152,838,18,820,8,236,231,77,13,7,3,59,21,165
38,497,144,18,126,3,123,2,30,27,18,4,0,1,13,0,28
38,498,535,78,457,8,449,9,129,123,34,2,3,1,45,12,91
38,499,814,175,639,22,617,13,160,69,111,6,5,0,40,20,193
38,500,428,60,368,12,356,9,94,96,42,7,2,1,38,3,64
38,501,1006,141,865,21,844,18,206,174,117,7,3,4,73,9,233
38,503,1623,145,1478,23,1455,55,204,334,205,20,2,6,148,23,458
38,504,1610,214,1396,16,1380,67,204,361,167,16,5,6,129,38,387
38,505,534,76,458,12,446,3,92,115,70,6,6,0,34,8,112
38,507,4140,700,3440,71,3369,38,820,896,292,43,16,8,278,69,909
38,508,446,42,404,12,392,6,85,90,42,12,1,0,43,15,98
38,509,4721,1133,3588,68,3520,69,734,877,448,41,20,5,246,60,1020
38,511,2264,345,1919,35,1884,74,258,504,220,21,8,5,192,35,567
38,512,425,75,350,5,345,12,85,96,28,2,1,1,43,12,65
38,513,169,15,154,2,152,2,13,43,20,3,2,2,28,3,36
38,514,214,42,172,0,172,7,31,32,27,5,1,1,25,11,32
38,515,1294,170,1124,21,1103,18,328,339,81,7,5,2,86,23,214
38,516,3810,554,3256,33,3223,160,292,1089,298,17,10,8,356,44,949
38,517,5280,977,4303,93,4210,115,860,896,515,37,22,14,424,91,1236
38,518,524,87,437,7,430,16,94,78,55,6,5,0,50,10,116
38,519,1820,259,1561,19,1542,35,394,531,111,23,5,5,118,26,294
38,520,446,69,377,8,369,12,117,112,31,3,0,1,35,7,51
38,521,62,9,53,1,52,5,11,4,11,1,0,0,1,2,17
38,522,210,31,179,3,176,10,34,27,19,6,0,0,10,5,65
38,523,672,91,581,17,564,15,159,140,71,2,0,1,50,16,110
38,524,4432,649,3783,57,3726,82,710,1120,387,22,20,11,336,67,971
38,525,305,46,259,8,251,4,75,66,31,0,1,2,30,5,37
38,526,286,28,258,8,250,10,52,60,26,3,0,1,26,7,65
38,527,400,62,338,2,336,12,51,114,50,1,2,1,23,6,76
38,528,897,121,776,10,766,21,160,171,96,7,0,2,84,19,206
38,529,2792,514,2278,37,2241,92,359,633,235,18,11,7,242,47,597
38,530,1699,317,1382,19,1363,33,298,393,136,13,9,3,141,39,298
38,531,411,78,333,6,327,13,75,76,43,4,3,0,28,8,77
38,532,447,71,376,3,373,9,89,114,36,3,1,4,32,11,74
38,533,587,57,530,7,523,35,60,144,68,5,2,1,50,8,150
38,534,730,175,555,10,545,17,84,229,44,4,3,3,48,6,107
38,535,189,26,163,3,160,4,33,49,13,1,0,0,11,5,44
38,536,900,115,785,15,770,15,180,186,101,9,4,3,66,15,191
38,537,3782,707,3075,37,3038,50,641,813,366,32,15,9,224,45,843
38,538,3066,385,2681,42,2639,91,442,586,326,21,20,5,240,54,854
38,539,432,50,382,5,377,5,105,97,52,0,0,1,29,6,82
38,540,1046,148,898,15,883,30,140,257,119,10,3,1,74,16,233
38,541,1385,245,1140,31,1109,24,291,312,94,13,7,0,108,27,233
38,542,275,36,239,5,234,7,58,59,18,2,2,1,28,4,55
38,543,1449,289,1160,23,1137,13,321,322,115,26,6,6,79,33,216
38,544,18290,3466,14824,253,14571,394,2232,3978,1719,139,67,33,1287,207,4515
38,545,5948,1045,4903,78,4825,98,1066,1192,625,50,24,10,434,86,1240
38,546,692,87,605,16,589,17,183,145,51,11,1,1,61,14,105
38,547,5275,1059,4216,90,4126,103,798,756,692,34,20,13,318,72,1320
38,548,3696,565,3131,44,3087,160,398,1034,395,40,19,11,275,78,677
38,549,38,7,31,0,31,0,4,8,4,0,0,0,4,0,11
38,550,83,18,65,2,63,1,6,18,1,1,0,1,11,0,24
38,551,45,10,35,1,34,1,1,12,7,0,0,0,1,0,12
38,552,315,36,279,8,271,2,46,57,57,5,0,1,21,8,74
38,553,10498,2442,8056,146,7910,217,1590,1229,1249,82,60,14,678,147,2644
38,554,1247,145,1102,14,1088,30,256,344,67,20,6,3,118,23,221
38,555,811,139,672,13,659,12,170,171,54,10,5,2,74,15,146
38,556,930,134,796,27,769,19,198,206,84,7,4,1,76,13,161
38,557,3225,524,2701,41,2660,38,692,924,179,23,16,3,239,61,485
38,558,1225,162,1063,15,1048,28,222,339,81,8,3,3,108,10,246
38,559,2757,572,2185,62,2123,47,509,535,236,24,19,8,179,41,525
38,560,765,136,629,5,624,10,112,165,81,11,7,3,49,8,178
38,561,1098,164,934,18,916,18,202,223,124,10,9,3,93,20,214
38,562,4858,1000,3858,68,3790,104,831,683,675,52,28,7,264,72,1074
38,563,14101,3037,11064,256,10808,351,1665,2921,1292,115,41,29,1043,176,3175
38,564,194,30,164,1,163,5,44,45,16,2,1,0,20,0,30
38,565,6959,1056,5903,105,5798,154,999,1493,637,63,20,22,593,99,1718
38,566,1290,176,1114,26,1088,29,194,277,132,11,5,4,117,19,300
38,567,426,91,335,4,331,11,43,123,50,10,2,0,24,1,67
39,1,601,83,518,8,510,3,162,107,49,8,1,3,42,20,115
39,2,48,16,32,0,32,2,4,10,3,0,0,0,7,1,5
39,3,36,5,31,1,30,2,5,7,4,0,0,0,5,2,5
39,4,49,9,40,1,39,1,5,21,4,0,0,0,3,0,5
39,6,315,37,278,3,275,19,36,64,34,4,3,0,29,8,78
39,7,136,15,121,3,118,1,32,29,12,0,2,0,10,5,27
39,8,250,28,222,4,218,3,48,51,35,2,3,1,21,5,49
39,9,421,64,357,7,350,14,61,86,51,5,3,0,46,6,78
39,10,72,13,59,0,59,2,10,18,4,0,1,0,11,0,13
39,11,318,51,267,9,258,2,62,93,15,3,1,2,14,10,56
39,13,2530,409,2121,42,2079,65,263,541,326,27,12,10,187,43,605
39,14,196,21,175,5,170,6,35,39,25,5,2,0,10,3,45
39,15,100,12,88,1,87,0,10,34,8,1,0,0,7,1,26
39,16,762,122,640,15,625,11,163,148,66,5,6,2,47,12,165
39,17,622,82,540,21,519,9,114,142,85,6,4,2,48,11,98
39,18,318,61,257,7,250,9,67,85,14,2,3,2,28,5,35
39,19,187,20,167,2,165,3,47,33,20,2,1,3,16,9,31
39,20,83,13,70,2,68,0,12,28,4,0,1,0,6,3,14
39,21,125,19,106,2,104,1,25,17,21,2,0,1,14,6,17
39,22,522,68,454,11,443,8,148,119,32,8,1,1,36,3,87
39,23,114,11,103,1,102,2,20,26,21,0,0,0,12,1,20
39,24,171,14,157,4,153,2,28,43,22,3,0,0,7,3,45
39,25,220,33,187,4,183,4,35,36,23,1,2,1,22,7,52
39,26,125,20,105,2,103,4,20,29,16,1,1,1,7,1,23
39,27,162,26,136,1,135,5,33,28,18,2,1,0,19,6,23
39,28,326,40,286,9,277,6,50,56,59,5,5,1,32,9,54
39,29,264,27,237,6,231,0,73,51,22,4,4,1,14,5,57
39,30,590,77,513,9,504,7,127,117,60,5,0,0,66,14,108
39,31,159,22,137,3,134,0,36,23,9,1,2,1,17,4,41
39,32,309,39,270,4,266,16,57,86,25,1,0,0,25,8,48
39,34,216,23,193,0,193,5,66,34,25,2,0,0,15,1,45
39,35,233,39,194,1,193,5,56,36,28,7,2,1,15,1,42
39,36,43,9,34,0,34,1,5,7,7,1,1,1,1,1,9
39,37,146,13,133,3,130,2,20,31,15,3,2,1,15,0,41
39,38,123,16,107,1,106,6,21,27,17,0,0,0,13,2,20
39,39,161,22,139,5,134,3,30,38,17,1,0,1,15,2,27
39,40,161,19,142,2,140,5,23,57,8,2,1,0,24,11,9
39,41,209,29,180,5,175,4,19,70,20,3,1,0,20,2,36
39,42,340,33,307,4,303,11,69,92,32,5,3,2,19,6,64
39,43,822,144,678,20,658,17,184,135,75,5,7,1,65,11,158
39,45,56,8,48,1,47,0,15,9,4,0,0,1,4,1,13
39,46,84,13,71,2,69,1,16,22,8,0,0,0,6,8,8
39,47,425,60,365,16,349,11,72,110,44,10,5,0,41,11,45
39,48,208,26,182,4,178,2,28,41,30,2,2,0,16,4,53
39,49,294,45,249,15,234,9,42,59,33,2,5,0,21,4,59
39,50,146,21,125,1,124,13,17,33,30,2,0,0,6,1,22
39,51,280,25,255,5,250,4,60,57,26,4,0,3,13,7,76
39,52,62,6,56,0,56,0,16,22,4,0,1,0,4,0,9
39,53,121,14,107,2,105,3,14,41,7,3,1,0,19,3,14
39,54,69,14,55,3,52,3,12,6,10,1,0,0,7,1,12
39,55,32,5,27,0,27,0,5,11,0,0,1,0,6,1,3
39,56,943,144,799,8,791,15,126,266,65,12,8,1,73,18,207
39,57,97,11,86,0,86,7,13,23,15,1,0,1,6,1,19
39,58,125,6,119,2,117,3,17,38,20,2,1,0,8,2,26
39,59,1222,239,983,38,945,29,136,307,102,9,11,2,153,42,154
39,60,48,11,37,2,35,2,19,3,4,1,0,0,1,0,5
39,61,92,14,78,2,76,4,14,26,5,1,1,2,12,2,9
39,62,48,5,43,0,43,2,13,6,0,1,1,0,3,4,13
39,63,202,34,168,2,166,8,32,57,16,7,0,1,17,3,25
39,64,37,6,31,1,30,0,10,5,2,0,0,1,1,3,8
39,65,83,14,69,5,64,5,14,9,14,0,0,0,8,1,13
39,66,146,9,137,4,133,2,29,32,7,4,1,0,16,2,40
39,68,242,31,211,2,209,12,38,48,33,4,3,0,14,8,49
39,69,106,21,85,5,80,4,17,11,15,0,1,0,4,2,26
39,70,82,9,73,2,71,1,20,13,5,1,0,0,4,11,16
39,72,245,28,217,6,211,6,24,66,15,1,1,1,25,4,68
39,73,140,24,116,1,115,10,22,28,11,0,0,0,15,3,26
39,74,184,36,148,4,144,1,23,60,16,2,0,0,12,4,26
39,75,180,26,154,2,152,3,36,32,25,1,3,1,13,3,35
39,76,142,12,130,4,126,2,36,28,11,2,0,0,8,2,37
39,77,38,8,30,0,30,0,3,11,4,1,0,0,7,1,3
39,78,507,60,447,13,434,9,107,99,43,5,1,1,25,7,137
39,79,161,12,149,4,145,6,29,35,18,0,0,0,14,3,40
39,80,43,6,37,0,37,0,11,10,4,0,0,0,1,2,9
39,81,285,39,246,8,238,5,53,54,24,5,4,1,29,5,58
39,83,242,29,213,5,208,7,52,70,20,6,0,0,23,4,26
39,84,109,12,97,2,95,4,13,30,14,0,1,0,14,2,17
39,85,64,6,58,0,58,1,10,25,2,1,0,0,8,3,8
39,86,203,45,158,8,150,1,41,33,15,2,2,0,15,8,33
39,88,298,39,259,4,255,6,46,53,35,2,1,1,27,4,80
39,89,53,6,47,0,47,0,11,15,6,0,1,0,5,0,9
39,90,120,21,99,1,98,3,25,21,13,0,0,0,9,3,24
39,91,79,8,71,0,71,4,7,24,6,1,0,0,17,1,11
39,92,134,17,117,2,115,3,37,36,14,0,3,0,9,1,12
39,93,313,49,264,9,255,14,54,74,39,4,2,0,19,5,44
39,94,127,13,114,1,113,7,17,40,12,2,0,0,11,2,22
39,95,97,5,92,0,92,7,10,24,10,3,0,0,8,0,30
39,96,255,45,210,2,208,4,57,59,19,4,0,1,13,8,43
39,97,5790,1137,4653,102,4551,62,887,1283,614,56,23,8,388,58,1172
39,99,318,40,278,3,275,5,62,83,24,4,3,0,20,3,71
39,100,94,17,77,0,77,4,16,15,12,0,0,1,6,1,22
39,101,1035,145,890,19,871,20,175,193,126,8,4,0,78,9,258
39,102,164,19,145,0,145,5,35,49,9,4,0,0,11,8,24
39,103,257,31,226,4,222,20,36,36,47,4,1,0,24,3,51
39,104,477,87,390,14,376,12,87,81,38,3,3,1,44,12,95
39,105,178,23,155,3,152,3,21,39,21,4,2,1,12,4,45
39,106,209,33,176,3,173,4,46,52,19,1,0,1,17,3,30
39,107,106,12,94,4,90,2,30,30,8,0,1,0,5,2,12
39,108,45,5,40,1,39,1,5,6,7,2,0,0,11,3,4
39,109,129,23,106,3,103,5,20,26,20,4,1,2,11,5,9
39,110,47,6,41,2,39,0,14,10,3,1,1,0,5,1,4
39,111,53,3,50,0,50,0,9,18,8,2,0,0,9,1,3
39,112,93,20,73,4,69,3,12,21,6,1,1,0,1,5,19
39,113,291,46,245,3,242,3,62,61,27,0,3,2,15,6,63
39,114,169,18,151,4,147,0,18,57,13,3,0,1,23,2,30
39,115,134,21,113,6,107,2,26,49,8,0,0,0,7,2,13
39,116,122,15,107,0,107,5,18,18,23,0,0,0,11,2,30
39,117,77,8,69,0,69,2,17,14,6,0,0,0,4,2,24
39,118,53,12,41,2,39,0,6,10,3,3,0,0,3,3,11
39,119,78,13,65,1,64,1,21,19,8,0,1,0,2,1,11
39,120,125,22,103,3,100,7,12,25,17,1,0,1,9,4,24
39,121,265,27,238,8,230,7,55,51,30,5,3,1,22,5,51
39,122,108,27,81,3,78,3,11,22,13,0,2,0,10,0,17
39,123,55,6,49,2,47,0,12,13,2,0,0,1,10,3,6
39,124,358,50,308,6,302,6,61,65,43,3,1,0,29,7,87
39,126,268,42,226,7,219,1,53,65,33,0,1,0,28,6,32
39,127,87,12,75,3,72,4,14,20,9,0,0,2,6,1,16
39,128,1077,132,945,18,927,13,255,253,96,9,6,0,81,20,194
39,129,272,47,225,3,222,5,44,68,16,3,3,0,28,3,52
39,130,131,14,117,1,116,5,10,37,7,4,0,0,20,5,28
39,131,375,54,321,11,310,3,70,96,35,4,2,3,30,10,57
39,132,33,4,29,1,28,2,4,6,3,1,0,0,1,0,11
39,133,57,7,50,1,49,0,9,21,9,0,0,0,3,1,6
39,134,152,14,138,3,135,4,28,46,13,1,1,0,12,3,27
39,135,103,9,94,3,91,2,28,16,13,5,3,0,11,1,12
39,136,31,2,29,2,27,1,8,5,6,0,0,0,3,0,4
39,137,95,8,87,1,86,1,34,15,4,1,1,1,9,3,17
39,138,248,33,215,3,212,2,68,46,25,3,1,0,24,4,39
39,139,63,3,60,1,59,1,8,17,0,0,0,0,6,1,26
39,140,37,4,33,0,33,0,7,12,5,1,0,0,1,2,5
39,141,195,20,175,2,173,7,50,28,20,4,4,1,7,4,48
39,142,128,22,106,0,106,2,33,34,4,3,1,0,7,1,21
39,143,32,3,29,0,29,2,10,6,6,2,0,0,0,1,2
39,145,261,14,247,5,242,5,52,72,26,4,0,1,34,7,41
39,146,397,50,347,7,340,9,49,70,66,5,0,2,29,10,100
39,147,84,9,75,0,75,0,12,24,10,0,0,0,12,1,16
39,148,60,9,51,0,51,0,13,9,6,2,0,0,6,1,14
39,149,257,26,231,7,224,3,48,63,25,4,2,2,8,7,62
39,150,744,109,635,12,623,10,121,168,66,5,10,2,66,13,162
39,151,118,15,103,2,101,4,16,19,30,1,0,0,8,4,19
39,153,649,83,566,12,554,9,120,150,59,8,4,1,52,13,138
39,154,1021,148,873,19,854,12,147,223,110,15,6,5,81,20,235
39,155,71,11,60,2,58,0,11,22,4,0,0,1,8,2,10
39,156,211,36,175,2,173,3,39,55,24,0,1,2,19,1,29
39,157,42,9,33,2,31,1,4,8,8,0,0,0,0,0,10
39,158,133,14,119,0,119,2,49,35,7,1,1,1,4,5,14
39,159,205,40,165,6,159,8,33,35,26,4,2,0,24,2,25
39,160,612,88,524,8,516,8,126,130,72,6,4,1,28,12,129
39,161,53,7,46,0,46,2,4,12,7,1,1,1,12,1,5
39,162,184,27,157,4,153,3,26,59,16,0,2,0,19,0,28
39,163,81,9,72,1,71,4,16,22,5,0,0,0,4,1,19
39,164,609,90,519,15,504,7,83,115,68,12,1,1,47,10,160
39,165,56,7,49,1,48,1,17,8,3,0,0,0,1,2,16
39,166,196,27,169,2,167,5,40,39,20,3,3,0,16,3,38
39,167,258,39,219,6,213,2,50,58,15,2,3,1,28,4,50
39,168,43,11,32,0,32,0,3,19,2,0,0,0,1,0,7
39,169,493,51,442,6,436,5,70,103,90,5,1,0,47,9,106
39,170,691,143,548,11,537,3,120,138,71,9,3,1,44,13,135
39,171,726,92,634,15,619,7,175,122,72,5,7,0,53,17,161
39,172,158,26,132,1,131,2,37,14,13,3,2,1,15,4,40
39,173,869,150,719,10,709,5,182,185,76,9,7,2,54,13,176
39,174,72,7,65,1,64,1,13,17,8,2,1,0,5,2,15
39,175,67,11,56,3,53,1,10,19,1,1,0,0,5,5,11
39,176,379,47,332,3,329,7,50,91,53,2,5,1,24,4,92
39,177,450,51,399,9,390,6,76,103,63,8,3,3,20,8,100
39,178,74,12,62,1,61,1,16,23,2,0,1,0,6,1,11
39,179,199,27,172,5,167,2,36,41,24,2,1,0,19,5,37
39,180,224,35,189,9,180,5,57,32,18,1,4,0,16,9,38
39,182,494,60,434,6,428,3,75,100,63,8,2,0,31,12,134
39,183,500,58,442,12,430,10,96,97,47,6,1,0,38,14,121
39,184,183,25,158,2,156,12,31,41,11,4,1,1,17,6,32
39,185,324,49,275,5,270,4,49,78,32,3,4,1,26,7,66
39,186,265,39,226,6,220,6,62,54,25,2,4,0,16,9,42
39,187,166,21,145,0,145,3,24,59,9,0,0,0,25,7,18
39,188,235,33,202,3,199,10,63,57,15,4,3,0,10,1,36
39,189,2164,457,1707,27,1680,21,390,297,269,24,21,8,112,42,496
39,190,813,127,686,12,674,10,161,158,68,12,4,3,54,15,189
39,191,80,4,76,1,75,0,6,30,18,1,0,0,2,3,15
39,192,63,8,55,0,55,3,7,13,11,0,1,1,10,1,8
39,193,691,84,607,8,599,10,207,133,64,7,8,2,39,13,116
39,194,372,48,324,5,319,5,81,79,38,8,1,1,25,6,75
39,195,60,7,53,1,52,0,10,18,4,2,1,0,10,3,4
39,196,95,12,83,2,81,0,23,11,18,1,1,0,9,3,15
39,197,303,33,270,6,264,7,73,77,25,3,1,2,23,5,48
39,198,15606,3196,12410,237,12173,297,2201,2845,1539,151,73,26,1117,219,3705
39,199,725,95,630,11,619,10,129,159,54,7,2,2,76,24,156
39,200,166,16,150,5,145,2,24,46,24,1,4,1,11,1,31
39,201,228,30,198,5,193,14,43,52,25,2,0,3,18,3,33
39,202,92,13,79,0,79,0,29,29,3,0,0,1,5,0,12
39,203,66,10,56,0,56,1,3,20,6,1,1,0,8,2,14
39,204,35,5,30,3,27,0,4,9,1,0,0,0,9,0,4
39,205,297,54,243,7,236,4,59,58,27,8,2,0,25,1,52
39,206,146,18,128,3,125,5,27,53,14,0,0,0,11,2,13
39,207,62,4,58,1,57,1,6,23,7,0,2,0,7,2,9
39,208,119,15,104,0,104,2,15,31,15,1,0,0,9,3,28
39,209,132,24,108,4,104,6,34,19,9,2,0,1,18,1,14
39,210,415,43,372,8,364,3,71,107,35,3,0,1,33,11,100
39,211,213,23,190,5,185,5,61,32,22,7,0,0,10,3,45
39,213,17,0,17,1,16,1,3,1,3,0,0,1,4,0,3
39,214,84,9,75,4,71,0,10,13,10,1,0,0,23,3,11
39,215,57,9,48,2,46,1,5,15,1,1,3,0,5,2,13
39,216,235,50,185,1,184,18,23,45,31,5,2,0,23,5,32
39,217,493,67,426,5,421,23,48,106,67,5,1,2,56,3,110
39,218,316,35,281,2,279,3,57,57,43,4,0,0,23,12,80
39,219,443,54,389,12,377,5,89,98,51,3,0,0,25,6,100
39,220,294,27,267,5,262,8,74,61,31,4,2,0,24,6,52
39,221,25,4,21,0,21,1,2,5,2,0,0,0,5,4,2
39,222,70,5,65,1,64,0,6,18,6,0,0,0,13,1,20
39,223,147,15,132,3,129,0,15,48,18,1,0,0,15,1,31
39,224,84,15,69,3,66,1,12,10,12,2,0,0,6,3,20
39,225,171,29,142,2,140,12,23,41,12,1,1,0,22,1,27
39,226,28,3,25,0,25,1,6,2,6,2,0,0,0,1,7
39,227,194,35,159,2,157,5,38,52,18,2,0,0,18,2,22
39,228,830,152,678,7,671,29,133,203,83,10,15,3,77,33,85
39,229,159,19,140,2,138,2,29,21,21,4,2,0,10,2,47
39,230,57,5,52,1,51,0,10,24,11,0,0,0,2,0,4
39,232,325,54,271,5,266,5,95,59,38,6,2,2,24,7,28
39,233,1397,189,1208,12,1196,22,295,224,154,18,7,6,104,17,349
39,234,68,15,53,2,51,1,14,13,5,1,1,0,2,1,13
39,235,754,129,625,21,604,8,176,113,71,11,8,2,52,11,152
39,236,29,8,21,0,21,0,5,4,2,0,0,0,4,1,5
39,237,41,10,31,0,31,0,4,10,2,0,1,0,11,1,2
39,238,100,9,91,0,91,6,18,20,17,5,1,0,5,1,18
39,239,36,2,34,0,34,0,9,4,14,0,0,0,2,0,5
39,240,132,10,122,3,119,10,15,37,12,4,3,0,10,5,23
39,241,283,24,259,5,254,4,63,66,23,2,1,0,18,8,69
39,243,70,9,61,2,59,1,18,11,7,1,2,0,3,1,15
39,244,144,14,130,4,126,10,21,21,12,8,1,1,27,5,20
39,245,248,33,215,7,208,2,67,49,27,1,2,1,17,4,38
39,246,258,23,235,7,228,7,61,43,28,4,1,0,22,3,59
39,247,56,8,48,0,48,0,8,15,4,0,0,0,10,7,4
39,248,34,6,28,2,26,0,4,5,5,0,0,0,3,0,9
39,249,61,9,52,1,51,1,17,13,5,0,0,0,4,1,10
39,250,120,17,103,4,99,1,26,16,13,0,1,0,14,2,26
39,251,310,51,259,3,256,8,67,47,41,4,2,1,15,3,68
39,252,468,63,405,8,397,4,93,100,48,1,3,2,34,10,102
39,253,242,27,215,2,213,5,44,71,22,2,5,1,17,5,41
39,254,97,14,83,1,82,2,18,23,9,1,0,0,12,1,16
39,255,160,40,120,1,119,1,19,38,15,2,0,1,15,3,25
39,258,372,62,310,7,303,17,56,95,29,4,6,1,48,7,40
39,259,36,9,27,0,27,1,2,5,9,1,0,0,2,0,7
39,260,105,17,88,2,86,2,7,26,17,1,1,0,12,1,19
39,261,130,17,113,2,111,10,19,29,13,0,0,0,15,1,24
39,262,106,18,88,1,87,2,34,20,4,1,0,0,4,0,22
39,263,324,52,272,9,263,5,61,59,34,7,2,1,21,8,65
39,264,167,21,146,6,140,6,26,39,25,0,1,0,16,6,21
39,265,165,15,150,1,149,4,19,44,15,3,0,1,22,4,37
39,266,229,38,191,0,191,4,57,44,13,3,0,0,23,3,44
39,267,68,6,62,1,61,0,14,21,7,1,1,1,9,0,7
39,268,54,5,49,1,48,1,10,12,9,1,1,0,7,0,7
39,269,206,34,172,5,167,5,55,27,18,2,2,1,15,8,34
39,270,388,30,358,6,352,6,102,66,54,8,1,0,30,3,82
39,271,272,35,237,6,231,9,31,62,31,7,5,0,35,4,47
39,272,53,11,42,0,42,3,13,11,1,1,1,1,3,1,7
39,273,63,14,49,0,49,1,12,14,4,0,1,0,4,1,12
39,274,196,16,180,2,178,15,18,29,25,3,0,0,30,7,51
39,275,443,75,368,7,361,12,35,77,71,8,1,0,53,12,92
39,277,59,11,48,2,46,0,9,12,4,0,0,0,10,1,10
39,278,134,16,118,0,118,0,39,30,8,0,0,0,20,0,21
39,279,439,53,386,12,374,8,75,77,51,5,2,2,41,11,102
39,280,108,15,93,2,91,3,25,11,18,1,0,1,5,5,22
39,281,61,8,53,0,53,3,17,8,4,0,0,0,6,0,15
39,282,73,6,67,4,63,0,16,21,5,1,0,0,2,0,18
39,283,454,67,387,6,381,5,108,96,35,3,2,0,34,15,83
39,284,102,15,87,3,84,1,26,22,7,0,1,0,10,1,16
39,285,212,38,174,5,169,2,36,45,12,0,2,1,17,8,46
39,286,1204,180,1024,19,1005,13,215,232,121,15,17,3,101,24,264
39,287,105,22,83,3,80,2,28,20,2,0,0,0,13,5,10
39,288,290,37,253,2,251,12,36,61,40,1,3,1,32,7,58
39,289,248,44,204,0,204,8,62,56,19,1,0,0,12,1,45
39,290,165,29,136,2,134,4,30,54,11,0,1,0,8,4,22
39,291,189,28,161,1,160,1,46,49,6,2,2,0,16,3,35
39,292,111,5,106,0,106,2,14,25,19,0,1,0,11,6,28
39,293,155,11,144,5,139,4,41,25,23,2,0,1,12,6,25
39,294,160,25,135,5,130,7,27,35,24,2,1,0,10,3,21
39,295,145,20,125,4,121,2,38,33,12,0,2,1,15,0,18
39,296,153,20,133,0,133,5,32,29,16,1,2,1,13,4,30
39,297,932,155,777,22,755,18,141,196,106,10,6,3,81,27,167
39,298,47,3,44,0,44,0,8,19,1,0,0,0,4,3,9
39,299,398,56,342,3,339,1,84,93,22,5,4,0,30,10,90
39,300,11992,3090,8902,155,8747,217,1284,2216,1289,97,30,10,912,188,2504
39,301,130,15,115,3,112,2,23,38,9,0,1,1,10,4,24
39,302,88,12,76,5,71,4,15,22,6,0,1,0,12,0,11
39,303,108,23,85,2,83,0,25,21,8,1,1,0,6,2,19
39,304,237,28,209,2,207,6,28,45,34,3,0,0,26,3,62
39,305,461,54,407,9,398,2,79,129,38,4,4,1,43,11,87
39,306,794,90,704,11,693,22,102,171,100,15,3,3,80,16,181
39,307,218,23,195,5,190,5,63,42,21,1,1,2,16,10,29
39,308,143,14,129,2,127,6,29,38,10,5,2,1,13,10,13
39,309,57,5,52,0,52,1,15,12,6,1,0,1,5,0,11
39,310,360,65,295,10,285,9,54,76,36,7,0,1,41,7,54
39,312,93,17,76,3,73,1,21,29,5,0,0,0,3,2,12
39,313,148,19,129,1,128,2,22,58,3,0,0,0,12,2,29
39,314,69,5,64,3,61,0,14,24,8,0,0,0,8,0,7
39,315,277,26,251,8,243,10,45,71,29,2,0,0,37,4,45
39,317,254,33,221,6,215,4,32,58,26,5,2,2,39,6,41
39,318,151,18,133,2,131,3,36,52,13,3,0,0,9,3,12
39,319,102,15,87,1,86,2,31,10,20,0,1,0,4,1,17
39,320,264,36,228,2,226,5,41,54,37,2,1,0,26,8,52
39,321,137,14,123,1,122,4,26,37,15,1,0,0,9,3,27
39,322,53,7,46,1,45,2,7,10,3,0,1,0,1,3,18
39,323,221,21,200,1,199,7,38,38,33,9,4,0,11,3,56
39,324,23,1,22,2,20,0,1,8,2,0,0,0,4,0,5
39,325,428,74,354,6,348,14,30,73,74,8,3,3,37,3,103
39,326,146,26,120,3,117,1,31,33,13,0,2,0,12,1,24
39,327,622,83,539,10,529,10,121,98,87,7,4,1,44,7,150
39,328,312,54,258,4,254,4,64,91,19,4,4,2,19,2,45
39,329,71,6,65,0,65,2,15,24,4,1,0,0,8,3,8
39,330,112,11,101,2,99,2,19,35,12,2,0,1,6,4,18
39,331,513,61,452,11,441,15,95,148,37,4,2,4,56,10,70
39,332,171,16,155,2,153,10,34,52,14,2,0,1,17,0,23
39,333,1303,204,1099,20,1079,17,269,267,141,13,3,1,60,22,286
39,334,106,10,96,2,94,3,24,25,9,0,1,0,16,0,16
39,335,391,53,338,12,326,7,59,84,41,5,0,1,25,11,93
39,336,90,10,80,3,77,3,8,38,2,0,0,0,8,1,17
39,337,68,15,53,0,53,1,8,14,3,0,0,0,13,0,14
39,338,407,49,358,2,356,3,85,83,35,5,2,0,26,4,113
39,339,442,83,359,5,354,7,111,85,34,2,4,0,23,14,74
39,340,24,7,17,0,17,0,6,10,0,0,0,0,0,0,1
39,341,107,17,90,1,89,7,11,22,21,0,0,2,12,1,13
39,342,116,21,95,3,92,6,12,19,14,2,1,1,7,1,29
39,343,25,5,20,1,19,1,4,4,1,0,0,0,3,0,6
39,344,257,28,229,5,224,3,45,67,34,3,1,1,21,5,44
39,345,347,31,316,7,309,8,55,77,60,0,2,0,23,5,79
39,346,101,13,88,0,88,4,36,10,12,1,0,0,7,4,14
39,347,87,12,75,1,74,4,25,20,10,0,0,0,6,1,8
39,348,362,31,331,2,329,19,48,87,55,3,9,1,31,8,68
39,349,373,32,341,5,336,25,45,77,46,3,1,0,48,6,85
39,350,233,38,195,6,189,7,62,23,27,4,4,1,10,10,41
39,351,142,16,126,0,126,3,25,33,15,3,1,0,9,3,34
39,352,112,5,107,0,107,2,37,30,14,2,0,0,9,2,11
39,353,163,25,138,1,137,9,24,30,23,3,1,0,9,3,35
39,354,257,43,214,7,207,2,50,62,16,0,2,0,27,5,43
39,355,243,34,209,4,205,5,35,78,31,3,2,0,17,3,31
39,356,144,17,127,4,123,2,20,33,14,1,2,0,24,4,23
39,359,21,0,21,1,20,0,3,15,0,0,0,0,1,0,1
39,360,151,24,127,0,127,4,24,24,20,1,0,0,11,5,38
39,361,145,16,129,5,124,6,30,22,18,2,1,0,7,2,36
39,362,2155,320,1835,34,1801,40,316,438,268,26,9,4,183,39,478
39,363,105,16,89,3,86,2,29,21,8,0,0,0,7,0,19
39,364,337,42,295,5,290,10,54,107,40,1,1,2,36,5,34
39,365,860,103,757,9,748,10,135,239,81,16,10,5,56,14,182
39,366,176,31,145,5,140,6,37,39,11,1,1,0,17,8,20
39,367,1798,347,1451,34,1417,28,283,421,157,15,13,1,153,34,312
39,368,2334,595,1739,32,1707,29,370,424,194,22,11,6,147,43,461
39,370,751,141,610,21,589,13,93,142,118,4,2,2,56,14,145
39,371,249,35,214,7,207,10,42,63,21,2,3,1,22,10,33
39,372,71,10,61,2,59,4,3,24,4,2,1,0,9,3,9
39,373,145,22,123,3,120,5,12,57,14,1,0,1,13,2,15
39,375,74,7,67,1,66,1,21,13,6,0,1,0,9,2,13
39,376,48,5,43,1,42,0,10,10,6,1,1,0,2,0,12
39,377,134,17,117,0,117,3,46,25,7,3,2,0,8,1,22
39,378,249,29,220,3,217,5,54,65,19,8,4,1,14,3,44
39,379,424,60,364,7,357,8,83,68,38,4,1,0,45,12,98
39,380,49,14,35,1,34,2,7,13,1,1,0,2,3,0,5
39,381,82,15,67,1,66,4,12,25,2,0,0,0,9,1,13
39,382,61,9,52,0,52,0,11,17,7,0,0,0,4,1,12
39,385,353,58,295,9,286,3,63,74,50,2,1,0,22,5,66
39,386,58,8,50,1,49,1,23,2,3,0,1,0,2,0,17
39,387,172,21,151,0,151,3,32,35,22,2,1,0,8,2,46
39,388,199,23,176,2,174,3,24,70,20,1,0,0,21,4,31
39,389,459,61,398,11,387,6,59,150,40,8,0,2,41,9,72
39,390,186,18,168,2,166,4,35,35,35,1,1,0,22,3,30
39,391,246,31,215,7,208,4,43,70,18,5,2,0,19,7,40
39,392,155,23,132,0,132,9,26,38,8,1,0,1,12,5,32
39,393,50,9,41,0,41,0,7,20,3,1,0,0,5,1,4
39,394,68,11,57,0,57,1,16,17,8,2,0,0,2,0,11
39,395,161,16,145,5,140,5,34,26,20,2,0,0,12,2,39
39,396,707,106,601,11,590,7,154,133,57,6,8,1,46,9,169
39,397,1119,176,943,23,920,23,164,271,88,10,8,1,87,27,241
39,398,245,32,213,6,207,4,63,42,31,5,0,1,11,4,46
39,399,249,42,207,6,201,1,48,60,21,5,2,0,17,4,43
39,400,120,18,102,0,102,1,24,39,9,0,1,0,6,3,19
39,401,186,22,164,4,160,2,33,40,33,2,2,0,22,2,24
39,402,249,31,218,6,212,5,55,61,16,9,3,1,8,5,49
39,403,186,28,158,1,157,5,32,33,31,0,1,0,12,1,42
39,404,386,47,339,9,330,9,38,70,32,3,1,0,52,10,115
39,405,746,114,632,11,621,6,131,156,90,11,9,3,44,13,158
39,406,197,23,174,5,169,2,40,46,12,4,3,1,27,9,25
39,407,276,25,251,7,244,10,23,79,35,2,1,1,28,4,61
39,408,115,20,95,3,92,0,16,47,7,0,0,1,3,5,13
39,409,116,22,94,3,91,0,5,29,23,0,0,1,8,1,24
39,411,1166,169,997,14,983,19,189,262,111,15,8,0,94,18,267
39,412,223,33,190,3,187,0,55,51,22,2,1,1,10,5,40
39,413,256,39,217,2,215,20,19,50,44,6,1,1,36,3,35
39,414,87,12,75,2,73,1,12,12,15,1,0,0,7,0,25
39,415,890,196,694,13,681,9,214,156,66,6,2,0,38,16,174
39,417,129,14,115,2,113,3,22,37,12,0,0,1,21,4,13
39,418,75,7,68,2,66,2,10,28,8,0,2,0,4,3,9
39,419,48,2,46,3,43,0,7,9,7,3,1,1,5,3,7
39,420,158,19,139,5,134,0,37,34,17,3,1,0,11,1,30
39,421,245,30,215,6,209,4,31,63,16,4,2,0,25,6,58
39,422,467,64,403,6,397,6,92,80,59,3,2,1,34,12,108
39,423,101,18,83,1,82,0,14,22,12,3,0,0,10,1,20
39,424,143,14,129,1,128,9,19,24,26,0,0,0,17,3,30
39,425,80,13,67,1,66,4,9,15,6,0,1,0,7,1,23
39,426,228,36,192,6,186,13,23,55,26,1,0,0,32,4,32
39,427,53,4,49,1,48,1,5,14,1,2,0,0,11,3,11
39,428,22,4,18,1,17,2,1,4,0,1,0,0,4,0,5
39,429,324,50,274,6,268,1,85,66,23,2,0,0,22,4,65
39,430,76,11,65,0,65,0,12,19,13,2,0,0,4,1,14
39,431,229,29,200,3,197,3,51,64,18,2,0,0,21,4,34
39,432,80,11,69,4,65,2,14,13,12,0,2,0,9,2,11
39,434,2755,565,2190,58,2132,67,317,550,309,24,15,4,224,37,585
39,435,479,61,418,8,410,6,95,117,56,4,8,1,28,9,86
39,436,135,21,114,0,114,0,13,35,7,0,0,0,25,3,31
39,437,177,22,155,7,148,8,29,47,15,0,1,0,12,2,34
39,438,69,7,62,3,59,1,9,21,5,0,0,0,4,6,13
39,439,382,55,327,8,319,11,53,95,57,7,2,0,28,7,59
39,440,322,49,273,6,267,12,37,40,59,4,2,1,27,4,81
39,441,748,127,621,18,603,30,102,191,76,12,1,5,63,16,107
39,442,221,19,202,5,197,5,32,33,42,4,0,0,33,5,43
39,443,97,17,80,4,76,1,22,29,8,1,1,0,3,1,10
39,444,52,4,48,0,48,1,8,11,8,1,0,0,8,0,11
39,445,239,31,208,12,196,5,25,45,39,2,3,0,29,12,36
39,446,193,20,173,4,169,4,25,43,12,0,0,0,18,4,63
39,447,188,16,172,4,168,1,33,29,36,1,1,1,18,6,42
39,448,442,63,379,3,376,8,86,92,41,1,4,1,33,7,103
39,449,173,19,154,2,152,2,28,30,18,1,4,2,17,5,45
39,451,302,39,263,5,258,4,68,67,25,3,1,0,17,4,69
39,452,300,43,257,5,252,4,63,61,34,5,1,0,26,3,55
39,453,329,28,301,5,296,8,67,61,40,1,2,0,33,6,78
39,454,76,15,61,0,61,1,16,17,9,1,4,0,4,2,7
39,455,49,6,43,1,42,3,13,5,6,1,0,1,2,2,9
39,456,246,32,214,2,212,2,76,39,18,1,0,1,26,3,46
39,457,33,2,31,0,31,0,7,11,3,0,0,0,6,1,3
39,458,220,35,185,0,185,3,41,40,17,6,0,0,15,4,59
39,460,162,29,133,3,130,0,37,32,15,5,0,2,10,8,21
39,461,81,6,75,2,73,2,14,21,10,0,1,0,12,1,12
39,462,469,66,403,10,393,3,111,83,64,1,3,1,30,7,90
39,463,192,17,175,2,173,9,36,47,14,1,1,0,22,12,31
39,464,162,17,145,3,142,6,26,26,29,4,0,0,6,3,42
39,465,151,24,127,2,125,2,38,25,4,2,0,1,10,3,40
39,466,135,20,115,4,111,2,28,21,22,1,4,0,13,1,19
39,467,143,23,120,6,114,0,22,36,15,1,0,0,9,1,30
39,468,110,22,88,3,85,0,21,16,12,2,0,0,9,3,22
39,469,78,5,73,1,72,3,21,24,7,1,0,0,1,0,15
39,470,2173,424,1749,31,1718,60,305,677,135,16,5,4,181,38,297
39,471,551,77,474,12,462,6,99,113,77,5,3,1,38,13,107
39,472,156,21,135,3,132,3,36,31,18,2,0,0,11,5,26
39,473,87,6,81,1,80,0,10,35,5,2,2,0,12,5,9
39,474,246,27,219,4,215,7,50,48,36,4,0,0,30,4,36
39,475,1596,302,1294,28,1266,39,253,303,159,12,11,3,99,19,368
39,476,1249,140,1109,19,1090,18,268,297,90,7,8,2,73,26,301
39,477,177,21,156,2,154,2,43,28,16,2,4,2,16,8,33
39,478,6112,1379,4733,73,4660,108,894,1056,662,65,23,16,384,89,1363
39,479,174,18,156,3,153,8,19,45,21,1,1,1,20,4,33
39,480,221,23,198,5,193,5,34,40,17,4,1,3,18,5,66
39,481,307,36,271,11,260,2,67,84,23,2,1,2,25,4,50
39,482,405,60,345,9,336,7,80,100,34,3,0,1,36,6,69
39,483,78,10,68,2,66,0,24,17,6,0,0,0,4,0,15
39,484,135,15,120,1,119,5,21,34,13,1,1,2,11,2,29
39,485,306,39,267,8,259,5,56,78,22,2,0,5,26,8,57
39,486,113,15,98,4,94,4,14,22,6,0,1,0,12,4,31
39,487,1198,207,991,26,965,17,148,274,133,18,9,2,105,16,243
39,488,259,36,223,3,220,11,49,58,22,5,3,1,27,5,39
39,489,381,64,317,5,312,20,41,74,42,6,6,1,35,7,80
39,490,218,21,197,6,191,3,56,51,12,4,1,0,29,5,30
39,491,1537,300,1237,28,1209,31,234,267,152,11,6,7,112,32,357
39,492,173,27,146,2,144,16,20,39,18,2,1,2,15,2,29
39,493,202,30,172,9,163,2,20,36,26,2,2,0,36,4,35
39,494,259,40,219,4,215,3,31,85,24,3,1,1,28,5,34
39,495,58,14,44,2,42,0,10,9,2,0,0,0,3,0,18
39,497,93,12,81,3,78,3,17,19,11,0,1,0,4,2,21
39,498,437,61,376,6,370,17,79,96,55,8,1,1,32,10,71
39,499,147,27,120,0,120,6,26,27,10,0,1,2,12,6,30
39,500,1977,461,1516,43,1473,37,255,371,199,36,11,1,119,33,411
39,501,595,72,523,7,516,9,108,105,66,3,3,2,44,13,163
39,502,243,44,199,3,196,0,40,51,33,1,3,0,23,4,41
39,503,252,29,223,8,215,6,29,67,23,5,3,1,17,7,57
39,504,180,21,159,5,154,4,31,45,12,4,4,4,20,1,29
39,505,49,9,40,0,40,5,7,17,3,1,0,0,4,2,1
39,506,105,17,88,1,87,3,23,26,12,1,0,0,8,1,13
39,507,76,5,71,0,71,1,14,27,12,2,1,0,4,3,7
39,508,555,98,457,22,435,8,127,94,39,16,6,0,25,14,106
39,509,38,7,31,0,31,0,7,10,5,0,0,0,4,1,4
39,510,532,100,432,12,420,31,73,88,56,4,4,5,54,10,95
39,511,48,8,40,0,40,0,8,5,13,0,0,0,1,0,13
39,512,45,5,40,0,40,0,13,7,6,0,2,0,2,3,7
39,513,183,17,166,4,162,4,34,44,26,2,0,0,14,4,34
39,514,135,22,113,7,106,4,21,22,23,0,1,0,5,2,28
39,517,414,44,370,8,362,7,89,91,38,3,3,0,29,10,92
39,518,57,8,49,1,48,5,5,9,5,3,1,0,10,2,8
39,519,124,17,107,2,105,3,24,20,10,2,0,1,11,4,30
39,520,385,53,332,7,325,2,76,89,44,13,4,1,27,7,62
39,522,88,7,81,3,78,0,14,21,6,0,0,0,11,1,25
39,523,156,14,142,0,142,7,31,40,5,3,1,0,14,0,41
39,525,264,49,215,11,204,3,55,56,31,3,2,0,13,5,36
39,526,3169,565,2604,49,2555,21,537,672,287,29,17,4,244,51,693
39,527,96,18,78,2,76,0,16,21,10,3,0,0,4,2,20
39,528,302,47,255,5,250,2,54,83,22,4,0,0,20,10,55
39,529,54,8,46,1,45,0,11,24,2,0,1,0,3,4,0
39,530,485,74,411,5,406,7,133,113,41,2,3,2,23,11,71
39,531,165,24,141,5,136,0,27,43,24,0,0,0,18,5,19
39,532,44,4,40,1,39,2,3,14,11,1,1,0,3,0,4
39,533,178,19,159,3,156,1,30,30,18,1,2,0,16,8,50
39,534,175,19,156,2,154,2,26,47,16,2,0,0,21,6,34
39,535,359,46,313,5,308,6,70,83,37,9,2,0,32,7,62
39,537,335,39,296,14,282,3,42,67,35,4,4,0,38,11,78
39,538,48,5,43,0,43,3,6,15,3,0,0,0,9,0,7
39,539,217,22,195,2,193,10,38,62,23,1,2,0,16,6,35
39,540,151,18,133,4,129,4,26,56,7,0,0,0,21,3,12
39,542,63,8,55,0,55,0,14,15,9,1,0,0,4,3,9
39,543,169,17,152,4,148,2,31,51,11,0,0,0,24,3,26
39,544,39,1,38,0,38,1,3,11,1,0,0,0,5,1,16
39,545,137,13,124,1,123,3,17,39,15,0,1,0,17,1,30
39,546,248,34,214,4,210,9,43,46,27,3,0,3,29,5,45
39,547,528,85,443,8,435,17,98,116,36,10,4,6,51,13,84
39,548,74,13,61,0,61,1,4,23,9,2,2,0,3,4,13
39,549,212,31,181,6,175,2,37,44,25,0,3,0,15,3,46
39,550,150,15,135,3,132,2,29,36,20,2,0,0,11,1,31
39,551,111,21,90,0,90,2,31,15,9,2,0,0,10,3,18
39,552,251,32,219,3,216,5,30,44,38,2,3,0,29,6,59
39,553,222,22,200,5,195,2,33,66,19,0,2,1,18,11,43
39,554,166,25,141,8,133,3,19,43,10,3,0,0,16,2,37
39,555,175,26,149,6,143,3,45,31,10,1,3,0,16,3,31
39,556,65,6,59,5,54,3,5,15,5,0,0,1,3,1,21
39,557,195,32,163,7,156,1,32,46,27,1,1,0,15,3,30
39,558,199,27,172,4,168,9,30,40,31,3,2,1,12,4,36
39,559,311,42,269,5,264,13,61,44,42,6,1,0,19,7,71
39,560,487,62,425,10,415,18,77,107,65,3,1,2,34,12,96
39,561,307,51,256,5,251,2,64,73,22,0,0,0,25,3,62
39,562,151,24,127,2,125,4,25,24,25,4,3,0,11,4,25
39,564,118,24,94,2,92,4,16,25,12,1,1,0,9,0,24
39,565,64,6,58,1,57,1,9,14,3,4,0,0,13,6,7
39,566,75,13,62,1,61,0,18,15,6,0,2,1,6,2,11
39,567,226,22,204,6,198,1,26,69,26,3,1,1,22,4,45
39,568,43,10,33,3,30,0,4,13,4,0,1,0,0,0,8
39,569,381,44,337,4,333,6,54,115,33,6,3,0,33,6,77
39,570,176,32,144,4,140,2,23,34,12,3,3,0,15,3,45
39,571,163,20,143,2,141,1,40,29,12,2,1,2,5,7,42
39,572,280,35,245,6,239,8,42,58,40,3,2,4,18,5,59
39,573,584,74,510,13,497,12,137,92,44,6,2,0,36,4,164
39,574,589,86,503,11,492,11,95,146,65,10,3,4,52,5,101
39,575,67,8,59,3,56,0,18,5,9,0,1,0,6,2,15
39,576,302,47,255,7,248,5,45,54,44,2,3,0,19,9,67
39,577,247,25,222,5,217,4,50,46,29,3,4,0,22,6,53
39,579,760,132,628,11,617,13,170,222,30,4,3,0,64,23,88
39,581,205,33,172,1,171,5,41,43,24,6,2,0,12,1,37
39,582,635,85,550,13,537,16,88,175,65,7,2,2,60,15,107
39,583,102,20,82,1,81,0,16,19,15,0,0,0,12,2,17
39,584,124,12,112,2,110,0,25,32,10,1,1,0,13,2,26
39,585,32,7,25,0,25,0,2,8,5,1,0,0,3,1,5
39,586,41,10,31,2,29,0,1,11,3,0,0,0,8,2,4
40,1,4575,742,3833,80,3753,69,505,926,383,65,22,6,458,56,1263
40,2,1174,159,1015,13,1002,8,105,262,96,13,8,5,139,13,353
40,3,213,20,193,6,187,1,26,30,29,8,1,0,19,2,71
40,4,1260,218,1042,16,1026,28,133,300,117,9,2,1,87,19,330
40,5,155,14,141,8,133,0,13,48,12,1,0,0,17,0,42
40,6,597,79,518,20,498,4,76,111,60,6,3,2,39,7,190
40,7,150,16,134,1,133,1,29,22,21,1,0,0,8,1,50
40,8,73,7,66,0,66,1,12,18,13,0,1,1,5,0,15
40,9,151,20,131,2,129,2,10,20,21,1,1,0,10,3,61
40,11,285,35,250,7,243,2,39,57,28,3,1,0,37,7,69
40,12,186,18,168,6,162,1,18,46,16,2,0,0,18,3,58
40,13,96,14,82,5,77,0,12,22,8,3,0,0,12,0,20
40,14,281,31,250,5,245,5,33,37,32,4,1,1,28,10,94
40,15,67,4,63,0,63,1,9,17,11,2,1,0,5,0,17
40,16,217,25,192,9,183,2,14,35,17,3,0,1,13,3,95
40,17,319,46,273,5,268,1,36,57,35,3,5,1,28,2,100
40,18,271,34,237,8,229,2,32,43,28,5,2,0,25,6,86
40,19,710,78,632,11,621,12,99,130,94,6,7,0,55,14,204
40,20,519,71,448,13,435,7,69,96,46,6,2,1,47,8,153
40,21,531,50,481,13,468,16,55,110,59,9,1,1,53,11,153
40,22,298,52,246,11,235,0,35,74,22,3,0,0,40,4,57
40,23,279,46,233,2,231,2,32,50,28,0,0,0,14,4,101
40,24,209,18,191,2,189,7,14,42,35,3,1,0,30,6,51
40,25,709,102,607,13,594,9,103,154,63,13,2,1,53,5,191
40,26,263,17,246,5,241,3,43,61,37,3,0,0,16,2,76
40,27,102,10,92,1,91,1,19,17,8,1,0,0,18,3,24
40,28,226,31,195,4,191,0,18,31,46,1,2,1,17,3,72
40,29,221,28,193,3,190,2,26,46,19,1,2,0,35,3,56
40,30,49,5,44,1,43,1,13,11,6,1,0,0,3,0,8
40,31,887,134,753,21,732,4,120,143,124,12,3,3,65,9,249
40,32,140,22,118,4,114,2,9,42,18,2,2,0,7,1,31
40,33,115,14,101,0,101,1,18,34,7,3,1,0,14,3,20
40,34,451,62,389,7,382,5,63,90,52,17,1,3,49,8,94
40,35,421,57,364,4,360,6,46,84,37,8,2,1,38,2,136
40,36,1910,369,1541,30,1511,32,260,396,166,24,12,4,155,23,439
40,37,1245,216,1029,29,1000,15,121,315,84,11,10,1,135,17,291
40,38,91,8,83,1,82,1,6,15,11,0,1,0,10,1,37
40,39,109,14,95,3,92,0,7,23,10,2,0,0,10,2,38
40,40,288,48,240,5,235,4,46,51,32,3,1,0,27,11,60
40,41,93,16,77,2,75,2,10,15,9,1,0,0,12,3,23
40,42,206,25,181,4,177,4,22,18,39,0,0,1,9,1,83
40,43,487,58,429,11,418,8,60,77,53,16,2,2,42,6,152
40,44,637,80,557,9,548,10,72,94,125,9,2,1,66,11,158
40,46,10873,2204,8669,140,8529,181,1556,2643,762,133,37,14,958,157,2088
40,47,238,23,215,2,213,4,16,32,26,3,1,1,36,7,87
40,48,244,21,223,10,213,1,45,41,34,7,0,1,20,5,59
40,49,279,29,250,1,249,6,46,57,27,4,1,0,18,3,87
40,50,136,20,116,0,116,6,10,29,22,2,2,1,8,0,36
40,51,542,63,479,8,471,10,69,101,71,6,2,2,41,11,158
40,52,172,9,163,5,158,4,13,56,22,4,0,0,19,2,38
40,53,279,45,234,5,229,7,46,58,32,1,1,0,24,5,55
40,54,241,23,218,6,212,2,12,43,34,2,2,0,28,4,85
40,55,935,115,820,11,809,14,128,193,87,14,0,3,97,13,260
40,56,619,72,547,13,534,6,76,137,58,10,4,5,60,8,170
40,57,217,36,181,4,177,1,38,39,21,3,3,1,8,3,60
40,58,199,37,162,2,160,3,24,36,26,2,1,0,14,3,51
40,59,515,70,445,7,438,21,63,97,56,7,3,2,46,7,136
40,60,148,26,122,2,120,3,29,27,18,3,2,0,8,4,26
40,61,748,97,651,19,632,7,90,143,67,8,3,0,77,5,232
40,62,244,34,210,10,200,2,43,56,23,0,0,2,18,2,54
40,63,603,100,503,13,490,12,60,131,46,4,1,3,50,3,180
40,64,141,30,111,2,109,2,24,11,10,2,1,0,10,6,43
40,65,6965,1418,5547,85,5462,166,661,1752,614,53,18,11,539,77,1571
40,66,419,55,364,10,354,4,53,52,58,7,0,0,28,10,142
40,67,542,71,471,13,458,3,58,62,118,9,4,1,42,11,150
40,68,389,57,332,5,327,2,38,54,33,7,1,1,47,7,137
40,69,279,52,227,2,225,4,30,38,27,3,2,2,32,5,82
40,70,322,30,292,5,287,8,23,83,32,6,3,0,33,4,95
40,71,457,61,396,10,386,11,46,72,62,3,3,0,39,4,146
40,72,166,25,141,3,138,3,17,47,8,1,0,0,18,1,43
40,73,104,13,91,3,88,0,10,12,14,5,3,0,18,0,26
40,74,377,50,327,13,314,5,33,60,53,4,1,0,41,5,112
40,75,1528,279,1249,28,1221,18,169,285,166,23,11,2,132,31,384
40,76,312,41,271,11,260,2,53,38,39,4,0,0,30,6,88
40,77,521,59,462,5,457,11,52,75,47,5,2,0,42,7,216
40,78,334,41,293,11,282,3,21,62,48,3,2,1,18,3,121
40,79,122,10,112,4,108,0,17,41,11,1,1,1,17,2,17
40,80,791,136,655,13,642,9,132,174,60,10,3,0,69,8,177
40,81,299,34,265,7,258,4,58,62,47,2,1,1,24,5,54
40,82,184,23,161,3,158,2,24,46,16,2,0,1,19,3,45
40,83,113,13,100,2,98,0,10,29,0,1,0,0,9,0,49
40,84,608,69,539,16,523,2,85,147,59,7,2,0,61,9,151
40,85,352,58,294,4,290,2,29,50,57,8,0,0,25,5,114
40,86,329,53,276,7,269,4,29,54,28,4,2,1,29,3,115
40,87,271,38,233,7,226,4,43,38,24,7,5,1,30,6,68
40,88,14314,3072,11242,216,11026,183,1432,3428,1141,145,46,18,1154,140,3339
40,89,688,87,601,11,590,5,58,136,46,10,2,2,76,15,240
40,90,357,35,322,4,318,6,33,91,30,5,6,0,26,3,118
40,91,533,70,463,10,453,4,58,92,59,2,3,1,45,10,179
40,92,195,25,170,1,169,1,21,37,13,1,3,0,13,3,77
40,93,224,32,192,4,188,3,32,39,18,1,1,0,19,6,69
40,94,472,63,409,2,407,6,51,90,57,3,2,2,37,9,150
40,95,481,58,423,5,418,11,46,83,83,8,4,0,51,5,127
40,96,74,20,54,0,54,0,8,22,2,2,2,0,5,1,12
40,97,384,55,329,2,327,9,37,117,14,2,1,2,31,2,112
40,98,315,37,278,1,277,2,27,63,33,3,0,0,44,4,101
40,99,253,28,225,9,216,3,27,42,20,4,0,0,14,2,104
40,100,305,48,257,6,251,6,36,42,26,2,1,1,34,1,102
40,101,363,34,329,11,318,5,43,72,55,10,4,1,24,1,103
40,102,949,129,820,19,801,13,154,227,58,5,10,3,59,20,252
40,103,447,63,384,9,375,5,59,58,50,5,0,0,29,9,160
40,104,825,107,718,16,702,10,93,141,110,11,3,2,68,10,254
40,105,286,32,254,2,252,7,43,51,30,3,0,0,26,6,86
40,106,159,12,147,3,144,3,11,37,27,4,0,0,8,1,53
40,107,266,27,239,4,235,3,25,45,48,6,1,0,26,2,79
40,108,503,70,433,10,423,6,91,101,58,4,2,4,48,11,98
40,109,372,39,333,8,325,3,40,72,39,8,3,0,39,10,111
40,110,522,105,417,8,409,12,46,118,47,10,6,2,35,9,124
40,111,574,93,481,14,467,5,80,97,60,14,2,2,40,10,157
40,112,88,5,83,0,83,1,12,21,3,0,0,1,9,0,36
40,113,436,59,377,9,368,4,63,61,50,5,2,1,51,4,127
40,114,286,18,268,7,261,8,23,76,32,6,3,0,33,2,78
40,115,193,19,174,0,174,1,23,36,23,5,0,0,18,5,63
40,116,216,14,202,3,199,4,30,43,30,4,1,0,10,8,69
40,117,1934,365,1569,35,1534,18,239,463,103,29,9,3,190,22,458
40,118,1119,147,972,21,951,15,117,210,175,6,6,0,114,13,295
40,119,3664,480,3184,68,3116,28,371,768,280,44,15,5,354,63,1188
40,120,434,48,386,4,382,13,40,99,44,3,1,0,61,7,114
40,121,188,15,173,4,169,1,16,34,62,3,0,0,9,1,43
40,122,730,103,627,7,620,3,104,130,75,8,4,0,64,9,223
40,123,834,89,745,21,724,15,113,176,83,12,5,0,78,15,227
40,124,105,13,92,4,88,1,17,25,13,0,3,0,7,3,19
40,125,1053,131,922,17,905,16,96,193,121,12,4,1,102,7,353
40,126,1299,172,1127,14,1113,16,197,278,153,14,6,2,104,22,321
40,127,478,58,420,15,405,9,74,96,43,5,1,1,45,7,124
40,128,544,57,487,4,483,6,57,101,40,4,2,1,50,10,212
40,129,615,98,517,16,501,10,87,103,76,7,3,1,57,12,145
40,130,112,12,100,4,96,1,12,18,7,0,2,0,17,1,38
40,131,558,105,453,7,446,9,69,145,43,6,1,0,43,2,128
40,132,992,154,838,17,821,12,126,156,137,12,7,4,84,14,269
40,133,3489,495,2994,59,2935,79,452,710,383,40,13,11,304,33,910
40,134,1834,341,1493,25,1468,17,264,312,183,29,16,3,110,18,516
40,135,583,111,472,8,464,6,72,118,65,11,1,1,45,12,133
40,136,115,13,102,4,98,0,10,26,11,0,2,0,14,4,31
40,137,195,18,177,2,175,2,35,34,28,4,0,0,14,4,54
40,138,201,31,170,3,167,0,16,44,10,4,1,0,20,2,70
40,139,454,53,401,10,391,3,54,105,33,7,2,1,47,5,134
40,140,167,26,141,3,138,1,26,26,21,2,2,0,15,8,37
40,141,239,29,210,3,207,5,38,37,31,4,2,0,16,1,73
40,142,651,107,544,14,530,8,75,111,87,14,4,1,52,5,173
40,143,254,35,219,4,215,2,36,40,31,4,0,1,17,10,74
40,144,205,19,186,4,182,0,14,29,21,1,0,0,13,1,103
40,145,488,72,416,10,406,4,80,124,36,5,4,1,45,10,97
40,146,144,17,127,3,124,0,22,45,3,2,0,0,22,2,28
40,147,293,30,263,1,262,8,32,38,42,3,1,0,23,4,111
40,148,66,8,58,3,55,2,14,21,1,1,0,0,6,2,8
40,149,344,38,306,5,301,7,55,60,49,3,1,0,29,3,94
40,150,1588,207,1381,24,1357,28,161,373,181,30,5,3,102,26,448
40,151,267,21,246,6,240,9,54,41,29,2,0,1,17,4,83
40,152,810,112,698,17,681,10,116,99,99,7,7,3,56,14,270
40,153,193,25,168,1,167,1,33,43,16,2,1,1,16,2,52
40,154,255,29,226,4,222,5,22,73,15,1,0,0,18,6,82
40,155,1004,103,901,18,883,21,91,205,87,16,1,2,79,21,360
40,156,342,64,278,8,270,5,55,59,29,8,3,0,11,8,92
40,157,1380,185,1195,36,1159,19,135,369,110,24,10,5,103,27,357
40,158,209,18,191,4,187,6,18,46,38,2,0,0,21,5,51
40,159,221,27,194,2,192,4,26,31,27,3,1,0,22,3,75
40,160,167,28,139,4,135,2,11,18,35,1,0,0,9,3,56
40,161,88,15,73,3,70,0,12,21,5,1,0,1,4,3,23
40,162,375,47,328,2,326,9,87,57,30,1,4,0,24,11,103
40,163,394,58,336,10,326,11,61,75,37,3,2,0,30,6,101
40,164,272,30,242,4,238,4,56,58,42,5,0,2,17,1,53
40,165,266,33,233,3,230,10,32,40,35,4,2,0,15,5,87
40,166,74,7,67,4,63,4,16,12,12,0,2,0,5,0,12
40,167,504,71,433,12,421,3,45,93,49,11,1,0,39,4,176
40,168,1382,171,1211,22,1189,22,129,272,120,24,7,3,122,22,468
40,169,100,15,85,1,84,3,9,19,17,2,2,0,10,0,22
40,170,180,7,173,2,171,1,17,42,32,2,0,2,6,0,69
40,171,104,15,89,2,87,0,11,18,11,0,2,0,9,1,35
40,172,239,37,202,2,200,1,31,62,10,3,1,0,40,1,51
40,173,104,14,90,1,89,1,17,7,8,1,0,0,18,2,35
40,174,64,9,55,2,53,0,13,14,2,0,1,0,8,5,10
40,175,348,46,302,7,295,2,44,90,34,2,2,0,26,2,93
40,176,78,8,70,1,69,1,5,12,16,2,0,0,9,3,21
40,177,278,35,243,8,235,4,14,64,16,3,1,0,38,6,89
40,178,586,90,496,5,491,12,64,116,58,9,0,1,82,12,137
40,179,1374,183,1191,21,1170,17,157,296,128,11,3,3,124,28,403
40,180,861,125,736,13,723,10,134,195,106,12,3,1,65,16,181
40,181,796,119,677,13,664,35,67,158,87,12,1,1,90,5,208
40,182,713,117,596,4,592,13,73,160,79,10,3,0,63,10,181
40,183,825,111,714,6,708,16,97,133,116,8,0,1,76,11,250
40,184,5538,926,4612,114,4498,81,562,1114,505,48,23,11,353,58,1743
40,185,319,48,271,6,265,0,34,100,11,8,1,1,31,7,72
40,186,578,84,494,21,473,3,76,75,131,10,2,1,46,4,125
40,187,783,110,673,5,668,22,52,219,79,7,3,1,73,8,204
40,188,322,28,294,4,290,1,48,82,22,5,1,0,30,6,95
40,189,70,7,63,0,63,3,5,9,4,1,1,0,7,0,33
40,190,304,45,259,2,257,4,41,39,32,3,2,0,31,4,101
40,191,506,45,461,5,456,10,43,105,64,1,4,1,68,9,151
40,192,21703,5151,16552,305,16247,270,2193,4044,1728,203,64,44,1892,272,5537
40,193,55,5,50,1,49,1,4,10,3,2,0,0,7,3,19
40,194,861,140,721,13,708,22,72,161,92,13,6,1,93,6,242
40,195,440,55,385,4,381,2,55,101,34,8,3,1,34,8,135
40,196,473,73,400,6,394,1,62,111,30,8,2,1,42,6,131
40,197,3434,568,2866,74,2792,28,299,454,454,47,17,9,166,33,1285
40,198,138,12,126,4,122,1,13,12,11,1,0,2,30,3,49
40,199,197,23,174,2,172,2,19,27,70,1,1,0,7,2,43
40,200,472,91,381,9,372,7,72,79,39,7,1,0,31,8,128
40,201,1028,134,894,14,880,19,90,155,131,12,3,3,73,10,384
40,202,2276,332,1944,46,1898,33,280,509,218,24,9,4,179,27,615
40,203,270,31,239,3,236,3,21,55,19,2,0,2,24,0,110
40,204,216,18,198,8,190,1,20,22,49,2,0,0,14,1,81
40,205,204,34,170,4,166,2,23,31,28,4,2,0,21,1,54
40,206,255,46,209,3,206,3,25,51,25,4,3,1,19,7,68
40,207,1010,137,873,19,854,19,155,204,98,12,4,6,102,18,236
40,208,283,35,248,7,241,4,27,44,36,7,0,0,23,4,96
40,209,3482,505,2977,49,2928,73,409,635,416,43,15,4,339,35,959
40,210,775,115,660,14,646,6,93,169,90,11,4,1,47,10,215
40,211,499,49,450,14,436,15,66,100,45,7,2,0,40,4,157
40,212,737,105,632,10,622,9,113,119,76,7,4,0,63,9,222
40,213,427,62,365,2,363,7,52,87,48,7,2,0,36,6,118
40,214,388,47,341,13,328,6,46,56,81,6,2,4,31,4,92
40,215,210,18,192,5,187,1,18,30,20,2,0,1,21,2,92
40,216,164,18,146,0,146,1,23,42,10,0,0,0,21,4,45
40,217,4040,626,3414,70,3344,53,571,795,431,53,7,8,321,79,1026
40,218,373,48,325,6,319,3,52,67,42,1,6,2,38,6,102
40,219,81,9,72,1,71,2,14,14,3,1,0,0,13,0,24
40,220,148,28,120,2,118,1,13,30,16,1,2,0,17,3,35
40,221,273,21,252,4,248,12,32,35,78,3,3,0,17,2,66
40,222,541,93,448,12,436,5,63,77,48,6,2,1,55,15,164
40,223,184,26,158,4,154,0,13,25,13,2,1,0,24,1,75
40,224,2531,494,2037,35,2002,37,324,490,247,36,6,3,272,33,554
40,225,181,26,155,4,151,3,17,44,9,1,0,0,23,6,48
40,226,183,29,154,3,151,2,17,37,21,1,1,0,23,2,47
40,227,1096,178,918,15,903,21,117,199,131,21,1,3,68,11,331
40,228,1142,141,1001,22,979,17,134,239,138,20,4,0,109,11,307
40,229,1090,182,908,14,894,23,130,184,108,15,3,2,106,20,303
40,230,1896,281,1615,31,1584,27,199,254,238,44,5,2,179,20,616
40,231,645,79,566,7,559,5,70,156,81,3,5,0,61,5,173
40,232,179,22,157,5,152,2,26,34,20,3,1,0,17,3,46
40,233,2370,363,2007,37,1970,19,258,516,299,25,9,6,234,30,574
40,234,620,99,521,11,510,19,74,129,43,5,2,1,45,15,177
40,235,464,67,397,11,386,3,52,59,70,7,1,0,15,7,172
40,236,644,84,560,7,553,9,70,116,51,7,1,4,57,7,231
40,237,524,101,423,6,417,12,60,57,55,9,3,0,44,1,176
40,238,489,71,418,9,409,4,91,111,42,2,1,1,29,3,125
40,239,90,9,81,0,81,0,12,31,6,1,0,0,14,0,17
40,240,425,76,349,8,341,0,49,78,29,10,5,2,42,4,122
40,242,71,4,67,2,65,1,12,17,1,2,0,1,2,0,29
40,243,1867,272,1595,36,1559,24,201,310,214,29,8,4,105,22,642
40,244,848,111,737,14,723,7,97,134,123,9,2,1,71,12,267
40,245,1451,242,1209,25,1184,11,181,278,135,22,7,1,107,13,429
40,246,863,129,734,8,726,11,77,117,139,14,1,1,41,18,307
40,247,161,22,139,1,138,0,24,51,12,0,0,1,15,6,29
40,248,1180,165,1015,15,1000,19,142,230,159,27,2,2,83,13,323
40,249,427,44,383,7,376,5,30,29,47,6,2,1,33,1,222
40,250,449,56,393,5,388,4,77,104,44,10,4,0,39,10,96
40,251,257,32,225,4,221,5,35,55,40,1,0,1,22,2,60
40,252,514,65,449,10,439,9,73,95,46,5,2,0,55,8,146
40,253,471,58,413,7,406,5,44,77,43,1,2,1,50,6,177
40,254,291,44,247,3,244,6,50,48,16,3,1,0,28,5,87
40,255,335,43,292,6,286,2,53,94,24,4,0,1,28,5,75
40,256,498,56,442,5,437,6,53,102,69,9,6,0,59,3,130
40,257,918,136,782,18,764,7,141,151,128,11,9,3,72,17,225
40,258,187,23,164,2,162,1,27,41,14,4,1,0,18,4,52
40,259,334,57,277,14,263,5,38,82,19,4,2,0,37,6,70
40,260,270,22,248,3,245,2,64,28,25,8,0,1,19,4,94
40,261,1705,278,1427,41,1386,22,215,318,173,18,2,3,131,29,475
40,262,255,30,225,4,221,3,19,55,37,4,2,2,17,4,78
40,263,289,31,258,4,254,6,33,34,42,2,3,0,26,1,107
40,264,995,150,845,20,825,18,113,182,148,7,4,1,77,15,260
40,265,105,10,95,1,94,1,16,28,9,1,1,1,3,0,34
40,266,1216,138,1078,23,1055,21,153,234,138,23,5,1,82,11,387
40,267,816,135,681,12,669,3,129,177,86,3,4,5,77,12,173
40,268,426,53,373,8,365,10,51,87,37,5,2,0,47,8,118
40,269,901,124,777,16,761,19,94,184,116,4,5,0,76,8,255
40,270,356,50,306,4,302,2,40,125,14,3,1,2,45,4,66
40,271,796,116,680,17,663,16,89,126,102,11,5,4,74,17,219
40,272,926,108,818,19,799,7,99,177,132,7,4,2,80,16,275
40,273,3746,591,3155,53,3102,68,441,693,410,47,8,2,379,29,1025
40,274,925,142,783,26,757,16,158,178,81,8,3,1,103,8,201
40,275,473,52,421,11,410,5,52,115,38,5,0,0,64,8,123
40,276,245,33,212,1,211,5,27,56,39,0,0,0,27,3,54
40,277,572,74,498,7,491,6,61,143,31,5,1,1,74,10,159
40,278,668,81,587,8,579,4,91,115,93,4,4,1,50,9,208
40,279,8941,1449,7492,130,7362,114,1037,1711,936,132,33,12,658,132,2597
40,280,1171,207,964,27,937,17,156,208,133,9,1,2,104,19,288
40,281,6691,1247,5444,92,5352,106,755,1369,601,86,22,12,613,75,1713
40,282,3737,621,3116,50,3066,45,400,858,288,40,9,5,353,54,1014
40,283,2116,294,1822,39,1783,34,249,399,245,26,7,4,185,23,611
40,284,5482,844,4638,86,4552,81,690,1079,598,67,26,7,458,81,1465
40,285,484,69,415,13,402,1,57,72,88,1,1,0,40,5,137
40,286,868,139,729,22,707,10,102,194,50,4,2,5,102,7,231
40,287,2800,489,2311,39,2272,54,481,660,206,28,8,4,222,71,538
40,288,831,99,732,15,717,11,123,134,86,9,6,0,61,10,277
40,289,156,17,139,3,136,0,20,28,13,0,1,0,26,4,44
40,290,88,17,71,2,69,0,16,12,4,3,0,1,11,0,22
40,291,1067,161,906,19,887,26,137,253,103,13,0,3,97,16,239
40,292,1033,132,901,15,886,12,91,218,146,19,8,1,104,10,277
40,293,639,89,550,8,542,13,74,128,70,6,3,2,55,11,180
40,294,1207,116,1091,17,1074,17,141,300,142,16,2,2,112,12,330
40,295,619,95,524,7,517,8,101,125,47,13,7,1,46,9,160
40,296,2773,499,2274,37,2237,118,268,759,198,37,7,4,239,34,573
40,297,169,28,141,5,136,1,21,21,34,6,1,2,14,1,35
40,298,316,26,290,10,280,9,30,87,28,4,0,1,31,4,86
40,299,163,18,145,2,143,2,10,20,12,6,1,0,19,1,72
40,300,639,101,538,10,528,5,82,101,69,11,1,2,54,10,193
40,301,84,14,70,3,67,3,3,8,11,3,1,0,6,1,31
40,302,150,22,128,0,128,0,16,26,19,1,1,0,11,1,53
40,303,232,37,195,1,194,0,39,53,33,6,0,0,10,3,50
40,304,3597,621,2976,41,2935,106,250,1362,202,24,5,4,316,57,609
40,305,133,21,112,3,109,1,17,31,10,0,1,0,16,2,31
40,306,515,63,452,7,445,9,54,69,70,12,1,3,76,7,144
40,307,744,87,657,18,639,11,74,148,97,11,7,1,74,12,204
40,308,698,107,591,12,579,15,80,129,91,9,2,1,80,10,162
40,309,857,122,735,12,723,2,63,113,188,16,4,1,66,10,260
40,310,5914,966,4948,103,4845,126,559,1236,689,68,19,15,473,85,1575
40,311,401,40,361,12,349,1,53,88,46,6,1,1,26,7,120
40,312,9546,1688,7858,147,7711,194,1026,1346,1710,120,46,15,747,102,2405
40,313,2342,413,1929,23,1906,23,268,420,241,20,6,0,173,36,719
40,314,905,127,778,18,760,17,111,218,94,13,6,5,91,10,195
40,315,529,75,454,10,444,6,57,94,59,7,1,0,40,9,171
40,316,611,74,537,6,531,17,90,111,77,4,2,0,62,5,163
40,317,1926,314,1612,34,1578,39,192,487,166,20,4,5,168,33,464
40,318,224,24,200,7,193,3,27,34,27,1,1,0,29,2,69
40,319,232,33,199,2,197,4,42,43,21,2,0,0,23,4,58
40,320,435,59,376,9,367,8,61,97,43,4,3,0,46,8,97
40,321,211,28,183,2,181,0,23,61,19,1,1,0,21,6,49
40,322,126,14,112,2,110,4,18,23,17,2,0,1,6,2,37
40,323,189,21,168,3,165,5,26,38,13,4,0,0,21,3,55
40,324,199,24,175,3,172,1,25,21,33,5,2,2,21,6,56
40,325,248,37,211,5,206,0,25,52,20,3,0,0,23,5,78
40,326,1060,130,930,21,909,16,126,198,115,17,3,1,86,15,332
40,327,201,31,170,1,169,4,33,32,20,3,0,0,14,0,63
40,328,1504,233,1271,21,1250,34,168,374,157,19,7,2,117,22,350
40,329,384,49,335,8,327,3,60,87,42,3,1,1,37,5,88
40,330,222,25,197,2,195,6,22,45,35,4,0,2,17,6,58
40,331,1775,351,1424,24,1400,20,241,338,159,18,6,2,110,28,478
40,332,1480,256,1224,15,1209,15,241,321,129,12,5,0,113,26,347
40,333,982,148,834,25,809,10,133,169,106,18,4,0,80,10,279
40,334,336,54,282,7,275,2,36,64,22,4,1,0,34,4,108
41,1,142,20,122,4,118,5,22,46,10,1,0,0,18,2,14
41,2,674,118,556,11,545,4,148,158,51,15,7,0,51,12,99
41,3,457,51,406,10,396,11,62,104,44,3,7,2,41,7,115
41,4,222,18,204,9,195,4,49,72,17,0,0,0,17,8,28
41,5,97,15,82,2,80,3,15,45,5,2,0,0,4,2,4
41,6,313,44,269,4,265,1,72,54,24,6,3,0,37,6,62
41,7,519,89,430,11,419,9,110,122,40,9,1,2,33,12,81
41,8,501,60,441,8,433,6,97,139,37,7,2,1,31,18,95
41,9,541,77,464,7,457,3,100,142,41,9,4,1,35,6,116
41,10,736,80,656,13,643,22,137,134,84,7,8,1,66,11,173
41,11,35,9,26,0,26,0,2,10,6,1,0,0,1,1,5
41,12,214,31,183,1,182,3,51,47,20,2,2,1,22,1,33
41,13,238,29,209,5,204,3,52,67,10,5,1,0,19,7,40
41,14,142,23,119,3,116,2,25,31,9,2,1,1,7,4,34
41,15,53,10,43,1,42,1,4,20,1,0,0,0,4,2,10
41,16,699,124,575,14,561,8,180,146,37,7,7,0,52,12,112
41,17,523,57,466,9,457,4,106,179,25,4,1,1,55,8,74
41,18,29152,7370,21782,317,21465,575,3371,5257,2372,239,111,50,2137,342,7011
41,19,79,12,67,2,65,2,16,27,3,1,0,1,3,1,11
41,20,418,60,358,8,350,4,93,64,41,6,6,0,37,7,92
41,22,155,26,129,3,126,0,42,39,6,3,0,0,18,2,16
41,23,525,100,425,7,418,7,81,148,36,6,3,2,31,7,97
41,24,191,31,160,2,158,5,22,40,22,0,2,1,13,7,46
41,25,960,156,804,17,787,17,175,241,64,6,5,4,76,15,184
41,26,127,18,109,5,104,1,30,42,5,3,1,0,10,2,10
41,27,99,7,92,0,92,3,17,28,6,3,1,0,10,7,17
41,28,297,27,270,6,264,9,63,62,26,2,6,3,32,7,54
41,29,1085,152,933,30,903,18,211,222,99,10,7,1,77,21,237
41,30,213,26,187,5,182,0,42,44,32,0,1,0,8,7,48
41,31,1858,210,1648,43,1605,32,292,509,146,23,13,6,182,31,371
41,32,1745,208,1537,32,1505,35,307,376,159,16,9,4,155,34,410
41,33,665,98,567,9,558,21,105,142,67,4,5,3,59,7,145
41,34,118,6,112,2,110,0,36,28,6,0,0,1,10,3,26
41,35,458,63,395,10,385,8,74,114,39,3,2,1,46,11,87
41,36,355,39,316,9,307,3,70,105,32,2,2,1,28,9,55
41,37,136,31,105,0,105,2,28,26,10,0,1,0,17,2,19
41,38,324,51,273,2,271,1,72,83,24,3,5,0,18,5,60
41,39,509,77,432,10,422,5,82,122,41,3,1,0,60,17,91
41,40,540,62,478,6,472,5,96,131,35,7,5,2,55,9,127
41,41,157,14,143,5,138,1,33,54,10,1,2,0,13,2,22
41,42,430,64,366,5,361,8,90,96,32,9,2,3,33,6,82
41,43,1243,130,1113,20,1093,14,292,258,133,19,6,1,75,18,277
41,44,844,152,692,10,682,7,184,156,101,9,3,0,39,12,171
41,45,821,132,689,10,679,9,160,174,64,6,4,1,79,14,168
41,46,884,148,736,16,720,13,164,254,62,20,2,2,60,20,123
41,47,3290,504,2786,33,2753,84,378,854,248,21,12,7,378,53,718
41,48,182,24,158,4,154,2,45,52,16,2,0,0,10,4,23
41,49,766,149,617,15,602,8,148,221,55,8,2,5,62,15,78
41,50,765,102,663,9,654,12,137,238,56,3,5,1,59,6,137
41,51,807,125,682,9,673,21,115,186,84,10,6,3,53,13,182
41,52,787,111,676,7,669,18,128,198,65,13,4,3,88,13,139
41,53,439,66,373,1,372,5,81,145,28,10,8,1,37,12,45
41,54,226,30,196,3,193,7,60,51,31,1,2,1,11,2,27
41,55,1574,235,1339,26,1313,33,234,304,161,20,11,7,142,27,374
41,56,145,26,119,3,116,1,31,38,11,1,1,0,9,1,23
41,57,140,25,115,3,112,2,18,38,8,2,1,1,25,3,14
41,58,121,19,102,2,100,0,22,28,10,2,0,0,9,2,27
41,59,2581,526,2055,56,1999,22,425,596,205,26,11,3,173,39,499
41,60,498,64,434,18,416,1,88,139,19,6,4,1,33,13,112
41,61,1013,129,884,15,869,20,208,214,94,10,6,0,75,13,229
41,62,441,85,356,5,351,9,57,114,43,3,3,1,48,11,62
41,63,469,74,395,7,388,4,83,99,39,5,2,1,51,16,88
41,64,259,35,224,3,221,6,68,62,20,4,0,1,23,1,36
41,65,410,50,360,9,351,10,69,96,33,10,7,0,37,10,79
41,66,342,55,287,9,278,6,65,69,42,5,3,0,31,5,52
41,67,2095,302,1793,27,1766,25,318,624,120,17,11,3,212,48,388
41,68,361,66,295,5,290,5,74,109,11,3,0,2,17,7,62
41,69,279,47,232,3,229,2,42,65,15,3,4,1,22,3,72
41,70,362,54,308,3,305,4,71,101,28,4,2,1,28,6,60
41,71,378,44,334,2,332,8,67,97,46,2,4,3,33,3,69
41,72,330,60,270,8,262,4,34,70,32,8,1,0,38,5,70
41,73,511,82,429,10,419,9,103,116,46,4,4,2,34,6,95
41,74,963,138,825,25,800,14,214,250,64,13,7,2,60,15,161
41,75,740,104,636,27,609,7,159,190,43,4,7,0,62,14,123
41,77,98,20,78,1,77,0,20,14,15,2,0,0,7,1,18
41,78,495,73,422,12,410,7,107,113,37,7,5,2,45,9,78
41,79,86,3,83,1,82,3,24,32,7,0,1,0,5,2,8
41,80,990,142,848,16,832,12,153,255,93,14,2,0,89,23,191
41,81,188,28,160,2,158,1,44,46,15,3,0,0,14,2,33
41,82,477,49,428,8,420,11,108,105,38,6,2,0,48,12,90
41,83,440,65,375,9,366,7,89,121,34,4,1,0,28,8,74
41,84,814,111,703,22,681,4,155,206,57,11,7,4,49,14,174
41,85,830,110,720,6,714,8,142,252,91,6,9,0,58,19,129
41,86,459,83,376,6,370,4,85,109,33,3,6,2,37,10,81
41,87,325,43,282,6,276,3,77,62,30,4,5,0,28,9,58
41,88,175,19,156,1,155,1,40,62,8,4,1,0,5,3,31
41,89,173,24,149,1,148,4,40,44,18,1,3,0,15,6,17
41,90,207,31,176,4,172,2,42,47,25,2,0,1,18,8,27
41,91,878,96,782,10,772,7,158,199,59,18,6,0,92,19,214
41,92,591,71,520,10,510,9,106,152,38,4,8,3,43,17,130
41,93,211,26,185,1,184,2,51,53,20,3,5,0,18,4,28
41,94,869,112,757,18,739,13,153,216,78,14,5,0,78,30,152
41,95,835,183,652,10,642,6,150,174,76,11,4,3,37,12,169
41,96,265,47,218,6,212,3,57,69,13,0,3,0,21,9,37
41,97,1408,228,1180,26,1154,13,307,341,123,12,8,5,81,27,237
41,98,150,19,131,7,124,1,37,26,13,6,1,1,17,2,20
41,99,402,55,347,9,338,3,85,102,36,3,3,1,29,5,71
41,100,163,23,140,2,138,2,37,54,7,2,1,0,16,0,19
41,101,831,139,692,16,676,6,177,171,50,10,10,2,82,18,150
41,102,296,42,254,7,247,4,51,64,33,4,3,0,36,5,47
41,103,309,38,271,8,263,3,75,71,21,3,0,0,31,5,54
41,104,1746,292,1454,14,1440,29,305,350,140,20,4,8,172,48,364
41,105,672,119,553,7,546,14,129,150,46,8,4,0,49,11,135
41,106,3415,669,2746,69,2677,31,487,834,304,45,16,9,211,45,695
41,107,378,47,331,8,323,4,65,94,42,2,0,0,40,11,65
41,108,107,12,95,4,91,1,16,27,8,1,2,1,8,4,23
41,109,522,89,433,14,419,5,88,119,42,9,3,0,37,7,109
41,110,640,86,554,18,536,4,158,136,50,8,3,2,30,6,139
41,112,205,23,182,0,182,3,34,70,17,2,0,0,10,7,39
41,113,221,34,187,3,184,5,37,67,20,3,0,0,19,2,31
41,114,183,27,156,4,152,6,22,48,17,2,1,0,13,2,41
41,115,345,49,296,5,291,3,58,86,36,5,1,0,26,6,70
41,116,164,19,145,2,143,0,38,43,6,1,1,1,24,3,26
41,118,172,22,150,6,144,0,26,55,12,2,1,0,15,6,27
41,119,257,35,222,10,212,4,43,67,22,2,1,1,22,7,43
41,120,1044,154,890,28,862,18,207,232,59,14,12,5,93,27,195
41,121,29,0,29,0,29,1,5,17,1,0,0,0,2,0,3
41,122,193,29,164,2,162,3,33,60,14,3,2,2,14,3,28
41,123,385,56,329,6,323,3,53,78,36,7,2,0,51,7,86
41,124,245,23,222,8,214,4,50,48,17,6,1,1,20,7,60
41,125,674,110,564,9,555,15,102,200,50,6,3,1,47,10,121
41,126,887,167,720,12,708,13,163,200,89,6,3,0,60,13,161
41,127,328,50,278,11,267,2,82,92,18,3,4,0,18,6,42
41,128,537,67,470,6,464,5,83,110,52,6,5,1,66,8,128
41,129,516,73,443,14,429,11,104,96,52,10,0,1,35,9,111
41,130,476,69,407,13,394,7,85,118,19,12,4,2,42,10,95
41,131,725,96,629,18,611,20,125,158,77,14,11,2,63,15,126
41,132,253,38,215,3,212,0,57,56,20,3,6,0,21,8,41
41,133,201,37,164,0,164,0,51,48,11,1,0,0,14,5,34
41,134,506,74,432,13,419,7,72,137,19,3,5,2,71,7,96
41,135,698,128,570,12,558,8,154,146,54,7,3,4,44,12,126
41,136,4038,655,3383,70,3313,50,715,855,319,35,21,13,307,68,930
41,137,435,69,366,2,364,9,65,103,53,10,3,2,18,6,95
41,138,239,17,222,6,216,2,37,62,22,3,3,0,33,4,50
41,139,903,176,727,20,707,6,172,224,53,11,2,0,73,26,140
41,140,581,70,511,10,501,13,132,166,28,4,2,1,48,10,97
41,141,226,41,185,5,180,1,62,38,14,5,0,0,22,3,35
41,142,692,92,600,9,591,24,80,199,63,6,3,0,63,9,144
41,143,1069,176,893,22,871,9,174,323,61,9,11,7,74,16,187
41,144,602,80,522,17,505,11,111,140,55,9,5,0,33,13,128
41,145,557,67,490,3,487,10,120,109,58,7,2,3,51,3,124
41,146,743,131,612,15,597,10,122,173,66,16,2,2,69,11,126
41,147,1273,189,1084,16,1068,17,216,260,116,10,8,4,123,25,289
41,148,1048,164,884,18,866,9,181,256,71,19,5,4,76,24,221
41,149,3262,670,2592,51,2541,36,572,752,239,26,22,7,239,72,576
41,150,2738,369,2369,39,2330,27,396,623,314,37,12,6,261,44,610
41,151,2321,470,1851,38,1813,34,337,616,178,15,6,2,147,30,448
41,152,490,64,426,2,424,5,107,166,12,3,6,1,53,6,65
41,153,115,12,103,3,100,2,21,41,9,2,0,0,6,0,19
41,154,843,130,713,16,697,6,136,254,45,9,8,3,46,17,173
41,155,1038,183,855,16,839,11,184,240,93,17,10,1,55,22,206
41,156,369,30,339,4,335,11,74,101,33,2,0,1,41,4,68
41,157,1003,144,859,18,841,9,229,273,47,12,8,2,64,14,183
41,158,1744,277,1467,29,1438,26,257,393,150,30,12,2,181,31,356
41,159,966,162,804,16,788,7,201,280,64,7,7,3,55,19,145
41,160,286,43,243,2,241,3,72,85,22,1,2,1,7,3,45
41,161,1721,246,1475,44,1431,20,291,510,130,17,12,11,108,31,301
41,163,103,13,90,5,85,0,9,39,2,3,0,0,10,2,20
41,164,2070,387,1683,29,1654,17,390,471,144,17,12,4,123,43,433
41,165,86,12,74,1,73,0,18,24,5,0,0,0,4,0,22
41,166,290,36,254,2,252,5,62,73,21,2,0,0,28,6,55
41,167,2617,400,2217,36,2181,40,486,553,212,33,15,3,238,66,535
41,168,194,31,163,1,162,1,37,28,34,4,0,0,16,4,38
41,169,742,83,659,15,644,7,142,148,58,8,1,2,54,24,200
41,170,683,86,597,11,586,12,131,163,75,5,2,0,48,8,142
41,171,1132,187,945,14,931,10,213,345,45,9,3,0,94,18,194
41,172,177,29,148,4,144,1,47,37,15,6,2,0,9,11,16
41,173,1334,177,1157,23,1134,11,253,374,74,18,8,3,129,29,235
41,174,177,26,151,6,145,4,22,44,7,6,2,0,24,4,32
41,175,839,103,736,11,725,12,164,210,57,17,8,3,69,19,166
41,176,666,100,566,11,555,5,129,225,23,6,5,2,40,14,106
41,177,161,15,146,4,142,2,34,45,11,2,2,0,16,2,28
41,178,65,10,55,1,54,1,15,16,3,1,3,0,7,1,7
41,179,201,25,176,3,173,4,43,73,4,0,0,2,17,4,26
41,180,1200,192,1008,28,980,10,190,340,64,11,10,2,136,23,194
41,181,633,87,546,15,531,14,138,139,40,6,6,1,46,10,131
41,182,194,29,165,1,164,4,38,59,14,1,0,0,14,1,33
41,183,187,25,162,5,157,1,43,47,20,2,2,2,14,0,26
41,184,493,88,405,10,395,5,118,102,40,9,1,0,31,8,81
41,185,1814,270,1544,30,1514,27,400,478,113,14,10,5,106,36,325
41,186,243,33,210,6,204,6,44,57,28,6,2,1,14,5,41
41,187,133,14,119,0,119,0,27,38,12,1,0,1,13,2,25
41,188,84,12,72,0,72,0,22,23,9,0,0,0,10,2,6
41,189,270,35,235,2,233,5,43,65,23,4,0,1,27,7,58
41,190,156,18,138,5,133,2,29,34,31,3,0,1,14,1,18
41,191,65,12,53,0,53,1,11,23,3,0,0,0,4,1,10
41,192,250,59,191,3,188,2,52,29,31,4,2,0,14,3,51
41,193,147,28,119,1,118,3,31,37,7,0,2,0,8,1,29
41,194,12488,2871,9617,221,9396,129,2069,2548,882,109,46,19,752,167,2675
41,195,117,19,98,1,97,2,30,27,5,2,1,0,8,1,21
41,196,71,6,65,3,62,2,8,19,4,2,0,0,10,2,15
41,197,240,24,216,3,213,5,32,65,29,7,1,1,17,6,50
41,198,2147,471,1676,35,1641,32,321,469,156,19,14,3,134,54,439
41,199,822,149,673,11,662,10,122,230,37,10,5,2,73,25,148
41,200,279,24,255,6,249,6,53,67,23,4,3,1,28,1,63
41,201,244,40,204,2,202,4,56,53,23,4,1,0,13,7,41
41,202,104,19,85,1,84,0,11,44,12,0,0,0,9,0,8
41,203,350,29,321,5,316,5,67,84,20,5,2,0,40,9,84
41,204,1292,143,1149,20,1129,19,251,287,112,9,5,0,110,27,309
41,205,180,28,152,1,151,3,39,42,9,2,1,1,19,1,34
41,206,662,83,579,7,572,8,93,209,37,10,3,0,72,12,128
41,207,892,125,767,11,756,6,182,195,84,5,2,4,70,21,187
41,208,100,13,87,2,85,0,17,33,14,1,1,1,7,0,11
41,209,608,80,528,8,520,6,113,133,64,12,3,3,53,9,124
41,210,90,6,84,0,84,1,14,33,3,1,0,0,10,1,21
41,211,1813,232,1581,29,1552,21,309,465,180,29,18,3,155,32,340
41,212,2589,392,2197,48,2149,54,302,583,225,22,11,4,294,49,605
41,213,105,24,81,3,78,0,15,28,7,0,0,0,13,0,15
41,214,540,98,442,9,433,6,135,120,31,4,11,2,24,5,95
41,215,84,11,73,3,70,1,16,22,4,0,0,0,8,1,18
41,216,362,61,301,5,296,4,82,62,26,4,3,2,31,8,74
41,217,584,77,507,14,493,4,120,132,48,6,5,0,37,14,127
41,218,629,109,520,6,514,6,158,121,62,4,1,2,36,15,109
41,219,248,29,219,2,217,5,38,63,23,4,0,1,24,4,55
41,220,3051,453,2598,43,2555,31,576,605,362,36,22,7,221,46,649
41,221,527,77,450,5,445,7,101,121,42,3,2,3,52,10,104
41,222,266,39,227,13,214,0,62,38,27,3,6,2,12,6,58
41,223,583,73,510,7,503,16,89,113,55,7,4,1,58,13,147
41,224,173,27,146,2,144,0,41,55,10,4,0,0,11,1,22
41,225,546,71,475,10,465,7,145,159,32,7,0,2,48,6,59
41,226,2686,395,2291,52,2239,25,389,596,214,32,15,1,218,39,710
41,228,258,39,219,8,211,2,47,52,22,3,3,0,26,10,46
41,229,1176,206,970,15,955,16,253,233,80,17,4,3,96,35,218
41,230,1432,194,1238,19,1219,18,233,281,109,18,9,7,152,25,367
41,231,1029,153,876,13,863,11,197,302,78,16,6,0,60,18,175
41,232,4392,891,3501,60,3441,48,804,879,348,52,21,12,317,81,879
41,233,719,109,610,8,602,5,168,184,69,9,5,2,48,13,99
41,234,212,21,191,2,189,2,23,91,12,6,3,0,17,2,33
41,235,835,106,729,24,705,12,157,219,65,17,10,1,64,23,137
41,236,74,4,70,1,69,1,11,24,2,0,0,1,10,2,18
41,237,716,138,578,10,568,7,123,135,59,10,2,1,61,9,161
41,238,1696,336,1360,38,1322,20,312,379,125,23,19,2,129,25,288
41,239,943,134,809,11,798,12,156,211,97,15,1,1,56,12,237
41,240,84,5,79,1,78,0,26,22,14,0,0,0,5,1,10
41,241,974,146,828,10,818,12,211,243,72,8,5,2,73,22,170
41,242,3167,651,2516,59,2457,46,542,645,254,15,14,5,259,47,630
41,243,587,93,494,20,474,7,114,144,35,6,4,2,47,18,97
41,244,89,8,81,2,79,0,22,22,7,0,0,0,13,3,12
41,245,265,25,240,5,235,2,55,72,17,1,2,1,27,3,55
41,246,381,58,323,6,317,8,52,96,22,4,2,0,36,6,91
41,247,1044,149,895,21,874,18,229,292,61,8,7,6,74,23,156
41,248,458,80,378,13,365,3,81,128,29,4,4,1,28,8,79
41,249,988,153,835,11,824,8,147,284,97,15,6,3,57,21,186
41,250,390,65,325,9,316,2,88,86,31,2,1,0,30,4,72
41,251,403,56,347,4,343,5,61,136,23,4,2,1,31,4,76
41,252,1201,144,1057,23,1034,12,215,237,106,21,9,5,121,17,291
41,253,231,35,196,4,192,2,33,43,29,2,1,0,35,5,42
41,254,165,18,147,4,143,2,39,48,3,1,2,0,21,2,25
41,255,268,41,227,4,223,7,57,66,27,1,0,0,19,4,42
41,256,1063,200,863,15,848,14,190,242,129,13,6,3,58,17,176
41,257,656,99,557,12,545,9,134,148,65,7,5,0,42,13,122
41,258,899,143,756,22,734,15,158,198,72,11,8,2,64,21,185
41,259,664,74,590,17,573,6,98,123,66,15,12,1,56,9,187
41,260,325,67,258,9,249,5,88,77,17,1,2,0,17,5,37
41,261,104,9,95,4,91,0,14,44,2,1,0,0,9,5,16
41,262,756,97,659,23,636,15,161,191,53,5,3,0,74,9,125
41,263,111,12,99,3,96,0,25,24,16,1,1,0,5,1,23
41,264,127,15,112,1,111,0,19,41,5,2,0,0,11,5,28
41,265,297,42,255,2,253,9,39,78,18,0,3,2,31,7,66
41,266,70,11,59,0,59,2,20,13,3,2,0,0,8,1,10
41,267,588,68,520,14,506,14,93,176,56,10,4,3,38,13,99
41,268,148,20,128,3,125,0,37,53,8,1,1,0,10,3,12
41,269,11078,2260,8818,187,8631,159,1369,2442,932,111,64,17,913,172,2452
41,270,371,57,314,8,306,6,72,107,28,3,2,0,37,5,46
41,271,458,53,405,12,393,8,107,138,23,3,1,1,26,11,75
41,272,147,14,133,1,132,0,36,48,9,0,1,0,3,2,33
41,273,445,84,361,11,350,6,88,107,31,4,1,2,25,11,75
41,274,119,18,101,9,92,2,27,24,2,2,1,0,6,3,25
41,275,873,140,733,10,723,13,142,195,69,7,6,1,93,16,181
41,276,1872,329,1543,29,1514,26,296,349,174,20,21,2,169,28,429
41,277,113,9,104,1,103,0,27,49,6,2,0,0,7,5,7
41,278,228,33,195,7,188,3,36,64,25,1,0,1,14,7,37
41,279,355,64,291,2,289,8,76,88,33,5,5,3,18,9,44
41,280,1890,327,1563,27,1536,23,423,386,151,23,21,6,107,29,367
41,281,329,28,301,4,297,5,56,77,38,4,2,0,41,8,66
41,282,323,30,293,9,284,9,51,98,15,1,1,1,23,12,73
41,283,214,20,194,1,193,7,41,30,18,3,1,1,40,5,47
41,284,53,5,48,1,47,0,5,20,7,0,0,1,2,0,12
41,285,327,30,297,5,292,2,73,126,19,3,0,0,20,8,41
41,286,119,22,97,1,96,1,27,29,4,4,0,0,15,3,13
41,287,418,52,366,15,351,0,82,95,34,3,1,0,37,9,90
41,288,614,101,513,11,502,11,115,137,44,4,2,2,62,11,114
41,289,256,35,221,4,217,0,58,74,15,2,0,0,25,9,34
41,290,181,16,165,3,162,6,25,47,13,5,0,2,29,4,31
41,291,232,33,199,6,193,4,32,68,18,2,0,0,16,3,50
41,292,175,32,143,6,137,3,26,44,26,0,0,1,15,4,18
41,293,194,25,169,3,166,3,40,46,8,3,4,1,20,7,34
41,294,993,150,843,14,829,16,156,266,75,8,3,1,95,15,194
41,295,5564,839,4725,83,4642,83,891,1174,448,54,24,15,553,74,1326
41,296,1013,128,885,16,869,13,178,269,101,8,5,4,77,26,188
41,297,485,59,426,3,423,11,78,159,41,3,1,1,38,6,85
42,1,285,21,264,7,257,13,74,35,38,3,2,0,19,3,70
42,2,135,25,110,2,108,0,26,22,16,0,0,0,6,5,33
42,3,1520,286,1234,20,1214,31,263,249,218,16,6,4,104,29,294
42,4,257,39,218,5,213,4,60,59,20,3,1,0,21,4,41
42,5,5820,1061,4759,82,4677,53,1009,1243,426,46,28,12,445,85,1330
42,6,337,49,288,3,285,2,66,74,34,4,1,0,45,10,49
42,7,155,26,129,1,128,1,30,36,13,1,1,0,15,4,27
42,8,99,27,72,0,72,3,14,17,9,1,0,0,10,1,17
42,9,426,71,355,8,347,1,104,75,44,3,2,0,39,5,74
42,10,1137,130,1007,22,985,26,221,313,64,12,7,0,116,35,191
42,11,1978,338,1640,31,1609,18,434,390,157,19,11,2,166,49,363
42,12,543,100,443,13,430,14,54,107,72,3,2,1,56,12,109
42,13,1262,184,1078,22,1056,27,232,271,92,14,6,0,135,26,253
42,14,218,42,176,5,171,5,46,41,17,2,0,1,27,4,28
42,15,1264,232,1032,29,1003,19,192,316,101,16,4,2,122,32,199
42,16,355,57,298,4,294,2,68,78,24,6,4,0,24,13,75
42,17,372,36,336,9,327,18,52,81,47,5,3,0,31,9,81
42,18,295,38,257,8,249,5,58,64,30,3,0,1,24,3,61
42,19,2261,395,1866,45,1821,32,374,389,234,22,20,5,180,31,534
42,20,699,81,618,11,607,9,154,184,49,5,2,1,79,10,114
42,21,880,129,751,24,727,24,174,151,107,13,5,0,68,18,167
42,22,2907,482,2425,28,2397,29,597,541,222,29,9,2,216,52,700
42,23,2326,394,1932,33,1899,39,395,527,206,38,21,1,223,38,411
42,25,152,18,134,2,132,5,22,48,16,1,1,0,17,4,18
42,26,1306,206,1100,18,1082,12,242,241,118,13,7,2,119,27,301
42,27,301,40,261,4,257,11,64,75,19,2,2,0,20,9,55
42,28,310,44,266,4,262,25,34,57,45,5,0,1,27,10,58
42,29,1029,142,887,33,854,16,205,177,88,21,6,1,119,34,187
42,30,369,55,314,9,305,7,47,69,32,1,2,0,48,2,97
42,31,285,27,258,4,254,9,60,78,25,2,0,0,26,6,48
42,32,1197,118,1079,17,1062,26,288,285,68,15,4,3,113,29,231
42,33,536,79,457,7,450,7,85,155,37,7,5,1,46,16,91
42,34,102,17,85,0,85,2,5,25,2,1,2,0,13,5,30
42,35,144,16,128,11,117,1,40,19,12,0,1,0,8,3,33
42,36,358,35,323,3,320,9,81,63,30,4,4,0,52,4,73
42,37,424,42,382,9,373,6,97,96,35,0,2,2,44,10,81
42,38,473,48,425,5,420,4,93,141,35,6,3,2,47,11,78
42,39,451,100,351,2,349,4,44,147,29,2,1,0,49,9,64
42,40,57,12,45,1,44,1,4,5,6,0,0,0,8,0,20
42,41,351,35,316,7,309,6,68,100,30,9,1,0,29,8,58
42,42,767,103,664,12,652,17,147,206,51,14,2,2,66,17,130
42,43,1271,151,1120,28,1092,15,154,368,89,12,4,4,170,26,250
42,44,8090,1610,6480,134,6346,70,1770,1092,827,73,37,16,382,95,1984
42,45,63,13,50,0,50,0,10,5,5,1,0,0,4,0,25
42,46,1261,147,1114,22,1092,26,275,242,101,9,5,7,128,49,250
42,47,265,40,225,4,221,7,43,44,30,3,3,2,23,4,62
42,48,1163,209,954,26,928,18,183,218,126,9,6,5,105,31,227
42,49,414,65,349,8,341,7,90,82,39,2,2,1,23,9,86
42,50,113,14,99,4,95,0,13,37,12,0,2,1,9,0,21
42,51,353,36,317,8,309,4,67,78,39,4,2,1,31,18,65
42,52,2415,463,1952,56,1896,32,298,516,262,25,11,7,197,40,508
42,53,1211,179,1032,10,1022,18,267,262,92,12,7,4,89,36,235
42,54,235,23,212,9,203,4,47,73,18,2,0,3,25,3,28
42,55,95,8,87,1,86,1,22,30,7,0,0,0,10,3,13
42,56,2008,317,1691,32,1659,42,370,428,161,24,11,1,184,45,393
42,58,184,25,159,7,152,7,40,23,17,2,3,0,22,6,32
42,59,3623,529,3094,64,3030,66,681,879,249,29,25,8,324,101,668
42,60,368,54,314,6,308,4,88,63,42,4,0,0,26,6,75
42,61,406,72,334,4,330,7,94,102,36,6,1,0,30,8,46
42,62,782,144,638,16,622,16,134,175,35,7,5,1,107,11,131
42,63,325,61,264,7,257,6,61,92,15,6,1,0,29,5,42
42,64,569,80,489,13,476,19,98,122,44,6,4,3,65,23,92
42,65,1068,120,948,12,936,13,200,286,82,7,3,3,143,16,183
42,66,438,59,379,13,366,8,97,101,33,5,2,2,31,12,75
42,67,249,25,224,5,219,13,64,34,28,6,0,1,28,14,31
42,68,297,25,272,10,262,1,97,68,17,1,2,1,17,8,50
42,69,2219,266,1953,46,1907,27,407,523,187,18,9,8,194,38,496
42,70,612,84,528,16,512,8,156,127,51,8,6,0,57,9,90
42,71,4662,755,3907,78,3829,44,806,1059,346,36,24,13,363,68,1070
42,72,88,18,70,1,69,3,10,6,18,1,0,0,7,2,22
42,73,513,103,410,9,401,10,108,104,48,5,1,1,57,9,58
42,74,794,105,689,20,669,3,151,208,50,10,4,4,95,14,130
42,75,824,104,720,15,705,10,213,157,73,3,3,0,72,21,153
42,76,746,130,616,22,594,8,154,154,48,6,5,0,90,18,111
42,77,212,36,176,5,171,3,48,40,19,2,0,0,13,5,41
42,78,233,47,186,4,182,4,40,44,25,0,0,0,12,3,54
42,79,462,76,386,8,378,9,112,119,22,7,6,0,26,15,62
42,81,1058,125,933,30,903,8,239,252,63,15,10,2,110,28,176
42,82,134,17,117,3,114,0,26,22,8,2,1,0,31,3,21
42,83,386,61,325,5,320,6,55,55,39,7,4,1,33,5,115
42,84,125,21,104,5,99,2,31,11,11,0,0,0,11,3,30
42,85,654,87,567,15,552,18,181,125,52,6,0,1,53,11,105
42,86,407,59,348,7,341,9,69,90,31,3,0,1,46,17,75
42,87,995,107,888,18,870,27,113,266,61,12,5,3,124,20,239
42,88,529,89,440,9,431,6,119,127,32,6,2,0,46,11,82
42,89,509,62,447,8,439,15,56,142,42,5,2,1,72,9,95
42,90,364,44,320,7,313,3,90,98,39,3,1,1,27,10,41
42,91,598,115,483,7,476,9,133,139,45,2,3,0,58,16,71
42,92,2071,264,1807,21,1786,37,292,783,126,12,4,2,159,38,333
42,93,968,86,882,17,865,18,189,238,85,9,8,2,86,19,211
42,94,5539,1134,4405,72,4333,64,913,1348,387,51,22,6,423,77,1042
42,95,11453,2396,9057,164,8893,124,2132,1632,1385,88,54,17,630,141,2690
42,96,473,59,414,8,406,6,85,111,46,3,4,2,68,8,73
42,97,3299,418,2881,50,2831,56,521,1082,202,22,13,7,282,53,593
42,98,475,55,420,13,407,9,99,101,36,6,1,1,57,13,84
42,99,2877,408,2469,49,2420,47,595,451,318,22,14,5,218,49,701
42,100,201,15,186,1,185,6,29,75,24,2,2,0,12,8,27
42,101,134,26,108,1,107,1,32,22,17,4,0,0,11,3,17
42,102,660,40,620,19,601,27,94,225,44,10,4,0,81,17,99
42,103,3026,566,2460,32,2428,20,568,422,282,29,7,3,208,49,840
42,104,591,95,496,16,480,2,129,169,27,4,6,5,45,10,83
42,105,96,7,89,2,87,4,12,30,6,0,0,0,11,5,19
42,106,236,44,192,6,186,2,50,56,18,5,4,0,20,5,26
42,107,277,53,224,4,220,11,53,24,28,3,4,0,22,3,72
42,108,648,94,554,7,547,2,164,157,48,2,3,0,43,17,111
42,109,118,28,90,2,88,1,26,16,10,2,1,0,10,3,19
42,110,2913,584,2329,42,2287,26,615,494,245,24,12,1,179,43,648
42,112,345,59,286,5,281,5,65,74,34,1,0,2,23,10,67
42,113,192,34,158,1,157,5,25,54,17,2,1,0,18,2,33
42,114,102,15,87,2,85,5,13,13,13,3,1,2,9,2,24
42,115,925,123,802,9,793,24,181,215,75,14,8,0,96,24,156
42,116,242,59,183,5,178,5,44,62,9,1,0,1,20,3,33
42,117,81,13,68,1,67,6,14,12,10,0,2,1,7,0,15
42,118,509,79,430,8,422,4,102,113,51,3,1,0,55,11,82
42,119,308,50,258,14,244,2,56,47,37,0,0,1,20,1,80
42,120,1096,121,975,27,948,11,220,270,76,10,4,3,119,22,213
42,121,127,21,106,2,104,3,27,34,9,0,0,0,8,5,18
42,122,1215,136,1079,27,1052,29,196,290,109,5,9,4,148,24,238
42,123,2968,465,2503,42,2461,32,603,459,279,27,18,6,193,73,771
42,124,266,23,243,9,234,9,40,64,28,5,3,1,26,5,53
42,125,132,22,110,3,107,2,22,32,6,1,1,0,19,1,23
42,126,784,94,690,20,670,13,183,159,91,5,0,2,52,12,153
42,127,5655,992,4663,93,4570,50,945,950,627,57,26,12,369,90,1444
42,128,287,39,248,5,243,3,47,70,40,4,1,0,29,10,39
42,129,1201,173,1028,23,1005,21,223,248,128,22,9,2,100,32,220
42,130,332,45,287,6,281,2,82,75,26,2,0,0,33,7,54
42,131,259,53,206,7,199,2,37,55,27,2,2,4,26,6,38
42,132,456,61,395,9,386,9,96,85,45,5,1,0,40,15,90
42,133,452,49,403,8,395,9,122,142,30,4,4,0,32,10,42
42,134,964,142,822,24,798,16,158,190,79,8,8,0,106,43,190
42,135,359,37,322,5,317,5,69,118,18,2,0,1,41,9,54
42,136,576,95,481,7,474,10,95,94,81,13,6,2,49,7,117
42,137,491,71,420,7,413,5,140,73,39,9,1,0,44,6,96
42,138,473,38,435,12,423,23,91,125,39,5,6,4,49,9,72
42,139,974,116,858,14,844,18,150,319,65,8,2,1,148,10,123
42,140,329,53,276,3,273,12,47,69,34,7,3,0,33,5,63
42,141,453,54,399,8,391,8,63,110,44,5,1,3,57,15,85
42,142,264,32,232,3,229,3,61,63,23,3,1,1,29,5,40
42,143,261,32,229,4,225,4,67,60,13,2,0,0,29,8,42
42,145,824,116,708,15,693,14,188,198,50,8,7,2,59,16,151
42,146,76,6,70,1,69,6,9,15,9,0,0,0,8,0,22
42,147,10651,2132,8519,176,8343,192,1526,2114,884,94,61,25,949,197,2301
42,148,394,57,337,9,328,5,69,84,34,3,6,0,37,13,77
42,149,3521,651,2870,60,2810,30,703,909,190,18,14,9,268,66,603
42,150,756,85,671,13,658,12,192,165,71,8,7,1,53,10,139
42,151,288,39,249,4,245,2,64,91,15,3,2,0,19,4,45
42,152,370,74,296,9,287,8,44,91,28,4,1,1,30,12,68
42,153,366,40,326,8,318,6,84,88,37,4,2,1,43,4,49
42,154,350,59,291,10,281,7,51,56,40,4,3,0,36,11,73
42,155,709,104,605,14,591,11,183,158,34,9,7,2,65,22,100
42,156,902,138,764,20,744,12,189,197,64,5,3,0,94,13,167
42,157,555,51,504,12,492,7,129,93,55,4,4,6,58,18,118
42,158,148,23,125,6,119,1,20,27,18,2,1,2,16,4,28
42,159,1380,231,1149,25,1124,32,197,270,126,14,10,2,149,16,308
42,160,139,18,121,4,117,3,33,22,8,0,0,1,20,3,27
42,161,434,52,382,6,376,13,91,125,32,0,2,0,37,9,67
42,162,909,122,787,10,777,11,230,216,62,7,4,0,67,16,164
42,163,872,196,676,12,664,4,174,193,85,5,4,0,42,5,152
42,164,59,6,53,0,53,1,15,9,7,0,0,0,11,1,9
42,165,2248,394,1854,50,1804,52,418,496,180,28,12,4,193,44,377
42,166,413,44,369,3,366,7,80,106,30,5,4,1,35,6,92
42,167,256,27,229,1,228,11,60,44,22,9,4,2,10,10,56
42,168,2670,412,2258,51,2207,95,478,492,263,32,18,6,278,59,486
42,169,1084,146,938,23,915,24,258,197,94,9,8,1,98,32,194
42,170,1592,207,1385,32,1353,18,350,393,119,14,8,6,113,26,306
42,171,218,38,180,4,176,1,34,61,16,0,0,0,27,10,27
42,172,796,84,712,21,691,18,118,206,85,2,3,1,74,8,176
42,173,286,44,242,2,240,3,63,91,22,1,1,0,15,5,39
42,174,744,94,650,7,643,9,179,189,47,2,6,0,68,9,134
42,175,873,123,750,14,736,11,167,225,60,6,15,2,84,26,140
42,176,1411,149,1262,25,1237,12,279,325,123,14,13,2,134,24,311
42,177,1972,391,1581,42,1539,27,363,401,142,28,14,4,131,36,393
42,178,587,84,503,11,492,5,153,163,22,5,4,0,58,15,67
42,179,644,76,568,12,556,8,133,132,43,5,10,4,61,12,148
42,180,705,101,604,9,595,8,148,161,56,8,5,2,50,17,140
42,181,1027,179,848,31,817,11,157,207,83,10,6,7,80,25,231
42,182,2377,341,2036,47,1989,48,397,584,197,16,11,3,217,47,469
42,183,5059,1363,3696,59,3637,40,857,501,711,36,25,11,183,43,1230
42,184,7928,1347,6581,169,6412,137,1215,1687,705,71,41,17,600,137,1802
42,185,393,55,338,1,337,1,78,90,27,2,3,0,40,10,86
42,186,7788,1584,6204,84,6120,81,1325,1074,1016,66,41,16,365,95,2041
42,187,21219,4082,17137,350,16787,318,3169,4440,2047,188,99,40,1398,270,4818
42,188,223,28,195,5,190,1,57,54,9,0,1,1,36,6,25
42,189,7552,1319,6233,114,6119,97,1599,1307,647,79,32,7,488,117,1746
42,191,655,89,566,20,546,18,129,123,72,6,6,3,50,12,127
42,192,351,37,314,5,309,2,84,69,51,2,1,0,27,8,65
42,193,1044,178,866,19,847,16,189,238,100,10,10,1,71,22,190
42,194,186,17,169,7,162,1,24,52,25,2,1,1,9,3,44
42,195,779,117,662,12,650,12,102,103,140,26,10,2,54,12,189
42,196,96,22,74,2,72,1,10,13,11,0,1,0,14,2,20
42,197,772,105,667,17,650,7,179,130,76,7,5,2,69,24,151
42,198,739,94,645,16,629,24,157,152,62,7,9,2,61,19,136
42,199,1547,182,1365,31,1334,15,263,346,151,20,6,4,115,26,388
42,200,1007,141,866,13,853,3,224,232,60,15,4,3,108,16,188
42,201,508,73,435,8,427,20,101,95,55,6,5,1,44,17,83
42,202,542,77,465,16,449,7,80,121,37,3,3,0,55,10,133
42,203,310,58,252,3,249,10,59,41,43,2,2,0,28,8,56
42,204,967,153,814,21,793,17,166,226,108,12,5,3,76,17,163
42,205,618,106,512,15,497,10,135,158,38,1,0,3,63,10,79
42,206,1213,127,1086,18,1068,36,181,488,48,5,2,1,119,19,169
42,207,24003,5635,18368,422,17946,331,4215,3924,1940,159,88,38,1516,282,5453
42,208,1264,90,1174,29,1145,28,283,363,88,13,3,2,151,41,173
42,209,353,45,308,7,301,6,98,86,21,2,4,2,32,10,40
42,210,352,46,306,5,301,16,65,80,34,7,1,1,32,10,55
42,211,1705,296,1409,24,1385,33,347,368,106,21,6,3,155,28,318
42,212,627,62,565,7,558,13,128,129,54,6,3,0,79,14,132
42,213,256,35,221,5,216,6,45,54,21,5,4,3,36,4,38
42,214,636,80,556,9,547,18,151,160,43,6,5,1,52,15,96
42,215,916,124,792,21,771,8,142,195,99,8,3,1,118,16,181
42,216,425,42,383,9,374,8,87,143,21,2,3,0,56,8,46
42,217,368,63,305,8,297,8,48,37,62,8,6,0,38,9,81
42,218,98455,22263,76192,1119,75073,1719,13248,16991,9965,700,416,151,6339,1176,24368
42,219,675,102,573,13,560,6,162,114,52,6,3,0,78,15,124
42,220,386,56,330,9,321,5,88,90,36,5,3,0,18,5,71
42,221,354,47,307,4,303,3,79,97,25,5,3,0,23,15,53
42,222,3906,569,3337,65,3272,68,605,1139,254,26,12,11,363,87,707
42,223,4357,660,3697,61,3636,62,727,972,361,33,16,10,409,63,983
42,224,2057,228,1829,33,1796,52,370,568,156,11,13,5,253,35,333
42,225,2621,293,2328,38,2290,43,513,554,259,35,18,7,234,44,583
42,226,269,33,236,2,234,2,59,64,18,3,0,0,25,9,54
42,227,392,54,338,8,330,2,73,112,24,3,1,0,47,11,57
42,228,1021,132,889,17,872,20,236,183,112,10,5,3,52,21,230
42,229,202,22,180,8,172,4,36,62,13,0,3,0,21,4,29
42,230,1225,249,976,24,952,18,230,255,102,13,9,1,83,32,209
42,231,872,126,746,10,736,6,171,240,62,6,6,4,74,22,145
42,232,420,38,382,4,378,23,72,90,57,4,1,1,30,9,91
42,233,747,111,636,14,622,9,159,160,72,8,5,1,59,18,131
42,234,2795,347,2448,53,2395,55,408,842,159,22,9,4,338,52,506
42,235,271,39,232,5,227,2,48,88,22,1,0,1,25,4,36
42,236,397,55,342,7,335,5,83,95,17,4,3,1,54,5,68
42,237,4626,760,3866,75,3791,69,896,833,479,37,25,15,341,67,1029
42,238,313,44,269,3,266,5,47,82,30,1,3,2,29,0,67
42,239,911,98,813,23,790,11,185,193,90,8,4,1,83,19,196
42,240,597,71,526,10,516,13,107,63,72,7,8,2,70,12,162
42,241,347,81,266,3,263,3,42,92,19,2,1,0,34,7,63
42,242,1337,174,1163,21,1142,29,238,276,127,15,9,3,118,35,292
42,243,239,45,194,7,187,3,33,60,27,3,0,1,15,4,41
42,245,360,76,284,11,273,2,56,61,33,5,7,1,25,4,79
42,246,852,105,747,10,737,27,141,133,140,16,10,3,65,16,186
42,247,294,60,234,6,228,7,70,45,29,4,1,2,36,4,30
42,248,931,163,768,25,743,18,151,241,75,7,7,2,65,17,160
42,249,1198,174,1024,28,996,17,236,274,62,9,7,0,123,24,244
42,251,466,64,402,7,395,6,122,117,36,2,0,0,38,12,62
42,252,246,41,205,7,198,2,37,38,24,4,2,0,23,11,57
42,253,836,105,731,19,712,5,198,207,70,11,3,1,63,18,136
42,254,606,98,508,13,495,7,127,134,52,2,2,0,62,10,99
42,255,218,39,179,7,172,5,31,39,16,0,3,1,22,6,49
42,256,3030,400,2630,55,2575,49,688,624,241,34,17,11,268,56,587
42,257,678,84,594,17,577,7,134,132,77,3,5,0,38,23,158
42,259,2766,397,2369,33,2336,48,464,588,225,21,11,5,300,77,597
42,260,720,127,593,15,578,11,157,164,57,10,6,2,67,19,85
42,261,641,79,562,16,546,6,153,181,25,8,3,1,80,17,72
42,262,1204,148,1056,7,1049,20,303,287,95,5,2,2,101,26,208
42,264,787,100,687,14,673,21,138,164,72,5,3,1,87,10,172
42,265,572,70,502,13,489,14,111,129,51,3,3,2,58,20,98
42,266,510,63,447,9,438,11,108,124,51,4,1,2,54,11,72
42,267,1166,151,1015,23,992,14,170,291,116,14,8,0,98,36,245
42,268,259,29,230,4,226,3,49,55,36,0,0,1,24,3,55
42,269,103,9,94,2,92,1,25,25,15,1,1,0,9,4,11
42,270,990,131,859,12,847,36,166,242,78,8,5,2,86,11,213
42,271,2929,443,2486,42,2444,59,566,523,286,24,21,5,267,53,640
42,272,1179,248,931,14,917,21,199,187,116,19,4,1,93,23,254
42,273,286,48,238,8,230,8,50,74,19,4,3,1,27,7,37
42,274,191,43,148,5,143,4,45,27,15,2,1,0,12,3,34
42,275,4186,595,3591,56,3535,64,640,1100,302,30,16,8,402,62,911
42,276,412,91,321,14,307,7,87,88,27,2,2,0,23,8,63
42,277,278,57,221,6,215,7,50,56,10,6,3,0,26,8,49
42,278,136,16,120,2,118,4,25,19,12,1,3,0,3,0,51
42,279,10574,1745,8829,143,8686,173,1760,2591,803,85,42,23,1016,201,1992
42,280,317,47,270,4,266,8,50,69,23,6,2,0,44,8,56
42,281,128,22,106,1,105,1,32,20,19,0,3,0,7,2,21
42,282,235,32,203,4,199,2,37,52,32,1,3,2,19,3,48
42,283,895,114,781,16,765,17,211,183,53,7,6,2,108,27,151
42,284,1156,123,1033,24,1009,17,195,274,100,18,9,2,100,24,270
42,285,2646,427,2219,37,2182,26,587,451,268,34,11,4,183,65,553
42,286,720,66,654,9,645,21,153,134,89,9,8,4,68,21,138
42,287,857,128,729,18,711,14,154,154,112,15,9,2,97,20,134
42,288,585,100,485,13,472,12,120,80,69,13,4,1,41,9,123
42,289,1227,175,1052,23,1029,23,290,258,91,12,7,2,111,28,207
42,290,476,46,430,9,421,14,89,102,42,6,2,4,57,11,94
42,291,169,32,137,3,134,4,35,34,8,1,3,0,11,2,36
42,293,783,94,689,28,661,18,178,202,70,5,4,2,41,14,127
42,294,774,103,671,15,656,17,122,233,37,5,2,1,78,18,143
42,295,377,45,332,10,322,8,64,100,21,4,7,0,34,6,78
42,296,413,53,360,5,355,3,71,120,17,3,1,2,48,14,76
42,297,479,72,407,13,394,19,69,137,18,6,1,1,61,8,74
42,298,351,33,318,6,312,7,80,119,14,0,0,0,42,4,46
42,299,2517,357,2160,44,2116,29,417,569,217,15,11,5,207,38,608
42,300,496,55,441,11,430,2,121,137,34,3,6,0,38,15,74
42,301,524,75,449,9,440,13,87,75,86,5,2,1,32,9,130
42,302,5802,621,5181,85,5096,103,1091,1479,449,46,18,12,529,98,1271
42,303,290,43,247,3,244,10,57,84,18,5,1,0,26,5,38
42,304,3541,617,2924,49,2875,46,761,739,299,28,10,2,281,64,645
42,305,4424,625,3799,61,3738,76,829,912,375,31,21,13,355,67,1059
42,306,379,49,330,11,319,11,78,80,20,2,1,0,39,6,82
42,307,535,60,475,9,466,7,116,92,60,3,2,1,45,18,122
42,308,561,76,485,7,478,9,141,121,52,3,6,1,44,5,96
42,310,181,30,151,2,149,6,26,42,20,1,0,0,32,6,16
42,311,939,109,830,9,821,27,128,290,75,9,4,4,92,19,173
42,312,445,44,401,11,390,9,115,99,49,4,5,0,29,12,68
42,313,475,47,428,10,418,8,85,83,33,9,4,0,52,12,132
42,314,300,64,236,6,230,1,49,91,13,2,2,0,26,5,41
42,315,265,34,231,6,225,0,68,61,20,2,3,1,26,4,40
42,316,5880,960,4920,94,4826,75,1330,872,727,64,27,8,418,93,1212
42,317,111,20,91,5,86,1,21,20,11,2,2,0,12,0,17
42,318,1138,147,991,18,973,21,258,285,63,10,10,2,106,24,194
42,319,487,64,423,13,410,8,107,114,34,7,5,0,53,7,75
42,320,448,33,415,9,406,6,111,117,28,6,2,0,51,24,61
42,321,104,19,85,1,84,1,14,36,4,1,0,0,8,4,16
42,322,684,92,592,7,585,21,229,118,44,11,1,0,56,13,92
42,323,6449,889,5560,102,5458,54,1276,1564,463,62,18,9,589,137,1286
42,324,681,59,622,19,603,8,161,136,61,10,2,0,61,13,151
42,325,253,48,205,5,200,3,56,51,11,2,1,0,28,9,39
42,326,608,82,526,8,518,28,74,129,79,2,0,1,62,25,118
42,327,482,84,398,7,391,16,82,117,33,6,0,2,31,7,97
42,328,488,87,401,10,391,24,76,86,53,2,3,0,46,5,96
42,329,321,57,264,4,260,8,61,52,23,6,4,1,24,5,76
42,330,6064,929,5135,59,5076,109,916,1187,626,65,30,15,507,112,1509
42,331,762,104,658,24,634,13,128,187,70,9,4,0,81,12,130
42,332,3643,534,3109,51,3058,46,560,916,359,31,17,3,287,58,781
42,333,417,54,363,11,352,5,95,98,43,6,2,1,32,10,60
42,334,1046,160,886,24,862,7,203,266,64,8,5,0,102,32,175
42,335,324,40,284,8,276,6,65,76,21,2,2,1,42,6,55
42,336,403,45,358,8,350,8,89,72,37,7,4,1,54,19,59
42,337,192,25,167,2,165,3,38,61,16,0,0,0,16,2,29
42,338,1140,182,958,25,933,14,213,267,87,11,7,2,107,24,201
42,339,245,64,181,2,179,5,33,41,17,3,1,0,19,6,54
43,1,178,49,129,7,122,2,17,29,23,3,2,0,16,3,27
43,2,1289,202,1087,17,1070,25,133,346,84,11,4,1,128,25,313
43,3,748,121,627,15,612,18,148,166,52,2,8,0,51,16,151
43,4,135,18,117,5,112,1,29,42,9,2,2,0,2,2,23
43,5,241,57,184,2,182,9,19,50,35,2,0,0,16,2,49
43,6,186,41,145,2,143,1,38,37,12,1,0,1,21,1,31
43,7,591,92,499,11,488,11,115,119,44,8,1,0,59,9,122
43,8,151,25,126,0,126,1,34,41,12,1,0,0,14,4,19
43,9,31,2,29,0,29,0,7,11,6,0,0,0,2,0,3
43,10,895,87,808,19,789,18,136,148,98,15,10,0,90,19,255
43,11,163,32,131,1,130,7,25,32,18,1,0,1,10,4,32
43,12,4144,564,3580,72,3508,70,903,813,394,46,30,6,348,67,831
43,13,321,36,285,3,282,7,47,64,41,1,0,0,33,9,80
43,14,59,16,43,2,41,0,7,17,4,1,0,0,5,2,5
43,15,71,13,58,1,57,1,16,13,4,3,1,0,9,0,10
43,16,686,113,573,8,565,4,121,95,87,15,6,1,45,9,182
43,17,252,36,216,3,213,4,40,44,25,1,2,1,16,2,78
43,18,962,115,847,34,813,13,220,192,83,8,8,0,87,15,187
43,19,84,6,78,1,77,1,14,29,5,2,1,0,12,2,11
43,20,3180,468,2712,60,2652,49,745,630,240,27,12,4,302,59,584
43,21,729,105,624,24,600,13,128,154,70,11,8,0,74,15,127
43,22,231,36,195,8,187,2,32,30,31,0,2,0,18,1,71
43,23,199,45,154,5,149,4,41,34,14,1,0,0,30,5,20
43,24,629,92,537,19,518,14,113,119,81,7,3,0,53,12,116
43,25,2038,247,1791,44,1747,30,514,385,181,23,17,5,178,29,385
43,26,409,93,316,13,303,5,73,78,28,3,3,0,32,13,68
43,27,72,13,59,0,59,3,16,12,8,4,1,1,7,2,5
43,28,307,26,281,11,270,9,80,49,13,3,2,1,32,9,72
43,29,143,47,96,1,95,0,20,36,5,2,0,0,18,1,13
43,30,270,22,248,9,239,9,51,60,22,1,4,0,31,3,58
43,31,125,15,110,4,106,2,12,17,18,2,1,0,20,1,33
43,32,1273,143,1130,28,1102,20,178,214,123,17,9,2,125,25,389
43,33,617,91,526,11,515,14,87,140,71,5,1,0,49,6,142
43,34,265,41,224,2,222,3,70,58,15,6,3,0,21,8,38
43,35,81,26,55,0,55,2,10,15,5,2,0,0,5,0,16
43,36,290,31,259,7,252,2,57,81,20,7,1,0,30,9,45
43,37,257,32,225,5,220,1,53,74,23,2,2,0,28,1,36
43,38,735,126,609,14,595,9,89,101,80,8,5,3,35,11,254
43,39,529,79,450,12,438,13,102,106,42,9,2,1,38,9,116
43,40,4926,993,3933,93,3840,74,508,954,426,35,29,6,352,49,1407
43,41,3042,591,2451,49,2402,59,367,506,311,43,16,3,248,30,819
43,42,545,52,493,24,469,6,122,138,45,4,2,1,49,10,92
43,43,429,80,349,6,343,5,63,85,32,6,2,1,46,5,98
43,44,191,35,156,5,151,2,24,42,23,3,1,0,20,2,34
43,45,369,44,325,2,323,15,66,66,37,3,4,0,43,5,84
43,46,2029,286,1743,36,1707,33,253,350,179,41,16,4,175,43,613
43,47,251,44,207,1,206,7,25,34,36,3,0,1,27,3,70
43,48,579,107,472,13,459,7,101,121,34,7,8,0,68,13,100
43,49,408,59,349,14,335,7,69,64,51,1,4,2,30,4,103
43,50,91,9,82,2,80,1,18,10,14,0,3,0,7,0,27
43,51,2214,528,1686,45,1641,42,183,435,158,20,9,2,179,25,588
43,52,231,34,197,8,189,9,24,59,22,8,1,3,14,5,44
43,53,248,57,191,1,190,6,40,55,16,4,2,0,20,2,45
43,54,227,41,186,3,183,0,27,93,14,3,2,1,18,5,20
43,55,143,20,123,2,121,2,30,23,13,2,1,0,7,4,39
43,56,387,66,321,16,305,4,55,59,46,11,4,0,28,9,89
43,57,81,18,63,3,60,2,6,13,11,1,0,0,3,1,23
43,58,666,49,617,20,597,12,210,150,47,8,3,0,54,18,95
43,59,143,32,111,6,105,1,23,18,14,0,2,0,16,7,24
43,60,83,16,67,3,64,3,6,17,4,0,0,0,15,5,14
43,61,563,62,501,10,491,18,82,118,62,9,6,3,48,8,137
43,62,553,53,500,24,476,11,99,114,50,8,4,1,53,14,122
43,63,150,25,125,2,123,4,20,36,22,2,1,0,8,3,27
43,64,103,15,88,1,87,0,14,29,7,0,0,0,9,3,25
43,65,171,58,113,3,110,5,30,28,6,0,2,0,17,0,22
43,66,112,18,94,1,93,2,18,21,10,2,1,0,14,1,24
43,67,250,41,209,4,205,7,58,47,21,0,4,1,21,4,42
43,68,38,5,33,3,30,0,12,7,3,0,0,0,4,0,4
43,69,227,21,206,8,198,10,57,62,9,2,1,0,19,2,36
43,70,186,17,169,3,166,6,31,30,23,2,0,0,15,4,55
43,71,435,75,360,12,348,14,61,100,47,7,4,1,40,4,70
43,72,130,20,110,2,108,3,19,23,11,0,0,1,19,3,29
43,73,157,37,120,6,114,3,40,34,13,0,0,1,6,4,13
43,74,608,81,527,19,508,8,96,105,57,1,1,0,65,11,164
43,75,91,13,78,3,75,2,19,12,10,0,0,0,18,0,14
43,76,148,19,129,4,125,4,25,35,9,0,0,0,15,6,31
43,77,439,57,382,7,375,1,100,106,32,2,1,1,44,8,80
43,78,2514,308,2206,57,2149,49,376,474,283,18,21,8,245,51,624
43,79,224,35,189,9,180,4,30,27,33,2,4,2,16,6,56
43,80,1682,334,1348,31,1317,27,250,448,106,14,13,1,144,25,289
43,81,47,9,38,0,38,0,6,8,4,0,0,1,7,1,11
43,82,97,32,65,1,64,2,14,24,6,1,0,0,6,0,11
43,83,126,26,100,2,98,0,26,17,13,3,2,0,20,2,15
43,84,1290,160,1130,18,1112,14,240,237,125,14,8,1,123,29,321
43,85,75,12,63,5,58,1,8,20,6,2,0,0,7,1,13
43,86,156,26,130,1,129,3,21,26,21,2,1,0,14,4,37
43,87,2073,250,1823,62,1761,21,462,547,127,21,12,1,217,46,307
43,88,227,26,201,1,200,4,37,49,22,4,1,1,25,5,52
43,89,2507,416,2091,56,2035,47,316,569,209,28,7,6,213,31,609
43,90,85,8,77,2,75,0,13,36,7,1,2,0,4,0,12
43,91,316,47,269,5,264,7,41,82,30,2,1,0,47,8,46
43,92,307,60,247,6,241,3,36,74,24,3,0,0,43,4,54
43,93,284,61,223,4,219,8,60,47,18,6,3,0,22,2,53
43,94,86,18,68,1,67,1,19,17,8,0,0,0,8,1,13
43,95,135,20,115,3,112,0,25,43,3,2,1,1,13,2,22
43,96,734,91,643,16,627,12,90,132,74,7,6,4,67,7,228
43,97,145,20,125,2,123,2,31,46,12,0,1,0,11,0,20
43,98,131,18,113,4,109,1,17,23,13,1,1,0,31,4,18
43,99,404,71,333,8,325,6,67,40,48,4,5,1,22,2,130
43,100,139,20,119,1,118,9,25,19,16,0,2,0,12,1,34
43,101,121,29,92,3,89,3,24,21,5,0,0,0,7,3,26
43,102,747,79,668,20,648,13,201,157,48,7,5,1,88,14,114
43,103,113,9,104,1,103,3,11,14,19,1,2,0,10,0,43
43,104,203,40,163,8,155,2,37,58,8,1,1,0,25,3,20
43,105,176,24,152,6,146,1,25,15,22,2,0,0,22,5,54
43,106,135,21,114,2,112,3,28,18,18,3,0,0,15,2,25
43,107,99,17,82,1,81,0,8,14,10,2,2,1,3,2,39
43,108,380,49,331,10,321,9,93,95,12,2,0,1,30,8,71
43,109,110,23,87,2,85,3,16,20,20,1,1,0,4,1,19
43,110,624,94,530,11,519,12,72,103,86,10,4,0,68,10,154
43,111,765,117,648,23,625,12,132,175,62,10,5,0,57,8,164
43,112,2858,502,2356,51,2305,36,363,522,318,41,16,2,226,48,733
43,113,1457,196,1261,35,1226,23,228,243,128,12,8,2,150,25,407
43,114,1320,205,1115,30,1085,16,307,245,89,26,10,2,126,32,232
43,115,873,114,759,15,744,21,152,214,73,8,6,2,91,9,168
43,116,67,15,52,0,52,1,7,17,7,0,0,0,5,1,14
43,117,216,30,186,6,180,17,27,37,19,3,3,0,17,2,55
43,118,264,36,228,5,223,2,38,78,16,4,0,0,21,2,62
43,119,606,85,521,18,503,6,114,100,66,6,1,3,58,7,142
43,120,988,162,826,21,805,19,158,137,115,17,8,3,71,15,262
43,121,215,34,181,2,179,8,39,40,28,6,1,1,8,3,45
43,122,236,27,209,209,0,0,0,0,0,0,0,0,0,0,0
43,123,236,25,211,9,202,1,41,47,34,5,2,0,19,4,49
43,124,732,129,603,12,591,22,108,139,62,6,7,1,55,16,175
43,125,140,28,112,0,112,5,29,14,20,4,0,1,6,1,32
43,126,597,85,512,11,501,9,108,128,64,4,7,1,56,21,103
43,127,550,64,486,11,475,10,123,104,57,11,5,1,37,10,117
43,128,101,12,89,2,87,7,13,28,10,1,0,0,10,0,18
43,129,184,35,149,5,144,3,48,25,19,0,0,0,18,7,24
43,130,1027,223,804,24,780,15,80,127,100,5,3,3,92,11,344
43,131,194,24,170,4,166,4,30,28,18,5,5,0,17,1,58
43,132,1236,214,1022,25,997,13,237,212,128,21,9,0,108,18,251
43,133,153,23,130,7,123,0,30,36,10,1,2,0,21,4,19
43,134,151,26,125,3,122,2,39,25,13,1,1,0,14,0,27
43,135,1330,186,1144,30,1114,25,179,249,161,12,8,4,125,24,327
43,136,228,37,191,2,189,3,30,33,30,7,3,0,33,5,45
43,137,6354,884,5470,120,5350,115,1234,1266,622,75,32,13,610,121,1262
43,138,349,67,282,11,271,6,73,65,20,3,3,2,35,8,56
43,139,51,13,38,0,38,0,17,4,4,1,1,0,6,2,3
43,140,496,60,436,6,430,11,57,107,57,5,3,1,52,7,130
43,141,961,122,839,23,816,12,233,266,56,7,9,2,100,26,105
43,142,503,61,442,10,432,8,121,139,40,5,1,4,43,9,62
43,143,128,13,115,3,112,4,26,27,13,0,0,0,19,3,20
43,144,106,20,86,5,81,2,9,28,4,2,0,0,21,1,14
43,145,63,13,50,2,48,1,8,18,5,1,0,0,7,6,2
43,147,564,66,498,16,482,8,69,98,70,9,3,1,48,12,164
43,148,657,115,542,8,534,10,74,109,74,9,2,2,57,10,187
43,149,114,8,106,8,98,1,19,30,9,3,2,1,13,3,17
43,150,405,50,355,8,347,7,59,80,42,4,5,0,53,6,91
43,151,226,43,183,5,178,2,30,31,23,3,0,2,19,3,65
43,152,2309,311,1998,45,1953,51,319,532,208,24,5,6,209,56,543
43,153,1374,215,1159,21,1138,15,346,166,137,14,11,1,109,22,317
43,154,412,67,345,8,337,2,67,96,36,2,1,0,27,6,100
43,155,90,8,82,3,79,1,16,23,13,0,1,0,6,1,18
43,156,167,29,138,1,137,0,29,34,10,3,2,0,32,2,25
43,157,12213,2788,9425,163,9262,247,1175,2572,1090,96,42,28,885,155,2972
43,158,280,48,232,3,229,16,29,34,43,2,2,2,26,3,72
43,159,708,79,629,13,616,9,219,146,39,11,10,0,67,13,102
43,160,171,19,152,0,152,2,22,50,20,4,0,1,16,3,34
43,162,2246,344,1902,45,1857,40,446,388,252,27,9,4,176,25,490
43,163,953,118,835,17,818,9,220,276,68,6,7,2,81,23,126
43,164,445,65,380,7,373,4,88,94,41,4,1,0,24,8,109
43,165,1109,125,984,23,961,29,178,245,96,10,16,5,121,17,244
43,166,317,40,277,5,272,5,43,58,44,9,5,0,41,9,58
43,167,184,26,158,5,153,5,32,45,17,3,1,0,24,1,25
43,168,124,24,100,1,99,0,23,37,9,3,1,0,12,1,13
43,169,58,14,44,0,44,3,7,13,6,0,1,0,8,0,6
43,170,268,44,224,6,218,3,37,52,44,1,3,0,19,4,55
43,171,76,14,62,1,61,4,17,16,5,0,0,0,13,0,6
43,172,202,23,179,9,170,4,29,54,22,3,0,0,34,1,23
43,173,116,10,106,9,97,0,16,22,15,2,1,0,19,3,19
43,174,799,89,710,16,694,16,152,149,79,7,4,1,61,13,212
43,175,152,26,126,0,126,0,40,13,11,1,0,0,28,3,30
43,176,52,6,46,0,46,2,5,8,7,0,1,0,8,3,12
43,177,2598,375,2223,53,2170,46,538,508,241,38,12,6,251,41,489
43,178,222,42,180,8,172,9,31,39,20,3,0,0,33,3,34
43,180,123,21,102,2,100,2,26,25,5,1,1,0,10,0,30
43,181,602,90,512,11,501,9,77,100,70,5,2,2,51,4,181
43,182,66,23,43,0,43,0,10,8,4,2,0,0,7,0,12
43,183,92,16,76,3,73,1,14,20,7,2,2,0,10,0,17
43,184,1802,193,1609,43,1566,23,443,352,177,21,8,6,136,38,362
43,185,2271,336,1935,43,1892,18,333,323,297,30,17,5,103,32,734
43,186,407,69,338,6,332,9,66,94,45,4,8,0,61,5,40
43,187,280,28,252,8,244,6,54,54,25,6,1,0,35,8,55
43,188,400,88,312,6,306,2,92,59,47,2,1,0,25,6,72
43,189,420,54,366,13,353,8,74,112,37,1,1,0,43,8,69
43,190,2771,305,2466,54,2412,43,417,502,284,26,20,6,292,50,772
43,191,196,31,165,6,159,2,33,17,21,1,1,2,13,6,63
43,192,377,68,309,9,300,2,74,90,28,3,3,0,30,8,62
43,193,171,39,132,4,128,6,25,25,25,3,0,1,18,1,24
43,194,558,88,470,15,455,22,72,87,53,6,2,1,52,16,144
43,195,230,32,198,3,195,16,32,28,32,5,2,0,15,7,58
43,196,186,50,136,1,135,2,35,32,10,3,1,0,23,0,29
43,197,367,53,314,10,304,5,64,77,25,3,3,2,45,10,70
43,198,279,38,241,5,236,4,58,65,17,4,0,0,46,4,38
43,199,804,135,669,11,658,20,131,148,80,7,5,0,71,19,177
43,200,1506,187,1319,26,1293,49,202,284,154,11,14,5,189,18,367
43,201,250,44,206,5,201,5,68,42,17,3,2,1,28,6,29
43,202,101,19,82,0,82,2,12,28,6,1,0,2,4,3,24
43,203,398,22,376,8,368,7,64,63,52,11,0,1,61,8,101
43,204,188,26,162,3,159,2,31,62,6,2,1,0,20,1,34
43,205,3094,470,2624,56,2568,61,672,612,275,32,16,9,256,57,578
43,206,381,73,308,8,300,7,38,68,40,2,2,0,50,7,86
43,207,212,23,189,7,182,1,21,32,26,1,1,1,17,10,72
43,208,50,14,36,2,34,0,6,6,8,0,1,0,3,0,10
43,210,239,35,204,6,198,3,44,41,15,2,3,0,27,4,59
43,211,1626,182,1444,34,1410,22,341,346,136,13,7,2,169,28,346
43,212,929,152,777,19,758,10,169,270,62,6,5,2,119,15,100
43,213,1651,203,1448,35,1413,30,402,308,144,23,14,2,190,45,255
43,214,117,17,100,5,95,1,22,22,9,1,0,0,20,2,18
43,215,234,31,203,1,202,2,61,47,13,0,1,0,24,4,50
43,216,1655,187,1468,36,1432,16,277,376,137,9,9,1,168,34,405
43,217,462,74,388,7,381,13,86,92,38,8,3,2,54,7,78
43,218,845,95,750,15,735,20,123,119,120,13,4,1,91,16,228
43,219,99,20,79,0,79,1,8,12,17,1,0,0,9,1,30
43,220,226,48,178,2,176,0,35,35,15,2,0,0,28,2,59
43,221,371,59,312,5,307,3,62,76,29,0,1,2,40,13,81
43,222,165,40,125,1,124,2,25,30,16,1,0,0,18,3,29
43,223,809,82,727,17,710,18,204,192,79,6,6,0,94,15,96
43,224,4139,621,3518,101,3417,55,873,892,319,46,24,8,413,74,713
43,225,49,3,46,2,44,1,7,9,10,0,0,0,5,1,11
43,226,114,21,93,3,90,4,9,29,4,3,1,0,15,3,22
43,227,562,81,481,12,469,8,101,130,44,8,4,2,58,23,91
43,228,121,28,93,3,90,2,26,19,8,1,0,0,20,1,13
43,229,396,30,366,11,355,0,73,85,39,3,2,0,45,9,99
43,230,872,134,738,21,717,12,177,178,79,14,4,1,76,12,164
43,231,191,32,159,3,156,6,30,36,20,2,0,0,17,1,44
43,232,319,89,230,6,224,3,53,46,33,2,1,1,26,7,52
43,233,848,99,749,24,725,14,156,176,82,14,11,1,75,17,179
43,234,1529,266,1263,31,1232,11,224,420,116,12,7,2,194,20,226
43,236,925,111,814,17,797,27,219,192,65,9,8,1,94,21,161
43,237,243,34,209,7,202,2,40,77,23,5,2,2,19,3,29
43,238,281,33,248,7,241,5,60,50,31,3,3,0,36,7,46
43,239,725,131,594,12,582,10,105,164,52,11,4,1,86,12,137
43,240,218,21,197,5,192,10,62,28,31,2,6,1,16,3,33
43,241,954,97,857,18,839,19,173,179,84,11,4,0,127,16,226
43,242,65,19,46,0,46,0,11,10,11,1,1,0,5,2,5
43,244,2606,412,2194,56,2138,43,408,608,289,21,15,4,241,55,454
43,245,211,30,181,7,174,0,31,70,11,2,1,1,29,7,22
43,246,414,47,367,9,358,10,89,105,37,6,0,2,35,5,69
43,247,75,11,64,3,61,1,6,19,11,1,2,0,7,3,11
43,249,414,36,378,6,372,8,110,87,36,10,2,1,37,5,76
43,250,49,5,44,6,38,1,9,2,4,3,0,0,1,1,17
43,251,2477,361,2116,46,2070,48,320,598,200,24,10,8,268,44,550
43,252,44,8,36,1,35,0,5,7,3,1,0,0,4,1,14
43,253,250,46,204,2,202,7,37,68,21,1,2,3,23,7,33
43,254,191,24,167,1,166,6,39,48,11,2,2,0,20,4,34
43,255,46,6,40,6,34,1,9,9,0,0,0,0,7,1,7
43,256,372,54,318,8,310,7,52,121,16,5,1,0,50,8,50
43,257,380,57,323,6,317,2,69,91,25,5,4,0,42,12,67
43,258,1435,276,1159,33,1126,11,189,163,189,15,6,2,73,21,457
43,259,333,38,295,6,289,6,68,96,15,4,5,0,29,7,59
43,260,33,5,28,0,28,1,7,8,0,0,0,0,0,3,9
43,261,419,45,374,5,369,3,71,56,59,7,4,0,27,3,139
43,262,923,102,821,18,803,23,121,161,125,13,12,3,65,19,261
43,263,80,16,64,2,62,4,14,19,8,0,0,0,6,2,9
43,264,276,54,222,6,216,12,33,56,35,1,0,1,24,4,50
43,265,881,115,766,16,750,25,219,151,95,12,11,3,89,16,129
43,267,1163,185,978,25,953,19,232,239,107,14,8,2,101,19,212
43,268,5422,830,4592,127,4465,88,881,1214,397,73,34,15,575,104,1084
44,1,1372,229,1143,21,1122,35,184,338,140,21,4,2,94,22,282
44,2,2228,212,2016,40,1976,56,231,555,238,27,15,1,237,52,564
44,3,5477,970,4507,102,4405,129,500,1201,455,36,22,15,622,79,1346
44,4,1393,157,1236,24,1212,40,203,299,153,18,12,3,123,28,333
44,5,2534,340,2194,54,2140,45,356,667,196,35,14,5,257,57,508
44,6,1430,241,1189,40,1149,54,212,333,120,21,7,2,94,21,285
44,7,1817,238,1579,20,1559,29,285,381,217,13,13,5,161,27,428
44,8,910,98,812,16,796,17,142,206,106,16,7,1,95,19,187
44,9,6534,664,5870,97,5773,172,450,1731,512,38,18,18,847,118,1869
44,10,2686,418,2268,36,2232,83,315,748,221,23,17,3,197,45,580
44,11,1337,218,1119,23,1096,37,188,343,113,18,4,4,123,21,245
44,12,2349,314,2035,23,2012,39,284,641,221,19,18,9,168,45,568
44,13,1926,231,1695,30,1665,43,284,324,237,32,19,4,179,38,505
44,14,2557,344,2213,47,2166,52,272,605,209,33,12,4,293,43,643
44,15,6895,1231,5664,168,5496,196,794,1292,742,97,46,10,539,119,1661
44,16,621,57,564,13,551,5,97,165,60,5,6,6,70,15,122
44,17,445,75,370,8,362,15,75,102,29,1,5,1,44,10,80
44,18,4779,487,4292,80,4212,93,465,1018,488,48,23,4,500,70,1503
44,19,683,125,558,12,546,24,81,110,70,10,9,2,52,14,174
44,20,13084,2013,11071,214,10857,344,1351,1940,1718,135,78,24,1042,197,4028
44,21,2333,329,2004,20,1984,39,396,617,192,26,11,5,194,56,448
44,22,1977,247,1730,50,1680,35,248,511,142,32,22,6,220,40,424
44,23,1980,242,1738,29,1709,77,240,423,188,32,15,5,203,38,488
44,24,1892,188,1704,38,1666,51,192,322,244,19,9,5,167,43,614
44,25,2706,286,2420,60,2360,110,331,506,288,40,19,6,314,69,677
44,26,13559,1882,11677,174,11503,307,1038,3461,1053,131,39,20,1627,227,3600
44,27,1398,150,1248,18,1230,53,173,273,141,22,10,3,149,35,371
44,28,2706,370,2336,25,2311,76,287,588,279,25,11,4,282,49,710
44,29,3879,584,3295,87,3208,78,517,941,332,49,24,9,385,68,805
44,30,2577,269,2308,54,2254,33,318,450,323,36,18,3,228,43,802
44,31,592,106,486,15,471,7,79,199,29,9,3,0,53,18,74
44,32,2180,272,1908,35,1873,40,234,494,202,34,11,7,238,44,569
44,33,2132,293,1839,37,1802,56,258,395,248,22,18,4,166,35,600
44,34,557,71,486,11,475,8,83,169,26,8,4,1,52,10,114
44,35,14653,2212,12441,170,12271,503,1071,3048,1225,119,38,26,1704,213,4324
44,36,8763,1775,6988,155,6833,160,887,1969,622,88,44,16,776,139,2132
44,37,2162,297,1865,41,1824,47,222,520,203,19,8,7,229,25,544
44,38,1920,314,1606,37,1569,37,316,474,156,22,12,7,195,41,309
44,39,609,52,557,11,546,14,69,155,78,8,1,1,61,15,144
44,40,1528,174,1354,36,1318,39,189,380,141,36,12,1,151,36,333
44,41,3946,561,3385,69,3316,89,525,860,330,42,31,4,355,70,1010
44,43,5312,831,4481,72,4409,166,445,1304,447,47,32,10,590,81,1287
44,44,797,116,681,6,675,21,163,188,66,9,4,0,52,16,156
44,45,2266,312,1954,37,1917,44,342,393,266,33,8,6,217,35,573
44,46,1944,300,1644,35,1609,34,291,357,204,30,13,4,172,41,463
44,47,14492,2269,12223,299,11924,316,1474,1938,1996,158,76,31,1123,209,4603
44,48,1678,207,1471,37,1434,46,202,357,165,22,19,2,205,39,377
44,49,3716,721,2995,43,2952,57,393,1154,256,31,13,8,264,56,720
44,50,2048,282,1766,41,1725,36,322,320,257,37,21,3,168,37,524
44,51,2263,368,1895,37,1858,54,301,492,187,39,16,2,239,30,498
44,52,4764,723,4041,72,3969,62,676,728,643,79,46,8,299,61,1367
44,53,1389,170,1219,22,1197,23,237,217,166,15,9,2,135,22,371
44,54,2166,291,1875,47,1828,35,293,457,184,40,12,7,215,38,547
44,55,14793,2685,12108,190,11918,215,1277,5828,731,96,33,19,1162,226,2331
44,56,2342,294,2048,26,2022,88,284,545,285,36,11,4,243,46,480
44,57,1682,220,1462,47,1415,36,233,321,197,33,14,4,150,17,410
44,58,350,53,297,7,290,3,67,70,28,3,4,0,27,10,78
44,59,946,138,808,14,794,12,186,249,61,11,6,0,112,13,144
44,60,695,107,588,12,576,17,83,167,62,9,4,3,66,18,147
44,61,2100,302,1798,53,1745,51,318,501,182,22,9,6,201,47,408
44,62,1080,129,951,16,935,34,146,202,121,14,4,1,106,26,281
44,63,2534,286,2248,59,2189,57,403,641,192,33,11,7,276,55,514
44,64,3000,377,2623,59,2564,61,307,750,289,34,20,9,305,75,714
44,65,572,77,495,12,483,10,89,175,40,6,6,4,43,12,98
44,66,3361,398,2963,48,2915,137,393,772,319,27,7,6,411,63,780
44,67,3797,546,3251,51,3200,101,486,820,396,43,20,8,288,49,989
44,68,2325,372,1953,25,1928,78,336,451,285,35,20,4,205,41,473
44,69,13073,2250,10823,186,10637,342,1336,3669,1034,122,49,31,1214,205,2635
44,70,3280,422,2858,52,2806,70,261,671,368,40,10,13,370,45,958
44,71,4242,508,3734,68,3666,92,395,1125,344,36,17,9,516,80,1052
44,72,4385,566,3819,90,3729,93,584,1000,435,63,26,8,395,68,1057
44,73,3973,534,3439,72,3367,107,598,829,390,42,23,6,463,68,841
44,74,2708,387,2321,30,2291,96,233,354,396,19,16,5,188,37,947
44,75,1430,199,1231,26,1205,13,252,332,89,24,6,3,112,25,349
44,76,959,131,828,22,806,26,133,217,90,18,4,0,89,11,218
44,77,1561,221,1340,25,1315,55,205,333,138,27,10,6,151,22,368
44,78,279,36,243,4,239,10,76,54,16,5,2,0,30,1,45
44,79,2077,293,1784,44,1740,41,254,483,176,27,15,4,268,35,437
44,80,515,67,448,8,440,18,55,89,76,12,9,0,47,4,130
44,81,3014,392,2622,62,2560,57,528,794,234,42,23,5,250,54,573
44,82,3174,410,2764,63,2701,60,481,588,284,37,17,6,457,74,697
44,83,1456,212,1244,21,1223,22,219,375,103,13,18,2,150,33,288
44,84,5115,644,4471,83,4388,118,654,1177,477,62,21,25,578,88,1188
44,85,659,71,588,18,570,8,138,136,47,2,4,2,80,14,139
44,86,770,114,656,14,642,11,97,213,64,19,6,3,64,14,151
44,87,4603,771,3832,93,3739,75,545,1216,319,57,26,15,497,68,921
44,88,1938,234,1704,24,1680,45,210,414,198,26,15,4,232,38,498
44,89,2256,285,1971,38,1933,55,283,354,298,27,13,3,208,53,639
44,90,959,143,816,14,802,23,135,288,91,12,12,0,87,22,132
44,91,1098,138,960,15,945,34,133,269,89,12,5,1,113,26,263
44,92,500,66,434,12,422,8,101,66,65,9,3,1,41,6,122
44,93,721,77,644,14,630,13,86,199,50,8,8,1,93,20,152
44,94,2192,287,1905,42,1863,54,224,467,254,27,19,3,230,32,553
44,95,919,98,821,15,806,13,130,258,88,14,6,2,64,19,212
44,96,3182,405,2777,77,2700,52,523,685,250,36,30,11,329,88,696
44,97,1751,215,1536,25,1511,58,148,568,175,22,9,6,153,19,353
44,98,3457,498,2959,68,2891,56,429,715,347,58,24,3,283,59,917
44,99,1440,183,1257,34,1223,24,179,488,88,12,9,4,117,19,283
44,100,1413,133,1280,29,1251,43,136,409,121,14,6,2,158,22,340
44,101,4483,624,3859,68,3791,122,410,607,719,62,34,11,323,63,1440
44,102,2167,266,1901,33,1868,52,239,538,196,14,12,1,243,38,535
44,103,4827,801,4026,61,3965,54,702,565,712,75,22,9,284,82,1460
44,104,590,73,517,18,499,13,91,148,51,5,4,1,40,13,133
44,105,284,33,251,4,247,4,36,57,37,7,4,0,28,2,72
44,106,1220,172,1048,18,1030,23,123,349,94,10,5,3,99,26,298
44,107,1287,179,1108,27,1081,27,175,255,143,15,7,2,134,32,291
44,108,1858,255,1603,30,1573,41,248,478,160,27,12,6,246,41,314
44,109,180728,34661,146067,1989,144078,6638,11213,36497,17838,1355,583,320,15733,1796,52105
44,110,5824,814,5010,90,4920,150,686,1194,522,84,33,11,582,118,1540
44,111,1460,205,1255,16,1239,73,197,275,187,31,4,0,179,34,259
44,112,438,49,389,10,379,6,84,110,32,8,5,0,42,8,84
44,113,2648,383,2265,43,2222,63,299,659,188,34,18,0,268,30,663
44,114,19235,3374,15861,336,15525,518,1444,4300,1465,129,53,31,1965,219,5401
44,115,2630,354,2276,39,2237,58,275,525,292,26,12,3,286,47,713
44,116,2035,348,1687,27,1660,42,266,348,242,33,21,1,127,37,543
44,117,2104,209,1895,49,1846,44,237,449,247,20,6,3,281,36,523
44,118,858,103,755,18,737,28,162,191,82,11,6,1,72,14,170
44,119,1326,159,1167,24,1143,17,177,372,88,25,15,3,152,37,257
44,120,3211,431,2780,49,2731,92,402,528,413,44,21,6,275,55,895
44,121,326,42,284,8,276,8,60,87,20,4,1,2,26,3,65
44,122,2463,315,2148,35,2113,51,392,479,224,28,12,3,277,46,601
44,123,699,107,592,9,583,19,145,164,60,13,1,0,48,5,128
44,124,507,83,424,13,411,6,62,170,36,5,3,0,35,16,78
44,125,2171,319,1852,24,1828,50,242,687,149,22,3,5,169,36,465
44,126,3060,419,2641,56,2585,69,483,725,260,34,17,8,233,71,685
44,127,1868,266,1602,50,1552,40,251,464,139,27,19,5,172,45,390
44,128,3365,473,2892,47,2845,118,448,625,437,66,26,13,290,52,770
44,129,7186,1126,6060,108,5952,127,935,1364,755,96,47,8,701,96,1823
44,130,4347,580,3767,68,3699,73,479,969,407,36,22,8,385,65,1255
44,131,12480,1889,10591,138,10453,318,1379,3821,871,125,33,33,1177,242,2454
44,132,9514,1544,7970,162,7808,212,871,2982,595,66,19,12,813,122,2116
44,133,1985,235,1750,35,1715,59,272,439,176,17,5,1,228,28,490
44,134,658,76,582,15,567,11,119,140,55,9,3,1,73,16,140
44,135,4482,750,3732,57,3675,94,447,1633,277,39,16,7,298,59,805
44,136,1292,166,1126,12,1114,31,135,466,78,10,4,5,111,14,260
44,137,2173,212,1961,34,1927,40,374,388,255,25,13,6,211,54,561
44,138,692,80,612,14,598,12,89,148,73,7,3,1,78,15,172
44,139,879,105,774,15,759,8,139,148,117,14,3,1,64,13,252
44,140,1035,145,890,23,867,18,173,236,92,19,8,1,111,16,193
44,141,751,80,671,20,651,19,110,188,62,4,8,0,87,17,156
44,142,1209,129,1080,27,1053,22,165,292,89,15,7,1,142,20,300
44,143,28086,5055,23031,366,22665,892,2202,4071,3366,296,123,52,2132,375,9156
44,144,1519,192,1327,43,1284,54,208,362,119,23,6,1,160,34,317
44,145,1928,247,1681,40,1641,38,256,388,190,31,17,7,225,55,434
44,146,1688,242,1446,34,1412,32,265,410,131,25,18,5,179,31,316
44,147,722,84,638,15,623,14,123,180,54,15,7,1,63,10,156
44,148,463,64,399,13,386,6,74,108,24,3,1,0,41,10,119
44,149,2666,363,2303,66,2237,71,351,483,295,40,14,5,241,44,693
44,150,3054,388,2666,77,2589,51,371,650,316,28,12,6,273,70,812
44,151,4159,523,3636,69,3567,78,457,1127,328,49,16,7,405,87,1013
44,152,1941,264,1677,35,1642,47,255,366,221,28,19,2,196,37,471
44,153,1177,128,1049,25,1024,18,174,273,97,18,8,1,129,28,278
44,154,9631,1451,8180,144,8036,192,1125,2259,869,107,51,22,893,172,2346
44,155,2031,239,1792,38,1754,37,332,501,171,35,7,1,221,40,409
44,156,1799,295,1504,45,1459,34,228,451,178,15,11,2,156,24,360
44,157,1065,157,908,15,893,6,149,317,69,12,6,1,138,15,180
44,158,5127,701,4426,83,4343,131,483,1120,496,43,23,13,591,82,1361
44,159,909,91,818,16,802,29,79,209,104,3,7,0,109,16,246
44,160,2330,316,2014,42,1972,45,262,512,179,28,18,2,288,41,597
44,161,2361,273,2088,45,2043,31,332,560,230,27,13,3,238,43,566
44,162,31680,6692,24988,378,24610,860,2630,5089,3118,252,122,50,2613,374,9502
44,163,1724,194,1530,31,1499,46,235,406,137,32,12,2,193,51,385
44,164,1425,219,1206,22,1184,37,161,360,125,23,14,6,134,46,278
44,165,1519,162,1357,32,1325,39,172,339,150,11,16,2,169,28,399
44,166,3932,422,3510,70,3440,105,431,618,545,52,22,8,314,58,1287
44,168,3150,560,2590,39,2551,38,455,334,457,51,20,5,181,39,971
44,169,5023,677,4346,92,4254,128,484,1266,425,46,16,9,573,86,1221
44,170,652,100,552,12,540,11,108,213,41,4,4,2,39,15,103
44,171,1179,102,1077,22,1055,32,150,243,125,14,8,0,136,24,323
44,172,9746,1141,8605,162,8443,213,851,2030,930,78,44,19,1112,138,3028
44,173,1373,184,1189,26,1163,30,177,293,152,10,2,4,181,29,285
44,174,1339,111,1228,22,1206,22,227,362,116,24,18,2,159,23,253
44,175,3117,345,2772,51,2721,59,412,758,284,47,17,3,306,47,788
44,176,2497,334,2163,36,2127,34,359,286,428,45,14,3,141,37,780
44,178,1807,228,1579,35,1544,49,214,389,193,36,9,3,190,34,427
44,179,3181,467,2714,49,2665,60,421,707,276,31,14,7,340,65,744
44,180,1731,227,1504,44,1460,22,294,500,124,20,13,8,158,41,280
44,181,877,120,757,12,745,9,125,229,65,12,5,5,90,21,184
44,182,3699,563,3136,64,3072,69,470,1043,284,34,12,9,327,74,750
44,183,1697,222,1475,18,1457,50,263,409,148,32,17,1,166,31,340
44,184,46806,9412,37394,573,36821,1119,4273,7235,5541,527,284,79,3227,562,13974
44,185,2308,340,1968,25,1943,50,279,447,216,20,19,7,191,36,678
44,186,3926,535,3391,73,3318,72,467,870,342,34,22,7,425,83,996
44,187,3036,502,2534,57,2477,51,418,748,233,33,25,9,287,81,592
44,188,6077,848,5229,102,5127,113,842,1538,467,88,45,9,669,116,1240
44,189,1536,220,1316,20,1296,15,189,227,212,26,14,3,90,23,497
44,190,19457,2847,16610,269,16341,497,1463,3819,1892,162,64,38,1997,242,6167
44,191,483,49,434,7,427,1,81,167,25,3,5,2,61,16,66
44,192,1567,173,1394,28,1366,19,229,417,165,19,12,3,145,27,330
44,193,1030,161,869,21,848,13,130,228,73,11,10,0,65,16,302
44,194,5881,647,5234,67,5167,136,477,1929,326,39,9,23,723,93,1412
44,195,5511,863,4648,76,4572,152,557,970,580,52,29,10,542,96,1584
44,196,1147,140,1007,20,987,23,181,186,125,17,11,2,91,25,326
44,197,1248,202,1046,26,1020,26,201,259,89,24,7,1,113,12,288
44,198,5675,576,5099,88,5011,126,588,1361,578,43,22,5,516,109,1663
44,199,1582,250,1332,36,1296,19,234,376,115,22,8,4,193,22,303
44,200,286,62,224,4,220,7,58,39,21,2,2,1,21,5,64
44,201,5051,562,4489,74,4415,166,383,1303,424,35,14,7,641,88,1354
44,202,1224,135,1089,37,1052,32,187,283,108,12,6,0,132,20,272
44,203,1279,166,1113,13,1100,28,227,233,116,11,9,5,127,31,313
44,204,6184,788,5396,85,5311,120,548,1502,528,47,11,14,758,95,1688
44,205,1642,279,1363,27,1336,31,241,342,120,26,16,3,185,16,356
44,206,1065,130,935,15,920,12,167,265,59,9,11,1,133,15,248
44,207,579,88,491,6,485,20,101,112,46,7,2,2,50,23,122
44,208,550,77,473,10,463,20,81,105,60,6,8,2,46,5,130
44,209,5877,721,5156,105,5051,208,577,1320,534,70,12,15,703,124,1488
44,210,5260,975,4285,72,4213,49,783,600,791,70,27,3,263,80,1547
44,211,3885,566,3319,58,3261,76,462,1059,294,53,17,4,315,65,916
44,212,6126,834,5292,153,5139,122,635,1647,499,74,32,8,780,134,1208
44,213,2647,397,2250,55,2195,66,317,589,174,31,18,4,284,55,657
44,214,1235,140,1095,22,1073,31,208,244,154,22,4,3,103,17,287
44,215,17597,2093,15504,269,15235,467,1405,4535,1556,152,61,42,1937,283,4797
44,216,2892,406,2486,50,2436,45,319,768,258,34,15,3,329,72,593
44,217,4206,533,3673,66,3607,193,406,997,411,38,19,4,466,64,1009
44,218,492,63,429,13,416,11,77,122,36,2,5,5,46,6,106
44,219,600,97,503,11,492,4,102,205,33,5,3,0,47,18,75
44,220,1069,185,884,15,869,16,163,215,99,13,7,2,101,17,236
44,221,903,123,780,15,765,23,109,171,86,14,9,1,102,28,222
44,222,836,105,731,20,711,12,110,210,42,12,7,6,109,14,189
44,223,2464,328,2136,61,2075,28,278,578,195,28,13,4,245,49,657
44,224,1059,66,993,85,908,49,145,183,116,15,10,2,120,15,253
45,1,158,14,144,1,143,3,49,42,7,2,0,2,17,3,18
45,2,317,62,255,3,252,1,87,84,10,2,1,0,28,6,33
45,4,8657,1841,6816,130,6686,124,1452,2079,546,61,34,28,597,158,1607
45,5,147,17,130,2,128,0,31,45,9,1,2,0,13,3,24
45,6,925,121,804,18,786,22,116,358,35,4,1,2,68,27,153
45,8,1176,193,983,28,955,8,246,302,63,8,4,1,85,17,221
45,9,768,105,663,10,653,8,157,192,54,14,9,6,55,17,141
45,10,676,103,573,10,563,12,156,162,40,3,2,4,49,8,127
45,11,172,18,154,4,150,4,48,50,9,0,1,1,19,2,16
45,12,134,18,116,2,114,2,26,30,15,1,1,1,13,6,19
45,13,181,26,155,3,152,5,23,47,21,1,0,3,12,2,38
45,14,404,80,324,0,324,4,78,104,30,2,1,1,34,11,59
45,15,539,76,463,6,457,8,140,111,31,6,1,1,40,14,105
45,16,837,171,666,10,656,14,183,163,39,7,7,1,67,12,163
45,17,287,35,252,6,246,5,59,107,16,3,1,0,24,2,29
45,18,656,112,544,10,534,14,171,133,46,5,1,1,44,18,101
45,19,504,74,430,4,426,10,79,147,27,3,4,2,59,13,82
45,20,749,102,647,14,633,11,140,166,69,12,3,6,53,13,160
45,21,224,38,186,4,182,3,47,48,15,2,3,1,19,4,40
45,22,302,44,258,8,250,4,88,72,12,7,2,0,10,4,51
45,23,86,15,71,1,70,1,15,23,6,0,0,1,10,1,13
45,24,1517,247,1270,31,1239,17,235,317,150,19,6,1,116,24,354
45,25,1016,172,844,14,830,10,220,231,63,13,5,5,71,25,187
45,26,655,109,546,13,533,5,178,126,56,4,3,2,37,24,98
45,27,320,49,271,1,270,8,67,98,24,3,0,0,23,8,39
45,28,5395,1256,4139,66,4073,78,651,1185,416,39,27,9,408,88,1172
45,29,1414,245,1169,22,1147,11,302,323,109,16,7,4,83,28,264
45,30,1310,261,1049,20,1029,11,293,344,73,19,11,5,83,15,175
45,31,987,171,816,13,803,13,217,264,54,10,5,2,66,22,150
45,32,221,38,183,2,181,2,43,76,12,2,4,0,10,5,27
45,33,274,25,249,3,246,12,66,60,25,2,3,1,33,3,41
45,34,1659,238,1421,27,1394,34,229,387,123,8,9,3,153,17,431
45,35,838,163,675,12,663,16,190,197,56,7,5,1,66,6,119
45,36,631,82,549,5,544,1,140,177,48,8,0,1,46,20,103
45,37,253,31,222,4,218,2,54,56,25,3,3,1,16,7,51
45,38,321,75,246,13,233,3,48,85,23,4,1,0,24,5,40
45,39,523,79,444,11,433,8,97,165,30,3,0,0,39,13,78
45,40,1376,230,1146,30,1116,11,298,308,126,17,9,9,87,26,225
45,41,99,13,86,1,85,0,33,34,1,1,0,0,6,1,9
45,42,1311,195,1116,19,1097,13,279,299,113,19,4,10,102,17,241
45,43,686,58,628,8,620,19,93,151,76,2,3,2,75,8,191
45,44,154,21,133,2,131,2,33,42,8,2,0,0,16,1,27
45,45,272,40,232,2,230,7,62,89,12,1,3,0,21,6,29
45,46,423,64,359,10,349,3,101,97,34,6,4,1,34,5,64
45,47,323,61,262,4,258,4,82,70,24,6,0,0,22,2,48
45,49,874,104,770,9,761,6,175,244,72,3,5,3,80,18,155
45,50,829,153,676,12,664,9,192,209,51,3,2,1,54,15,128
45,51,948,154,794,20,774,6,197,247,55,12,8,1,70,27,151
45,52,66,8,58,0,58,2,13,20,4,1,0,0,5,2,11
45,53,4168,980,3188,54,3134,42,678,844,363,23,15,14,245,60,850
45,54,444,56,388,9,379,2,113,96,35,1,0,1,30,8,93
45,55,381,86,295,4,291,0,79,86,30,5,4,0,30,8,49
45,56,230,39,191,4,187,2,56,77,10,0,1,0,14,5,22
45,57,75,14,61,0,61,1,16,27,3,0,0,0,7,2,5
45,58,118,8,110,3,107,1,41,32,9,1,0,0,6,5,12
45,59,171,13,158,5,153,2,50,56,12,1,0,0,9,0,23
45,60,615,83,532,12,520,9,128,134,59,4,9,2,38,12,125
45,61,1837,422,1415,23,1392,22,388,379,150,8,14,4,82,44,301
45,62,832,113,719,15,704,8,188,189,54,5,5,0,62,27,166
45,63,810,104,706,17,689,6,169,244,47,16,3,2,72,21,109
45,64,366,58,308,6,302,6,79,87,28,2,3,1,23,9,64
45,65,164,19,145,1,144,0,30,65,9,1,1,1,12,3,22
45,66,530,75,455,14,441,4,162,107,35,5,6,2,34,7,79
45,67,2612,401,2211,39,2172,37,480,685,165,14,22,5,241,48,475
45,68,7284,1747,5537,121,5416,62,1140,959,1077,65,26,8,322,109,1648
45,69,646,99,547,11,536,7,144,117,41,7,3,1,55,9,152
45,70,48,2,46,1,45,0,14,21,2,1,0,0,1,1,5
45,72,979,116,863,15,848,15,159,229,106,5,2,2,73,18,239
45,73,359,49,310,2,308,6,95,92,19,1,0,0,25,10,60
45,74,67,4,63,0,63,1,24,21,2,0,2,0,5,1,7
45,75,6791,1390,5401,97,5304,116,935,1415,575,60,32,18,565,96,1492
45,76,214,35,179,2,177,0,50,49,19,4,4,0,9,3,39
45,77,393,55,338,13,325,0,110,110,18,3,2,1,23,6,52
45,78,193,31,162,2,160,3,36,49,14,1,1,1,16,5,34
45,79,122,18,104,0,104,1,27,39,8,1,1,0,8,5,14
45,80,273,38,235,4,231,4,77,78,19,8,5,2,13,2,23
45,81,456,87,369,12,357,4,85,128,39,4,1,2,30,4,60
45,82,5312,970,4342,73,4269,96,953,1260,369,28,21,6,412,82,1042
45,83,1659,325,1334,29,1305,20,307,417,113,10,9,6,124,42,257
45,84,364,71,293,6,287,5,68,81,24,5,1,0,27,10,66
45,85,1379,267,1112,20,1092,21,244,371,92,9,7,3,97,35,213
45,86,223,25,198,6,192,0,50,67,14,2,1,0,20,3,35
45,87,2381,391,1990,45,1945,28,429,495,261,26,10,7,162,36,491
45,88,253,50,203,3,200,6,41,66,20,0,0,1,21,4,41
45,89,6033,939,5094,94,5000,92,874,1511,491,58,22,12,516,93,1331
45,91,259,41,218,2,216,6,60,67,11,0,1,1,17,5,48
45,92,1108,191,917,8,909,10,236,314,71,10,2,3,92,21,150
45,93,1859,318,1541,33,1508,9,414,461,140,16,18,3,129,35,283
45,94,205,24,181,3,178,3,33,82,14,2,1,1,9,3,30
45,95,1321,213,1108,20,1088,15,265,323,91,11,10,5,108,30,230
45,96,386,51,335,4,331,4,98,109,19,1,3,0,32,7,58
45,97,856,143,713,9,704,10,182,208,58,8,3,1,68,29,137
45,98,2419,318,2101,48,2053,46,405,613,167,25,7,7,197,55,531
45,99,398,76,322,5,317,3,102,88,22,6,5,3,27,10,51
45,100,387,36,351,3,348,12,40,150,24,4,0,2,46,2,68
45,101,190,17,173,4,169,4,45,63,15,3,0,2,10,4,23
45,102,299,44,255,3,252,5,54,98,21,3,0,0,32,4,35
45,103,1018,174,844,22,822,10,251,241,51,7,13,1,59,19,170
45,104,1728,284,1444,36,1408,17,411,360,172,23,9,2,92,42,280
45,105,72,7,65,2,63,9,8,21,4,1,3,0,3,4,10
45,106,318,62,256,5,251,6,79,65,29,3,0,1,14,5,49
45,107,250,25,225,1,224,1,50,71,24,1,1,0,21,6,49
45,108,1822,269,1553,29,1524,15,438,498,91,16,7,3,160,28,268
45,109,421,58,363,6,357,2,86,118,16,4,0,1,35,6,89
45,110,220,30,190,3,187,2,64,46,10,1,0,0,21,2,41
45,111,314,53,261,3,258,2,72,81,23,8,0,0,11,7,54
45,112,240,26,214,6,208,7,67,67,8,3,2,0,18,8,28
45,113,238,46,192,5,187,1,55,74,11,0,2,0,15,5,24
45,114,182,25,157,9,148,4,35,53,17,1,0,0,7,2,29
45,115,2919,606,2313,30,2283,24,626,810,170,19,12,5,185,42,390
45,116,689,91,598,13,585,7,170,161,62,7,2,2,39,11,124
45,118,241,38,203,3,200,0,50,73,13,3,1,0,28,2,30
45,119,1639,285,1354,26,1328,18,313,353,114,12,12,5,127,20,354
45,120,157,24,133,3,130,1,38,48,11,0,1,0,10,5,16
45,121,343,40,303,3,300,3,87,91,17,1,3,0,33,6,59
45,122,904,137,767,11,756,6,206,215,85,5,2,1,62,19,155
45,123,1463,211,1252,27,1225,25,251,334,127,18,4,1,121,29,315
45,124,137,35,102,2,100,1,31,26,8,1,1,0,13,0,19
45,125,88,9,79,4,75,1,22,14,8,2,0,0,5,0,23
45,126,1977,257,1720,30,1690,22,327,535,133,16,3,3,220,44,387
45,127,2131,443,1688,32,1656,17,445,450,169,14,11,1,110,39,400
45,129,780,154,626,11,615,12,187,217,35,10,1,3,30,15,105
45,130,886,133,753,14,739,11,161,212,75,9,2,5,70,18,176
45,131,258,24,234,1,233,7,53,62,25,2,2,1,21,5,55
45,132,271,42,229,2,227,0,70,65,25,4,4,1,10,2,46
45,133,314,38,276,3,273,5,91,85,13,5,2,0,18,16,38
45,134,918,104,814,14,800,11,179,312,67,2,3,1,70,24,131
45,135,216,32,184,0,184,4,46,65,14,2,0,1,13,3,36
45,136,418,51,367,6,361,4,111,112,24,8,1,1,23,8,69
45,137,502,68,434,10,424,7,127,123,37,5,3,1,43,4,74
45,138,59,4,55,1,54,1,7,24,2,2,0,0,9,3,6
45,139,410,56,354,6,348,8,77,132,35,4,1,1,30,3,57
45,141,122,23,99,1,98,0,36,29,9,2,0,0,3,2,17
45,142,2200,302,1898,33,1865,29,433,528,149,22,11,5,188,50,450
45,143,39,4,35,0,35,1,9,13,0,0,0,0,3,1,8
45,144,847,109,738,7,731,22,152,195,60,10,6,0,78,25,183
45,145,2611,503,2108,37,2071,29,482,632,194,20,18,4,200,55,437
45,146,5285,795,4490,79,4411,75,881,1233,420,50,28,21,382,87,1234
45,147,13096,2829,10267,192,10075,190,1916,2140,1285,99,64,16,951,158,3256
45,148,1207,210,997,24,973,6,301,284,87,14,5,4,65,17,190
45,149,216,26,190,4,186,5,78,43,15,3,1,0,9,5,27
45,150,149,15,134,3,131,1,27,62,6,2,1,0,15,3,14
45,151,206,30,176,4,172,4,59,47,14,4,0,0,11,4,29
45,152,162,12,150,4,146,2,34,58,8,0,1,0,13,6,24
45,153,497,55,442,7,435,6,106,146,43,4,0,0,31,9,90
45,154,1180,140,1040,20,1020,18,245,319,57,4,6,1,93,31,246
45,155,8787,2159,6628,121,6507,82,1558,1779,583,52,24,15,566,108,1740
45,156,477,77,400,8,392,2,121,111,35,7,2,2,46,10,56
45,157,316,57,259,5,254,2,50,86,26,3,1,2,27,9,48
45,158,294,54,240,10,230,0,54,77,22,1,4,0,18,9,45
45,159,156,30,126,5,121,1,33,51,3,1,2,0,9,8,13
45,160,501,86,415,8,407,6,109,168,29,4,4,0,29,6,52
45,161,618,90,528,6,522,10,132,178,43,6,2,0,57,8,86
45,162,380,52,328,6,322,4,95,106,19,1,5,1,16,6,69
45,164,452,69,383,5,378,6,105,121,30,1,4,1,28,9,73
45,165,497,71,426,4,422,14,106,140,44,3,3,1,26,13,72
45,166,182,22,160,3,157,5,40,71,9,2,0,0,6,2,22
45,167,1288,204,1084,19,1065,24,226,378,73,17,7,1,87,20,232
45,168,374,54,320,5,315,8,90,90,36,3,5,0,21,3,59
45,169,5873,958,4915,100,4815,98,912,1287,448,60,20,14,503,131,1342
45,170,76,9,67,5,62,0,15,22,4,0,1,0,8,1,11
45,171,414,50,364,12,352,2,90,124,20,4,3,2,23,14,70
45,173,3090,580,2510,42,2468,54,467,633,241,37,17,7,236,60,716
45,174,202,20,182,0,182,3,52,50,19,3,0,0,19,2,34
45,175,1086,139,947,16,931,22,140,290,97,7,9,3,113,19,231
45,176,314,44,270,3,267,2,79,104,16,4,1,1,23,5,32
45,177,148,26,122,7,115,1,34,24,7,2,1,0,19,2,25
45,178,962,204,758,12,746,9,160,242,63,11,2,2,67,19,171
45,179,1935,290,1645,38,1607,27,378,503,122,17,14,8,131,36,371
45,180,91,9,82,0,82,0,20,35,5,0,1,0,7,1,13
45,181,49,6,43,0,43,1,5,14,3,2,0,0,8,4,6
45,182,1082,155,927,12,915,18,161,317,70,9,5,2,97,14,222
45,183,92,10,82,1,81,1,20,22,5,0,0,0,18,0,15
45,184,329,56,273,7,266,8,69,92,15,4,3,1,23,2,49
45,185,221,23,198,7,191,5,58,61,12,0,1,0,21,1,32
45,186,367,67,300,2,298,9,106,106,11,3,2,0,20,8,33
45,187,1975,345,1630,26,1604,21,355,520,146,11,8,3,132,34,374
45,188,1887,314,1573,26,1547,22,339,399,140,13,16,5,170,45,398
45,189,244,28,216,1,215,1,67,74,14,1,1,1,21,4,31
45,190,165,18,147,1,146,2,34,49,20,1,1,1,9,5,24
45,191,3854,969,2885,67,2818,48,707,687,278,35,18,3,201,73,768
45,192,467,81,386,7,379,6,112,104,43,7,2,0,35,7,63
45,193,1640,212,1428,29,1399,31,240,454,133,9,11,3,141,31,346
45,194,1951,304,1647,28,1619,34,315,493,134,12,2,5,189,31,404
45,195,440,78,362,9,353,4,107,104,19,6,2,0,37,6,68
45,196,989,119,870,20,850,20,190,230,70,14,3,4,94,24,201
45,197,896,108,788,14,774,17,157,252,83,7,4,2,73,14,165
45,198,219,34,185,3,182,1,45,64,9,3,1,0,8,2,49
45,199,400,61,339,9,330,3,92,115,26,0,2,1,27,8,56
45,200,1111,116,995,15,980,23,172,345,98,16,7,3,88,15,213
45,201,154,19,135,1,134,0,55,36,7,1,0,0,12,2,21
45,202,732,114,618,10,608,11,129,180,81,6,4,3,55,6,133
45,203,4314,916,3398,54,3344,73,634,955,435,33,24,10,297,50,833
45,204,558,63,495,7,488,22,86,137,47,7,0,0,68,8,113
45,205,213,33,180,3,177,0,48,74,14,1,2,0,12,8,18
45,206,218,32,186,8,178,4,46,61,10,1,0,1,18,4,33
45,207,275,48,227,8,219,3,75,52,18,2,2,1,22,6,38
45,208,8876,2614,6262,117,6145,122,1217,1830,687,46,38,6,517,98,1584
45,209,241,34,207,3,204,4,62,52,20,1,4,0,12,6,43
45,210,542,73,469,4,465,4,119,178,42,2,5,2,30,18,65
45,211,329,38,291,5,286,5,92,82,27,1,2,0,23,4,50
45,212,966,150,816,12,804,16,192,256,62,7,4,3,69,25,170
45,213,497,57,440,8,432,7,124,146,34,7,4,0,29,14,67
45,214,172,16,156,2,154,2,44,61,8,2,2,0,10,3,22
45,215,165,14,151,1,150,2,24,59,16,3,0,0,12,5,29
45,216,97,8,89,3,86,0,27,29,4,0,2,1,6,0,17
45,217,147,20,127,1,126,1,40,36,7,0,2,0,16,3,21
45,218,128,11,117,1,116,3,37,38,13,1,0,0,9,4,11
45,219,137,29,108,3,105,3,31,28,4,2,0,0,13,8,16
45,220,402,52,350,11,339,4,107,88,36,1,3,1,28,2,69
45,221,88,10,78,3,75,0,15,31,10,0,0,0,5,2,12
45,222,980,147,833,24,809,12,241,258,66,15,4,3,55,13,142
45,223,279,37,242,6,236,4,73,66,21,2,1,0,14,7,48
45,224,2780,392,2388,58,2330,40,479,678,188,29,10,2,222,58,624
45,225,267,26,241,5,236,3,60,78,11,1,0,0,28,7,48
45,226,819,100,719,17,702,14,200,189,77,7,5,3,70,17,120
45,227,909,107,802,14,788,7,180,222,68,4,9,2,61,14,221
45,228,826,101,725,3,722,23,199,213,68,8,2,2,50,10,147
45,229,1774,423,1351,22,1329,32,326,377,123,23,12,3,95,40,298
45,230,557,88,469,14,455,7,108,156,41,4,3,0,53,16,67
45,231,94,9,85,0,85,1,17,35,5,2,1,0,5,1,18
45,232,13980,2316,11664,176,11488,298,1349,4142,870,74,42,29,1442,231,3011
45,233,318,65,253,3,250,5,66,76,21,3,3,0,16,4,56
45,234,60912,12368,48544,834,47710,1389,5788,13515,5168,433,227,113,4751,762,15564
45,235,2617,420,2197,50,2147,32,454,705,159,18,12,5,175,41,546
45,236,296,67,229,2,227,1,65,65,11,4,0,0,22,15,44
45,237,106,12,94,0,94,4,17,40,4,1,0,0,7,5,16
45,238,589,67,522,9,513,6,109,153,59,3,3,0,36,7,137
45,239,307,48,259,4,255,5,88,75,10,4,2,0,19,7,45
45,240,979,168,811,15,796,7,213,217,60,6,5,3,79,25,181
45,241,351,31,320,7,313,10,70,87,28,4,1,2,21,10,80
45,242,184,22,162,0,162,3,42,59,13,0,0,0,17,8,20
45,243,233,25,208,7,201,1,46,83,11,3,2,0,21,7,27
45,244,2115,368,1747,35,1712,14,478,384,233,28,10,6,144,33,382
45,245,907,123,784,10,774,8,243,240,57,8,11,4,53,13,137
45,246,74,9,65,3,62,0,23,18,2,1,1,0,5,2,10
45,247,2477,402,2075,44,2031,26,538,573,209,23,7,4,167,45,439
45,248,1334,245,1089,22,1067,9,260,349,73,11,13,5,103,24,220
45,249,772,99,673,17,656,18,113,180,69,6,0,1,68,25,176
45,250,168,16,152,1,151,5,42,47,9,3,0,0,16,6,23
45,251,274,59,215,0,215,7,55,54,11,3,0,0,25,8,52
45,252,4817,1284,3533,64,3469,36,692,938,333,51,18,6,262,59,1074
45,253,1399,272,1127,25,1102,15,273,333,97,10,6,2,127,17,222
45,254,1898,297,1601,29,1572,21,408,492,119,13,14,3,132,41,329
45,255,378,69,309,4,305,3,106,93,22,1,1,0,27,7,45
45,256,176,28,148,3,145,3,43,44,15,2,0,0,10,2,26
45,257,339,63,276,6,270,2,85,98,20,2,2,1,18,7,35
45,258,2243,489,1754,52,1702,22,429,489,147,26,13,7,179,41,349
45,259,909,128,781,18,763,12,169,311,63,5,6,4,51,22,120
45,260,168,28,140,3,137,1,36,42,14,0,1,0,11,0,32
45,261,973,111,862,18,844,17,186,219,79,8,8,2,90,28,207
45,262,111,17,94,1,93,0,23,30,10,2,2,0,7,1,18
45,263,182,28,154,4,150,1,41,55,8,2,2,0,9,2,30
45,264,140,21,119,2,117,1,24,44,4,0,1,0,9,3,31
45,265,287,46,241,2,239,2,82,66,21,3,0,0,11,10,44
45,266,189,25,164,5,159,0,43,66,12,1,1,0,10,6,20
45,267,216,43,173,1,172,4,62,41,10,4,1,1,23,3,23
45,268,446,75,371,11,360,2,92,117,23,3,0,1,24,12,86
45,269,2572,544,2028,30,1998,50,427,592,146,21,10,2,198,42,510
45,270,1408,220,1188,23,1165,12,280,423,73,14,4,2,127,30,200
45,271,784,88,696,15,681,10,145,213,68,5,6,1,68,19,146
45,272,2531,332,2199,41,2158,52,293,645,195,21,9,8,267,46,622
45,273,2079,358,1721,36,1685,34,363,474,147,16,11,3,143,38,456
45,274,5803,810,4993,107,4886,96,726,1699,394,38,21,9,591,103,1209
45,275,350,47,303,8,295,8,99,93,29,1,2,1,19,7,36
45,276,397,44,353,14,339,6,103,92,24,1,2,0,23,17,71
45,277,385,67,318,9,309,6,73,105,16,3,3,0,24,6,73
45,278,797,121,676,9,667,6,173,220,43,4,2,0,61,19,139
45,279,1266,194,1072,13,1059,20,297,311,93,11,6,2,77,23,219
45,280,842,102,740,14,726,3,195,234,59,8,2,1,68,27,129
45,281,714,118,596,6,590,12,169,192,44,2,0,1,48,24,98
45,282,2197,319,1878,38,1840,53,284,625,147,19,9,6,233,51,413
45,283,125,23,102,1,101,0,30,42,7,1,0,0,9,3,9
45,284,12545,2365,10180,176,10004,223,1676,2642,1027,104,52,18,961,179,3122
45,285,9750,2120,7630,144,7486,150,1355,1649,807,80,40,23,595,134,2653
45,286,5520,946,4574,81,4493,111,631,1520,404,39,11,12,520,86,1159
45,287,82,16,66,3,63,0,11,17,7,2,0,0,5,5,16
45,288,347,70,277,7,270,6,67,84,12,3,1,0,34,13,50
45,289,869,139,730,12,718,12,173,203,72,12,4,1,63,17,161
45,290,1165,149,1016,13,1003,21,232,306,88,14,8,4,84,23,223
45,291,953,102,851,22,829,11,216,255,80,8,5,0,61,20,173
45,292,693,118,575,9,566,16,133,198,41,10,5,3,36,19,105
45,293,826,124,702,12,690,13,185,214,62,3,4,5,63,11,130
45,294,128,27,101,0,101,1,27,42,8,0,1,0,5,2,15
45,296,497,73,424,8,416,2,98,144,31,7,3,0,36,17,78
45,297,769,106,663,13,650,5,179,219,37,7,4,0,67,10,122
45,298,4101,697,3404,45,3359,71,489,1229,266,26,10,8,357,66,837
45,299,201,24,177,4,173,0,39,51,13,3,3,1,15,8,40
45,300,2912,370,2542,61,2481,43,433,767,188,40,7,5,247,51,700
45,301,282,34,248,8,240,5,67,64,20,5,0,1,24,6,48
45,302,10732,2145,8587,162,8425,126,1641,1871,1151,92,66,21,743,130,2584
45,303,426,53,373,3,370,4,93,134,30,3,4,1,19,17,65
45,305,123,7,116,2,114,2,23,37,17,0,2,0,4,4,25
45,306,601,106,495,12,483,9,137,161,36,3,2,1,46,11,77
45,307,672,93,579,13,566,11,149,189,60,3,4,2,36,13,99
45,308,2393,351,2042,41,2001,47,332,521,197,20,20,5,228,49,582
45,309,496,62,434,12,422,3,110,161,18,3,3,1,33,8,82
45,310,1045,177,868,10,858,10,241,248,70,15,6,1,60,26,181
45,311,462,69,393,5,388,12,96,118,36,4,2,0,36,7,77
45,312,346,51,295,4,291,12,83,79,17,4,0,0,23,13,60
45,313,663,115,548,8,540,3,164,159,44,2,3,1,39,15,110
45,314,293,49,244,1,243,6,48,66,30,1,3,1,22,4,62
45,315,3705,858,2847,40,2807,33,640,830,250,25,20,3,236,47,723
45,316,596,96,500,4,496,14,135,150,22,11,1,0,52,7,104
45,317,1082,177,905,15,890,26,130,300,74,7,8,2,91,16,236
45,320,238,28,210,2,208,3,51,49,32,3,2,0,22,3,43
45,321,443,49,394,15,379,7,104,112,34,4,5,0,27,12,74
45,322,125,29,96,3,93,1,27,20,13,1,1,1,8,4,17
45,323,181,28,153,1,152,2,36,54,2,5,0,0,20,6,27
45,324,1661,239,1422,22,1400,28,313,453,126,11,3,1,117,26,322
45,325,183,33,150,3,147,2,38,56,12,0,0,0,15,2,22
45,326,274,33,241,7,234,5,47,98,10,7,2,1,17,2,45
45,327,2342,418,1924,34,1890,31,399,499,176,23,10,4,186,49,513
45,328,223,28,195,6,189,4,52,55,16,0,1,0,17,4,40
45,329,1019,149,870,14,856,11,261,273,77,14,4,1,52,22,141
45,330,171,19,152,0,152,0,39,56,10,0,0,0,20,3,24
45,331,514,81,433,5,428,7,93,135,34,2,5,2,20,3,127
45,332,1134,202,932,21,911,7,314,297,47,12,3,3,59,21,148
45,333,1021,152,869,15,854,15,190,254,64,7,4,2,84,30,204
45,334,463,57,406,14,392,9,98,97,43,8,6,1,33,17,80
45,335,1342,174,1168,31,1137,24,257,294,131,14,3,5,118,36,255
45,336,674,75,599,5,594,8,167,193,31,9,5,3,39,23,116
45,337,227,41,186,2,184,2,37,79,11,2,0,1,20,7,25
45,338,4803,840,3963,86,3877,55,1007,1267,299,27,20,9,309,94,790
45,339,365,39,326,5,321,3,92,107,13,3,4,0,40,12,47
45,340,389,55,334,1,333,2,92,130,18,5,2,2,14,8,60
45,341,169,22,147,2,145,2,46,53,13,1,2,0,6,5,17
45,342,291,39,252,6,246,3,57,61,29,7,2,0,23,9,55
45,343,164,22,142,3,139,2,43,49,8,0,0,0,10,7,20
45,344,879,143,736,15,721,14,179,193,70,7,2,0,60,23,173
45,345,803,109,694,19,675,13,186,190,61,10,7,5,63,13,127
45,346,1373,191,1182,22,1160,19,241,382,90,7,2,5,114,15,285
45,347,619,102,517,12,505,8,141,132,56,4,3,0,36,7,118
45,348,599,78,521,16,505,14,128,163,30,6,2,1,41,11,109
46,1,503,80,423,4,419,19,43,88,73,7,4,1,39,8,137
46,2,72,5,67,3,64,1,13,19,9,1,0,0,8,2,11
46,3,576,75,501,11,490,15,58,114,79,5,5,3,39,18,154
46,4,167,23,144,3,141,4,8,25,16,7,2,1,21,2,55
46,5,270,33,237,5,232,6,21,63,27,6,5,2,27,0,75
46,6,278,47,231,7,224,10,28,43,56,4,2,0,7,2,72
46,7,730,94,636,14,622,16,93,130,87,11,3,4,58,14,206
46,8,157,28,129,4,125,6,14,25,22,0,0,0,16,1,41
46,9,462,60,402,8,394,16,35,65,73,11,1,0,37,6,150
46,10,256,23,233,0,233,13,27,46,41,2,0,1,15,2,86
46,11,299,28,271,5,266,3,45,48,36,3,4,0,26,7,94
46,12,511,70,441,6,435,13,46,77,74,10,2,0,47,7,159
46,13,150,26,124,2,122,3,17,31,12,6,2,0,14,1,36
46,14,174,24,150,3,147,7,19,36,15,2,3,1,31,1,32
46,15,1264,219,1045,32,1013,10,166,249,127,12,6,1,109,14,319
46,16,325,48,277,6,271,9,31,52,35,5,1,0,34,11,93
46,17,129,10,119,1,118,1,12,37,15,0,1,1,22,1,28
46,18,109,9,100,3,97,0,18,28,16,2,0,1,14,0,18
46,19,63,7,56,0,56,2,9,17,7,1,0,1,5,3,11
46,20,200,22,178,4,174,10,9,28,32,1,0,0,12,3,79
46,21,594,82,512,21,491,16,72,90,83,9,1,0,34,9,177
46,22,180,25,155,0,155,15,9,23,35,4,1,0,16,6,46
46,23,406,51,355,9,346,10,52,95,64,7,2,0,34,6,76
46,24,309,25,284,11,273,2,39,50,31,1,2,0,22,7,119
46,25,137,28,109,2,107,7,16,20,18,1,0,0,10,0,35
46,26,108,12,96,1,95,3,20,43,3,0,0,0,8,2,16
46,27,95,4,91,4,87,5,12,23,12,0,1,0,9,3,22
46,28,794,91,703,13,690,11,104,159,78,6,3,2,77,19,231
46,29,1425,184,1241,22,1219,19,152,207,212,14,5,3,71,21,515
46,30,267,15,252,10,242,8,30,57,20,4,0,0,23,15,85
46,31,118,18,100,0,100,2,16,38,10,0,0,0,4,2,28
46,32,290,23,267,10,257,13,28,44,32,4,2,1,13,5,115
46,33,172,23,149,2,147,5,20,35,19,4,3,0,24,3,34
46,34,233,30,203,6,197,9,29,31,27,5,1,1,15,6,73
46,35,138,18,120,2,118,2,4,13,24,0,0,0,20,2,53
46,36,97,11,86,1,85,2,10,20,11,2,0,0,11,4,25
46,37,78,6,72,1,71,4,8,14,17,0,0,0,12,1,15
46,38,958,119,839,20,819,15,113,204,75,8,5,1,63,12,323
46,39,161,24,137,2,135,6,13,42,17,4,0,1,11,3,38
46,40,187,33,154,3,151,5,17,35,23,4,0,0,13,2,52
46,41,135,13,122,3,119,2,18,36,11,4,2,0,7,3,36
46,42,13839,2566,11273,174,11099,315,1443,2232,1591,161,44,19,942,177,4175
46,43,181,20,161,4,157,5,22,28,21,1,0,0,13,1,66
46,44,468,54,414,10,404,13,51,80,66,6,0,1,36,9,142
46,45,960,134,826,21,805,29,85,212,104,8,9,4,74,12,268
46,46,371,41,330,7,323,11,52,64,53,3,3,0,27,4,106
46,47,155,19,136,1,135,1,13,51,8,0,0,1,18,8,35
46,48,173,33,140,3,137,0,20,35,7,1,1,0,15,3,55
46,49,169,15,154,4,150,6,19,33,25,4,0,1,7,2,53
46,50,126,11,115,0,115,2,12,22,26,4,0,0,10,0,39
46,51,281,28,253,6,247,5,42,32,58,5,1,0,26,5,73
46,52,200,17,183,4,179,4,29,56,29,2,1,1,15,3,39
46,53,336,32,304,4,300,14,40,70,31,3,2,2,34,6,98
46,54,235,27,208,3,205,11,31,39,35,0,0,0,24,5,60
46,55,896,118,778,18,760,23,96,158,120,8,3,0,78,10,264
46,56,67,5,62,0,62,1,7,5,13,1,0,0,6,0,29
46,57,464,60,404,7,397,13,58,73,58,5,1,0,27,4,158
46,58,371,40,331,15,316,11,31,70,47,5,4,0,36,2,110
46,59,177,15,162,0,162,5,33,22,21,5,4,1,16,3,52
46,60,215,32,183,12,171,11,42,33,15,0,2,1,11,3,53
46,61,159,24,135,1,134,6,27,27,9,6,2,1,6,8,42
46,62,255,30,225,6,219,8,39,46,32,5,0,0,15,4,70
46,63,1518,226,1292,23,1269,28,203,346,184,13,5,1,129,26,334
46,64,623,83,540,12,528,9,84,125,86,7,6,2,29,8,172
46,65,317,36,281,11,270,2,51,55,29,2,1,1,24,7,98
46,66,470,54,416,3,413,3,65,133,49,7,0,1,37,10,108
46,67,332,40,292,4,288,10,32,58,37,4,4,1,35,6,101
46,68,166,19,147,4,143,3,7,35,27,1,1,1,11,2,55
46,69,154,21,133,4,129,3,34,27,12,1,1,0,12,3,36
46,70,360,41,319,5,314,12,49,69,44,2,0,1,23,5,109
46,71,195,24,171,7,164,5,14,26,14,0,1,0,23,4,77
46,72,306,35,271,3,268,4,38,59,40,3,6,0,24,0,94
46,73,354,39,315,4,311,32,31,71,67,3,2,0,29,3,73
46,74,290,37,253,4,249,3,37,37,37,4,3,3,24,2,99
46,75,171,22,149,8,141,9,11,25,24,3,1,0,12,6,50
46,76,276,28,248,8,240,7,28,45,22,4,2,1,28,3,100
46,77,251,22,229,11,218,13,33,44,28,7,1,0,16,6,70
46,78,94,23,71,1,70,0,10,19,21,0,0,0,8,4,8
46,79,80,8,72,2,70,0,14,20,11,1,0,0,5,0,19
46,80,499,44,455,10,445,20,83,89,60,3,2,2,30,6,150
46,81,73,23,50,0,50,3,3,12,11,0,0,0,8,0,13
46,82,289,29,260,10,250,14,36,55,38,1,0,0,34,3,69
46,83,524,48,476,6,470,10,78,120,52,2,1,1,52,5,149
46,84,252,25,227,4,223,2,33,47,35,0,0,1,27,10,68
46,85,167,13,154,3,151,5,14,26,33,1,3,0,13,3,53
46,86,421,33,388,12,376,9,60,87,45,7,2,3,29,13,121
46,87,540,96,444,6,438,10,89,88,64,3,4,1,29,13,137
46,88,652,81,571,6,565,14,68,117,74,9,5,1,67,11,199
46,89,737,115,622,16,606,7,97,136,99,10,2,0,53,16,186
46,90,125,9,116,3,113,5,7,26,12,4,1,0,16,1,41
46,91,143,15,128,2,126,7,12,32,23,0,0,0,16,1,35
46,92,189,16,173,4,169,7,42,34,34,5,0,0,5,6,36
46,93,78,6,72,1,71,2,4,19,7,3,0,0,5,0,31
46,94,246,29,217,5,212,6,26,39,39,3,1,1,13,5,79
46,95,707,85,622,11,611,11,90,91,133,9,4,2,31,10,230
46,96,103,18,85,3,82,1,10,21,10,3,0,0,12,0,25
46,97,87,12,75,5,70,0,10,27,2,4,0,0,9,3,15
46,98,227,19,208,4,204,4,21,22,53,8,1,1,15,2,77
46,99,122,15,107,2,105,5,21,19,17,0,0,2,24,1,16
46,100,544,49,495,9,486,16,42,75,99,6,2,0,48,5,193
46,101,321,36,285,12,273,5,35,59,42,4,4,0,27,5,92
46,102,6688,1191,5497,103,5394,142,508,1150,805,67,30,18,521,87,2066
46,103,358,36,322,7,315,7,51,66,45,2,0,2,43,3,96
46,104,90,14,76,2,74,2,14,16,10,1,0,0,5,0,26
46,105,599,45,554,11,543,19,86,103,70,9,2,0,38,17,199
46,106,253,45,208,6,202,8,19,43,28,2,2,1,25,7,67
46,107,130,28,102,3,99,2,12,19,19,1,0,0,12,1,33
46,108,334,44,290,9,281,12,31,55,58,4,1,2,26,4,88
46,109,351,38,313,3,310,9,57,75,44,5,2,1,29,5,83
46,110,78,6,72,3,69,2,2,28,1,0,0,1,14,0,21
46,111,118,9,109,2,107,6,9,30,24,3,0,0,9,2,24
46,112,178,22,156,2,154,6,18,33,32,0,1,2,15,1,46
46,113,251,38,213,5,208,8,37,60,21,1,0,0,20,5,56
46,114,338,53,285,6,279,4,51,64,44,6,3,0,16,3,88
46,115,160,17,143,0,143,9,16,40,25,0,2,0,23,0,28
46,116,59,5,54,0,54,3,2,22,8,1,2,0,5,0,11
46,117,559,63,496,9,487,9,60,96,54,6,3,1,39,12,207
46,118,560,55,505,12,493,7,87,55,60,9,1,4,53,14,203
46,119,176,14,162,5,157,2,16,51,21,3,0,0,19,4,41
46,120,268,39,229,9,220,2,36,34,42,3,3,0,19,6,75
46,121,151,18,133,2,131,1,20,21,14,3,1,0,16,2,53
46,122,85,9,76,1,75,0,11,15,9,1,0,0,8,4,27
46,123,303,26,277,7,270,3,38,40,29,2,2,0,30,6,120
46,124,224,24,200,9,191,2,26,51,10,3,0,0,29,6,64
46,125,286,54,232,7,225,7,20,56,28,1,1,2,29,7,74
46,126,153,17,136,2,134,4,17,35,28,3,4,1,10,1,31
46,127,3460,553,2907,68,2839,54,393,659,370,35,20,8,236,41,1023
46,128,2659,423,2236,33,2203,40,302,495,291,41,14,10,210,44,756
46,129,228,26,202,1,201,7,29,38,32,2,3,1,22,5,62
46,130,195,23,172,12,160,5,34,39,25,2,1,0,19,1,34
46,131,163,20,143,2,141,5,22,18,21,2,1,0,15,8,49
46,132,389,51,338,10,328,4,53,70,46,5,2,0,18,8,122
46,133,195,31,164,3,161,10,20,24,25,1,0,0,12,5,64
46,134,194,28,166,4,162,6,21,22,35,2,3,2,6,4,61
46,135,52,10,42,3,39,1,2,18,4,0,1,0,4,2,7
46,136,205,29,176,2,174,10,18,30,28,5,2,0,6,6,69
46,137,923,101,822,16,806,22,162,163,121,9,5,2,97,16,209
46,138,521,61,460,8,452,9,65,153,43,10,0,0,36,10,126
46,139,184,15,169,5,164,9,22,21,28,2,1,2,14,3,62
46,140,234,23,211,4,207,4,33,37,31,3,1,0,24,6,68
46,141,93,17,76,2,74,3,7,5,21,2,0,0,8,2,26
46,142,128,12,116,3,113,5,24,14,14,3,1,0,12,2,38
46,143,960,146,814,19,795,22,113,162,119,12,9,1,68,10,279
46,144,250,26,224,4,220,9,24,55,27,3,2,0,30,3,67
46,145,632,69,563,15,548,2,90,123,76,7,4,2,36,14,194
46,146,103,14,89,3,86,1,11,21,22,0,0,0,7,2,22
46,147,112,18,94,3,91,1,15,18,6,1,0,1,11,2,36
46,148,1223,135,1088,14,1074,29,160,203,209,9,5,4,95,29,331
46,149,634,68,566,10,556,20,85,94,74,13,3,0,56,12,199
46,150,69,20,49,2,47,1,2,13,3,3,0,0,7,2,16
46,151,109,13,96,1,95,1,16,14,23,0,0,0,7,1,33
46,152,249,39,210,5,205,8,28,47,53,3,3,0,18,0,45
46,153,502,58,444,15,429,4,73,80,71,12,3,0,38,6,142
46,154,260,32,228,8,220,10,39,55,25,2,0,0,24,3,62
46,155,129,18,111,3,108,3,8,36,20,0,2,0,9,2,28
46,156,389,44,345,3,342,8,39,83,41,3,2,3,24,8,131
46,157,119,12,107,2,105,1,12,36,13,4,0,1,9,2,27
46,158,170,24,146,1,145,8,30,35,17,1,0,1,18,3,32
46,159,198,31,167,1,166,9,22,31,24,1,1,2,18,4,54
46,160,376,53,323,10,313,9,32,47,30,10,3,0,41,5,136
46,161,258,48,210,5,205,2,20,39,31,4,2,1,29,3,74
46,162,144,17,127,4,123,5,22,24,11,1,0,2,14,2,42
46,163,261,48,213,6,207,7,33,25,38,1,2,2,13,1,85
46,164,184,26,158,3,155,3,20,32,22,1,1,2,10,4,60
46,165,358,41,317,7,310,3,31,74,43,5,3,1,22,8,120
46,166,123,22,101,4,97,2,21,35,4,1,0,1,5,1,27
46,167,100,12,88,2,86,3,15,21,5,3,0,0,9,5,25
46,168,137,14,123,2,121,5,19,25,16,2,0,0,15,1,38
46,169,180,14,166,4,162,6,19,40,21,1,0,0,20,4,51
46,170,591,69,522,3,519,9,43,56,123,7,3,1,35,4,238
46,171,176,21,155,2,153,6,20,34,21,0,0,0,14,4,54
46,172,389,62,327,10,317,9,37,63,46,8,5,0,42,10,97
46,173,613,69,544,16,528,19,71,138,82,9,0,2,46,13,148
46,174,165,27,138,2,136,3,18,38,15,1,0,0,12,6,43
46,175,693,84,609,13,596,23,69,82,120,5,3,3,46,13,232
46,176,514,57,457,13,444,6,58,97,84,7,0,1,37,5,149
46,177,426,45,381,6,375,9,63,62,44,6,1,4,50,9,127
46,178,218,31,187,4,183,4,27,29,30,6,2,0,15,1,69
46,179,115,21,94,1,93,9,10,20,13,3,0,0,4,2,32
46,180,400,46,354,5,349,7,48,60,60,3,1,0,39,10,121
46,181,68,3,65,0,65,0,3,18,13,2,0,0,7,4,18
46,182,1198,173,1025,17,1008,24,120,262,156,8,1,1,90,20,326
46,183,211,24,187,1,186,8,14,39,55,1,3,0,18,5,43
46,184,299,39,260,10,250,9,34,54,53,3,3,0,23,6,65
46,185,1314,163,1151,24,1127,19,151,280,141,23,7,3,100,31,372
46,186,256,27,229,5,224,2,30,39,52,5,4,0,15,3,74
46,187,362,70,292,4,288,10,62,54,43,4,0,1,26,6,82
46,188,225,29,196,5,191,8,20,37,24,3,1,2,19,2,75
46,189,385,52,333,1,332,6,27,61,41,6,0,3,46,10,132
46,190,115,11,104,1,103,4,14,18,24,2,2,0,8,0,31
46,191,734,107,627,11,616,13,124,125,76,7,2,2,39,14,214
46,192,258,29,229,7,222,3,16,63,32,4,0,2,17,5,80
46,193,339,30,309,7,302,5,59,73,25,3,3,0,30,9,95
46,194,183,25,158,11,147,3,18,43,27,2,1,0,11,3,39
46,195,315,41,274,8,266,9,25,64,41,2,0,1,30,1,93
46,196,104,12,92,1,91,3,11,14,6,1,0,0,10,0,46
46,197,833,106,727,12,715,21,128,116,86,11,2,0,77,26,248
46,198,80,10,70,2,68,3,6,18,9,0,0,0,9,3,20
46,199,287,38,249,4,245,8,41,63,27,2,1,0,22,9,72
46,200,281,33,248,3,245,2,42,55,45,5,2,0,17,2,75
46,201,908,135,773,8,765,29,108,212,92,8,3,3,82,14,214
46,202,368,28,340,6,334,4,55,76,52,2,0,2,35,5,103
46,203,187,23,164,5,159,4,31,31,19,1,2,1,22,4,44
46,204,318,38,280,7,273,10,21,78,33,4,2,1,24,8,92
46,205,235,20,215,4,211,7,32,55,32,3,0,0,15,7,60
46,206,84,4,80,1,79,2,8,19,10,2,1,0,16,0,21
46,207,193,26,167,3,164,4,15,46,18,3,0,0,24,2,52
46,208,286,42,244,4,240,9,23,59,39,3,1,0,9,4,93
46,209,151,12,139,5,134,2,15,20,18,3,1,0,10,3,62
46,210,55,9,46,0,46,0,7,8,4,1,0,1,9,1,15
46,211,261,33,228,6,222,8,37,23,40,0,1,0,16,0,97
46,212,85,12,73,1,72,7,9,16,10,1,0,0,6,1,22
46,213,157,19,138,1,137,7,13,32,22,1,0,0,19,5,38
46,214,350,38,312,9,303,7,27,78,50,2,0,1,40,6,92
46,215,544,83,461,7,454,8,71,107,81,7,3,4,32,10,131
46,216,564,84,480,12,468,12,70,76,89,3,2,1,35,12,168
46,217,356,34,322,3,319,12,42,68,42,4,1,0,48,5,97
46,218,104,12,92,3,89,2,21,15,5,3,1,1,14,4,23
46,219,298,51,247,5,242,3,29,52,33,8,1,3,24,4,85
46,220,618,62,556,12,544,8,68,116,67,8,1,2,51,6,217
46,221,381,45,336,8,328,8,26,70,50,4,3,1,45,9,112
46,222,140,14,126,2,124,1,12,29,20,1,2,0,11,3,45
46,223,158,17,141,1,140,9,17,23,26,5,0,0,12,1,47
46,224,2509,324,2185,40,2145,40,286,364,315,29,8,1,177,43,882
46,225,1903,321,1582,37,1545,38,230,381,182,22,5,8,133,34,512
46,226,181,25,156,2,154,10,14,30,35,3,1,0,12,2,47
46,227,187,28,159,3,156,7,22,34,21,3,0,0,11,1,57
46,228,589,71,518,15,503,16,62,114,69,5,4,5,62,12,154
46,229,704,88,616,8,608,10,93,111,50,15,3,1,48,12,265
46,230,71,10,61,2,59,3,8,18,5,0,0,0,12,0,13
46,231,1606,284,1322,20,1302,29,238,312,163,17,10,5,106,19,403
46,232,451,51,400,6,394,6,56,98,43,6,3,0,28,5,149
46,233,107,15,92,3,89,4,6,18,10,1,1,1,1,1,46
46,234,93,18,75,3,72,2,14,5,18,2,2,1,7,4,17
46,235,144,13,131,2,129,3,12,23,20,7,1,0,13,1,49
46,236,114,13,101,2,99,2,15,30,11,1,1,0,6,3,30
46,237,257,26,231,9,222,2,32,42,33,5,1,3,23,9,72
46,238,251,25,226,2,224,10,11,40,30,7,1,1,27,4,93
46,239,188,29,159,3,156,3,29,34,19,2,1,0,13,1,54
46,240,499,61,438,12,426,11,52,151,31,3,3,2,54,11,108
46,241,143,13,130,1,129,9,6,22,24,5,1,0,13,0,49
46,242,162,18,144,2,142,5,6,29,14,0,2,0,21,4,61
46,243,169,36,133,1,132,5,12,31,18,5,0,1,14,3,43
46,244,92,10,82,2,80,5,6,20,15,0,0,1,6,1,26
46,245,84,18,66,2,64,1,16,12,8,1,0,0,7,2,17
46,246,62,7,55,2,53,3,5,10,10,3,1,1,7,2,11
46,247,137,15,122,3,119,8,10,16,15,5,0,0,16,8,41
46,248,96,10,86,0,86,1,16,22,7,3,0,0,15,3,19
46,249,121,14,107,2,105,10,6,29,15,6,0,0,4,2,33
46,250,74,8,66,1,65,3,10,18,4,4,0,0,7,2,17
46,251,2663,427,2236,41,2195,43,212,514,274,29,14,3,192,39,875
46,252,199,19,180,5,175,4,20,38,17,4,4,0,21,3,64
46,253,194,15,179,3,176,8,23,36,29,3,2,0,13,6,56
46,254,147,14,133,2,131,3,12,37,18,1,0,0,17,2,41
46,255,298,49,249,8,241,4,38,58,26,7,1,0,41,4,62
46,256,220,27,193,2,191,9,18,34,50,6,4,1,17,3,49
46,257,103,10,93,0,93,1,18,19,18,1,0,2,13,3,18
46,258,116,8,108,0,108,1,15,20,17,4,1,1,9,3,37
46,259,147,11,136,7,129,5,14,21,17,0,0,0,6,2,64
46,260,160,19,141,4,137,2,15,35,12,2,0,0,25,1,45
46,261,43,5,38,0,38,1,3,12,6,2,0,0,6,0,8
46,262,229,40,189,7,182,9,22,45,17,6,1,1,23,10,48
46,263,169,30,139,1,138,8,21,36,8,2,0,0,21,6,36
46,264,153,18,135,3,132,2,23,31,19,3,1,0,5,1,47
46,265,297,56,241,4,237,6,45,53,19,3,2,1,19,9,80
46,266,342,36,306,7,299,1,44,57,46,4,0,0,41,7,99
46,267,442,53,389,5,384,10,51,46,69,4,3,0,51,7,143
46,268,355,45,310,8,302,13,46,60,52,3,0,0,24,7,97
46,269,70,16,54,3,51,2,3,17,3,0,0,0,3,1,22
46,270,209,14,195,5,190,4,23,52,30,3,1,0,17,2,58
46,271,340,31,309,6,303,6,33,71,31,3,2,0,31,4,122
46,272,196,26,170,4,166,5,30,29,37,2,0,0,16,5,42
46,273,776,84,692,12,680,4,120,155,64,9,4,0,75,12,237
46,274,171,24,147,2,145,15,23,27,22,2,1,0,16,3,36
46,275,113,14,99,1,98,5,8,13,12,0,1,0,13,1,45
46,276,173,20,153,6,147,7,9,27,28,3,0,0,25,2,46
46,277,161,23,138,2,136,3,38,35,9,1,3,0,7,2,38
46,278,92,13,79,1,78,1,9,16,10,0,0,0,2,4,36
46,279,188,18,170,0,170,1,21,42,10,1,0,0,33,6,56
46,280,151,15,136,3,133,9,12,26,23,2,0,0,3,1,57
46,281,170,21,149,2,147,1,17,32,19,0,2,0,20,2,54
46,282,75,11,64,2,62,0,12,11,8,2,1,0,5,0,23
46,283,272,41,231,6,225,7,35,31,37,3,1,0,14,8,89
46,284,305,31,274,5,269,6,39,52,31,5,1,1,27,8,99
46,285,171,19,152,2,150,4,23,24,24,1,0,0,9,2,63
46,286,175,18,157,4,153,5,24,25,16,1,1,0,20,6,55
46,287,451,55,396,4,392,19,55,90,67,6,2,0,40,13,100
46,288,176,22,154,7,147,8,22,31,31,2,0,0,16,2,35
46,289,106,11,95,0,95,1,6,23,13,2,1,0,11,0,38
46,290,296,31,265,2,263,4,43,68,31,3,3,0,18,7,86
46,291,48,4,44,1,43,1,12,9,6,0,0,0,6,0,9
46,292,132,15,117,0,117,6,12,17,16,3,0,2,14,3,44
46,293,416,44,372,8,364,6,30,66,55,2,4,1,25,13,162
46,294,133,14,119,4,115,2,8,23,23,2,1,0,10,1,45
46,295,156,18,138,2,136,5,17,36,7,3,1,0,17,2,48
46,296,445,59,386,5,381,14,33,95,68,2,3,0,39,0,127
46,297,901,164,737,13,724,17,106,172,142,9,8,3,58,10,199
46,298,476,60,416,7,409,12,43,116,38,8,0,0,38,6,148
46,299,117,14,103,1,102,4,6,19,21,0,0,0,12,0,40
46,300,100,15,85,0,85,1,14,22,9,1,1,0,8,3,26
46,301,391,36,355,6,349,12,35,67,53,10,3,1,23,2,143
46,302,133,20,113,4,109,0,17,11,9,2,3,0,21,6,40
46,303,132,19,113,3,110,2,6,27,23,4,1,1,17,0,29
46,304,126,22,104,3,101,3,10,30,12,4,1,0,11,1,29
46,305,257,39,218,3,215,7,41,54,36,5,1,0,16,4,51
46,306,75,9,66,2,64,2,7,14,14,0,0,0,6,3,18
46,307,491,72,419,14,405,4,69,76,70,5,4,1,37,7,132
46,308,90,19,71,2,69,3,11,23,5,0,0,0,5,0,22
46,309,2525,434,2091,44,2047,31,293,534,246,32,9,6,159,48,689
46,310,101,9,92,5,87,0,7,30,9,1,0,0,10,0,30
46,311,705,98,607,16,591,14,68,112,63,10,2,0,57,8,257
46,312,229,22,207,3,204,9,35,28,30,3,0,0,16,4,79
46,313,288,27,261,9,252,0,31,45,35,4,5,1,21,4,106
46,314,187,18,169,7,162,3,16,18,20,2,0,1,18,4,80
46,315,166,21,145,4,141,4,14,26,22,2,2,0,15,0,56
46,316,258,41,217,5,212,9,26,33,38,3,1,3,11,2,86
46,317,400,37,363,3,360,2,49,71,67,3,0,1,38,5,124
46,318,202,21,181,2,179,5,14,41,34,4,1,0,23,5,52
46,319,135,16,119,2,117,7,20,18,31,1,1,0,10,1,28
46,320,276,37,239,2,237,9,36,47,42,1,2,0,21,3,76
46,321,278,48,230,1,229,2,40,44,34,2,2,1,26,2,76
46,322,608,65,543,10,533,11,83,110,79,6,4,2,32,7,199
46,323,81,11,70,4,66,1,18,15,9,1,0,0,7,2,13
46,324,194,28,166,6,160,4,19,27,24,1,0,0,16,2,67
46,325,99,12,87,2,85,4,12,26,6,1,0,1,5,2,28
46,326,116,19,97,3,94,3,18,23,17,3,0,0,9,3,18
46,327,358,35,323,6,317,12,51,47,47,9,2,1,24,6,118
46,328,283,41,242,10,232,13,34,48,36,5,0,0,31,4,61
46,329,188,24,164,0,164,7,19,43,20,2,0,1,23,5,44
46,330,951,144,807,20,787,13,122,185,90,13,4,2,57,17,284
46,331,343,43,300,5,295,16,42,76,57,2,0,1,29,2,70
46,332,269,41,228,4,224,10,28,48,42,3,0,2,29,0,62
46,333,161,22,139,4,135,5,22,24,26,2,1,0,17,6,32
46,334,1142,155,987,20,967,26,153,219,134,12,1,6,65,30,321
46,335,342,33,309,8,301,10,43,60,39,7,1,2,31,9,99
46,336,287,36,251,6,245,5,32,38,32,7,1,0,46,4,80
46,337,224,43,181,1,180,2,23,43,14,2,2,1,20,4,69
46,338,83,14,69,5,64,1,5,16,2,0,0,0,7,3,30
46,339,278,25,253,8,245,3,36,31,37,3,0,1,29,1,104
46,340,266,33,233,5,228,7,48,42,25,2,1,0,31,1,71
47,1,18112,3550,14562,291,14271,381,2452,3642,1710,180,61,25,1232,218,4370
47,2,100,8,92,4,88,2,15,27,8,0,0,2,12,0,22
47,3,327,34,293,4,289,7,49,82,49,7,2,0,27,4,62
47,4,2905,613,2292,54,2238,40,489,575,270,29,8,6,166,24,631
47,5,383,49,334,10,324,4,68,86,28,7,2,1,29,6,93
47,6,446,65,381,3,378,6,75,92,42,9,0,0,36,13,105
47,7,146,18,128,4,124,10,15,24,23,1,1,0,8,2,40
47,8,93,7,86,0,86,3,22,12,13,0,3,0,6,3,24
47,9,195,37,158,0,158,1,30,58,18,3,1,0,11,4,32
47,10,148,18,130,1,129,5,21,28,18,1,1,0,14,1,40
47,11,139,23,116,3,113,0,32,26,15,3,2,0,9,3,23
47,12,225,34,191,2,189,5,55,41,16,3,0,1,12,2,54
47,13,269,51,218,6,212,4,54,56,52,6,1,1,5,4,29
47,14,149,29,120,1,119,2,22,29,22,1,0,1,10,1,31
47,15,1537,222,1315,44,1271,28,262,357,123,21,10,3,111,24,332
47,16,799,83,716,16,700,11,158,190,92,10,3,2,73,11,150
47,17,265,50,215,4,211,0,66,47,18,2,2,1,25,6,44
47,18,142,23,119,3,116,1,27,38,6,2,0,0,15,1,26
47,19,797,118,679,12,667,20,174,128,80,8,2,1,51,12,191
47,20,126,18,108,2,106,4,13,31,20,0,1,0,13,1,23
47,21,1129,180,949,28,921,16,227,181,134,9,5,1,71,19,258
47,22,384,54,330,6,324,11,81,80,56,6,1,0,28,7,54
47,23,241,23,218,3,215,5,47,58,29,5,0,0,38,3,30
47,24,1086,141,945,15,930,12,201,273,80,9,5,3,90,10,247
47,25,413,69,344,7,337,4,57,75,36,2,9,2,41,7,104
47,26,214,33,181,3,178,7,37,29,31,3,2,0,19,1,49
47,27,2482,477,2005,41,1964,37,444,456,219,23,9,5,175,30,566
47,28,609,85,524,5,519,5,139,140,42,5,6,0,56,13,113
47,29,385,58,327,14,313,6,55,70,39,6,2,2,17,4,112
47,30,200,37,163,1,162,5,39,33,19,4,2,1,11,4,44
47,31,3935,628,3307,53,3254,38,809,775,332,45,16,5,246,51,937
47,32,4834,777,4057,79,3978,80,790,982,484,45,25,11,377,66,1118
47,33,277,25,252,4,248,10,53,59,32,3,5,1,39,4,42
47,34,449,65,384,6,378,4,104,106,60,8,1,2,26,4,63
47,35,200,24,176,1,175,3,44,46,17,3,1,1,23,4,33
47,36,274,47,227,6,221,0,62,65,22,4,0,2,22,4,40
47,37,158,21,137,2,135,3,34,34,10,3,0,0,15,5,31
47,38,454,63,391,7,384,7,97,114,30,8,3,1,45,3,76
47,39,38,5,33,0,33,0,6,2,11,0,1,0,4,0,9
47,40,1405,165,1240,25,1215,15,243,326,109,4,3,1,132,19,363
47,41,603,102,501,14,487,10,101,167,46,5,3,2,49,8,96
47,42,132,16,116,2,114,4,20,38,13,1,1,0,6,1,30
47,43,924,167,757,12,745,14,196,215,67,9,4,3,41,15,181
47,44,232,30,202,5,197,1,50,38,27,3,1,1,15,6,55
47,45,388,50,338,11,327,5,70,84,40,2,2,0,26,10,88
47,46,417,60,357,8,349,3,88,57,59,3,0,1,20,7,111
47,47,119,15,104,3,101,5,13,27,12,0,3,0,11,3,27
47,48,886,109,777,12,765,7,169,221,54,20,1,2,68,14,209
47,49,1654,257,1397,24,1373,26,295,297,165,22,14,3,113,25,413
47,50,94,10,84,1,83,2,18,19,10,1,0,0,9,2,22
47,51,1668,211,1457,28,1429,19,339,332,180,18,6,5,120,26,384
47,52,3649,710,2939,58,2881,38,516,795,400,32,20,3,231,45,801
47,53,246,38,208,5,203,13,44,34,37,9,0,0,23,0,43
47,54,1199,200,999,11,988,18,218,253,93,8,3,3,108,19,265
47,55,371,61,310,5,305,3,95,76,27,3,1,1,24,3,72
47,56,634,77,557,10,547,15,123,141,80,6,4,0,59,8,111
47,57,1012,181,831,12,819,18,170,242,71,11,2,4,81,15,205
47,58,163,15,148,2,146,1,43,21,29,3,1,1,11,0,36
47,59,166,22,144,4,140,4,29,35,17,0,0,0,15,4,36
47,60,729,96,633,18,615,3,169,157,58,10,6,2,49,10,151
47,61,454,50,404,12,392,2,94,97,54,13,0,2,25,11,94
47,62,313,44,269,5,264,9,55,60,20,11,2,4,20,8,75
47,63,125,15,110,3,107,1,21,37,7,0,0,0,7,3,31
47,64,211,33,178,6,172,5,36,37,27,1,1,0,17,5,43
47,65,1699,266,1433,37,1396,23,287,368,165,23,6,6,125,32,361
47,66,595,88,507,11,496,8,118,128,64,5,2,1,44,11,115
47,67,304,21,283,7,276,3,75,63,16,3,3,0,29,7,77
47,68,819,112,707,22,685,11,150,187,88,15,3,0,54,15,162
47,69,2145,286,1859,47,1812,32,416,513,182,26,6,2,170,28,437
47,70,674,85,589,10,579,12,122,118,68,4,0,1,49,15,190
47,71,181,22,159,1,158,2,33,39,16,1,1,1,33,4,28
47,72,90,7,83,0,83,4,17,22,6,1,0,0,14,0,19
47,73,166,22,144,1,143,4,22,33,20,1,1,0,14,2,46
47,74,291,39,252,5,247,7,49,61,33,3,3,0,20,8,63
47,75,655,81,574,9,565,12,136,138,69,4,2,0,52,13,139
47,76,245,42,203,4,199,1,47,37,27,3,3,1,23,4,53
47,77,744,88,656,12,644,9,118,149,66,19,0,2,85,9,187
47,78,935,178,757,13,744,11,173,183,75,9,0,2,71,13,207
47,79,331,39,292,7,285,4,62,66,34,4,3,2,33,3,74
47,80,117,18,99,0,99,1,23,27,12,1,2,0,3,4,26
47,81,509,65,444,13,431,9,91,112,50,10,0,2,36,9,112
47,82,194,25,169,2,167,11,30,49,25,4,1,0,13,1,33
47,83,62,7,55,1,54,2,13,19,4,0,0,0,7,0,9
47,84,196,27,169,4,165,3,23,51,18,2,1,2,22,3,40
47,85,256,44,212,1,211,3,52,61,23,5,4,0,17,3,43
47,86,910,131,779,23,756,14,142,236,89,7,7,3,82,13,163
47,87,139,28,111,2,109,2,16,17,23,3,0,0,11,3,34
47,88,434,59,375,6,369,3,91,91,42,7,3,1,34,8,89
47,89,121,15,106,0,106,2,19,33,10,3,1,0,14,3,21
47,90,296,32,264,10,254,4,64,58,25,1,0,1,33,11,57
47,91,1472,176,1296,14,1282,18,316,316,147,22,2,1,118,25,317
47,92,282,38,244,4,240,12,65,50,20,0,0,0,30,7,56
47,93,308,31,277,2,275,8,60,55,40,6,4,3,18,3,78
47,94,468,105,363,5,358,1,100,101,29,0,2,0,26,1,98
47,95,680,88,592,13,579,9,157,150,66,11,6,1,33,7,139
47,96,156,27,129,2,127,1,17,35,10,1,0,0,17,2,44
47,97,620,111,509,12,497,3,131,132,61,10,1,4,38,9,108
47,98,259,47,212,4,208,0,36,85,13,4,0,0,30,5,35
47,99,464,68,396,8,388,10,79,102,42,4,0,0,23,2,126
47,100,4128,650,3478,73,3405,80,632,821,381,45,12,3,342,71,1018
47,101,1001,128,873,19,854,13,215,210,98,7,1,3,71,14,222
47,102,557,75,482,13,469,9,86,181,31,6,3,3,47,9,94
47,103,193,39,154,7,147,6,29,53,6,2,2,0,16,2,31
47,104,199,21,178,4,174,4,51,29,22,2,1,1,19,4,41
47,105,204,36,168,5,163,8,39,35,22,4,0,0,15,1,39
47,106,3796,723,3073,62,3011,51,566,646,342,46,10,5,164,73,1108
47,107,263,23,240,0,240,2,62,55,39,1,0,2,17,3,59
47,108,215,20,195,4,191,3,37,53,24,2,2,1,21,0,48
47,109,215,28,187,2,185,5,59,54,16,2,0,1,17,3,28
47,110,1191,173,1018,29,989,8,256,298,78,17,3,2,111,28,188
47,111,440,78,362,5,357,4,80,96,36,4,2,1,18,5,111
47,112,365,44,321,3,318,14,76,54,49,6,2,0,26,5,86
47,113,107,5,102,0,102,0,27,34,12,3,0,0,6,0,20
47,114,281,28,253,4,249,3,47,50,58,4,1,0,31,2,53
47,115,229,24,205,3,202,5,44,31,36,4,2,0,25,10,45
47,117,589,74,515,7,508,10,140,126,69,9,5,2,40,18,89
47,118,124,11,113,5,108,1,27,28,9,2,0,0,14,9,18
47,119,480,84,396,5,391,8,64,80,68,9,3,1,26,10,122
47,120,87,7,80,2,78,3,15,20,11,0,0,0,12,2,15
47,121,230,24,206,4,202,8,35,46,31,3,2,0,16,10,51
47,122,143,16,127,3,124,3,35,29,10,2,2,0,21,4,18
47,123,369,44,325,7,318,8,45,35,58,8,4,2,26,6,126
47,124,159,28,131,5,126,2,18,37,9,1,2,0,17,3,37
47,125,251,32,219,2,217,7,46,68,9,3,1,0,31,7,45
47,126,71,7,64,1,63,4,14,16,4,0,0,0,14,0,11
47,127,555,78,477,5,472,3,123,121,53,8,1,0,35,10,118
47,128,892,146,746,19,727,10,204,196,68,17,3,1,57,12,159
47,129,213,38,175,4,171,6,34,48,32,1,0,1,21,4,24
47,130,263,38,225,4,221,9,48,50,39,1,3,1,25,5,40
47,131,530,46,484,8,476,10,146,114,42,11,0,3,35,13,102
47,132,118,19,99,3,96,1,28,20,9,1,0,1,11,1,24
47,133,383,59,324,3,321,10,73,73,57,7,6,1,34,3,57
47,134,348,26,322,4,318,9,49,97,34,3,0,1,31,8,86
47,135,310,49,261,5,256,4,59,44,48,5,4,1,15,4,72
47,136,102,15,87,0,87,0,19,22,16,1,0,0,6,4,19
47,137,1036,123,913,22,891,16,198,246,95,12,7,2,83,9,223
47,138,1173,141,1032,15,1017,16,206,273,116,13,5,0,86,20,282
47,139,67,6,61,3,58,3,4,16,12,1,1,0,6,0,15
47,140,460,51,409,7,402,12,89,115,41,5,4,1,25,9,101
47,141,222,38,184,4,180,4,35,39,18,5,1,0,22,4,52
47,142,529,94,435,4,431,11,59,133,45,11,3,2,48,7,112
47,143,1700,276,1424,34,1390,23,313,321,161,14,5,3,112,27,411
47,144,441,49,392,10,382,5,104,100,29,4,2,2,37,10,89
47,145,2891,493,2398,45,2353,41,513,606,264,27,4,5,191,37,665
47,146,919,94,825,17,808,13,194,236,74,6,2,0,74,25,184
47,147,495,77,418,6,412,8,80,108,55,6,5,0,34,7,109
47,148,184,23,161,3,158,1,47,27,25,5,1,1,13,4,34
47,150,267,34,233,2,231,3,73,66,30,2,0,0,14,4,39
47,151,247,30,217,5,212,10,34,71,17,0,1,0,35,4,40
47,152,314,39,275,6,269,5,73,78,26,3,0,1,27,7,49
47,154,258,28,230,9,221,4,45,43,27,5,0,0,37,10,50
47,155,486,45,441,5,436,8,118,116,35,4,0,1,48,10,96
47,156,628,87,541,12,529,6,125,119,68,13,1,3,56,14,124
47,157,12879,2993,9886,203,9683,156,1892,2519,1094,131,49,20,791,169,2862
47,158,108,10,98,1,97,3,19,25,13,0,0,1,18,2,16
47,159,1059,149,910,21,889,15,176,204,114,17,5,0,71,6,281
47,160,139,16,123,4,119,5,27,24,16,1,4,0,3,2,37
47,161,90,16,74,0,74,1,9,29,14,2,0,1,5,0,13
47,162,163,21,142,6,136,2,33,55,15,1,1,0,9,1,19
47,163,419,57,362,11,351,7,86,95,37,4,1,1,27,5,88
47,164,102,10,92,4,88,1,18,33,5,0,0,0,12,4,15
47,165,982,125,857,24,833,20,162,205,115,14,2,2,70,8,235
47,167,1066,145,921,23,898,22,146,261,119,12,3,1,80,17,237
47,168,2277,409,1868,39,1829,27,403,425,205,21,12,4,151,32,549
47,169,903,94,809,17,792,26,156,198,102,4,3,3,97,26,177
47,170,504,76,428,10,418,8,93,118,57,6,0,2,45,10,79
47,171,305,34,271,3,268,11,62,47,42,6,1,0,29,8,62
47,172,447,63,384,8,376,10,74,101,41,6,2,1,33,7,101
47,173,631,112,519,10,509,14,103,140,94,11,3,2,39,11,92
47,174,641,96,545,14,531,27,124,130,58,3,3,1,59,12,114
47,175,1776,250,1526,27,1499,32,251,379,177,24,3,2,177,30,424
47,176,145,26,119,1,118,0,26,31,10,2,0,1,21,2,25
47,177,174,19,155,4,151,2,36,26,21,1,3,0,12,1,49
47,178,330,46,284,6,278,4,68,52,35,4,2,0,27,7,79
47,179,1603,285,1318,48,1270,27,221,262,161,28,10,3,83,20,455
47,180,502,55,447,5,442,8,95,111,48,7,2,0,45,6,120
47,181,219,33,186,4,182,8,51,42,20,0,0,1,18,3,39
47,182,213,26,187,5,182,0,51,54,12,2,0,2,21,4,36
47,183,162,18,144,2,142,4,34,39,16,4,5,0,14,4,22
47,184,189,21,168,1,167,2,57,24,17,4,0,1,15,8,39
47,185,2338,408,1930,39,1891,25,387,392,227,26,7,5,120,34,668
47,186,566,76,490,14,476,6,107,146,61,7,3,0,39,7,100
47,187,207,27,180,5,175,4,42,51,21,3,0,1,20,5,28
47,188,224,30,194,0,194,1,45,33,24,3,3,1,30,1,53
47,189,117,22,95,1,94,0,21,35,7,4,1,0,8,1,17
47,190,418,52,366,4,362,23,82,102,32,6,0,0,35,7,75
47,191,567,63,504,8,496,7,138,92,87,9,3,1,56,11,92
47,192,62,8,54,1,53,2,14,20,1,2,0,0,5,2,7
47,193,167,25,142,4,138,7,31,38,12,4,0,1,19,5,21
47,194,226,38,188,4,184,6,36,53,29,2,2,0,13,3,40
47,195,5407,930,4477,110,4367,83,783,1150,602,40,21,12,404,58,1214
47,196,194,39,155,2,153,2,41,45,25,1,0,0,9,6,24
47,197,172,21,151,5,146,4,33,41,17,5,0,2,15,3,26
47,198,240,22,218,3,215,4,49,45,25,4,0,0,22,3,63
47,199,211,38,173,5,168,5,23,62,11,1,2,2,22,2,38
47,200,101,24,77,2,75,1,22,25,4,1,0,0,10,0,12
47,201,7214,1468,5746,103,5643,101,1173,1378,636,97,25,15,526,105,1587
47,202,214,23,191,3,188,1,42,33,26,4,0,0,16,10,56
47,203,1801,307,1494,23,1471,38,317,351,186,27,11,2,136,16,387
47,204,223,28,195,4,191,4,44,54,14,2,2,0,19,3,49
47,205,186,15,171,9,162,6,23,39,18,4,2,2,8,3,57
47,206,377,55,322,2,320,14,50,92,39,10,3,0,40,2,70
47,207,181,19,162,6,156,5,38,33,21,4,2,0,9,6,38
47,208,134,14,120,3,117,2,28,26,32,2,0,0,3,3,21
47,209,3286,453,2833,57,2776,46,690,628,286,32,6,6,271,43,768
47,210,1132,208,924,13,911,24,194,241,123,12,2,3,58,13,241
47,211,192,22,170,6,164,3,33,52,16,0,0,0,16,4,40
47,212,202,20,182,2,180,2,37,31,23,3,0,1,29,2,52
47,213,770,107,663,17,646,20,101,191,76,9,3,3,84,7,152
47,214,567,78,489,6,483,0,117,161,43,5,3,1,33,5,115
47,215,2904,466,2438,57,2381,41,498,655,221,27,10,10,181,53,685
47,216,462,36,426,8,418,9,96,102,55,11,2,0,46,5,92
47,217,736,143,593,10,583,4,149,144,57,8,2,2,47,17,153
47,218,203,31,172,0,172,9,36,43,21,2,0,0,24,1,36
47,219,134,12,122,1,121,0,35,22,7,2,0,1,24,2,28
47,220,187,29,158,5,153,3,31,44,29,0,0,2,9,5,30
47,221,499,68,431,13,418,9,89,87,82,3,3,2,37,7,99
47,222,375,46,329,4,325,5,69,102,41,5,1,0,21,8,73
47,223,204,32,172,8,164,2,32,28,19,2,2,0,20,5,54
47,224,138,16,122,1,121,6,22,21,28,1,1,1,16,2,23
47,225,1403,218,1185,25,1160,24,262,316,116,15,4,0,100,21,302
47,226,443,51,392,16,376,6,62,123,41,5,1,0,40,12,86
47,227,137,17,120,3,117,4,29,29,13,1,1,1,14,2,23
47,228,493,66,427,13,414,5,85,94,63,6,1,3,37,4,116
47,229,132,13,119,1,118,2,22,51,11,1,0,0,8,4,19
47,230,341,44,297,10,287,7,55,77,29,4,2,1,32,10,70
47,231,129,12,117,5,112,5,30,24,12,0,1,0,7,5,28
47,232,376,46,330,7,323,6,82,79,49,4,6,0,25,1,71
47,233,2375,378,1997,53,1944,22,418,492,244,22,8,5,166,40,527
47,234,493,65,428,6,422,9,104,96,63,4,1,0,32,4,109
47,235,383,64,319,5,314,4,83,84,22,3,3,0,35,3,77
47,236,74,11,63,4,59,3,11,13,5,3,1,0,9,3,11
47,237,338,38,300,7,293,8,61,99,29,3,1,0,24,6,62
47,238,1266,175,1091,20,1071,23,244,281,115,10,3,2,93,33,267
47,239,664,122,542,15,527,13,130,146,77,11,6,0,38,15,91
47,240,241,33,208,4,204,6,39,33,34,3,0,1,31,2,55
47,241,480,58,422,10,412,22,75,84,47,6,3,0,49,6,120
47,242,451,66,385,5,380,9,73,92,47,10,0,2,39,10,98
47,244,273,41,232,2,230,7,51,63,27,6,2,0,24,7,43
47,245,60,6,54,1,53,1,18,6,10,0,0,0,3,4,11
47,246,1127,164,963,13,950,27,210,233,101,13,5,0,75,25,261
47,247,178,26,152,3,149,10,34,42,5,1,0,0,18,1,38
47,248,401,41,360,8,352,3,98,73,53,2,2,0,28,7,86
47,249,332,62,270,4,266,1,52,70,39,2,3,1,30,4,64
47,250,145,17,128,2,126,3,40,35,11,2,1,0,12,2,20
47,251,226,23,203,10,193,3,52,42,17,1,3,1,12,7,55
47,252,4393,934,3459,46,3413,43,788,925,357,56,19,9,199,47,970
47,253,421,52,369,9,360,4,78,83,45,4,3,0,32,4,107
47,254,257,31,226,3,223,14,38,42,31,3,2,1,19,5,68
47,255,123,8,115,0,115,3,37,28,14,3,2,0,9,3,16
47,256,100,11,89,5,84,3,16,26,8,1,1,1,12,1,15
47,257,341,49,292,5,287,4,72,74,25,9,2,0,29,9,63
47,258,266,40,226,4,222,7,43,67,22,5,0,0,27,3,48
47,259,98,6,92,2,90,3,19,24,12,3,1,0,11,1,16
47,260,338,27,311,4,307,7,88,78,29,5,1,1,35,9,54
47,262,294,55,239,8,231,7,76,51,18,4,0,0,22,3,50
47,263,475,85,390,8,382,3,90,97,38,12,2,3,35,12,90
47,264,969,150,819,16,803,4,188,205,84,9,3,3,49,14,244
47,265,293,41,252,3,249,6,58,57,34,7,1,0,26,4,56
47,266,175,33,142,2,140,5,31,33,20,2,0,0,16,7,26
47,267,202,37,165,1,164,0,54,49,10,2,0,0,10,4,35
47,269,691,101,590,16,574,12,138,174,52,7,4,3,58,6,120
47,271,208,25,183,4,179,5,43,47,25,6,0,2,10,3,38
47,272,140,18,122,1,121,2,20,29,15,0,0,0,11,6,38
47,273,157,18,139,2,137,4,34,19,31,0,0,0,12,5,32
47,274,331,48,283,6,277,8,90,49,33,3,2,0,32,4,56
47,275,156,21,135,5,130,2,46,27,25,0,4,0,9,2,15
47,276,236,41,195,2,193,2,42,59,20,0,2,0,17,2,49
47,277,236,19,217,2,215,5,44,58,37,7,1,0,23,1,39
47,278,261,43,218,6,212,4,74,44,18,3,1,1,15,0,52
47,279,260,36,224,5,219,11,48,52,21,4,0,0,22,2,59
47,280,1755,285,1470,30,1440,30,342,417,114,16,5,5,142,23,346
47,281,197,23,174,3,171,8,51,41,15,3,1,0,15,5,32
47,282,223,33,190,5,185,6,49,53,25,2,1,0,20,1,28
47,283,826,130,696,10,686,11,114,127,93,11,3,1,36,5,285
47,284,219,23,196,5,191,1,39,23,34,4,2,0,28,12,48
47,285,595,68,527,9,518,12,103,127,89,6,2,1,32,10,136
47,286,88,9,79,0,79,1,16,21,11,0,0,0,4,0,26
47,287,167,18,149,1,148,5,24,23,22,0,0,1,28,3,42
47,288,379,44,335,5,330,5,70,90,37,3,2,0,28,5,90
47,289,355,47,308,5,303,6,90,58,39,3,1,4,33,4,65
47,290,406,68,338,14,324,9,89,79,35,5,1,2,29,6,69
47,291,432,47,385,10,375,8,101,92,51,5,1,0,36,3,78
47,292,431,69,362,13,349,0,66,109,48,3,4,3,24,9,83
47,293,317,46,271,2,269,4,65,72,36,3,2,1,21,3,62
47,294,163,28,135,4,131,5,39,46,7,0,0,0,15,0,19
47,295,235,18,217,6,211,6,37,41,31,7,2,1,27,2,57
47,296,124,25,99,0,99,4,31,14,10,2,1,0,8,3,26
47,297,123,24,99,3,96,3,17,32,6,1,0,0,19,1,17
47,298,179,17,162,4,158,1,35,46,25,0,0,0,12,0,39
47,299,118,20,98,4,94,3,19,19,12,2,4,0,13,6,16
47,300,798,124,674,13,661,6,179,164,58,7,4,1,75,20,147
47,301,738,127,611,23,588,3,141,169,58,10,5,1,58,11,132
47,302,514,76,438,10,428,6,107,118,40,8,0,0,34,6,109
47,303,184,37,147,5,142,2,32,39,14,4,0,0,21,2,28
47,304,69,12,57,0,57,1,14,17,12,0,0,0,1,0,12
47,305,291,25,266,7,259,3,57,76,33,3,0,0,28,8,51
47,306,768,98,670,9,661,17,167,159,73,14,6,2,56,11,156
47,307,140,14,126,1,125,0,33,38,16,1,0,1,10,2,24
47,308,170,14,156,3,153,1,47,52,18,2,1,1,6,3,22
47,309,336,50,286,9,277,4,52,92,38,4,0,1,29,4,53
47,310,6577,1407,5170,111,5059,81,1200,1111,617,59,27,9,418,73,1464
47,311,96,14,82,0,82,1,27,10,11,0,0,0,14,2,17
47,312,495,67,428,8,420,13,71,116,57,9,5,4,55,5,85
47,313,99,9,90,3,87,0,28,28,7,0,0,0,8,0,16
47,314,243,29,214,3,211,3,55,48,21,4,1,2,13,6,58
47,315,633,77,556,12,544,10,96,142,82,7,2,2,66,13,124
47,316,511,67,444,4,440,7,122,114,51,11,1,0,31,7,96
47,317,361,41,320,4,316,3,85,86,36,3,5,1,33,13,51
47,318,798,120,678,13,665,9,164,153,69,11,6,0,47,11,195
47,319,71,5,66,1,65,1,13,20,10,1,0,0,6,1,13
47,320,291,32,259,9,250,1,52,60,45,2,3,2,23,4,58
47,321,194,23,171,5,166,3,31,71,14,2,1,1,9,4,30
47,323,17219,4011,13208,260,12948,226,2535,3411,1525,140,56,32,1007,202,3814
47,324,903,153,750,14,736,23,117,222,68,5,6,1,71,9,214
47,325,373,68,305,4,301,8,76,76,41,3,1,0,14,2,80
47,326,1412,190,1222,25,1197,18,261,297,135,17,10,1,133,14,311
47,327,346,37,309,3,306,4,62,68,34,7,0,0,38,8,85
47,328,422,49,373,19,354,9,85,69,47,7,0,1,37,5,94
48,1,163,32,131,4,127,0,18,56,7,1,2,0,20,3,20
48,2,445,52,393,5,388,3,47,115,52,9,6,2,50,6,98
48,3,227,21,206,6,200,5,22,38,47,2,1,1,36,2,46
48,4,223,48,175,4,171,4,49,53,13,1,0,1,22,1,27
48,5,248,32,216,3,213,5,47,66,6,3,0,1,41,6,38
48,7,57,5,52,0,52,0,24,14,1,0,0,0,10,1,2
48,8,179,39,140,1,139,1,23,51,7,2,1,0,24,2,28
48,9,901,122,779,12,767,6,171,331,39,9,8,4,62,16,121
48,10,275,34,241,1,240,1,53,78,26,2,2,0,23,2,53
48,12,302,52,250,5,245,5,61,82,10,1,1,0,29,10,46
48,13,758,95,663,7,656,11,115,184,46,7,1,2,78,16,196
48,14,202,38,164,1,163,2,36,45,15,1,1,0,34,4,25
48,15,191,22,169,2,167,6,26,26,52,2,1,1,15,1,37
48,16,408,56,352,3,349,12,67,76,38,5,0,1,31,8,111
48,17,675,82,593,11,582,15,114,123,81,7,1,5,57,13,166
48,18,491,52,439,14,425,13,39,109,65,7,1,2,50,9,130
48,19,227,29,198,6,192,11,31,33,42,4,2,0,9,0,60
48,20,64,6,58,0,58,2,11,9,12,2,0,0,0,1,21
48,21,173,29,144,3,141,2,31,41,21,3,0,0,16,0,27
48,22,246,44,202,8,194,7,35,23,35,1,0,2,12,3,76
48,23,88,18,70,2,68,1,11,32,6,1,0,0,8,0,9
48,25,388,39,349,6,343,8,63,83,38,1,4,0,41,6,99
48,26,226,34,192,4,188,4,49,48,14,1,1,1,18,2,50
48,27,281,38,243,5,238,7,39,69,37,2,1,0,30,7,46
48,28,158,33,125,1,124,3,21,55,9,3,0,0,8,0,25
48,29,137,23,114,2,112,1,15,38,10,1,0,0,22,0,25
48,30,311,31,280,9,271,11,33,79,44,7,1,0,24,3,69
48,31,98,15,83,2,81,1,29,26,0,0,0,3,18,0,4
48,32,196,21,175,5,170,3,26,60,12,3,2,0,32,3,29
48,33,116,9,107,0,107,3,10,26,21,2,0,0,19,0,26
48,34,1468,199,1269,40,1229,23,245,444,91,17,2,2,131,23,251
48,36,135,23,112,2,110,1,25,21,22,1,0,0,12,3,25
48,37,95,13,82,0,82,3,10,9,13,4,1,0,11,0,31
48,38,194,37,157,1,156,1,27,44,16,0,2,1,26,3,36
48,39,1066,140,926,16,910,31,168,226,142,19,7,1,93,17,206
48,40,172,31,141,1,140,3,31,29,22,1,2,0,13,1,38
48,41,95,13,82,0,82,3,19,27,4,0,1,1,14,3,10
48,42,571,52,519,17,502,9,84,143,43,8,3,1,83,12,116
48,43,338,55,283,6,277,4,62,95,10,4,3,0,37,6,56
48,44,98,13,85,0,85,0,34,30,2,0,1,1,6,1,10
48,45,214,29,185,2,183,1,40,53,11,2,3,0,36,2,35
48,46,84,24,60,0,60,1,7,24,3,0,0,0,9,0,16
48,47,245,29,216,3,213,3,43,74,10,1,0,2,29,7,44
48,48,72,12,60,2,58,5,7,17,6,1,0,0,7,1,14
48,49,761,74,687,13,674,20,129,174,66,6,3,2,93,14,167
48,50,147,21,126,1,125,3,23,26,27,1,0,0,6,2,37
48,51,568,104,464,6,458,9,103,73,82,9,4,0,29,13,136
48,53,205,50,155,1,154,5,43,46,8,2,1,0,17,4,28
48,54,48,10,38,1,37,0,3,7,6,0,2,0,8,0,11
48,55,109,18,91,1,90,1,20,19,15,1,1,0,10,3,20
48,56,240,25,215,9,206,5,37,58,34,3,2,0,22,2,43
48,57,159,15,144,2,142,5,25,55,6,1,0,1,19,2,28
48,58,158,30,128,9,119,0,39,42,4,2,6,0,10,4,12
48,59,213,19,194,3,191,1,42,74,9,3,0,1,29,10,22
48,60,167,24,143,3,140,3,47,51,6,0,0,0,12,6,15
48,61,1224,168,1056,29,1027,35,96,202,233,20,8,1,68,14,350
48,62,112,19,93,2,91,0,18,26,5,1,0,0,16,1,24
48,63,216,33,183,4,179,3,22,81,14,1,1,0,19,3,35
48,64,318,49,269,3,266,3,76,93,14,2,2,0,46,1,29
48,65,85,21,64,0,64,0,14,29,3,0,1,0,2,1,14
48,66,196,40,156,4,152,5,10,29,29,3,2,0,20,4,50
48,67,82,8,74,0,74,10,2,7,36,1,1,0,6,0,11
48,68,149,25,124,3,121,1,41,21,12,2,1,1,15,7,20
48,69,49,6,43,2,41,2,8,5,13,0,0,2,4,0,7
48,70,603,105,498,13,485,9,94,121,68,10,8,0,62,14,99
48,71,85,18,67,0,67,0,16,43,1,0,0,0,3,0,4
48,72,158,17,141,6,135,5,23,38,21,2,1,0,12,3,30
48,73,127,22,105,2,103,3,27,26,7,0,0,0,15,0,25
48,74,219,31,188,4,184,18,25,50,27,4,2,0,25,2,31
48,75,658,105,553,9,544,34,54,127,94,7,4,3,53,11,157
48,76,264,32,232,3,229,1,37,81,22,3,1,0,32,9,43
48,77,67,13,54,2,52,0,15,18,2,1,1,0,4,0,11
48,78,174,22,152,2,150,1,22,37,17,1,0,0,34,1,37
48,79,126,13,113,4,109,2,17,35,12,0,0,0,13,0,30
48,80,2328,472,1856,38,1818,36,323,508,205,21,14,5,157,20,529
48,81,250,29,221,3,218,6,34,40,32,2,1,0,32,3,68
48,82,106,14,92,0,92,2,12,21,18,3,1,0,9,4,22
48,83,164,31,133,2,131,0,21,62,8,1,1,0,16,0,22
48,84,83,15,68,0,68,4,12,11,11,0,0,0,9,2,19
48,85,118,25,93,0,93,3,23,37,6,1,0,0,9,0,14
48,86,233,35,198,5,193,1,43,52,27,1,0,0,29,5,35
48,87,123,19,104,2,102,3,19,40,4,0,0,1,15,2,18
48,88,152,16,136,4,132,3,24,45,14,3,1,0,20,3,19
48,89,416,37,379,8,371,9,107,109,25,1,0,1,40,12,67
48,90,647,100,547,14,533,4,111,196,30,7,3,0,68,7,107
48,91,57,8,49,1,48,0,15,16,7,0,0,0,4,2,4
48,92,3445,535,2910,63,2847,60,570,763,287,26,15,15,270,54,787
48,93,137,25,112,4,108,0,30,45,8,0,0,0,10,1,14
48,94,326,35,291,6,285,1,50,90,22,3,1,2,32,2,82
48,95,7576,1283,6293,128,6165,152,802,1588,715,73,23,15,708,95,1994
48,96,664,87,577,7,570,6,75,175,77,5,4,1,43,7,177
48,97,194,14,180,3,177,6,21,53,27,4,0,0,9,0,57
48,98,101,9,92,0,92,20,4,5,30,2,0,0,1,0,30
48,99,709,75,634,10,624,13,114,147,75,9,4,2,59,10,191
48,100,146,30,116,5,111,1,26,35,3,1,2,0,15,4,24
48,101,99,17,82,2,80,5,8,9,13,1,1,0,17,4,22
48,103,775,93,682,24,658,18,159,137,72,9,3,0,73,18,169
48,104,443,57,386,8,378,7,67,192,16,2,2,0,42,3,47
48,105,180,19,161,3,158,2,35,42,18,4,0,0,19,6,32
48,106,82,10,72,1,71,2,15,28,7,0,0,0,9,2,8
48,107,135,13,122,5,117,2,29,23,9,0,0,0,16,3,35
48,108,82,9,73,1,72,0,20,29,5,0,0,0,3,0,15
48,110,108,22,86,2,84,0,22,31,4,0,0,0,11,3,13
48,111,175,23,152,3,149,1,20,50,14,2,1,0,30,3,28
48,112,119,22,97,0,97,2,16,24,11,5,0,0,7,1,31
48,115,180,12,168,3,165,11,22,29,38,2,0,1,13,4,45
48,116,317,44,273,5,268,12,25,43,62,6,0,3,22,3,92
48,117,123,15,108,2,106,4,30,17,17,2,0,0,14,0,22
48,119,235,24,211,4,207,4,33,63,30,1,2,0,32,4,38
48,120,168,27,141,5,136,3,21,56,3,1,0,0,33,3,16
48,121,204,21,183,3,180,1,33,47,31,2,1,1,22,3,39
48,122,290,47,243,5,238,19,43,41,47,4,1,0,23,6,54
48,123,155,20,135,0,135,0,30,74,7,0,0,0,10,0,14
48,124,94,19,75,1,74,1,8,31,9,0,0,0,12,1,12
48,125,104,7,97,0,97,6,20,28,7,0,1,0,13,4,18
48,126,162,22,140,5,135,5,29,50,5,3,1,1,23,0,18
48,127,598,75,523,12,511,12,109,185,43,6,2,0,67,13,74
48,128,483,49,434,10,424,8,78,127,36,3,1,2,62,4,103
48,129,209,40,169,2,167,2,34,48,19,2,1,0,21,3,37
48,130,112,14,98,4,94,7,7,12,22,1,0,0,11,1,33
48,131,132,16,116,0,116,4,21,26,20,3,0,0,12,3,27
48,132,1221,222,999,24,975,8,155,329,102,15,1,3,105,14,243
48,133,131,21,110,0,110,0,30,31,9,0,1,0,13,2,24
48,134,95,9,86,0,86,8,13,5,25,2,1,0,3,0,29
48,135,150,15,135,1,134,6,18,24,18,1,0,0,28,1,38
48,136,113,15,98,4,94,16,15,5,19,0,0,0,10,1,28
48,137,430,61,369,8,361,17,38,100,71,4,2,1,35,7,86
48,138,68,15,53,1,52,4,12,8,8,3,0,0,7,0,10
48,139,120,17,103,1,102,0,22,24,13,0,1,0,11,1,30
48,140,2897,434,2463,48,2415,34,416,728,254,34,9,5,241,43,651
48,141,127,18,109,0,109,6,22,23,14,0,0,0,15,4,25
48,142,179,23,156,3,153,6,38,54,10,0,0,1,14,3,27
48,144,278,49,229,6,223,31,12,44,56,4,2,0,8,4,62
48,145,195,45,150,3,147,2,37,60,3,2,2,0,15,1,25
48,146,509,73,436,7,429,14,52,126,62,2,3,1,40,7,122
48,147,468,47,421,13,408,11,54,105,60,4,4,2,43,7,118
48,148,435,49,386,14,372,34,47,62,114,10,0,1,18,6,80
48,149,47,4,43,1,42,1,4,21,5,0,0,0,3,2,6
48,150,159,24,135,1,134,3,14,46,18,4,2,0,8,7,32
48,151,55,6,49,1,48,2,11,16,3,2,0,0,5,0,9
48,152,175,27,148,2,146,9,13,11,56,4,1,0,12,1,39
48,153,75,10,65,0,65,5,19,12,5,0,1,0,11,0,12
48,154,233,26,207,5,202,3,38,62,17,6,1,0,30,7,38
48,155,363,57,306,7,299,17,28,32,107,5,1,1,20,1,87
48,156,524,72,452,15,437,7,86,136,52,5,6,0,41,7,97
48,157,64,7,57,0,57,4,11,11,7,1,0,0,9,0,14
48,158,87,13,74,0,74,1,13,13,26,1,0,1,4,0,15
48,160,147,18,129,1,128,1,25,38,11,2,0,0,17,4,30
48,161,60,11,49,1,48,0,16,24,2,0,0,0,0,0,6
48,162,121,29,92,1,91,5,8,17,19,0,0,0,6,1,35
48,163,129,14,115,1,114,0,25,24,19,4,1,0,11,0,30
48,164,145,30,115,2,113,5,18,25,23,2,1,0,12,0,27
48,165,174,24,150,0,150,5,39,49,9,0,2,0,22,3,21
48,166,137,9,128,1,127,15,14,11,25,2,0,0,7,2,51
48,167,43,3,40,3,37,0,5,11,6,0,0,0,2,0,13
48,168,186,32,154,4,150,7,32,23,18,2,0,0,31,5,32
48,169,203,32,171,8,163,1,22,60,15,4,1,0,23,1,36
48,170,176,31,145,0,145,9,12,19,76,3,0,0,2,1,23
48,171,129,18,111,4,107,21,9,10,39,2,0,0,6,1,19
48,172,84,15,69,3,66,4,8,8,19,1,0,0,4,0,22
48,173,190,21,169,4,165,4,35,16,55,3,1,0,9,3,39
48,174,141,25,116,2,114,1,16,61,7,2,0,0,13,1,13
48,175,156,27,129,1,128,1,19,47,13,1,0,0,15,0,32
48,176,78,13,65,1,64,10,3,8,11,0,1,0,9,1,21
48,177,253,26,227,9,218,1,40,70,17,8,3,3,29,2,45
48,178,240,38,202,4,198,4,22,35,47,3,0,1,21,1,64
48,179,116,19,97,2,95,0,21,26,10,2,0,0,14,2,20
48,180,71,5,66,0,66,1,4,16,9,2,1,0,10,0,23
48,181,96,10,86,3,83,1,24,21,3,4,0,0,8,1,21
48,182,64,15,49,1,48,0,5,27,0,0,0,0,11,0,5
48,183,238,28,210,3,207,5,40,87,16,1,0,0,21,2,35
48,184,267,46,221,3,218,5,32,55,38,3,1,2,23,2,57
48,185,149,22,127,4,123,5,27,25,18,2,1,0,18,0,27
48,186,147,15,132,1,131,4,9,11,38,3,2,1,7,1,55
48,187,108,17,91,3,88,1,12,33,12,2,1,0,10,3,14
48,188,209,42,167,2,165,3,26,66,16,0,2,0,19,1,32
48,189,142,20,122,1,121,8,29,37,13,1,1,0,13,0,19
48,190,165,20,145,1,144,3,31,62,7,2,1,0,19,1,18
48,191,87,10,77,0,77,0,11,34,9,0,0,0,10,0,13
48,192,101,11,90,2,88,0,25,28,9,0,0,0,12,2,12
48,193,218,38,180,2,178,11,27,37,16,2,1,0,11,2,71
48,194,400,66,334,4,330,19,36,42,79,10,1,0,33,6,104
48,195,105,21,84,2,82,2,16,33,2,3,0,0,10,0,16
48,197,45,11,34,0,34,0,8,16,2,0,0,0,5,0,3
48,198,445,77,368,2,366,3,65,106,56,6,2,0,41,5,82
49,1,592,84,508,21,487,14,59,133,46,3,4,1,56,17,154
49,2,1955,287,1668,45,1623,18,379,519,119,24,13,3,167,46,335
49,3,623,77,546,19,527,11,78,181,44,8,6,1,79,8,111
49,4,1814,204,1610,38,1572,32,212,471,138,18,12,3,180,33,473
49,5,223,29,194,6,188,3,29,49,23,4,5,2,25,1,47
49,6,1523,212,1311,37,1274,32,177,409,101,19,16,8,228,41,243
49,7,87309,17611,69698,1250,68448,2240,6831,18398,7598,781,386,158,8054,1068,22934
49,8,654,78,576,20,556,11,105,184,50,7,4,2,80,13,100
49,9,343,54,289,8,281,1,81,92,22,2,4,1,18,3,57
49,10,237,31,206,4,202,6,41,79,11,4,1,0,33,3,24
49,11,315,33,282,6,276,2,65,87,26,3,3,2,26,5,57
49,12,273,24,249,3,246,6,34,79,24,4,1,0,33,7,58
49,13,321,52,269,3,266,4,48,87,19,3,3,2,30,8,62
49,14,350,48,302,9,293,9,60,82,24,5,0,0,41,6,66
49,15,10241,1593,8648,144,8504,229,786,2679,709,71,35,24,1153,165,2653
49,17,310,44,266,10,256,3,46,72,38,2,2,1,28,8,56
49,18,2596,455,2141,52,2089,39,293,726,183,22,12,3,183,52,576
49,19,1161,183,978,16,962,14,145,284,88,9,6,3,119,18,276
49,20,3973,447,3526,59,3467,82,371,909,321,32,15,8,500,74,1155
49,21,4462,754,3708,110,3598,72,639,988,389,54,33,7,409,105,902
49,22,1003,95,908,24,884,18,104,308,96,15,8,2,130,28,175
49,23,5326,939,4387,124,4263,97,405,1385,343,64,37,6,798,116,1012
49,24,297,35,262,15,247,6,45,88,14,2,3,0,39,8,42
49,25,178,12,166,5,161,3,32,38,20,3,2,0,13,3,47
49,26,1937,279,1658,39,1619,19,279,467,153,16,12,2,205,38,428
49,27,1331,113,1218,51,1167,28,209,367,77,12,14,2,194,34,230
49,28,121,13,108,1,107,7,4,26,23,0,1,1,16,0,29
49,29,878,103,775,25,750,30,87,238,99,3,6,1,72,8,206
49,30,668,103,565,15,550,3,112,185,49,9,3,2,58,13,116
49,31,425,46,379,5,374,11,66,110,28,4,1,0,50,10,94
49,32,903,71,832,11,821,27,87,209,102,11,5,3,94,14,269
49,33,312,42,270,7,263,11,60,66,12,5,1,0,27,6,75
49,34,588,49,539,18,521,9,83,169,34,9,7,4,76,11,119
49,35,5254,682,4572,72,4500,160,389,1445,409,44,23,11,614,75,1330
49,36,501,61,440,11,429,12,61,135,46,3,4,3,32,12,121
49,37,574,72,502,8,494,7,66,214,39,9,1,1,65,11,81
49,38,148,11,137,3,134,3,17,28,17,6,4,0,20,1,38
49,39,539,44,495,19,476,14,52,155,54,14,5,1,90,8,83
49,40,1149,157,992,43,949,29,151,261,76,13,10,2,133,25,249
49,41,1460,233,1227,34,1193,19,277,364,112,16,8,2,110,33,252
49,42,2560,277,2283,43,2240,53,314,607,225,40,20,13,282,41,645
49,43,625,63,562,11,551,19,64,125,87,9,3,0,74,12,158
49,44,238,31,207,0,207,1,40,65,25,4,2,0,34,1,35
49,45,365,65,300,7,293,8,86,85,26,1,1,2,39,7,38
49,46,929,159,770,16,754,4,166,211,60,23,5,0,53,26,206
49,47,338,38,300,4,296,9,70,112,20,4,2,2,23,5,49
49,48,2004,200,1804,32,1772,43,234,544,169,17,11,9,236,35,474
49,49,843,132,711,20,691,9,126,210,65,4,2,3,85,19,168
49,50,2212,432,1780,42,1738,31,233,504,172,26,12,6,234,41,479
49,51,443,57,386,4,382,11,88,105,36,6,1,0,57,11,67
49,52,220,41,179,4,175,1,42,54,18,4,2,0,13,3,38
49,53,231,38,193,6,187,2,59,46,8,3,1,1,23,3,41
49,54,1963,278,1685,49,1636,21,264,600,109,19,15,4,223,42,339
49,55,1655,196,1459,35,1424,27,134,425,150,22,5,6,196,30,429
49,56,161,10,151,4,147,1,37,46,11,5,1,1,12,4,29
49,57,234,29,205,4,201,7,37,50,25,10,3,1,29,4,35
49,58,539,70,469,13,456,8,67,153,34,9,9,0,87,8,81
49,59,334,64,270,5,265,5,43,92,18,4,3,1,34,11,54
49,60,967,125,842,20,822,15,170,222,80,16,4,3,91,33,188
49,61,608,76,532,17,515,9,87,224,27,6,2,0,71,11,78
49,62,117,17,100,2,98,1,26,23,14,0,1,0,9,4,20
49,63,4867,810,4057,118,3939,96,487,1207,397,40,28,11,517,80,1076
49,64,262,32,230,4,226,5,36,91,15,5,1,0,26,5,42
49,65,1404,209,1195,27,1168,20,181,416,97,16,6,5,151,25,251
49,66,720,90,630,12,618,17,91,250,36,11,2,2,84,10,115
49,67,195,27,168,2,166,4,28,66,15,0,0,0,12,2,39
49,68,1322,178,1144,36,1108,26,193,336,108,23,14,1,118,30,259
49,69,1768,225,1543,30,1513,51,226,425,145,29,12,9,184,34,398
49,70,516,67,449,10,439,7,53,141,36,9,2,1,78,11,101
49,71,820,91,729,22,707,31,126,215,74,8,8,1,99,15,130
49,72,885,110,775,21,754,7,127,284,46,6,3,2,136,18,125
49,73,95,7,88,1,87,1,21,26,7,3,1,2,8,4,14
49,74,513,58,455,8,447,3,40,167,40,7,3,2,70,12,103
49,75,990,137,853,25,828,19,142,234,75,15,8,3,104,38,190
49,76,433,37,396,18,378,12,70,90,46,8,5,3,45,5,94
49,77,411,39,372,16,356,11,43,120,29,7,1,0,56,20,69
49,78,569,75,494,10,484,18,59,133,73,8,5,0,50,20,118
49,79,43,2,41,1,40,0,8,19,5,0,0,0,1,2,5
49,80,2029,343,1686,54,1632,18,294,537,151,32,17,2,138,31,412
49,81,454,50,404,9,395,11,54,134,40,4,1,2,66,5,78
49,82,742,80,662,22,640,28,93,186,79,8,6,2,71,11,156
49,83,1048,159,889,33,856,6,160,316,39,11,6,1,130,30,157
49,84,244,32,212,4,208,9,32,62,20,1,0,0,15,7,62
49,85,597,73,524,18,506,4,92,183,31,5,6,2,82,18,83
49,86,779,95,684,22,662,14,116,214,64,17,4,1,92,22,118
49,87,85,10,75,5,70,1,11,22,6,2,0,0,9,2,17
49,88,617,73,544,14,530,11,84,175,47,14,9,0,68,14,108
49,89,704,71,633,17,616,19,83,250,40,6,7,2,77,18,114
49,90,655,83,572,9,563,17,78,162,82,10,6,1,60,15,132
49,91,535,64,471,12,459,23,77,139,43,3,3,1,52,16,102
49,92,5178,957,4221,95,4126,116,474,1378,328,70,29,7,650,128,946
49,93,194,29,165,1,164,2,44,65,7,1,0,0,10,1,34
49,94,790,111,679,14,665,25,108,208,53,13,6,1,86,15,150
49,95,84,15,69,1,68,1,7,37,4,0,0,0,9,1,9
49,96,365,62,303,14,289,1,64,94,24,3,3,0,29,7,64
49,97,664,90,574,13,561,29,95,142,65,14,2,4,77,18,115
49,98,201,32,169,0,169,7,40,50,16,6,0,1,15,2,32
49,99,36315,6848,29467,608,28859,584,3009,8378,2582,339,222,72,3747,538,9388
49,100,339,56,283,6,277,6,80,84,14,6,2,2,32,5,46
49,101,693,91,602,12,590,11,131,168,50,9,9,1,72,21,118
49,102,220,36,184,1,183,1,20,88,11,0,3,0,34,6,20
49,103,2037,320,1717,46,1671,27,229,460,201,29,19,3,176,28,499
49,104,408,64,344,5,339,4,77,114,22,6,5,3,33,11,64
49,105,541,90,451,8,443,11,78,143,43,7,6,1,48,6,100
49,106,2161,264,1897,51,1846,44,280,547,174,21,11,2,211,34,522
49,107,323,40,283,13,270,6,34,81,30,5,2,1,28,3,80
49,108,692,98,594,10,584,12,119,171,53,9,5,2,77,17,119
49,109,1057,143,914,27,887,14,125,348,74,23,7,1,124,33,138
49,110,1196,147,1049,28,1021,21,147,260,146,14,8,2,109,31,283
49,111,298,26,272,7,265,7,35,60,23,6,3,4,38,11,78
49,112,727,99,628,17,611,11,95,178,68,10,4,2,62,9,172
49,113,353,59,294,8,286,5,57,78,16,11,0,1,22,9,87
49,114,132,12,120,4,116,3,25,47,5,2,1,0,7,3,23
49,115,406,51,355,4,351,17,45,71,44,9,1,0,45,8,111
49,116,415,60,355,7,348,2,78,101,21,7,1,2,33,15,88
49,117,980,113,867,14,853,24,135,175,99,14,4,6,106,25,265
49,119,1083,146,937,37,900,17,189,340,71,14,2,3,91,26,147
49,120,1041,113,928,19,909,31,110,244,109,14,9,6,111,15,260
49,121,347,48,299,4,295,6,75,90,26,1,3,0,30,1,63
49,122,230,48,182,8,174,0,54,45,13,3,2,0,16,0,41
49,123,1169,165,1004,27,977,10,195,336,81,9,4,6,107,19,210
49,125,5600,1048,4552,121,4431,77,855,1336,306,88,35,5,502,110,1117
49,126,1487,196,1291,43,1248,35,216,387,90,15,16,4,180,26,279
49,127,2505,427,2078,50,2028,40,361,604,194,42,18,6,182,57,524
49,128,431,68,363,6,357,10,76,82,30,6,2,1,39,8,103
49,129,2975,343,2632,69,2563,54,343,771,243,37,19,8,308,45,735
49,130,486,72,414,6,408,17,47,130,42,5,1,0,60,5,101
49,131,465,76,389,13,376,1,109,108,27,12,1,1,30,10,77
49,132,994,113,881,26,855,15,158,258,74,8,11,3,117,19,192
49,133,463,55,408,8,400,16,59,143,51,3,3,1,51,7,66
49,134,1009,124,885,31,854,36,137,257,74,16,3,3,123,31,174
49,135,1594,251,1343,31,1312,32,153,432,133,22,5,4,171,29,331
49,136,243,25,218,5,213,6,34,89,23,1,1,1,28,3,27
49,137,1188,142,1046,25,1021,18,169,335,72,13,17,3,174,32,188
49,138,689,91,598,22,576,13,119,152,56,8,1,0,59,15,153
49,139,359,39,320,16,304,8,42,67,43,7,6,1,30,9,91
49,140,850,137,713,16,697,16,161,192,62,12,4,0,69,19,162
49,141,210,21,189,4,185,3,41,80,16,1,1,0,15,0,28
49,142,158,18,140,3,137,6,19,36,22,2,0,0,16,5,31
49,143,529,73,456,8,448,9,94,136,57,8,2,1,30,13,98
49,144,846,124,722,21,701,17,160,256,37,7,5,1,88,25,105
49,145,1451,214,1237,48,1189,22,213,390,78,17,13,3,184,42,227
49,147,312,34,278,9,269,8,35,76,24,6,1,1,31,7,80
49,148,304,33,271,6,265,3,48,75,16,11,3,2,37,11,59
49,149,1430,185,1245,29,1216,31,169,372,125,26,6,3,137,24,323
49,150,249,39,210,5,205,3,34,53,28,1,0,1,20,1,64
49,151,1998,311,1687,45,1642,29,303,513,118,28,17,1,246,57,330
49,153,1528,178,1350,26,1324,27,197,536,100,20,18,4,188,28,206
49,154,385,52,333,9,324,13,34,94,45,9,0,0,37,5,87
49,155,971,106,865,20,845,34,94,319,70,6,2,2,88,13,217
49,156,188,18,170,2,168,4,18,71,9,7,2,0,20,4,33
49,157,266,34,232,2,230,7,41,75,24,7,2,0,11,9,54
49,158,340,39,301,7,294,3,57,100,12,6,2,1,47,7,59
49,159,395,57,338,8,330,6,77,87,29,8,4,0,48,12,59
49,160,1238,186,1052,30,1022,28,156,284,95,21,12,0,137,36,253
49,161,240,34,206,4,202,7,57,49,26,1,3,0,16,3,40
49,162,2409,321,2088,60,2028,34,233,832,117,19,14,8,351,54,366
49,163,1156,137,1019,33,986,22,171,314,88,11,10,2,100,21,247
49,165,891,111,780,18,762,17,93,231,41,25,7,4,141,24,179
49,167,2126,271,1855,35,1820,41,182,644,155,29,7,6,252,38,466
49,169,951,112,839,31,808,13,101,293,55,27,9,2,135,20,153
49,170,651,83,568,15,553,18,83,142,86,5,2,2,56,14,145
49,171,91,6,85,3,82,0,20,25,10,0,2,1,9,0,15
49,172,1233,167,1066,44,1022,18,188,341,84,16,13,3,152,26,181
49,173,210,21,189,3,186,3,45,62,20,1,2,0,12,4,37
49,174,524,62,462,7,455,8,113,111,41,10,6,0,50,15,101
49,175,77,11,66,2,64,3,12,11,4,0,0,0,13,1,20
49,176,3000,581,2419,61,2358,27,336,766,220,25,18,5,315,51,595
49,177,1875,243,1632,44,1588,32,216,489,135,25,14,3,235,40,399
49,178,625,88,537,10,527,8,67,208,44,4,6,1,88,14,87
49,179,1561,206,1355,38,1317,30,177,479,85,28,7,1,176,18,316
49,180,4922,866,4056,135,3921,56,846,1280,310,36,34,7,397,88,867
49,181,324,54,270,6,264,13,43,76,28,5,2,2,26,6,63
49,182,535,71,464,7,457,7,88,190,22,1,3,0,46,11,89
49,183,1876,264,1612,42,1570,19,281,504,143,21,17,7,211,24,343
49,184,405,63,342,8,334,10,42,108,15,4,2,2,54,17,80
49,185,243,21,222,8,214,6,36,77,24,2,3,1,19,4,42
49,186,189,14,175,5,170,6,28,49,20,3,7,0,16,3,38
49,187,332,37,295,2,293,7,35,118,31,3,2,0,55,6,36
49,188,606,81,525,7,518,9,80,125,92,5,5,1,60,9,132
49,189,459,46,413,10,403,13,74,144,39,8,3,0,51,9,62
49,190,674,80,594,19,575,10,120,168,62,1,9,2,80,19,104
49,191,1368,201,1167,17,1150,23,207,345,123,20,9,2,129,31,261
49,192,2290,340,1950,59,1891,41,247,612,110,31,22,2,317,47,462
49,193,2962,489,2473,68,2405,45,324,672,207,43,24,2,379,54,655
49,194,3501,462,3039,87,2952,65,464,687,311,54,25,6,383,99,858
49,195,772,81,691,26,665,5,64,195,59,10,7,6,99,21,199
49,196,1590,144,1446,23,1423,38,138,435,124,13,7,1,211,36,420
49,197,235,27,208,4,204,2,46,65,13,5,2,3,29,8,31
49,198,204,23,181,5,176,1,26,72,15,5,3,0,22,0,32
49,199,1217,132,1085,28,1057,31,127,387,74,15,8,3,170,28,214
49,200,1406,140,1266,33,1233,29,182,334,123,20,6,3,173,20,343
49,201,1488,212,1276,27,1249,43,201,302,145,25,12,3,140,28,350
49,202,190,35,155,4,151,2,37,37,11,5,4,1,17,3,34
49,204,1070,91,979,29,950,21,134,309,85,17,13,4,131,39,197
49,205,670,79,591,15,576,4,150,202,38,5,2,2,56,10,107
49,206,1461,248,1213,23,1190,14,232,351,110,17,12,3,163,28,260
49,207,93,15,78,1,77,0,16,36,4,1,0,0,6,3,11
49,208,153,21,132,3,129,6,24,43,9,2,1,0,19,5,20
49,209,266,43,223,2,221,7,42,81,27,1,1,0,24,5,33
49,211,961,172,789,24,765,13,107,295,51,12,8,2,125,16,136
49,212,2195,290,1905,50,1855,60,235,606,172,34,18,3,257,38,432
49,213,134,10,124,3,121,3,22,45,9,2,2,1,12,6,19
49,214,5501,838,4663,95,4568,104,524,1168,455,71,29,13,579,75,1550
49,215,2874,566,2308,56,2252,44,448,642,169,25,17,2,191,47,667
49,216,341,35,306,10,296,7,33,96,35,4,1,1,34,9,76
49,217,466,45,421,8,413,11,58,110,49,13,4,0,51,11,106
49,218,919,141,778,11,767,11,112,204,70,11,4,1,98,17,239
49,219,345,59,286,3,283,10,43,108,22,2,0,1,32,11,54
49,220,1226,191,1035,17,1018,13,224,388,69,5,8,3,95,23,190
49,221,684,123,561,10,551,14,117,166,53,3,5,0,56,15,122
49,222,1517,210,1307,37,1270,26,213,348,108,18,9,2,141,39,366
49,223,4129,585,3544,71,3473,103,393,926,384,41,23,10,474,61,1058
49,224,667,67,600,12,588,6,117,179,43,11,2,3,70,24,133
49,225,614,80,534,11,523,6,73,228,26,10,5,4,85,20,66
49,226,331,43,288,10,278,10,44,107,16,5,1,0,39,12,44
49,227,463,49,414,9,405,8,67,115,49,7,3,1,51,10,94
49,228,1290,180,1110,22,1088,14,170,392,88,8,11,2,102,26,275
49,229,1387,222,1165,28,1137,14,193,191,143,17,13,1,86,27,452
49,230,201,23,178,1,177,3,28,55,19,1,2,1,24,9,35
49,231,1041,97,944,11,933,17,116,281,93,20,9,3,141,24,229
49,232,1037,173,864,21,843,14,117,365,39,4,7,2,124,37,134
49,233,959,169,790,18,772,19,128,210,70,14,7,2,93,16,213
49,234,613,116,497,10,487,7,109,149,38,5,3,3,53,8,112
49,235,346,47,299,13,286,9,39,90,33,6,5,0,39,2,63
49,236,105,12,93,4,89,4,12,24,7,1,0,0,15,1,25
49,237,124,13,111,4,107,0,35,25,7,1,2,1,6,1,29
49,238,1713,293,1420,34,1386,45,189,335,144,26,11,10,152,34,440
49,239,927,97,830,17,813,12,104,353,67,22,5,0,134,20,96
49,240,753,138,615,10,605,15,107,139,52,17,5,3,80,20,167
49,241,1751,218,1533,28,1505,44,178,461,132,20,6,7,185,26,446
49,242,884,97,787,20,767,26,111,187,63,12,6,5,115,26,216
49,243,789,96,693,26,667,12,94,267,43,13,5,1,126,18,88
49,244,2975,331,2644,86,2558,55,297,947,162,31,24,9,413,69,551
49,245,198,33,165,5,160,3,33,59,14,3,0,0,20,0,28
49,246,9087,1568,7519,135,7384,200,856,1977,711,102,68,30,917,133,2390
49,247,1831,234,1597,34,1563,74,157,432,184,15,14,3,194,24,466
49,248,2300,386,1914,42,1872,30,239,635,161,23,15,7,258,47,457
49,249,1217,133,1084,35,1049,11,172,231,101,23,19,2,137,31,322
49,250,205,33,172,3,169,6,19,70,9,1,2,0,28,4,30
49,251,460,39,421,13,408,13,36,141,43,4,2,0,42,15,112
49,252,809,137,672,20,652,15,168,209,41,9,7,2,89,18,94
49,253,921,175,746,19,727,16,170,225,53,10,5,4,83,10,151
49,254,177,20,157,2,155,2,34,42,17,0,1,1,25,4,29
49,256,595,82,513,9,504,29,48,92,99,8,2,1,52,12,161
49,257,702,92,610,12,598,9,117,170,69,4,10,3,48,17,151
49,258,743,119,624,24,600,4,113,210,42,6,6,1,97,13,108
49,259,1656,234,1422,26,1396,48,167,405,166,18,6,3,176,21,386
49,260,1253,154,1099,41,1058,28,159,349,67,18,8,4,148,33,244
49,261,1737,273,1464,34,1430,37,235,458,163,17,10,2,155,32,321
49,262,534,54,480,13,467,9,87,153,42,7,3,3,48,16,99
49,263,831,125,706,33,673,24,84,180,60,15,7,1,151,16,135
49,264,1934,243,1691,39,1652,56,222,459,127,43,12,3,279,39,412
49,265,885,78,807,16,791,21,109,205,74,11,7,4,119,24,217
49,266,708,63,645,13,632,24,92,155,67,9,1,1,114,18,151
49,267,6860,1065,5795,132,5663,137,679,1436,598,84,27,10,721,124,1847
49,268,553,62,491,29,462,9,82,162,26,5,6,2,70,8,92
49,269,2098,304,1794,57,1737,36,196,535,129,31,16,8,264,40,482
49,270,466,53,413,9,404,6,98,133,45,5,2,0,32,8,75
49,271,1363,134,1229,36,1193,24,183,337,112,15,9,1,167,29,316
49,272,795,107,688,19,669,9,103,182,70,14,4,4,60,9,214
49,273,1124,154,970,22,948,14,209,293,71,23,7,3,102,34,192
49,274,653,82,571,9,562,3,124,165,38,11,2,1,51,13,154
49,276,2179,289,1890,55,1835,35,235,566,158,22,11,5,313,33,457
49,277,1110,139,971,21,950,15,105,375,80,13,7,2,117,20,216
49,278,2832,389,2443,51,2392,65,256,753,172,28,25,6,322,42,723
49,279,517,64,453,4,449,24,64,129,56,8,0,2,51,5,110
49,280,294,34,260,6,254,4,44,68,28,3,4,1,26,7,69
49,281,1242,179,1063,21,1042,11,134,401,78,13,6,1,149,18,231
49,282,541,104,437,10,427,14,107,132,34,7,2,2,56,8,65
49,283,2370,263,2107,53,2054,49,286,577,211,33,26,4,251,41,576
49,284,1003,136,867,18,849,22,129,257,72,8,17,1,104,17,222
49,285,1997,327,1670,42,1628,23,285,502,113,31,12,3,201,34,424
49,288,171,24,147,2,145,10,22,24,22,4,2,0,11,0,50
49,289,1292,131,1161,32,1129,24,122,353,82,12,6,6,150,23,351
49,290,1362,161,1201,34,1167,26,130,289,138,14,2,2,157,24,385
49,291,275,59,216,6,210,1,73,54,19,2,3,0,13,5,40
49,292,1351,127,1224,27,1197,24,197,333,130,24,13,3,159,46,268
49,294,1840,188,1652,43,1609,38,230,484,119,23,13,9,220,32,441
49,295,1307,127,1180,42,1138,25,146,394,96,19,9,1,217,32,199
49,296,1455,156,1299,40,1259,20,225,410,109,18,11,7,172,27,260
49,297,579,70,509,18,491,7,68,179,46,8,3,6,80,11,83
49,298,1144,125,1019,21,998,36,109,296,98,5,1,3,137,20,293
49,299,2085,302,1783,45,1738,27,194,438,161,27,10,7,293,45,536
49,300,577,69,508,17,491,21,50,172,35,4,4,3,107,10,85
49,301,4827,654,4173,87,4086,77,544,1200,327,88,31,12,544,99,1164
49,302,301,65,236,4,232,2,55,66,27,4,1,0,16,3,58
49,303,545,54,491,15,476,9,78,114,65,6,2,4,60,12,126
49,304,805,114,691,13,678,9,145,196,62,10,8,2,85,14,147
49,305,555,80,475,13,462,11,59,150,37,9,4,0,60,10,122
49,306,1228,117,1111,31,1080,36,137,263,133,13,6,4,158,17,313
49,307,1753,215,1538,35,1503,31,189,483,160,21,9,6,194,27,383
49,308,1576,130,1446,34,1412,30,178,464,107,14,11,1,211,34,362
49,309,286,30,256,0,256,9,30,102,20,2,2,0,40,8,43
49,310,454,78,376,11,365,0,54,145,23,9,4,2,50,13,65
49,311,842,100,742,18,724,15,160,228,55,9,9,0,92,15,141
49,312,276,34,242,5,237,10,35,77,21,3,3,0,40,3,45
49,313,2477,333,2144,65,2079,33,306,675,165,27,18,5,275,54,521
49,314,817,110,707,35,672,8,116,300,42,7,10,0,102,16,71
49,315,232,39,193,3,190,3,37,56,25,2,2,0,13,4,48
49,316,1084,129,955,24,931,7,164,295,67,16,6,0,165,29,182
49,317,739,96,643,14,629,30,61,163,79,9,4,1,81,12,189
49,318,979,87,892,21,871,33,127,202,111,12,5,1,112,20,248
49,319,216,29,187,4,183,5,30,61,21,2,3,0,14,4,43
49,320,601,73,528,24,504,10,71,169,38,5,7,3,82,12,107
49,321,288,31,257,7,250,13,39,59,44,1,5,1,20,4,64
49,322,156,17,139,7,132,9,9,50,18,2,1,0,13,2,28
49,323,3413,429,2984,81,2903,47,362,895,240,29,18,10,416,76,810
49,324,972,143,829,29,800,12,106,284,60,13,9,1,153,29,133
49,325,791,137,654,15,639,7,62,291,48,18,5,1,99,16,92
49,326,621,57,564,16,548,16,69,120,51,8,4,3,81,12,184
49,327,398,58,340,5,335,4,59,88,30,4,3,0,55,5,87
49,328,19296,3971,15325,305,15020,239,2240,5076,1216,167,93,47,1621,312,4009
49,329,965,96,869,22,847,39,97,225,116,8,3,3,107,20,229
49,330,657,57,600,16,584,12,105,176,55,5,5,1,54,10,161
49,331,5066,1038,4028,91,3937,102,502,1206,330,59,33,13,498,80,1114
49,332,3082,416,2666,70,2596,53,291,872,176,37,23,5,432,57,650
49,333,1975,287,1688,39,1649,32,250,439,213,25,10,4,186,43,447
49,334,212,30,182,6,176,2,46,57,17,5,4,1,18,2,24
49,335,232,24,208,7,201,10,44,77,16,2,1,0,7,6,38
49,336,658,85,573,8,565,12,86,201,33,6,0,1,87,11,128
49,337,1973,272,1701,31,1670,50,262,362,195,21,16,3,229,33,499
49,338,985,99,886,17,869,33,84,226,98,12,6,3,104,16,287
49,339,1048,97,951,21,930,22,155,227,108,16,5,0,121,31,245
49,341,532,59,473,4,469,2,95,155,46,8,5,0,55,12,91
49,342,213,37,176,2,174,2,35,75,8,3,3,1,21,4,22
49,343,2416,356,2060,48,2012,37,222,671,147,31,12,5,302,51,534
49,344,733,98,635,9,626,12,116,195,56,9,6,2,69,11,150
49,345,1421,212,1209,35,1174,38,185,358,126,18,8,1,175,28,237
49,346,363,38,325,2,323,15,46,89,42,2,1,1,40,7,80
49,347,3138,442,2696,53,2643,43,397,842,233,39,20,7,312,76,674
49,348,556,108,448,11,437,9,85,122,51,11,5,1,55,14,84
49,349,1260,163,1097,24,1073,19,203,354,77,12,10,2,156,25,215
49,350,1495,230,1265,43,1222,16,178,450,68,16,4,1,211,28,250
49,351,996,100,896,29,867,14,131,333,81,10,9,2,114,29,144
49,352,832,95,737,17,720,10,90,247,42,7,3,1,125,15,180
49,353,8546,1491,7055,138,6917,169,899,1146,994,103,83,19,637,131,2736
49,354,254,40,214,3,211,3,26,97,11,1,1,1,41,5,25
49,355,2184,310,1874,74,1800,37,208,554,136,37,16,3,269,43,497
49,356,287,40,247,6,241,4,34,111,19,2,4,0,29,9,29
49,358,423,80,343,4,339,9,64,107,29,6,0,5,36,10,73
49,359,394,48,346,4,342,6,74,125,28,1,1,1,45,12,49
49,360,1320,174,1146,31,1115,37,180,287,136,16,9,2,140,24,284
49,361,1408,238,1170,26,1144,16,282,366,85,11,4,2,115,28,235
49,362,923,114,809,11,798,13,133,296,55,13,5,0,84,21,178
49,363,1169,126,1043,17,1026,28,170,282,104,7,6,0,112,18,299
49,364,890,131,759,17,742,12,197,223,53,13,5,0,62,19,158
49,365,626,104,522,10,512,7,114,163,42,14,1,1,54,15,101
49,366,235,38,197,3,194,3,42,75,9,2,2,0,17,5,39
49,367,1501,240,1261,32,1229,26,196,427,97,17,11,1,141,35,278
49,368,1252,213,1039,34,1005,17,196,282,128,22,14,1,84,16,245
49,369,859,136,723,25,698,12,158,188,62,12,12,1,79,23,151
49,370,338,52,286,10,276,5,69,69,15,2,1,1,25,12,77
49,371,1172,148,1024,32,992,10,149,310,86,15,2,4,133,22,261
49,372,995,158,837,22,815,26,138,234,71,12,2,5,111,10,206
49,373,3125,447,2678,70,2608,47,369,859,220,49,28,9,404,75,548
49,374,1081,195,886,19,867,19,185,238,88,12,5,1,68,30,221
49,375,1754,246,1508,38,1470,20,238,384,131,19,14,1,241,49,373
49,376,464,57,407,9,398,9,75,103,43,7,7,1,61,13,79
49,377,2103,316,1787,54,1733,49,208,477,179,32,7,6,239,42,494
49,378,1603,231,1372,23,1349,18,290,460,100,23,9,1,134,40,274
49,380,202,41,161,3,158,3,41,35,15,3,4,1,13,6,37
49,381,1439,217,1222,37,1185,25,163,456,79,25,17,3,157,33,227
50,1,531,66,465,9,456,4,80,113,56,5,3,3,58,9,125
50,2,3453,513,2940,51,2889,72,274,827,248,23,13,7,427,51,947
50,3,2599,420,2179,27,2152,84,237,847,173,18,8,5,204,41,535
50,4,376,64,312,2,310,3,95,89,23,9,2,0,28,6,55
50,5,230,45,185,4,181,5,46,57,14,2,5,0,20,5,27
50,6,119,8,111,1,110,2,27,29,9,3,0,0,14,1,25
50,7,172,24,148,3,145,2,37,59,12,0,1,0,13,2,19
50,8,359,33,326,12,314,6,56,85,37,6,6,3,43,5,67
50,9,190,27,163,3,160,2,22,39,20,4,0,2,26,2,43
50,10,60,10,50,1,49,0,8,23,3,0,0,0,5,2,8
50,12,214,42,172,2,170,0,38,46,17,1,3,0,20,3,42
50,13,328,56,272,3,269,4,51,119,17,2,2,3,28,9,34
50,14,212,39,173,0,173,8,24,51,19,4,0,0,18,6,43
50,15,501,74,427,6,421,13,58,158,38,3,4,2,46,10,89
50,16,171,28,143,1,142,0,16,37,14,5,0,0,21,5,44
50,18,415,64,351,5,346,0,72,120,27,5,1,0,32,6,83
50,19,321,61,260,6,254,1,57,74,29,5,1,0,18,6,63
50,20,235,32,203,1,202,3,18,48,30,0,5,2,29,2,65
50,21,59,14,45,2,43,0,6,16,6,1,0,0,3,2,9
50,22,95,20,75,0,75,3,20,25,2,0,1,0,10,5,9
50,23,500,81,419,6,413,5,88,97,39,3,3,1,49,10,118
50,24,128,19,109,3,106,6,22,33,2,2,0,1,16,2,22
50,25,5582,1263,4319,97,4222,103,502,1333,413,62,27,11,499,99,1173
50,26,74,12,62,0,62,1,8,22,8,0,0,0,4,0,19
50,27,711,97,614,16,598,6,102,182,61,8,6,3,74,19,137
50,28,82,20,62,1,61,4,17,12,3,3,0,0,5,3,14
50,29,922,151,771,27,744,13,118,236,47,11,9,3,127,26,154
50,30,492,100,392,5,387,5,68,163,18,4,3,0,29,8,89
50,31,1977,317,1660,19,1641,28,218,592,167,16,16,2,161,33,408
50,32,788,111,677,9,668,18,70,153,46,9,0,1,102,23,246
50,33,142,31,111,3,108,1,15,50,4,0,1,0,15,2,20
50,34,403,32,371,9,362,19,40,90,33,3,1,1,37,10,128
50,35,84,7,77,0,77,1,14,17,10,0,1,0,10,3,21
50,36,321,65,256,2,254,1,41,58,29,2,1,1,10,13,98
50,37,104,15,89,4,85,2,7,33,6,1,4,0,17,1,14
50,38,312,58,254,5,249,7,42,79,25,0,0,0,41,4,51
50,39,114,24,90,1,89,4,17,40,5,1,1,0,7,3,11
50,40,140,23,117,0,117,2,26,54,7,3,1,0,12,2,10
50,41,1001,137,864,24,840,8,175,214,76,20,10,3,78,19,237
50,42,330,71,259,4,255,8,47,116,16,1,2,3,24,5,33
50,43,115,20,95,3,92,3,19,28,6,5,3,1,7,5,15
50,44,218,24,194,5,189,3,33,68,16,2,0,3,24,6,34
50,45,407,57,350,5,345,3,56,99,42,3,6,1,40,4,91
50,46,297,43,254,4,250,9,34,77,13,6,3,2,34,10,62
50,48,396,80,316,11,305,12,70,90,23,1,2,0,62,5,40
50,49,512,98,414,9,405,3,99,100,48,5,5,2,46,10,87
50,50,88,12,76,2,74,3,16,27,6,3,0,1,11,0,7
50,51,46,10,36,0,36,0,4,20,2,1,0,0,3,2,4
50,52,125,21,104,0,104,1,15,52,2,2,0,0,10,0,22
50,54,129,16,113,2,111,2,35,35,8,2,0,1,9,1,18
50,55,76,8,68,3,65,1,19,18,3,2,0,1,10,1,10
50,56,346,50,296,7,289,5,56,62,29,3,3,0,47,6,78
50,57,404,44,360,4,356,4,82,47,56,7,3,2,27,6,122
50,58,1299,194,1105,22,1083,24,167,379,117,9,5,6,116,12,248
50,59,200,26,174,2,172,1,42,51,12,2,0,0,21,8,35
50,60,343,65,278,8,270,2,60,98,22,2,0,1,20,7,58
50,61,156,13,143,2,141,3,34,49,10,2,0,0,18,2,23
50,62,78,22,56,0,56,6,8,23,3,0,1,0,4,0,11
50,63,299,64,235,6,229,4,40,52,24,0,4,2,29,5,69
50,64,113,18,95,2,93,0,23,29,4,1,1,1,9,1,24
50,66,2008,279,1729,31,1698,44,214,650,131,14,6,3,196,33,407
50,69,223,34,189,3,186,2,40,70,16,4,2,0,21,1,30
50,70,47,2,45,1,44,0,2,16,9,0,0,0,5,1,11
50,71,142,11,131,6,125,1,32,58,10,0,0,0,14,0,10
50,72,163,14,149,6,143,7,35,41,10,0,2,1,14,4,29
50,73,104,10,94,4,90,3,16,26,7,1,2,0,5,2,28
50,74,1764,287,1477,37,1440,20,210,480,122,17,15,2,250,35,289
50,75,128,16,112,2,110,2,25,33,6,0,3,0,15,1,25
50,76,2600,404,2196,49,2147,58,306,647,191,28,8,10,266,47,586
50,77,980,164,816,9,807,19,109,209,120,10,1,1,68,13,257
50,78,339,54,285,3,282,1,70,80,24,2,0,0,29,3,73
50,79,310,56,254,5,249,7,54,77,35,4,1,1,15,7,48
50,80,255,31,224,5,219,1,41,61,30,3,3,0,20,7,53
50,81,694,89,605,12,593,15,65,220,41,4,1,4,78,8,157
50,82,3412,741,2671,39,2632,27,444,694,318,38,22,3,261,53,772
50,83,393,55,338,6,332,3,47,82,56,11,3,0,32,5,93
50,84,459,56,403,1,402,7,50,112,33,6,2,3,59,13,117
50,85,955,137,818,17,801,23,108,268,79,11,2,5,93,17,195
50,86,289,46,243,6,237,5,40,88,14,1,0,1,18,6,64
50,87,1717,276,1441,15,1426,12,211,390,156,22,10,6,202,34,383
50,88,135,18,117,0,117,6,15,31,21,5,0,0,9,1,29
50,89,123,12,111,2,109,2,16,49,6,2,0,0,13,2,19
50,90,433,61,372,8,364,3,68,161,22,4,0,0,49,7,50
50,92,544,71,473,11,462,9,84,138,38,8,1,1,75,9,99
50,93,312,46,266,3,263,4,58,64,36,3,6,0,22,5,65
50,94,287,36,251,3,248,3,70,68,18,3,1,3,30,10,42
50,95,785,120,665,10,655,6,111,201,51,11,7,0,78,14,176
50,96,169,26,143,6,137,2,34,40,18,0,0,0,10,5,28
50,97,103,16,87,0,87,1,21,26,4,0,0,0,10,1,24
50,98,439,59,380,8,372,4,82,111,38,6,3,0,40,11,77
50,99,4215,953,3262,58,3204,50,532,931,310,49,22,6,292,59,953
50,100,345,36,309,6,303,5,51,104,17,3,5,1,40,7,70
50,101,174,31,143,1,142,1,23,57,7,0,1,0,11,6,36
50,102,763,104,659,5,654,25,77,263,33,8,3,4,100,6,135
50,103,221,39,182,5,177,3,38,53,13,1,2,1,15,5,46
50,105,76,5,71,0,71,1,14,12,5,4,0,1,18,0,16
50,106,184,17,167,0,167,0,43,51,8,1,1,0,18,2,43
50,107,98,9,89,1,88,3,15,29,4,0,0,0,9,2,26
50,108,334,46,288,6,282,9,55,78,30,8,5,1,33,5,58
50,109,1561,360,1201,38,1163,21,271,345,100,16,16,2,127,18,247
50,110,620,101,519,9,510,13,90,167,37,6,4,2,63,14,114
50,111,729,110,619,12,607,16,137,170,54,5,9,1,68,12,135
50,112,337,52,285,7,278,7,53,88,24,8,2,2,40,4,50
50,114,90,5,85,1,84,5,18,27,3,3,0,0,12,2,14
50,115,171,20,151,3,148,9,36,45,7,3,1,0,10,1,36
50,116,146,14,132,3,129,3,24,47,7,4,1,1,14,3,25
50,117,303,39,264,2,262,8,52,79,23,2,0,0,42,7,49
50,118,217,22,195,4,191,7,42,77,16,4,0,0,17,5,23
50,119,147,22,125,0,125,1,14,43,7,1,3,0,18,2,36
50,120,241,19,222,3,219,5,54,35,17,4,3,0,38,9,54
50,121,175,33,142,0,142,0,31,50,11,1,0,0,25,4,20
50,123,522,80,442,5,437,5,71,116,48,9,1,0,57,7,123
50,124,111,22,89,1,88,0,13,39,3,1,0,1,17,2,12
50,125,69,10,59,2,57,0,10,29,1,2,0,0,5,1,9
50,126,117,20,97,1,96,2,15,21,6,0,1,0,19,6,26
50,127,535,79,456,10,446,2,91,92,30,9,6,0,32,9,175
50,128,217,44,173,6,167,6,42,33,11,2,2,0,28,9,34
50,129,23746,5447,18299,300,17999,345,2375,4264,2393,251,129,63,1611,333,6235
50,130,317,57,260,8,252,2,54,94,9,4,3,2,29,8,47
50,131,238,50,188,5,183,3,35,57,14,3,4,1,33,10,23
50,132,197,25,172,7,165,5,34,49,17,2,3,0,14,11,30
50,133,166,13,153,4,149,1,27,53,8,2,3,0,24,10,21
50,134,70,14,56,3,53,1,10,20,4,1,0,0,5,3,9
50,135,161,18,143,4,139,2,25,43,15,4,1,1,11,2,35
50,136,150,19,131,4,127,4,26,24,9,2,0,0,11,3,48
50,137,461,53,408,8,400,4,90,142,19,7,4,0,44,8,82
50,138,368,53,315,7,308,3,61,80,42,6,4,0,32,3,77
50,139,2569,292,2277,40,2237,19,378,650,198,46,18,4,256,55,613
50,140,300,45,255,7,248,5,51,53,33,1,3,0,34,6,62
50,142,480,68,412,9,403,7,60,141,47,9,4,1,26,7,101
50,143,648,74,574,11,563,13,85,132,55,7,5,4,78,21,163
50,144,413,102,311,12,299,3,58,102,25,7,5,1,39,9,50
50,145,437,65,372,4,368,17,72,94,51,4,1,2,25,9,93
50,146,190,35,155,6,149,2,43,37,19,2,0,1,23,1,21
50,147,5912,1142,4770,99,4671,114,588,1185,529,63,33,13,577,93,1476
50,148,329,54,275,6,269,6,43,83,27,2,0,1,34,5,68
50,149,683,88,595,8,587,5,97,123,64,8,8,3,69,22,188
50,150,202,37,165,2,163,0,38,57,10,1,0,1,16,3,37
50,151,1686,250,1436,27,1409,13,311,407,87,19,5,1,100,33,433
50,152,213,56,157,3,154,0,31,56,9,4,0,0,30,1,23
50,153,195,34,161,2,159,9,32,40,15,3,1,1,6,7,45
50,154,362,48,314,6,308,8,68,95,29,6,4,1,32,9,56
50,155,194,18,176,2,174,8,32,53,23,8,1,1,17,5,26
50,156,55,8,47,0,47,2,13,11,5,1,0,0,4,3,8
50,158,277,59,218,6,212,2,26,79,12,3,1,0,41,8,40
50,159,475,85,390,9,381,9,83,113,36,7,2,2,43,9,77
50,160,499,100,399,7,392,7,62,128,40,5,4,0,48,7,91
50,161,403,79,324,6,318,8,69,103,34,1,2,0,30,3,68
50,162,1282,194,1088,18,1070,13,174,262,129,8,8,2,95,27,352
50,163,203,18,185,3,182,1,33,59,19,0,4,1,15,6,44
50,164,772,140,632,15,617,10,138,156,52,20,6,1,77,12,145
50,165,2968,605,2363,45,2318,56,268,677,269,34,9,8,233,60,704
50,166,229,38,191,9,182,3,44,55,15,3,1,0,17,5,39
50,167,576,75,501,4,497,6,64,168,56,6,1,2,64,9,121
50,168,1743,253,1490,29,1461,25,217,484,144,25,10,3,187,25,341
50,169,80,17,63,1,62,0,11,21,7,2,1,0,8,0,12
50,170,71,6,65,0,65,1,11,8,8,0,0,2,8,5,22
50,171,33,5,28,2,26,3,3,9,2,0,0,0,4,0,5
50,172,268,32,236,7,229,1,35,72,27,3,1,0,35,1,54
50,173,12790,2459,10331,193,10138,156,1383,1818,1488,132,82,30,865,199,3985
50,174,131,19,112,1,111,1,28,29,12,0,1,1,18,1,20
50,175,178,36,142,1,141,1,34,28,5,5,0,1,17,5,45
50,176,245,22,223,6,217,6,57,62,13,4,3,1,13,6,52
50,177,291,41,250,2,248,4,40,81,19,4,2,0,18,9,71
50,178,1145,172,973,19,954,36,154,232,126,11,5,2,76,21,291
50,179,34,4,30,2,28,0,9,9,1,0,0,0,5,2,2
50,180,265,21,244,5,239,7,58,66,16,5,4,1,31,3,48
50,181,253,36,217,1,216,3,36,55,27,2,4,3,29,16,41
50,182,235,34,201,3,198,3,41,61,21,1,2,1,15,3,50
50,183,220,36,184,3,181,4,45,68,18,0,2,1,11,3,29
50,184,1215,210,1005,11,994,18,236,230,92,14,10,2,75,20,297
50,185,778,116,662,18,644,10,106,222,53,6,6,0,100,15,126
50,186,150,22,128,0,128,2,26,44,10,0,2,0,11,2,31
50,187,681,78,603,10,593,8,99,115,70,4,5,3,75,15,199
50,188,701,101,600,14,586,13,117,143,49,17,3,2,88,9,145
50,189,244,38,206,5,201,1,43,64,19,1,0,1,38,8,26
50,190,158,23,135,2,133,2,26,48,5,2,2,0,21,1,26
50,191,109,15,94,3,91,1,17,20,6,2,2,0,9,3,31
50,192,81,15,66,0,66,0,17,31,6,0,0,0,6,4,2
50,193,182,19,163,7,156,0,29,55,12,1,0,0,24,2,33
50,194,319,73,246,4,242,5,64,58,18,2,2,1,24,10,58
50,195,193,26,167,3,164,2,36,50,16,4,0,1,10,6,39
50,196,464,89,375,2,373,7,51,159,29,3,3,0,29,7,85
50,197,1143,178,965,18,947,22,175,330,77,8,6,6,141,25,157
50,198,347,64,283,3,280,5,56,96,19,2,2,0,34,11,55
50,199,407,54,353,6,347,15,69,138,19,2,1,1,31,10,61
50,200,673,103,570,12,558,6,109,181,29,12,7,3,87,7,117
50,202,545,67,478,13,465,4,105,112,38,7,3,0,52,11,133
50,203,4395,940,3455,55,3400,43,613,688,419,49,33,10,326,81,1138
50,204,133,13,120,1,119,0,22,49,9,1,1,0,7,6,24
50,205,189,30,159,2,157,2,35,37,21,0,2,0,20,8,32
50,206,94,16,78,4,74,1,8,20,10,1,0,0,10,3,21
50,207,133,19,114,3,111,3,24,37,9,1,1,0,20,5,11
50,208,112,18,94,1,93,2,30,24,7,1,0,0,7,1,21
50,209,663,101,562,10,552,11,140,124,49,2,8,2,57,6,153
50,210,289,49,240,5,235,9,48,77,22,2,0,1,36,2,38
50,211,107,20,87,0,87,1,28,22,6,1,1,0,6,0,22
50,212,114,7,107,4,103,2,24,45,4,1,1,3,8,4,11
50,213,353,34,319,5,314,8,32,80,42,6,2,2,35,10,97
50,214,219,34,185,5,180,2,37,63,20,4,1,0,21,2,30
50,215,1657,234,1423,31,1392,16,223,457,100,15,8,7,161,23,382
50,216,554,103,451,10,441,1,109,123,38,4,2,0,33,15,116
50,217,424,54,370,11,359,8,70,97,44,2,5,2,40,6,85
50,218,9511,2117,7394,130,7264,186,902,2182,789,73,42,18,800,132,2140
50,219,541,76,465,9,456,12,75,112,51,6,3,0,69,12,116
50,220,602,72,530,3,527,19,80,117,76,7,3,5,48,8,164
50,221,47,3,44,0,44,3,18,10,4,0,0,0,3,2,4
50,222,583,96,487,10,477,6,92,114,53,11,4,2,63,14,118
50,223,95,16,79,2,77,1,17,30,9,2,0,0,8,1,9
50,224,767,122,645,11,634,8,145,182,69,12,5,1,87,12,113
50,225,83,14,69,2,67,1,5,25,4,3,1,0,11,2,15
50,227,265,72,193,3,190,0,42,34,19,1,2,1,23,4,64
50,228,879,126,753,18,735,16,156,249,48,9,5,1,84,18,149
50,229,89,11,78,5,73,4,9,32,7,4,1,0,9,0,7
50,230,655,70,585,13,572,4,90,143,86,6,5,4,68,14,152
50,231,646,125,521,6,515,8,83,206,39,3,4,1,60,7,104
50,232,298,41,257,1,256,9,63,65,15,2,2,2,34,3,61
50,233,104,20,84,2,82,1,14,32,4,1,0,2,4,2,22
50,234,58,6,52,2,50,0,10,23,3,1,1,0,5,1,6
50,235,199,36,163,0,163,2,25,40,19,0,0,0,25,5,47
50,236,1220,258,962,23,939,7,137,318,63,16,3,1,105,17,272
50,237,907,133,774,13,761,10,129,239,44,8,4,1,101,17,208
50,238,302,50,252,6,246,7,47,78,32,3,1,2,29,5,42
50,239,864,115,749,13,736,12,126,199,61,8,4,1,108,16,201
50,240,315,45,270,2,268,4,54,55,22,0,0,1,37,7,88
50,241,134,19,115,3,112,4,22,25,13,2,1,0,12,2,31
50,242,112,13,99,1,98,2,22,24,13,2,0,0,8,4,23
50,243,421,61,360,11,349,11,61,123,22,5,3,4,39,9,72
50,244,167,19,148,3,145,3,27,40,15,5,1,0,19,2,33
50,245,163,34,129,4,125,7,26,42,10,0,1,0,9,2,28
50,246,61,5,56,1,55,5,14,19,0,3,0,0,7,4,3
50,247,128,15,113,1,112,3,23,23,14,6,0,0,9,4,30
50,248,238,45,193,3,190,4,52,32,30,2,1,2,12,3,52
50,249,203,20,183,2,181,3,43,51,21,3,0,0,20,6,34
50,250,57,17,40,1,39,0,5,11,6,0,0,0,8,0,9
50,251,275,32,243,4,239,8,47,65,15,4,3,1,25,3,68
50,252,625,89,536,11,525,10,115,158,56,3,4,1,61,18,99
50,253,149,17,132,2,130,2,21,50,14,1,2,0,9,0,31
50,254,183,19,164,5,159,5,29,72,8,5,0,0,25,6,9
50,255,287,37,250,3,247,6,42,62,31,2,3,1,41,5,54
50,256,2360,259,2101,72,2029,29,375,686,152,25,21,12,263,66,400
50,257,335,36,299,3,296,11,51,72,29,7,0,1,41,8,76
50,258,81,22,59,3,56,0,17,12,8,1,0,2,3,2,11
50,259,469,65,404,12,392,8,63,117,49,5,3,0,65,8,74
50,260,462,64,398,13,385,5,78,131,18,11,1,0,59,15,67
50,261,139,20,119,3,116,2,27,50,8,0,0,0,9,3,17
50,262,396,66,330,9,321,3,52,105,27,1,7,0,53,7,66
50,263,336,45,291,6,285,1,66,112,14,7,1,0,37,10,37
50,265,124,11,113,1,112,3,29,51,0,0,1,0,6,4,18
50,266,352,54,298,4,294,5,86,68,24,6,1,1,36,11,56
50,267,1434,242,1192,30,1162,17,241,389,105,16,12,1,90,28,263
50,268,210,46,164,1,163,0,33,50,16,3,2,0,14,3,42
50,269,153,20,133,1,132,1,22,33,9,2,2,0,22,6,35
50,270,306,46,260,1,259,3,44,77,15,7,2,1,31,10,69
50,271,51,11,40,0,40,1,8,15,2,0,0,0,6,4,4
50,272,836,126,710,10,700,8,124,232,62,15,3,2,65,13,176
50,273,392,63,329,8,321,3,88,104,24,5,3,2,26,4,62
50,274,719,120,599,19,580,4,110,237,48,4,2,0,64,16,95
50,275,117,7,110,3,107,0,29,37,9,1,0,0,9,0,22
50,276,442,69,373,8,365,9,59,112,43,5,1,0,49,3,84
50,277,555,99,456,8,448,10,78,152,39,4,1,2,35,12,115
50,278,171,24,147,3,144,1,25,36,20,2,1,0,17,4,38
50,279,429,68,361,3,358,7,60,131,20,10,2,0,51,8,69
50,280,252,51,201,4,197,3,46,57,23,1,1,1,27,2,36
50,281,693,129,564,10,554,10,115,165,52,5,0,1,70,13,123
50,282,170,26,144,2,142,4,19,54,11,5,1,0,20,7,21
50,283,49,1,48,1,47,0,5,20,4,1,0,0,7,0,10
50,284,77,14,63,2,61,3,14,17,6,0,1,0,11,1,8
50,285,206,32,174,2,172,2,50,42,15,5,1,2,18,4,33
50,287,397,61,336,8,328,5,46,85,30,5,2,2,51,14,88
50,288,1010,108,902,25,877,17,112,239,81,10,6,2,145,21,244
50,289,504,63,441,11,430,8,93,85,56,5,5,4,48,6,120
50,290,275,38,237,5,232,5,44,62,24,8,1,0,33,2,53
50,291,102,21,81,2,79,2,14,29,4,2,2,1,10,0,15
50,292,1663,288,1375,38,1337,22,202,407,103,26,10,8,189,35,335
50,293,242,39,203,4,199,0,38,79,13,3,0,1,32,4,29
50,294,888,129,759,7,752,17,96,196,80,15,4,0,95,20,229
50,295,108,15,93,5,88,4,22,33,3,1,2,0,10,1,12
50,296,220,19,201,1,200,2,23,51,22,2,1,1,12,6,80
50,297,826,123,703,12,691,10,112,166,82,9,2,0,69,16,225
50,298,501,76,425,10,415,4,72,104,44,8,1,1,33,9,139
50,299,154,14,140,4,136,0,33,52,8,3,1,1,10,3,25
50,300,136,26,110,1,109,0,21,43,11,0,2,0,20,4,8
50,301,130,20,110,1,109,1,31,31,12,2,0,0,7,0,25
50,302,224,21,203,0,203,7,27,64,26,3,1,0,23,6,46
50,304,120,22,98,5,93,4,20,34,15,1,1,0,8,0,10
50,305,504,81,423,8,415,5,72,83,51,5,4,1,45,12,137
50,308,218,32,186,2,184,4,36,43,14,1,0,0,34,10,42
50,310,108,17,91,3,88,1,16,30,2,1,0,1,7,2,28
50,311,195,31,164,5,159,4,17,60,20,5,3,0,15,7,28
50,312,108,13,95,0,95,2,13,44,5,0,0,0,11,1,19
50,313,102,13,89,2,87,3,17,30,4,1,1,0,13,1,17
50,315,213,32,181,2,179,2,25,73,10,1,3,3,27,6,29
50,316,168,17,151,1,150,7,27,41,16,3,2,0,12,3,39
50,317,176,35,141,4,137,3,32,30,6,3,0,0,23,4,36
50,318,155,20,135,5,130,0,21,50,10,5,1,0,24,1,18
50,319,287,28,259,5,254,6,38,56,26,7,0,1,35,4,81
50,320,123,12,111,1,110,6,28,32,7,1,1,1,21,1,12
50,321,419,34,385,5,380,11,57,107,26,3,3,0,38,11,124
50,323,164,30,134,5,129,0,40,36,4,3,0,0,25,4,17
50,324,79,14,65,1,64,3,20,20,1,0,0,0,7,1,12
50,325,171,29,142,2,140,6,35,32,20,2,2,1,7,5,30
50,326,208,28,180,0,180,6,33,73,13,1,0,0,17,6,31
50,327,116,13,103,1,102,2,12,36,10,1,1,0,14,2,24
50,328,493,82,411,11,400,9,98,127,29,6,6,1,47,13,64
50,329,242,28,214,8,206,1,24,92,19,2,4,1,34,8,21
50,330,181,42,139,4,135,0,19,53,5,2,1,0,9,8,38
50,332,577,82,495,13,482,6,88,158,51,12,5,3,50,10,99
50,333,240,32,208,4,204,6,44,36,24,2,0,2,17,6,67
50,334,202,30,172,6,166,7,38,49,9,2,1,0,26,3,31
50,335,376,67,309,8,301,4,59,78,25,4,1,3,37,9,81
50,336,152,21,131,7,124,0,32,45,13,2,0,0,9,3,20
50,337,303,50,253,9,244,2,47,106,11,0,2,1,20,12,43
50,338,284,48,236,5,231,0,41,96,9,3,3,1,32,2,44
50,339,254,25,229,6,223,2,45,58,24,0,0,0,26,8,60
50,340,135,20,115,1,114,2,23,34,12,3,2,0,16,2,20
50,341,1354,220,1134,13,1121,13,209,273,131,13,15,4,87,23,353
50,342,682,129,553,13,540,15,118,190,46,4,4,0,45,15,103
50,343,364,61,303,8,295,1,47,115,26,4,6,1,29,10,56
50,345,527,57,470,6,464,6,86,119,41,3,2,0,54,8,145
50,347,227,38,189,6,183,8,28,71,13,6,0,1,14,6,36
50,348,446,84,362,2,360,7,90,115,26,6,1,2,29,17,67
50,349,1112,177,935,18,917,28,141,252,112,7,1,0,103,26,247
50,350,389,65,324,2,322,9,86,102,33,7,2,0,25,6,52
50,351,65,18,47,1,46,0,13,6,6,1,0,0,10,1,9
50,352,207,33,174,6,168,1,37,42,7,0,0,1,26,5,49
50,353,102,10,92,5,87,0,14,55,1,0,0,1,11,0,5
50,354,262,41,221,1,220,8,54,70,16,1,2,0,17,4,48
50,355,270,33,237,7,230,0,33,75,13,4,1,2,35,5,62
50,356,658,133,525,13,512,5,118,125,35,12,11,0,38,7,161
50,357,70,5,65,0,65,0,10,28,8,1,0,0,5,0,13
50,358,198,31,167,0,167,2,41,58,12,1,0,0,15,3,35
50,359,1241,242,999,23,976,27,130,285,73,20,8,2,153,28,250
50,360,200,23,177,4,173,1,35,49,10,1,0,1,27,7,42
50,361,130,16,114,2,112,0,29,35,8,3,1,1,18,0,17
50,362,236,26,210,5,205,0,42,83,11,3,6,1,21,4,34
50,363,748,101,647,13,634,13,105,201,52,10,3,1,98,16,135
50,364,493,97,396,5,391,5,91,124,29,8,1,1,43,10,79
50,365,318,30,288,6,282,4,57,77,21,4,1,0,34,8,76
50,368,63,12,51,1,50,0,10,16,4,2,0,0,8,1,9
50,369,594,80,514,8,506,6,80,145,52,8,3,1,63,20,128
50,370,427,59,368,7,361,7,79,89,31,5,2,2,22,16,108
50,371,345,44,301,3,298,3,40,85,22,4,5,1,44,5,89
50,372,119,18,101,0,101,2,23,20,11,1,1,0,13,0,30
50,373,76,15,61,0,61,2,13,21,5,0,0,0,7,1,12
50,374,31,7,24,3,21,0,4,9,0,0,0,0,1,0,7
50,375,148,17,131,0,131,2,25,39,12,0,0,0,13,1,39
50,376,337,43,294,7,287,1,48,82,28,2,3,0,37,6,80
50,378,464,72,392,6,386,6,79,118,31,8,2,3,54,8,77
50,379,93,13,80,2,78,0,10,29,5,2,1,1,13,6,11
50,380,127,23,104,5,99,1,22,36,2,1,0,2,6,2,27
50,381,505,71,434,8,426,8,78,157,22,4,6,4,52,10,85
50,382,380,47,333,2,331,1,42,62,39,8,0,4,33,7,135
50,384,158,26,132,1,131,2,24,57,9,0,0,1,10,5,23
50,385,135,12,123,1,122,3,10,46,14,0,1,0,15,2,31
50,386,416,65,351,7,344,11,38,83,45,7,1,2,25,5,127
50,387,266,36,230,3,227,0,38,91,22,3,4,1,22,5,41
50,388,751,110,641,12,629,19,109,148,93,8,1,1,86,8,156
50,389,348,53,295,11,284,10,52,66,32,6,0,4,41,17,56
50,390,125,23,102,5,97,1,22,39,6,0,1,0,3,3,22
50,391,1547,227,1320,33,1287,20,196,417,102,21,11,5,182,37,296
50,393,1613,257,1356,38,1318,21,189,539,79,18,9,2,164,36,261
50,394,1729,347,1382,25,1357,19,240,460,118,12,15,7,174,23,289
50,395,197,33,164,2,162,4,44,77,5,1,1,0,4,3,23
50,396,141,30,111,0,111,1,35,21,13,2,1,0,10,1,27
50,397,159,13,146,1,145,4,36,31,10,3,2,0,32,5,22
50,398,133,11,122,2,120,0,38,38,7,2,0,0,8,3,24
50,399,155,25,130,4,126,4,26,35,12,1,1,0,17,7,23
50,400,1224,229,995,18,977,11,231,279,72,18,7,3,82,22,252
50,401,538,105,433,7,426,8,86,105,34,7,2,0,40,7,137
50,402,2523,421,2102,38,2064,44,311,498,310,31,18,9,188,42,613
50,403,1330,259,1071,9,1062,18,241,324,80,11,7,3,75,19,284
50,404,157,23,134,7,127,2,18,46,12,1,3,0,16,1,28
50,405,192,38,154,1,153,1,34,67,3,2,0,0,11,1,34
50,406,295,42,253,8,245,8,51,85,20,4,3,0,28,3,43
50,407,663,83,580,13,567,7,103,165,54,12,6,1,83,17,119
50,408,370,59,311,4,307,2,56,98,28,4,4,0,34,8,73
50,409,1380,218,1162,20,1142,15,159,333,78,10,8,3,145,23,368
50,410,2865,472,2393,53,2340,30,411,783,191,27,19,14,206,48,611
50,411,462,68,394,10,384,3,69,125,27,6,0,0,47,10,97
50,412,1342,228,1114,16,1098,14,184,353,107,17,6,4,137,21,255
50,413,364,77,287,6,281,3,53,62,25,3,3,1,48,7,76
50,414,377,49,328,7,321,5,58,96,24,5,1,0,31,3,98
50,415,214,33,181,2,179,5,31,53,15,4,0,1,18,7,45
50,416,3588,644,2944,55,2889,26,438,608,372,44,25,8,263,63,1042
50,417,1259,230,1029,23,1006,14,236,355,47,5,9,1,76,23,240
50,418,549,80,469,11,458,10,81,123,47,10,3,2,61,11,110
50,419,1049,147,902,15,887,10,184,234,68,20,6,2,124,25,214
50,420,664,96,568,10,558,20,106,161,50,9,6,0,63,7,136
50,421,259,59,200,4,196,3,32,81,12,2,2,0,18,4,42
50,422,150,19,131,4,127,3,26,41,12,1,1,0,14,5,24
50,423,187,23,164,3,161,7,21,42,16,1,3,0,29,2,40
50,425,855,126,729,14,715,6,103,183,87,11,6,3,94,19,203
50,426,328,54,274,6,268,4,54,95,21,3,4,0,18,7,62
50,427,248,34,214,2,212,5,42,86,16,1,1,0,15,8,38
50,428,407,103,304,10,294,5,54,108,14,6,2,1,55,4,45
50,429,719,107,612,12,600,33,83,148,80,12,1,1,58,9,175
50,430,25,3,22,0,22,0,1,7,0,0,1,0,4,0,9
50,431,485,109,376,11,365,4,82,117,29,3,3,0,33,3,91
50,432,110,19,91,0,91,0,13,30,6,1,0,0,16,1,24
50,433,968,170,798,12,786,11,152,328,50,7,7,4,67,21,139
50,434,260,40,220,5,215,14,33,67,14,3,2,0,27,7,48
50,435,478,67,411,7,404,5,69,87,42,3,6,0,45,13,134
50,436,857,112,745,21,724,8,103,254,62,3,9,1,106,27,151
50,437,620,137,483,12,471,6,91,182,24,4,3,2,62,6,91
50,438,287,31,256,2,254,3,43,95,22,3,3,0,34,3,48
50,440,249,31,218,4,214,2,66,51,15,1,1,1,32,7,38
50,441,237,32,205,4,201,3,51,54,13,1,1,0,26,4,48
50,442,214,25,189,4,185,13,25,48,22,1,0,2,21,3,50
50,443,427,62,365,11,354,7,84,117,28,2,1,0,49,10,56
50,444,1715,178,1537,27,1510,18,305,416,157,17,10,5,176,40,366
50,445,230,42,188,2,186,1,27,50,20,3,3,2,29,9,42
50,446,412,61,351,4,347,5,55,123,27,4,2,1,39,5,86
50,447,324,39,285,7,278,7,46,92,21,3,1,0,33,11,64
50,448,519,63,456,13,443,10,95,142,23,7,2,1,69,15,79
50,449,176,29,147,2,145,3,29,39,11,2,3,0,22,1,35
50,450,276,38,238,6,232,1,49,70,15,4,6,2,32,6,47
50,451,105,16,89,3,86,2,17,26,9,1,1,1,12,1,16
50,452,507,68,439,7,432,0,93,151,24,3,5,3,57,22,74
50,453,678,105,573,13,560,8,101,198,50,6,10,0,64,7,116
50,454,301,35,266,7,259,8,54,55,34,2,3,1,26,5,71
50,455,632,92,540,9,531,11,77,199,31,9,3,0,45,18,138
50,456,424,67,357,10,347,4,65,122,18,4,2,0,54,14,64
50,457,138,20,118,1,117,0,35,29,8,2,3,0,9,2,29
50,458,417,71,346,8,338,3,78,121,28,4,0,3,32,9,60
50,460,581,78,503,4,499,8,89,133,71,12,2,1,53,15,115
50,461,165,19,146,1,145,1,31,36,15,0,1,0,14,4,43
50,462,327,61,266,5,261,8,62,84,14,2,2,1,42,4,42
50,463,397,75,322,6,316,8,54,119,29,7,1,0,51,8,39
50,464,438,66,372,4,368,13,96,105,34,6,6,0,35,9,64
50,465,548,61,487,13,474,9,65,112,48,7,4,1,69,17,142
50,467,372,51,321,4,317,7,44,78,29,4,2,3,37,10,103
50,468,545,85,460,4,456,8,133,122,38,5,3,2,36,17,92
50,469,241,32,209,5,204,2,36,96,19,0,0,1,12,8,30
50,470,326,61,265,1,264,4,50,76,19,5,6,1,29,5,69
50,471,248,29,219,2,217,2,39,58,22,2,1,1,37,4,51
50,472,171,19,152,1,151,3,16,38,14,3,2,1,29,3,42
50,473,337,57,280,10,270,5,47,78,33,7,0,0,28,5,67
50,474,407,54,353,8,345,4,81,125,20,8,2,2,38,9,56
50,475,778,105,673,8,665,16,64,193,54,5,3,2,86,14,228
50,476,163,28,135,2,133,6,29,35,11,2,3,0,21,2,24
50,477,301,37,264,2,262,8,45,80,25,4,2,0,26,4,68
50,478,300,39,261,2,259,2,52,69,31,5,0,1,20,1,78
50,479,103,20,83,1,82,0,12,42,5,0,1,1,8,5,8
50,480,594,96,498,13,485,7,71,152,66,7,4,0,41,11,126
50,481,841,165,676,8,668,3,127,204,53,6,2,4,61,26,182
50,482,163,32,131,5,126,0,35,35,11,3,2,0,22,1,17
50,483,667,64,603,4,599,11,80,166,57,8,6,0,78,19,174
50,484,2955,474,2481,72,2409,29,334,949,156,38,18,9,295,58,523
50,485,1057,151,906,19,887,7,155,269,84,8,6,1,65,18,274
50,486,385,66,319,5,314,2,77,78,37,7,5,2,35,6,65
50,487,1916,324,1592,36,1556,21,215,513,142,22,16,5,217,43,362
50,488,461,63,398,5,393,6,84,105,28,7,1,0,37,13,112
50,489,420,43,377,12,365,12,60,84,39,5,3,1,56,5,100
50,490,293,36,257,3,254,3,41,97,22,0,1,2,28,8,52
50,491,274,34,240,3,237,7,57,64,20,8,2,1,32,5,41
50,492,937,120,817,20,797,10,151,220,74,14,4,1,101,21,201
50,493,964,125,839,23,816,17,157,245,80,9,5,0,100,25,178
50,494,203,25,178,6,172,1,33,71,11,4,0,0,31,6,15
50,495,58,6,52,0,52,0,5,22,4,1,1,0,6,3,10
50,496,386,45,341,7,334,8,56,106,26,3,1,2,36,12,84
50,497,314,61,253,8,245,3,70,80,14,9,3,1,15,1,49
50,498,616,92,524,13,511,3,91,135,78,5,4,3,50,16,126
50,499,398,52,346,9,337,2,77,134,30,3,4,0,52,7,28
50,500,450,69,381,10,371,0,63,140,32,5,4,1,62,7,57
50,502,13494,2943,10551,162,10389,274,1197,2678,1085,141,69,24,1128,186,3607
50,503,440,87,353,4,349,5,71,96,37,12,3,2,20,5,98
50,504,150,13,137,4,133,4,36,30,7,2,1,0,37,2,14
50,505,539,55,484,16,468,11,74,118,47,6,3,1,63,13,132
50,506,306,38,268,7,261,5,68,65,35,4,0,2,16,5,61
50,507,297,46,251,2,249,4,63,83,16,3,2,0,19,7,52
50,508,49,10,39,0,39,2,8,15,1,0,0,0,6,1,6
50,509,561,101,460,4,456,5,92,158,30,12,2,1,50,14,92
50,510,399,74,325,8,317,5,84,75,33,3,2,1,32,9,73
50,511,102,20,82,3,79,0,18,31,9,0,0,0,11,2,8
50,512,416,49,367,8,359,7,67,95,36,6,4,0,44,14,86
50,513,170,28,142,1,141,1,24,30,20,2,0,1,22,3,38
50,514,203,26,177,7,170,2,45,52,9,2,2,2,11,3,42
50,515,924,135,789,18,771,8,123,300,51,13,5,4,107,21,139
50,516,2012,281,1731,39,1692,40,156,516,168,20,9,1,232,42,508
50,517,158,37,121,5,116,2,32,42,8,0,0,0,13,0,19
50,518,238,32,206,7,199,3,38,77,17,3,4,2,26,6,23
50,519,298,33,265,9,256,3,54,56,32,6,4,2,35,2,62
50,520,112,16,96,0,96,1,18,25,7,0,0,0,10,4,31
50,521,101,15,86,1,85,1,15,31,5,2,0,0,11,1,19
50,522,247,37,210,3,207,3,35,64,23,2,2,1,12,4,61
50,523,1136,152,984,15,969,9,219,309,52,10,11,0,103,17,239
50,524,156,28,128,6,122,2,19,36,9,3,0,2,19,1,31
50,525,247,31,216,1,215,11,50,62,20,3,4,0,16,9,40
50,528,223,29,194,6,188,4,32,43,18,2,1,1,15,4,68
50,529,63,9,54,0,54,0,18,17,2,0,1,0,6,1,9
50,531,562,73,489,17,472,6,72,124,48,7,6,2,96,20,91
50,532,3295,432,2863,32,2831,56,311,934,252,22,9,3,344,48,852
50,533,127,24,103,5,98,1,17,39,4,1,0,0,15,1,20
50,534,299,41,258,4,254,4,57,80,20,7,1,0,21,5,59
50,535,228,38,190,5,185,5,30,62,14,4,1,1,19,2,47
50,536,126,16,110,0,110,0,23,40,3,1,0,1,8,0,34
50,537,311,33,278,4,274,5,37,75,29,2,1,0,30,7,88
50,538,350,48,302,4,298,6,43,74,26,3,4,1,51,11,79
50,539,1270,230,1040,17,1023,12,209,282,94,14,7,2,81,15,307
50,540,411,68,343,5,338,9,55,108,39,3,2,0,47,8,67
50,541,979,83,896,31,865,30,140,187,104,22,3,2,110,14,253
50,542,394,53,341,16,325,3,50,125,20,5,2,2,46,16,56
50,543,998,154,844,23,821,17,155,232,83,15,6,1,119,17,176
50,544,199,18,181,5,176,2,31,51,25,2,2,0,16,3,44
50,545,524,72,452,14,438,2,76,146,36,6,4,0,61,8,99
50,546,628,77,551,11,540,6,87,144,40,12,6,2,64,15,164
50,548,103,10,93,2,91,1,20,43,4,1,0,0,13,1,8
50,549,280,53,227,5,222,10,45,72,13,6,0,0,38,1,37
50,550,1218,204,1014,29,985,16,167,243,101,15,7,2,134,28,272
50,551,1652,313,1339,17,1322,24,240,369,127,16,9,3,147,29,358
50,552,251,39,212,5,207,3,37,88,6,2,3,0,15,7,46
50,553,247,44,203,4,199,11,26,54,20,2,1,0,33,2,50
50,554,1164,243,921,21,900,14,113,287,61,8,5,0,121,12,279
50,556,484,63,421,8,413,10,58,75,44,7,7,1,70,8,133
50,557,104,13,91,0,91,1,33,29,5,1,0,0,12,1,9
50,558,675,72,603,15,588,7,93,194,32,4,1,1,65,18,173
50,562,1715,416,1299,23,1276,22,259,457,84,9,11,4,91,23,316
50,563,196,27,169,5,164,3,41,56,12,5,0,1,18,3,25
50,564,615,114,501,8,493,6,93,173,53,12,4,0,54,19,79
50,565,1124,205,919,19,900,20,148,290,69,9,10,1,89,28,236
50,567,762,115,647,14,633,7,105,143,73,12,4,2,68,15,204
50,568,404,53,351,4,347,17,58,77,40,11,1,1,37,12,93
50,569,288,28,260,2,258,5,52,61,28,2,2,0,31,9,68
50,570,362,73,289,5,284,6,75,94,12,4,0,1,39,14,39
50,571,28,3,25,0,25,0,4,9,0,0,0,0,5,0,7
50,572,162,33,129,2,127,1,26,40,16,3,2,1,15,1,22
50,573,152,17,135,4,131,8,25,28,12,0,0,0,19,1,38
50,574,214,42,172,7,165,1,40,43,29,3,0,0,15,4,30
50,575,421,39,382,5,377,7,58,81,41,2,0,2,61,11,114
50,576,826,147,679,10,669,19,112,150,107,10,7,1,56,13,194
50,577,232,54,178,2,176,1,34,41,23,3,0,0,31,4,39
50,578,85,6,79,0,79,1,22,19,11,1,0,0,11,1,13
50,579,940,116,824,12,812,19,132,177,90,9,10,0,109,27,239
50,580,320,44,276,1,275,11,56,70,51,3,1,1,23,3,56
50,581,335,31,304,6,298,6,57,86,30,2,0,2,39,4,72
50,582,2202,389,1813,69,1744,20,278,635,126,28,22,10,205,43,377
50,583,139,23,116,2,114,1,33,35,9,2,0,0,10,0,24
50,584,270,35,235,2,233,5,33,70,25,5,1,0,42,7,45
50,585,969,149,820,12,808,6,160,243,86,7,4,5,76,17,204
50,586,166,29,137,0,137,2,45,37,11,1,0,0,12,2,27
50,587,22,0,22,0,22,0,2,10,1,0,0,0,3,0,6
50,588,506,69,437,11,426,7,61,133,54,5,5,1,40,10,110
50,589,232,12,220,11,209,3,57,59,14,0,2,0,23,6,45
50,590,276,36,240,7,233,2,64,47,25,1,0,0,18,7,69
50,591,999,187,812,26,786,13,142,349,33,5,4,2,93,13,132
50,592,1142,212,930,33,897,14,157,320,68,12,8,4,111,21,182
50,593,495,106,389,10,379,11,94,105,41,2,3,0,31,12,80
50,594,686,91,595,12,583,9,109,139,80,7,1,4,58,19,157
50,595,487,76,411,6,405,7,55,111,44,2,4,0,37,18,127
50,596,230,21,209,6,203,4,30,74,18,2,1,1,18,3,52
50,597,605,84,521,10,511,12,81,162,45,7,3,4,85,16,96
50,598,238,40,198,6,192,4,50,61,18,4,0,1,14,2,38
50,599,923,98,825,11,814,19,134,183,96,9,6,2,99,21,245
50,600,535,66,469,6,463,3,58,63,70,10,2,3,51,16,187
50,601,1705,328,1377,36,1341,11,241,452,110,9,13,2,123,38,342
50,602,12353,2309,10044,155,9889,169,1441,1966,1276,147,64,30,835,168,3793
50,603,633,94,539,9,530,14,71,146,76,5,3,0,60,5,150
50,604,577,121,456,8,448,11,87,108,52,3,2,1,46,10,128
50,605,504,94,410,12,398,14,93,133,24,2,3,3,33,11,82
50,606,439,91,348,10,338,7,86,98,30,4,2,0,31,17,63
50,607,274,43,231,3,228,6,52,67,20,3,3,0,29,8,40
50,608,236,25,211,3,208,2,29,65,17,3,2,1,36,4,49
50,609,111,12,99,0,99,2,11,37,9,2,2,1,11,2,22
50,610,152,22,130,0,130,1,21,45,11,4,2,2,7,7,30
50,611,1782,222,1560,23,1537,29,166,352,192,16,7,5,180,45,545
50,612,595,59,536,9,527,12,57,140,74,8,3,0,86,15,132
50,613,309,62,247,5,242,2,56,79,17,2,1,1,15,7,62
50,614,116,29,87,0,87,0,21,21,6,0,0,0,11,1,27
50,615,5210,977,4233,61,4172,69,599,1219,424,60,22,10,446,85,1238
50,616,1510,159,1351,28,1323,33,167,364,131,12,7,2,187,31,389
50,617,258,48,210,4,206,4,46,56,21,4,1,1,20,6,47
50,618,249,50,199,2,197,2,39,64,18,3,3,1,12,2,53
50,619,240,41,199,3,196,2,45,76,12,5,0,0,16,5,35
50,620,796,118,678,12,666,13,150,142,77,8,6,2,54,22,192
50,621,72,12,60,2,58,2,6,24,2,0,1,0,7,2,14
50,622,268,29,239,6,233,4,38,71,35,6,1,0,22,4,52
50,623,317,31,286,7,279,15,30,76,35,1,0,0,32,6,84
50,624,341,33,308,6,302,9,45,101,25,8,0,0,51,4,59
50,625,404,85,319,3,316,0,51,122,35,2,4,0,42,4,56
50,626,268,47,221,4,217,5,72,46,18,2,0,0,41,7,26
50,627,194,38,156,4,152,9,32,41,9,4,1,0,20,7,29
50,628,139,23,116,2,114,4,13,31,14,1,1,0,24,5,21
50,629,514,95,419,6,413,2,132,123,38,3,8,2,30,7,68
50,630,295,44,251,3,248,3,55,107,16,1,1,1,23,5,36
50,631,307,43,264,3,261,2,59,77,22,10,1,0,39,5,46
50,633,100,14,86,1,85,0,15,36,3,0,2,1,11,0,17
50,634,64,13,51,1,50,0,8,12,9,2,0,0,1,2,16
50,635,106,11,95,1,94,1,19,20,9,0,1,0,9,11,24
50,636,36,3,33,2,31,0,3,19,3,0,0,0,2,1,3
50,637,240,47,193,1,192,4,45,69,13,3,0,0,20,6,32
50,638,147,21,126,2,124,0,24,42,9,0,0,0,23,7,19
50,639,2834,592,2242,44,2198,25,335,711,200,26,19,8,289,49,536
50,640,149,19,130,2,128,2,26,40,7,0,1,0,22,3,27
50,641,452,63,389,6,383,7,49,109,28,8,2,1,44,6,129
50,642,239,36,203,0,203,0,41,56,24,3,1,1,20,7,50
50,643,655,91,564,8,556,12,88,168,59,3,3,1,54,11,157
50,644,784,98,686,25,661,8,112,218,51,11,10,1,115,18,117
50,646,448,80,368,1,367,8,94,112,37,3,1,0,44,8,60
50,647,829,104,725,8,717,16,90,207,55,8,3,1,87,16,234
50,648,872,84,788,16,772,21,153,200,68,15,4,1,101,15,194
51,1,130,22,108,0,108,3,36,25,12,2,0,0,6,2,22
51,2,1128,188,940,21,919,16,228,274,73,19,6,1,79,25,198
51,3,188,25,163,1,162,1,56,50,14,2,0,0,14,2,23
51,4,91,12,79,1,78,0,5,53,2,0,0,0,12,0,6
51,5,120,10,110,0,110,0,22,49,9,0,0,0,11,1,18
51,6,137,25,112,5,107,1,21,31,15,2,0,0,15,4,18
51,7,708,138,570,7,563,14,146,201,46,17,2,2,51,7,77
51,8,176,22,154,3,151,1,57,50,6,1,2,0,7,6,21
51,9,653,120,533,7,526,7,163,146,44,4,2,2,45,13,100
51,10,114,13,101,1,100,1,33,24,11,3,0,0,7,4,17
51,12,52,4,48,3,45,0,8,23,1,0,0,0,4,0,9
51,13,80,11,69,1,68,0,10,33,5,1,0,0,14,0,5
51,14,269,45,224,0,224,10,31,88,9,3,2,1,34,5,41
51,15,80,8,72,0,72,2,27,24,2,0,1,0,11,1,4
51,16,249,46,203,3,200,2,57,48,17,4,3,0,23,3,43
51,17,277,29,248,5,243,1,92,71,13,2,2,0,11,9,42
51,18,526,74,452,10,442,3,138,115,33,2,6,1,46,13,85
51,19,165,9,156,4,152,0,35,64,7,2,3,0,19,1,21
51,20,36,3,33,1,32,1,9,11,0,0,0,0,2,0,9
51,22,122,16,106,3,103,2,27,37,3,1,4,0,13,1,15
51,23,178,10,168,4,164,5,33,63,9,3,0,0,14,4,33
51,25,641,87,554,13,541,4,161,160,41,6,5,4,42,9,109
51,27,194,29,165,3,162,1,27,78,8,0,0,0,27,3,18
51,28,753,163,590,13,577,9,142,176,43,2,5,0,64,13,123
51,29,1193,229,964,15,949,12,198,326,64,14,11,3,84,42,195
51,30,2685,525,2160,40,2120,33,484,508,287,34,16,8,161,33,556
51,31,215,27,188,4,184,5,48,79,13,1,3,0,17,3,15
51,32,359,41,318,4,314,1,113,73,25,8,0,0,24,6,64
51,33,200,41,159,9,150,3,55,34,14,1,1,1,9,1,31
51,34,27,8,19,2,17,0,0,9,5,0,0,0,1,1,1
51,35,203,21,182,6,176,2,52,63,7,1,0,0,28,7,16
51,36,389,75,314,3,311,0,73,116,17,1,3,1,24,6,70
51,37,215,25,190,8,182,2,50,51,9,4,1,2,21,12,30
51,38,138,17,121,1,120,1,24,59,7,1,0,0,12,2,14
51,39,105,16,89,3,86,0,27,26,4,0,4,0,15,0,10
51,40,259,40,219,2,217,0,69,75,11,2,0,3,20,1,36
51,41,102,15,87,1,86,0,19,31,8,1,1,0,17,2,7
51,42,356,80,276,4,272,5,57,108,11,3,7,2,14,10,55
51,43,1549,339,1210,21,1189,17,333,247,112,22,17,4,119,26,292
51,44,559,82,477,14,463,10,106,128,37,12,5,0,56,14,95
51,45,93,12,81,1,80,0,23,24,8,1,0,0,9,2,13
51,46,737,113,624,17,607,6,123,210,43,4,6,1,73,14,127
51,47,48,11,37,1,36,4,7,6,3,1,0,0,7,0,8
51,48,147,34,113,3,110,3,15,34,13,3,0,0,15,3,24
51,49,500,101,399,6,393,5,94,151,18,5,1,0,32,11,76
51,50,126,15,111,2,109,2,26,52,5,1,1,0,9,5,8
51,51,123,15,108,0,108,0,18,37,8,4,1,0,16,5,19
51,52,382,55,327,1,326,4,73,113,20,2,0,3,33,3,75
51,53,63,10,53,0,53,0,12,24,1,0,0,0,11,3,2
51,54,801,125,676,7,669,8,210,170,46,18,6,3,37,16,155
51,55,5238,1053,4185,67,4118,75,879,1146,357,56,33,14,388,91,1079
51,56,260,42,218,6,212,1,41,101,13,3,0,0,21,9,23
51,57,73,11,62,3,59,1,19,20,8,0,0,1,1,1,8
51,58,1151,183,968,10,958,30,110,374,61,4,5,2,151,10,211
51,59,325,54,271,3,268,0,93,85,8,1,1,0,14,7,59
51,60,143,16,127,2,125,0,41,36,4,4,1,0,14,0,25
51,61,96,5,91,1,90,0,14,60,0,0,0,0,7,2,7
51,62,99,17,82,2,80,1,30,18,4,1,3,1,4,0,18
51,63,138,22,116,4,112,0,32,44,5,0,1,0,6,1,23
51,64,473,75,398,2,396,6,110,95,43,2,2,2,39,6,91
51,65,474,70,404,9,395,5,131,135,14,6,3,1,33,8,59
51,66,283,38,245,4,241,5,83,61,9,1,1,0,10,5,66
51,68,161,31,130,4,126,3,55,19,10,3,3,0,6,3,24
51,69,98,12,86,2,84,1,11,34,15,0,1,0,5,2,15
51,70,190,47,143,1,142,3,55,45,10,4,0,0,4,1,20
51,71,150,21,129,1,128,3,28,52,14,2,0,0,5,1,23
51,72,141,21,120,2,118,4,22,53,7,1,0,0,15,3,13
51,73,139,10,129,4,125,0,25,38,15,0,0,0,12,2,33
51,74,1145,176,969,24,945,6,246,254,72,15,6,5,96,25,220
51,75,740,110,630,14,616,5,118,203,45,11,2,1,80,6,145
51,76,383,67,316,6,310,1,82,112,15,1,1,0,32,9,57
51,77,161,23,138,5,133,4,31,44,9,1,0,0,16,4,24
51,78,376,72,304,11,293,6,76,95,11,1,1,0,30,6,67
51,79,747,149,598,2,596,3,147,258,47,4,6,2,55,6,68
51,80,131,28,103,3,100,0,32,35,9,1,0,0,5,0,18
51,81,216,37,179,7,172,1,17,54,22,6,1,0,24,1,46
51,82,78,6,72,3,69,1,15,17,8,0,0,0,17,1,10
51,83,73,6,67,1,66,0,13,26,3,0,0,0,9,2,13
51,84,89,15,74,3,71,0,21,23,1,0,0,0,10,1,15
51,85,289,45,244,4,240,0,66,92,16,5,4,0,24,12,21
51,86,207,27,180,0,180,3,43,53,6,1,3,1,33,3,34
51,87,184,25,159,3,156,3,36,44,17,1,1,0,18,7,29
51,88,372,55,317,4,313,5,67,128,16,4,0,0,33,8,52
51,89,87,8,79,2,77,1,25,33,5,1,0,0,5,2,5
51,90,184,25,159,3,156,1,28,59,12,1,4,0,10,3,38
51,91,108,22,86,3,83,0,16,38,5,1,2,0,14,0,7
51,92,296,67,229,4,225,5,77,72,15,2,1,1,12,8,32
51,93,351,57,294,3,291,4,51,129,16,3,0,1,27,4,56
51,94,176,46,130,5,125,0,41,37,8,0,2,0,13,4,20
51,95,76,14,62,2,60,0,21,15,2,1,0,1,3,3,14
51,97,153,26,127,1,126,3,35,46,4,4,0,0,22,1,11
51,98,106,23,83,0,83,0,21,35,6,0,0,0,15,2,4
51,99,233,62,171,2,169,1,48,51,14,7,2,0,14,4,28
51,100,71,11,60,2,58,1,11,20,4,1,0,0,5,4,12
51,101,509,63,446,5,441,9,74,161,17,4,1,0,64,12,99
51,102,334,34,300,6,294,3,62,116,21,3,1,2,24,4,58
51,103,155,27,128,1,127,0,38,49,4,0,1,0,16,2,17
51,104,118,18,100,5,95,3,25,37,2,1,0,1,3,5,18
51,105,990,124,866,9,857,18,157,358,33,4,2,3,125,18,139
51,106,110,15,95,5,90,3,23,26,10,1,0,0,13,4,10
51,107,225,52,173,1,172,1,51,43,11,0,1,0,25,3,37
51,108,27414,7241,20173,335,19838,367,4010,5177,2163,265,112,55,1806,347,5536
51,109,134,22,112,4,108,3,18,51,5,0,1,0,9,0,21
51,110,79,18,61,3,58,1,17,20,3,2,0,0,8,0,7
51,111,107,14,93,3,90,0,17,26,13,1,0,0,13,4,16
51,112,316,36,280,4,276,2,47,133,12,3,0,0,40,9,30
51,113,115,26,89,1,88,0,26,27,6,2,0,0,11,5,11
51,115,448,66,382,3,379,7,62,156,29,5,1,0,40,2,77
51,116,208,52,156,4,152,1,26,54,14,6,1,0,24,6,20
51,117,244,28,216,3,213,3,48,81,3,5,3,0,28,7,35
51,118,986,153,833,13,820,11,159,268,73,15,4,3,80,10,197
51,119,417,41,376,3,373,9,50,169,21,4,1,2,37,5,75
51,120,121,19,102,0,102,3,22,39,10,1,0,0,12,3,12
51,121,162,19,143,2,141,7,22,42,16,3,4,0,14,6,27
51,122,117,12,105,2,103,3,36,31,3,0,3,0,10,1,16
51,124,56,3,53,0,53,2,8,34,2,3,0,0,3,0,1
51,125,43,6,37,0,37,1,17,14,0,0,0,0,3,1,1
51,126,58,12,46,0,46,0,7,27,1,0,0,0,10,0,1
51,127,88,17,71,0,71,3,10,25,3,3,0,0,21,2,4
51,128,44,4,40,0,40,0,11,21,2,1,0,0,4,1,0
51,129,187,32,155,0,155,1,49,58,19,1,0,0,13,3,11
51,130,191,37,154,3,151,4,39,45,11,0,0,0,14,5,33
51,132,122,26,96,1,95,1,30,28,5,2,2,1,11,5,10
51,133,63,12,51,1,50,0,14,13,5,1,1,0,5,0,11
51,134,209,33,176,2,174,0,69,49,8,1,0,0,8,8,31
51,135,71,10,61,0,61,0,20,20,6,0,1,1,5,0,8
51,136,550,125,425,8,417,2,103,176,14,4,2,1,48,3,64
51,137,167,12,155,7,148,1,42,66,6,1,0,0,11,1,20
51,138,35,6,29,1,28,0,7,15,1,0,0,0,2,1,2
51,139,280,42,238,5,233,5,70,76,13,4,0,1,17,5,42
51,140,275,43,232,9,223,2,55,88,15,3,2,1,13,5,39
51,141,508,80,428,6,422,8,122,118,21,9,2,0,45,9,88
51,142,310,36,274,4,270,3,69,113,9,1,3,0,25,9,38
51,143,55,14,41,1,40,0,11,10,0,0,0,0,10,1,8
51,144,489,67,422,7,415,7,138,94,32,7,5,2,37,16,77
51,145,220,25,195,1,194,13,25,86,3,2,0,1,17,3,44
51,146,87,19,68,3,65,0,20,27,0,1,0,0,8,0,9
51,147,258,34,224,1,223,2,69,66,16,1,0,1,21,5,42
51,148,150,27,123,5,118,0,33,60,2,0,1,0,10,1,11
51,149,336,44,292,5,287,2,86,85,14,2,2,0,25,9,62
51,150,78,7,71,1,70,1,13,23,5,1,0,0,10,0,17
51,151,142,19,123,2,121,1,37,34,14,0,0,0,5,1,29
51,152,443,77,366,4,362,2,73,198,11,0,2,3,29,9,35
51,153,810,142,668,10,658,6,166,270,36,7,2,1,54,17,99
51,154,175,27,148,4,144,3,26,64,11,0,1,0,20,2,17
51,155,431,48,383,9,374,7,135,110,30,5,4,4,21,3,55
51,156,122,28,94,2,92,0,34,31,2,0,3,1,4,2,15
51,157,87,12,75,4,71,0,30,21,2,1,2,0,4,2,9
51,158,444,84,360,12,348,0,113,101,27,5,2,3,30,15,52
51,160,967,157,810,15,795,15,165,180,81,5,4,4,93,16,232
51,161,531,78,453,9,444,0,131,125,28,6,6,2,35,19,92
51,162,502,102,400,5,395,2,165,82,33,0,3,0,23,9,78
51,163,194,34,160,2,158,2,36,57,8,2,2,0,22,5,24
51,164,117,17,100,1,99,1,21,39,6,0,0,0,13,1,18
51,165,743,126,617,15,602,8,133,176,58,21,7,4,40,24,131
51,166,52,4,48,0,48,0,8,21,3,0,0,0,5,1,10
51,167,140,29,111,4,107,0,25,43,4,1,3,0,17,2,12
51,168,190,33,157,0,157,1,25,57,17,3,1,1,15,2,35
51,169,84,13,71,0,71,0,17,36,0,0,1,0,8,2,7
51,170,73,9,64,4,60,0,17,21,2,1,0,1,6,0,12
51,171,994,152,842,13,829,7,193,297,65,11,3,3,68,13,169
51,172,5172,923,4249,63,4186,69,764,1109,346,57,20,9,421,78,1313
51,173,101,9,92,1,91,1,21,46,6,0,0,0,8,1,8
51,174,47,3,44,0,44,0,8,19,6,0,0,0,5,1,5
51,175,142,25,117,1,116,2,35,40,7,0,0,1,4,5,22
51,176,116,28,88,1,87,0,18,37,6,1,1,0,12,3,9
51,177,175,25,150,2,148,2,18,76,7,2,0,1,22,1,19
51,178,63,11,52,1,51,0,13,18,5,2,0,1,2,1,9
51,179,137,12,125,1,124,5,34,40,5,2,0,1,17,3,17
51,181,249,33,216,4,212,1,34,81,12,1,1,0,29,5,48
51,182,84,17,67,0,67,0,20,29,2,0,0,0,5,1,10
51,183,806,140,666,14,652,8,155,202,40,10,2,1,69,18,147
51,184,351,41,310,7,303,0,74,86,14,5,0,1,29,6,88
51,185,207,35,172,4,168,0,46,48,16,3,1,0,16,6,32
51,186,56,7,49,0,49,2,10,24,2,0,0,0,5,2,4
51,187,192,26,166,1,165,0,31,49,12,4,2,1,13,1,52
51,188,161,26,135,5,130,0,34,47,7,3,2,1,7,4,25
51,190,46,1,45,0,45,2,2,13,5,0,0,0,4,2,17
51,191,56,12,44,2,42,1,11,10,6,0,0,1,7,0,6
51,192,288,61,227,5,222,1,52,72,28,0,1,0,17,6,45
51,193,1993,249,1744,19,1725,25,358,546,111,13,11,4,281,46,330
51,194,346,58,288,4,284,5,59,76,34,4,1,2,30,4,69
51,195,727,112,615,18,597,4,181,154,49,13,6,5,35,15,135
51,196,739,122,617,12,605,4,164,243,18,9,7,1,46,18,95
51,197,69,12,57,1,56,1,19,28,2,0,0,0,4,0,2
51,198,469,96,373,7,366,7,104,115,36,3,0,1,32,10,58
51,199,337,83,254,3,251,0,92,94,8,2,0,1,15,5,34
51,200,311,37,274,5,269,1,67,94,32,1,0,0,23,8,43
51,201,111,15,96,4,92,2,21,40,10,0,3,0,8,1,7
51,202,684,119,565,8,557,6,116,195,63,7,5,0,44,17,104
51,203,177,24,153,4,149,5,27,60,12,0,2,0,15,2,26
51,204,1103,138,965,23,942,14,231,326,88,4,9,1,76,24,169
51,205,238,37,201,3,198,3,44,59,19,3,0,1,24,4,41
51,206,86,10,76,0,76,1,19,18,5,2,4,1,7,2,17
51,208,81,7,74,1,73,1,22,32,6,0,0,0,6,0,6
51,210,1298,185,1113,16,1097,21,239,294,92,14,8,1,101,30,297
51,211,61,16,45,0,45,0,12,15,2,1,0,0,6,2,7
51,212,139,22,117,2,115,1,28,52,10,0,0,2,8,1,13
51,213,54,8,46,0,46,1,9,12,0,0,0,0,17,1,6
51,214,109,8,101,1,100,1,32,43,4,0,0,0,10,0,10
51,215,105,12,93,3,90,4,17,44,0,0,1,0,6,0,18
51,216,165,31,134,2,132,1,20,68,2,4,0,0,18,3,16
51,217,2208,509,1699,20,1679,27,435,548,134,31,9,4,154,47,290
51,218,110,16,94,0,94,0,18,32,2,2,1,1,17,3,18
51,219,159,26,133,1,132,0,29,25,9,0,1,2,10,7,49
51,220,115,15,100,3,97,1,29,34,8,1,0,0,3,1,20
51,222,73,13,60,1,59,1,16,16,6,3,0,0,4,3,10
51,223,49,1,48,7,41,1,14,14,0,0,0,0,4,0,8
51,224,144,26,118,1,117,1,38,40,3,1,0,0,8,2,24
51,225,287,48,239,4,235,3,44,122,7,0,0,2,22,5,30
51,226,64,7,57,2,55,0,18,16,2,1,0,0,2,0,16
51,227,339,42,297,4,293,7,65,73,14,1,1,0,26,4,102
51,228,87,15,72,6,66,1,19,22,3,0,1,0,8,1,11
51,229,87,12,75,2,73,0,17,32,4,0,3,0,2,4,11
51,230,15288,4330,10958,230,10728,156,2139,2748,1124,125,84,15,1094,201,3042
51,231,453,54,399,8,391,3,68,170,19,1,2,2,45,9,72
51,232,318,62,256,5,251,1,42,85,25,3,3,2,29,6,55
51,233,80,10,70,0,70,4,25,18,2,1,1,0,7,7,5
51,234,458,78,380,8,372,3,85,102,38,2,1,0,37,12,92
51,235,196,32,164,1,163,3,44,68,16,2,2,0,8,2,18
51,236,122,21,101,0,101,0,26,45,8,1,0,0,10,4,7
51,237,1252,227,1025,14,1011,10,261,340,80,12,9,5,71,22,201
51,238,242,33,209,1,208,4,61,64,11,2,0,1,17,6,42
51,239,92,20,72,3,69,0,25,10,9,1,1,0,3,4,16
51,240,123,26,97,2,95,4,33,25,3,0,1,0,14,3,12
51,241,76,8,68,2,66,0,20,18,5,0,0,1,11,1,10
51,242,3914,745,3169,53,3116,50,709,673,376,39,17,12,285,54,901
51,243,245,37,208,7,201,1,69,53,23,3,3,0,14,6,29
51,244,222,36,186,4,182,1,65,55,3,3,1,0,17,2,35
51,245,396,68,328,5,323,6,84,117,23,0,4,0,26,11,52
51,246,150,10,140,4,136,1,50,40,10,0,2,1,14,1,17
51,247,153,24,129,2,127,2,31,55,5,1,0,0,11,1,21
51,248,1555,339,1216,21,1195,8,360,355,80,8,12,3,135,27,207
51,249,347,44,303,7,296,4,91,101,9,3,2,1,38,7,40
51,250,3799,839,2960,39,2921,40,880,590,255,35,29,7,208,59,818
51,251,150,26,124,4,120,2,18,59,4,3,0,1,15,1,17
51,252,388,69,319,7,312,3,90,140,12,3,3,0,18,10,33
51,253,200,23,177,2,175,1,44,34,14,4,2,1,16,3,56
51,254,210,31,179,2,177,1,39,72,9,1,1,1,20,5,28
51,255,21,4,17,1,16,0,1,6,0,0,0,0,2,1,6
51,256,252,36,216,3,213,7,35,79,7,3,1,1,31,6,43
51,258,199,37,162,2,160,2,53,41,15,1,1,1,13,4,29
51,259,155,25,130,3,127,1,28,59,10,0,0,0,12,1,16
51,260,55,7,48,2,46,0,3,23,4,0,0,0,5,0,11
51,261,340,47,293,3,290,3,61,107,12,4,1,1,26,11,64
51,262,1448,262,1186,19,1167,11,313,332,75,7,11,4,99,18,297
51,263,258,59,199,4,195,2,67,64,16,1,4,0,18,5,18
51,264,390,54,336,4,332,2,88,116,20,5,0,0,27,12,62
51,265,424,92,332,7,325,6,90,102,20,5,2,0,31,2,67
51,266,383,56,327,7,320,9,62,89,24,7,4,1,24,9,91
51,267,188,48,140,4,136,0,29,51,6,0,1,0,15,4,30
51,268,110,12,98,2,96,0,35,34,2,1,0,0,11,4,9
51,269,254,35,219,5,214,0,64,70,8,2,0,1,22,7,40
51,270,187,34,153,3,150,1,74,36,1,3,2,0,14,1,18
51,271,121,18,103,2,101,2,31,34,7,1,1,0,0,3,22
51,272,305,67,238,2,236,2,57,74,22,4,0,1,16,5,55
51,273,66,4,62,2,60,2,9,28,3,1,2,0,4,2,9
51,274,96,16,80,0,80,2,17,32,6,0,1,0,6,1,15
51,275,133,11,122,3,119,1,38,40,4,0,1,0,4,3,28
51,276,136,17,119,1,118,1,29,54,5,0,1,0,10,1,17
51,277,235,41,194,4,190,3,58,52,12,3,1,0,25,10,26
51,278,205,35,170,1,169,2,50,48,9,1,0,0,18,4,37
51,279,111,29,82,1,81,1,20,21,8,2,1,1,11,2,14
51,280,32,5,27,0,27,0,1,20,0,0,0,0,4,0,2
51,281,528,74,454,13,441,5,127,138,40,8,3,1,46,11,62
51,282,1321,189,1132,13,1119,14,124,525,47,7,5,3,137,23,234
51,283,131,27,104,0,104,0,26,53,1,0,0,0,7,2,15
51,284,189,29,160,4,156,0,58,39,8,3,1,0,6,3,38
51,285,145,17,128,2,126,3,25,45,10,1,0,0,19,0,23
51,286,208,37,171,2,169,4,47,49,17,3,0,0,10,3,36
51,287,629,66,563,18,545,12,67,199,33,5,1,2,65,12,149
51,288,167,22,145,0,145,6,24,51,18,0,3,0,7,4,32
51,289,324,37,287,6,281,2,98,68,23,2,0,0,30,7,51
51,290,217,63,154,6,148,1,49,39,18,1,3,0,7,0,30
51,291,1059,154,905,15,890,15,146,377,51,7,3,3,81,14,193
51,292,120,17,103,1,102,1,26,46,1,2,1,0,9,1,15
51,293,278,47,231,2,229,0,46,83,14,2,2,1,27,13,41
51,294,69,19,50,1,49,0,7,24,0,0,1,0,6,0,11
51,295,283,43,240,2,238,2,67,67,12,5,0,0,24,5,56
51,296,64,12,52,0,52,0,13,26,2,0,0,0,6,0,5
51,298,307,64,243,2,241,3,71,72,16,0,1,2,20,6,50
51,299,548,88,460,3,457,9,117,136,36,7,4,0,55,5,88
51,300,76,7,69,2,67,1,22,18,2,4,0,0,2,1,17
51,301,99,5,94,2,92,1,26,36,2,0,0,0,9,0,18
51,302,92,18,74,1,73,1,19,24,4,1,2,0,9,3,10
51,303,386,77,309,7,302,4,85,100,26,3,0,0,30,5,49
51,304,107,19,88,1,87,1,24,42,3,0,0,0,5,1,11
51,305,114,17,97,0,97,2,8,72,2,0,0,0,8,1,4
51,306,72,8,64,0,64,0,20,21,1,0,1,0,13,2,6
51,307,138,15,123,3,120,0,33,50,5,0,0,0,18,1,13
51,308,1524,297,1227,20,1207,16,190,411,54,17,11,4,163,24,317
51,309,80,10,70,2,68,0,8,35,4,2,0,0,10,0,9
51,310,180,22,158,0,158,4,25,80,6,3,1,2,9,2,26
51,311,133,21,112,0,112,0,44,25,8,1,0,0,5,3,26
51,312,754,117,637,14,623,15,157,178,52,6,3,0,80,8,124
51,313,277,56,221,2,219,4,61,65,14,2,2,1,38,2,30
51,314,155,27,128,4,124,1,29,44,2,1,0,0,9,6,32
51,315,122,25,97,4,93,1,26,27,6,0,0,0,7,4,22
51,316,251,40,211,2,209,1,64,61,13,0,1,0,14,5,50
51,317,51,13,38,3,35,0,7,19,1,0,0,0,3,1,4
51,318,408,46,362,9,353,5,61,122,25,3,2,0,50,7,78
51,319,96,11,85,0,85,0,18,44,0,1,0,0,11,0,11
51,320,234,36,198,6,192,5,59,81,13,2,0,0,15,3,14
51,321,63,14,49,0,49,0,7,28,2,0,0,0,3,2,7
51,322,85,10,75,5,70,1,23,24,8,0,1,1,4,1,7
51,323,88,21,67,3,64,1,8,27,4,1,0,0,12,2,9
51,324,101,21,80,0,80,1,36,34,3,0,0,1,2,0,3
51,325,109,18,91,1,90,1,25,36,2,1,0,0,5,0,20
51,326,724,135,589,11,578,8,157,172,29,5,4,1,56,16,130
51,327,150,22,128,2,126,4,34,46,12,1,1,1,11,1,15
51,328,742,101,641,5,636,5,174,186,45,5,9,0,51,6,155
51,329,1008,168,840,9,831,14,196,246,81,8,3,2,84,23,174
51,331,243,41,202,8,194,2,55,70,15,2,2,0,24,5,19
51,333,507,65,442,8,434,1,93,165,18,2,2,1,58,11,83
51,334,369,59,310,9,301,1,114,72,23,4,4,0,32,8,43
51,336,57,13,44,1,43,0,8,16,2,1,3,0,8,3,2
51,337,200,33,167,5,162,2,44,36,11,1,0,0,15,4,49
51,338,613,127,486,15,471,11,85,201,33,6,3,2,46,13,71
51,339,461,63,398,11,387,6,90,93,35,3,3,1,48,10,98
51,340,408,66,342,9,333,0,99,98,18,10,3,0,37,9,59
51,341,27,6,21,0,21,0,8,8,2,0,0,0,3,0,0
51,342,237,34,203,4,199,0,46,66,16,2,4,1,17,7,40
51,343,429,0,429,4,425,7,89,156,39,2,2,3,29,16,82
51,344,1291,213,1078,17,1061,10,230,255,131,10,9,4,83,15,314
51,345,193,27,166,1,165,2,45,49,18,2,3,1,18,2,25
51,346,926,192,734,16,718,7,198,231,48,11,3,3,58,11,148
51,347,988,175,813,23,790,9,164,227,87,11,7,0,78,13,194
51,348,115,23,92,2,90,0,13,29,13,0,1,0,10,1,23
51,349,157,15,142,1,141,0,42,44,3,0,0,0,15,8,29
51,350,89,19,70,1,69,0,20,21,4,0,0,0,9,3,12
51,351,84,16,68,0,68,0,25,24,2,2,0,0,3,2,10
51,352,578,110,468,7,461,3,163,125,27,9,4,1,29,10,90
51,353,47,9,38,0,38,1,7,24,1,0,0,0,4,0,1
51,354,233,28,205,7,198,2,35,64,15,2,2,0,27,7,44
51,355,42,10,32,0,32,0,7,11,2,0,0,0,10,0,2
51,356,105,15,90,3,87,3,30,34,2,1,0,0,8,0,9
51,357,498,80,418,12,406,2,99,134,37,5,1,0,41,13,74
51,358,401,67,334,4,330,1,115,66,33,3,3,1,13,6,89
51,359,151,20,131,3,128,0,48,53,1,2,0,0,11,1,12
51,360,220,31,189,5,184,1,44,40,16,1,0,0,10,4,68
51,361,112,15,97,0,97,1,19,37,6,0,1,0,10,2,21
51,362,514,79,435,5,430,10,72,170,37,5,0,1,41,16,78
51,363,180,18,162,4,158,0,51,55,4,1,1,0,13,2,31
51,364,58,6,52,1,51,0,10,23,5,2,0,0,7,0,4
51,365,760,127,633,7,626,18,88,249,32,6,3,1,97,12,120
51,367,833,129,704,8,696,7,204,249,46,5,4,0,53,11,117
51,368,52,6,46,2,44,0,11,19,3,0,1,0,9,1,0
51,369,245,34,211,6,205,0,39,66,22,3,2,0,23,4,46
51,370,183,21,162,5,157,0,46,36,7,1,1,1,17,6,42
51,371,47,8,39,3,36,0,10,21,0,0,2,0,2,0,1
51,372,404,38,366,4,362,2,88,110,28,1,1,0,42,14,76
51,373,96,18,78,0,78,1,28,30,4,1,1,0,6,0,7
51,374,51,9,42,1,41,0,13,17,4,0,1,0,4,1,1
51,375,222,35,187,2,185,4,46,63,5,0,0,0,19,11,37
51,376,110,13,97,1,96,1,25,42,6,0,0,1,7,0,14
51,377,34,4,30,0,30,0,11,11,1,0,0,1,3,0,3
51,378,272,48,224,3,221,0,68,91,10,1,0,0,18,4,29
51,379,357,57,300,6,294,7,51,103,18,2,2,1,47,4,59
51,380,2668,671,1997,36,1961,24,577,637,125,24,20,7,157,58,332
51,381,471,74,397,7,390,10,67,127,39,5,3,4,35,12,88
51,382,86,16,70,1,69,2,15,18,13,1,0,0,5,1,14
51,384,239,30,209,1,208,3,60,49,16,1,0,1,25,3,50
51,386,119,18,101,3,98,2,21,36,12,1,0,0,12,3,11
51,387,242,28,214,2,212,8,66,36,18,4,3,0,27,6,44
51,388,2596,489,2107,50,2057,18,683,646,104,22,12,7,148,45,372
51,389,659,169,490,10,480,8,142,132,36,7,3,3,50,13,86
51,390,615,111,504,10,494,11,93,192,43,4,2,1,36,12,100
51,391,1715,226,1489,28,1461,15,298,418,114,18,5,5,169,30,389
51,392,168,17,151,0,151,3,33,42,24,4,0,1,10,2,32
51,393,194,28,166,1,165,5,37,57,17,0,2,0,14,1,32
51,395,86,16,70,2,68,1,20,23,5,0,0,0,10,1,8
51,396,118,10,108,0,108,0,32,43,9,0,0,1,5,2,16
51,397,133,21,112,0,112,1,28,25,12,2,1,0,9,2,32
51,398,155,40,115,3,112,0,15,57,4,0,1,0,15,1,19
51,399,397,68,329,5,324,4,99,86,37,3,1,2,22,7,63
51,402,176,35,141,0,141,3,36,37,17,3,1,1,9,6,28
51,403,418,69,349,4,345,4,62,183,17,4,3,1,23,8,40
51,404,111,16,95,1,94,0,11,49,2,0,1,1,13,2,15
51,406,127,24,103,0,103,4,42,21,13,1,1,0,6,2,13
51,407,219,37,182,3,179,3,66,52,7,1,2,0,21,7,20
51,409,242,52,190,7,183,2,47,58,8,1,0,1,22,4,40
51,410,478,96,382,8,374,7,91,117,45,2,2,0,23,11,76
51,411,479,72,407,7,400,3,95,188,18,2,4,2,38,6,44
51,412,59,7,52,1,51,2,7,24,1,1,1,0,5,1,9
51,413,698,90,608,7,601,6,170,154,67,7,8,0,44,13,132
51,414,113,9,104,2,102,0,21,49,1,0,1,0,14,3,13
51,415,173,22,151,2,149,0,48,20,13,4,0,4,11,4,45
51,416,423,65,358,5,353,3,79,110,25,8,3,2,38,10,75
51,417,356,67,289,3,286,3,100,84,12,2,4,0,18,8,55
51,418,339,36,303,4,299,5,45,110,22,3,1,0,37,5,71
51,419,127,15,112,0,112,3,31,47,5,2,0,1,9,2,12
51,420,83,7,76,1,75,2,20,30,3,1,0,0,11,1,7
51,421,69,17,52,1,51,0,19,11,4,0,0,0,2,2,13
51,422,279,35,244,10,234,2,40,90,18,2,1,0,20,8,53
51,423,1450,421,1029,12,1017,6,336,206,80,13,15,1,54,20,286
51,424,167,20,147,2,145,1,51,34,5,0,0,2,26,3,23
51,425,305,61,244,7,237,3,54,106,20,1,2,1,14,9,27
51,426,61,7,54,2,52,0,7,25,6,0,0,0,1,1,12
51,428,307,52,255,6,249,1,72,50,23,5,2,0,35,5,56
51,429,181,23,158,2,156,0,31,82,11,0,1,0,15,2,14
51,430,80,18,62,2,60,0,8,36,2,1,1,0,6,1,5
51,431,1055,180,875,12,863,8,199,224,94,13,5,2,93,12,213
51,432,587,103,484,9,475,2,148,120,43,8,8,1,46,9,90
51,433,152,32,120,2,118,3,29,28,9,1,1,0,19,4,24
51,434,554,75,479,8,471,5,118,125,27,8,5,1,61,4,117
51,435,150,29,121,1,120,3,23,42,6,1,0,0,19,3,23
51,436,611,76,535,17,518,6,142,166,39,5,0,2,65,9,84
51,437,84,9,75,0,75,0,13,24,6,2,2,0,6,3,19
51,438,88,13,75,2,73,3,12,39,1,1,1,0,4,5,7
51,439,306,48,258,7,251,1,44,99,11,2,0,0,42,5,47
51,440,1060,176,884,22,862,8,245,194,84,14,8,3,75,24,207
51,441,127,27,100,2,98,6,31,31,6,2,0,1,3,0,18
51,442,132,29,103,1,102,5,26,31,10,1,2,0,14,0,13
51,443,72,8,64,0,64,0,17,19,10,0,0,0,5,2,11
51,444,357,72,285,9,276,4,67,105,12,1,1,1,27,10,48
51,445,150,23,127,3,124,5,19,26,8,1,0,0,12,5,48
51,446,350,72,278,6,272,2,80,64,20,4,2,0,31,10,59
51,447,387,47,340,13,327,6,91,103,18,7,1,0,29,5,67
51,448,417,54,363,5,358,6,77,143,17,5,1,1,41,11,56
51,449,762,105,657,7,650,11,147,207,52,5,4,4,53,22,145
51,450,290,40,250,4,246,3,39,92,14,1,0,0,28,5,64
51,451,70,13,57,0,57,2,15,15,8,0,0,0,0,1,16
51,452,24,1,23,0,23,0,4,15,0,0,0,0,3,0,1
51,453,793,133,660,14,646,3,133,236,48,6,2,1,69,20,128
51,454,99802,26126,73676,1023,72653,1463,13353,18936,7778,885,485,154,6562,1169,21868
51,455,175,18,157,1,156,0,40,57,3,2,3,0,14,1,36
51,456,64,10,54,1,53,0,15,23,1,0,1,0,3,2,8
51,457,229,40,189,3,186,4,49,83,10,2,3,0,17,0,18
51,458,54,10,44,1,43,0,7,17,0,0,0,0,10,2,7
51,459,101,13,88,1,87,2,33,25,9,0,0,0,3,1,14
51,460,150,50,100,0,100,0,37,41,3,1,2,0,5,1,10
51,461,846,156,690,15,675,20,115,253,59,7,2,1,82,13,123
51,463,162,19,143,3,140,3,31,31,16,1,1,0,11,2,44
51,464,241,41,200,3,197,1,39,50,16,1,0,0,36,2,52
51,465,144,21,123,2,121,2,32,51,0,3,1,0,12,4,16
51,466,162,26,136,3,133,1,30,52,5,0,1,0,22,1,21
51,468,269,26,243,1,242,6,43,79,20,1,0,0,21,3,69
51,469,63,5,58,1,57,1,15,15,8,0,1,1,6,4,6
51,470,10,3,7,0,7,0,3,1,0,0,0,0,1,0,2
51,471,318,35,283,2,281,4,51,154,7,0,0,0,27,6,32
51,472,755,120,635,10,625,11,175,226,29,4,2,2,48,18,110
51,473,92,15,77,5,72,0,27,19,5,0,0,0,5,0,16
51,474,2781,503,2278,39,2239,29,429,516,277,50,15,5,197,34,687
51,475,66,13,53,0,53,0,19,22,2,0,1,0,6,2,1
51,476,479,80,399,10,389,5,96,129,37,4,2,0,39,12,65
51,477,192,28,164,5,159,3,43,37,10,4,0,1,14,1,46
51,478,306,65,241,7,234,1,99,54,16,6,0,1,22,7,28
51,479,203,36,167,5,162,1,38,54,5,0,0,0,26,1,37
51,480,107,14,93,1,92,4,17,38,6,3,2,0,3,1,18
51,482,388,59,329,5,324,1,86,105,26,2,4,0,36,9,55
51,483,338,36,302,7,295,4,53,75,32,2,0,0,25,12,92
51,484,182,29,153,2,151,5,31,42,10,1,0,0,14,8,40
51,485,250,39,211,4,207,1,35,84,11,3,0,0,19,3,51
51,486,268,50,218,2,216,3,35,121,9,2,0,0,23,5,18
51,487,206,24,182,0,182,2,52,48,9,4,0,4,18,8,37
51,488,239,30,209,4,205,1,54,49,19,1,0,1,29,4,47
51,489,35,8,27,0,27,0,5,10,2,1,0,0,6,1,2
51,490,129,16,113,0,113,0,34,38,9,0,0,0,11,1,20
51,491,85,8,77,3,74,2,17,33,0,0,0,0,12,0,10
51,492,1046,155,891,18,873,3,277,195,93,13,9,1,58,16,208
51,493,69,4,65,2,63,1,6,44,0,1,1,0,1,1,8
51,495,67,20,47,0,47,0,9,26,1,0,1,0,1,0,9
51,496,196,28,168,2,166,0,52,61,12,2,0,0,15,0,24
51,497,38,2,36,0,36,0,12,7,3,0,0,0,1,0,13
51,498,47,7,40,0,40,0,7,20,1,3,0,0,4,1,4
51,499,115,11,104,2,102,0,34,38,11,1,1,0,3,1,13
51,500,108,18,90,1,89,3,23,32,9,0,1,0,6,7,8
51,501,176,28,148,4,144,2,32,77,7,1,0,0,8,5,12
51,502,73,20,53,0,53,1,9,26,3,1,0,0,5,3,5
51,503,73,7,66,0,66,0,16,23,5,0,0,0,5,5,12
51,504,656,107,549,8,541,13,93,197,31,5,1,0,82,15,104
51,505,348,70,278,9,269,0,84,78,19,0,2,1,19,10,56
51,506,3753,774,2979,38,2941,35,571,810,300,35,12,10,340,76,752
51,507,3033,683,2350,61,2289,30,536,698,157,32,10,6,223,50,547
51,508,187,38,149,2,147,2,47,56,9,0,0,0,11,4,18
51,509,202,19,183,3,180,2,33,80,8,2,0,1,15,2,37
51,510,119,23,96,1,95,0,32,15,9,3,2,0,6,5,23
51,511,128,31,97,2,95,1,24,41,2,0,2,0,10,4,11
51,512,68,9,59,4,55,1,12,22,3,2,0,0,7,1,7
51,513,426,86,340,3,337,3,121,88,27,7,3,0,28,10,50
51,514,93,15,78,0,78,0,20,36,3,1,0,0,6,2,10
51,515,240,43,197,1,196,2,33,83,8,4,1,0,31,6,28
51,516,50,7,43,1,42,0,5,12,10,0,1,0,4,4,6
51,517,118,13,105,0,105,1,31,46,2,1,0,0,12,1,11
51,518,429,45,384,1,383,4,41,146,22,4,1,2,52,7,104
51,519,40,7,33,0,33,0,9,8,0,1,1,1,4,1,8
51,520,81,8,73,5,68,0,23,32,1,0,0,0,9,0,3
51,521,171,27,144,2,142,0,62,42,7,3,1,0,11,6,10
51,522,262,63,199,1,198,1,63,82,2,0,0,0,11,3,36
51,523,184,32,152,1,151,3,27,60,16,1,0,0,8,4,32
51,524,255,34,221,2,219,4,62,75,23,0,0,0,20,5,30
51,525,1624,214,1410,24,1386,33,257,428,109,10,7,4,143,36,359
51,526,298,55,243,3,240,3,64,78,24,6,0,1,23,3,38
51,527,211,42,169,4,165,4,36,46,16,0,0,1,27,5,30
51,528,102,17,85,2,83,0,17,28,8,1,1,0,9,0,19
51,529,281,59,222,3,219,0,70,63,12,4,1,0,19,6,44
51,530,375,57,318,1,317,6,76,100,24,6,5,0,28,5,67
51,531,1444,280,1164,21,1143,14,370,278,88,19,12,3,93,21,245
51,532,509,73,436,9,427,7,69,174,34,1,1,1,46,13,81
51,533,101,21,80,1,79,0,26,24,1,0,0,1,13,2,12
51,534,152,22,130,0,130,2,26,45,9,3,0,0,12,3,30
51,535,3764,1044,2720,43,2677,28,634,768,205,41,14,5,255,55,672
51,536,1355,197,1158,17,1141,13,237,354,84,8,6,0,132,21,286
51,537,150,15,135,2,133,1,29,36,10,1,0,1,24,2,29
51,538,112,18,94,2,92,0,25,37,7,0,0,0,11,2,10
51,539,39,5,34,0,34,0,9,15,0,0,0,0,2,2,6
51,542,118,23,95,0,95,0,20,22,9,3,3,0,14,6,18
51,543,71,12,59,1,58,0,20,18,2,0,0,0,11,2,5
51,544,461,109,352,7,345,2,81,168,11,1,3,3,40,7,29
51,545,385,46,339,3,336,5,129,86,17,5,1,1,31,7,54
51,546,337,77,260,6,254,0,88,104,8,4,1,1,21,6,21
51,547,119,14,105,1,104,0,36,46,2,1,0,0,7,5,7
51,548,246,42,204,4,200,1,43,74,16,0,3,1,20,6,36
51,549,83,7,76,0,76,0,18,36,3,1,0,0,7,5,6
51,550,233,51,182,1,181,3,44,59,8,4,3,0,17,1,42
51,551,176,25,151,1,150,1,38,60,9,1,0,0,19,2,20
51,552,229,33,196,3,193,1,48,75,20,0,3,0,12,0,34
51,553,137,10,127,7,120,1,31,57,7,0,0,0,9,1,14
51,555,123,19,104,1,103,1,17,65,2,2,0,0,8,2,6
51,556,251,45,206,3,203,3,42,81,14,5,3,2,20,3,30
51,557,350,55,295,2,293,3,69,87,29,3,2,1,21,7,71
51,558,109,13,96,2,94,0,24,29,9,0,1,0,12,2,17
51,559,2100,510,1590,17,1573,11,583,453,89,18,13,4,107,32,263
51,560,92,10,82,0,82,1,30,21,5,3,0,0,5,2,15
51,562,1767,215,1552,26,1526,18,269,493,92,13,8,5,216,24,388
51,563,75,23,52,2,50,0,10,19,3,0,0,0,7,1,10
51,564,207,36,171,1,170,5,19,78,16,5,0,0,20,3,24
51,565,86,14,72,1,71,0,23,22,3,1,1,1,8,3,9
51,566,229,32,197,1,196,3,37,74,12,0,2,1,18,16,33
51,567,425,114,311,3,308,1,126,91,17,3,1,1,23,9,36
51,568,239,38,201,1,200,0,51,73,9,2,2,0,28,4,31
51,569,211,11,200,2,198,2,33,95,4,0,0,1,30,3,30
51,570,117,15,102,2,100,0,20,38,8,0,0,1,12,4,17
51,571,619,73,546,7,539,12,103,185,39,4,1,0,49,9,137
51,572,206,33,173,2,171,3,52,77,6,2,0,2,11,2,16
51,573,7825,1706,6119,99,6020,88,1145,1732,546,80,34,13,606,125,1651
51,574,130,23,107,2,105,2,36,35,10,0,0,0,9,3,10
51,576,961,168,793,14,779,10,190,235,62,14,8,3,77,20,160
51,577,126,20,106,5,101,5,20,48,4,0,1,1,10,3,9
51,578,65,7,58,1,57,1,15,20,3,0,1,0,1,3,13
51,579,119,16,103,1,102,0,34,44,6,1,2,0,4,2,9
51,580,358,87,271,1,270,8,46,132,13,5,0,1,24,4,37
51,581,152,30,122,1,121,3,35,29,13,2,1,0,12,3,23
51,582,409,60,349,3,346,1,57,144,21,2,1,2,43,9,66
51,583,202,41,161,5,156,6,62,38,11,3,2,0,9,7,18
51,584,123,8,115,4,111,4,26,50,5,1,2,0,6,1,16
51,585,620,78,542,9,533,2,156,172,42,9,3,1,37,11,100
51,586,126,13,113,2,111,3,27,48,7,0,2,0,11,1,12
51,587,221,30,191,5,186,1,49,67,12,0,3,0,23,5,26
51,588,217,41,176,0,176,2,52,69,8,4,0,0,22,2,17
51,589,138,15,123,2,121,4,24,62,5,0,0,0,8,4,14
51,590,292,41,251,3,248,1,69,87,13,1,0,1,36,6,34
51,591,160,25,135,7,128,2,33,37,13,4,0,1,13,2,23
51,592,267,44,223,7,216,1,45,124,5,0,1,1,13,3,23
51,594,68,15,53,0,53,0,12,27,5,0,0,0,6,0,3
51,595,89,10,79,6,73,0,18,27,9,0,0,0,14,2,3
51,596,250,35,215,9,206,4,57,58,18,2,4,0,20,7,36
51,597,226,34,192,2,190,2,57,58,10,4,1,0,20,10,28
51,598,395,76,319,9,310,1,88,95,11,3,3,1,12,13,83
51,599,203,35,168,3,165,0,35,69,8,1,2,0,11,7,32
51,600,106,17,89,1,88,2,16,43,6,0,0,1,13,2,5
51,601,148,24,124,0,124,0,35,58,1,0,0,1,6,3,20
51,602,66,9,57,2,55,0,22,12,4,0,0,0,4,1,12
51,603,117,20,97,2,95,2,30,41,4,0,1,0,9,4,4
51,604,206,32,174,6,168,7,41,52,12,4,3,1,18,6,24
51,605,424,61,363,5,358,4,80,169,22,2,1,0,15,17,48
51,607,161,33,128,4,124,2,30,39,6,2,0,0,19,4,22
51,608,73,3,70,2,68,2,16,23,1,1,2,0,10,3,10
51,609,623,77,546,6,540,12,154,204,43,5,4,0,32,14,72
51,610,353,44,309,7,302,1,66,95,25,2,2,0,37,8,66
51,611,255,42,213,5,208,4,40,93,8,0,2,2,14,3,42
51,612,1721,249,1472,27,1445,11,346,521,92,10,19,4,169,38,235
51,613,773,131,642,8,634,12,127,254,32,5,6,2,51,12,133
51,614,826,161,665,12,653,11,123,190,47,13,4,1,62,10,192
51,616,218,39,179,5,174,1,53,46,17,3,1,0,16,1,36
51,617,454,41,413,6,407,7,88,132,33,3,1,2,34,11,96
51,618,170,43,127,4,123,5,45,21,8,4,0,0,7,8,25
51,619,90,11,79,0,79,2,21,23,0,0,0,0,13,2,18
51,620,146,27,119,0,119,1,28,37,9,1,0,0,12,2,29
51,621,411,75,336,5,331,1,124,70,17,1,2,0,24,15,77
51,622,373,43,330,7,323,5,48,179,9,2,0,2,31,3,44
51,623,227,24,203,0,203,8,22,85,6,1,0,0,34,8,39
51,624,464,86,378,8,370,8,81,103,33,5,3,0,39,6,92
51,625,267,58,209,5,204,3,67,56,24,2,4,1,21,3,23
51,626,91,14,77,0,77,0,8,36,9,1,0,0,10,0,13
51,627,252,55,197,3,194,3,59,65,11,1,1,0,20,3,31
51,628,103,17,86,1,85,2,16,37,3,1,0,0,10,3,13
51,629,569,92,477,4,473,13,84,215,22,4,1,4,38,3,89
51,630,227,41,186,4,182,3,59,32,16,3,5,0,11,8,45
51,631,142,11,131,1,130,0,12,64,2,2,0,1,18,3,28
51,632,201,36,165,6,159,2,38,49,16,1,0,0,23,2,28
51,633,248,39,209,5,204,6,41,66,13,3,1,0,18,4,52
51,634,211,26,185,4,181,3,43,71,13,2,0,2,20,9,18
51,635,88,19,69,1,68,1,27,17,2,0,1,0,5,1,14
51,636,482,80,402,7,395,1,95,170,14,3,2,1,31,8,70
51,637,171,27,144,0,144,0,28,90,3,2,1,0,9,1,10
51,638,147,27,120,3,117,3,35,37,9,2,4,0,14,1,12
51,639,59,12,47,0,47,0,10,22,3,0,0,1,4,1,6
51,640,164,35,129,2,127,2,41,33,9,3,1,0,14,1,23
51,641,183,30,153,3,150,1,39,65,4,1,2,0,12,1,25
51,642,75,16,59,0,59,0,15,29,5,0,0,0,6,2,2
51,643,445,74,371,8,363,3,86,113,29,9,4,1,38,4,76
51,644,252,50,202,6,196,3,36,79,12,4,1,0,26,1,34
51,645,103,18,85,0,85,1,19,38,3,0,1,0,7,1,15
51,646,68,10,58,1,57,0,15,24,1,1,1,0,6,3,6
51,647,679,77,602,9,593,8,158,171,35,7,6,1,59,14,134
51,648,303,52,251,3,248,1,93,76,11,4,2,0,17,5,39
51,649,8274,2160,6114,102,6012,58,1505,1543,449,69,46,10,405,99,1828
51,650,42,4,38,1,37,1,11,11,3,1,0,0,4,0,6
51,651,186,36,150,2,148,1,51,38,9,1,2,0,24,2,20
51,652,56,1,55,1,54,0,20,17,1,0,0,0,9,0,7
51,654,158,27,131,2,129,3,45,34,15,3,0,0,9,3,17
51,655,235,33,202,6,196,1,67,56,16,3,0,0,18,6,29
51,656,402,104,298,11,287,9,69,104,14,3,1,1,43,9,34
51,657,181,39,142,3,139,0,41,60,5,2,0,1,13,3,14
51,658,97,23,74,1,73,0,23,20,5,2,2,0,6,3,12
51,659,46,14,32,2,30,0,10,11,0,0,0,0,9,0,0
51,660,1641,316,1325,19,1306,19,329,368,106,19,6,2,125,27,305
51,662,3724,685,3039,43,2996,31,704,804,253,35,18,8,319,60,764
51,663,1369,343,1026,19,1007,17,262,187,107,23,4,0,86,20,301
52,1,255,36,219,2,217,4,47,60,27,0,2,0,18,4,55
52,2,20,2,18,0,18,2,7,3,0,0,0,0,3,0,3
52,3,147,26,121,0,121,0,42,36,6,2,1,1,10,0,23
52,4,14,0,14,0,14,1,2,7,1,0,0,0,1,2,0
52,5,26,1,25,0,25,0,11,9,1,0,0,0,2,0,2
52,6,332,91,241,5,236,1,95,46,16,2,2,0,8,2,64
52,7,67,11,56,0,56,2,11,18,6,2,1,0,7,5,4
52,8,645,136,509,5,504,10,122,143,33,11,8,3,39,22,113
52,9,101,13,88,0,88,1,18,19,13,4,1,1,18,1,12
52,11,70,9,61,1,60,1,12,22,4,1,0,0,5,2,13
52,12,29,6,23,0,23,0,10,7,1,0,0,0,2,0,3
52,13,119,22,97,0,97,2,16,15,14,4,0,0,7,3,36
52,14,181,39,142,7,135,5,37,45,7,0,0,1,15,5,20
52,15,83,3,80,20,60,0,16,17,1,0,2,0,6,2,16
52,16,66,16,50,1,49,2,4,17,8,1,0,0,2,0,15
52,17,579,91,488,6,482,3,121,169,31,6,4,0,30,8,110
52,19,110,16,94,1,93,2,34,20,9,0,1,2,2,1,22
52,21,236,42,194,3,191,1,61,59,15,4,2,0,13,7,29
52,22,168,23,145,3,142,3,29,52,8,0,4,1,6,7,32
52,23,149,23,126,2,124,0,27,41,14,1,0,0,3,1,37
52,25,79,15,64,2,62,1,10,28,2,0,0,0,6,3,12
52,27,66,8,58,2,56,1,16,19,2,0,0,0,5,3,10
52,28,52,11,41,2,39,1,14,13,0,0,1,0,5,0,5
52,29,140,13,127,4,123,2,36,34,9,3,0,0,11,5,23
52,30,60,10,50,2,48,1,18,9,6,1,1,0,3,1,8
52,31,343,55,288,8,280,4,97,84,14,1,4,0,30,15,31
52,33,101,10,91,1,90,2,29,28,1,2,1,0,9,3,15
52,34,119,26,93,0,93,1,32,23,9,1,0,0,7,0,20
52,35,172,31,141,5,136,2,39,46,7,2,1,0,14,6,19
52,36,202,43,159,4,155,1,37,42,15,2,0,0,17,4,37
52,37,315,74,241,4,237,10,70,71,16,3,2,1,15,4,45
52,38,62,8,54,0,54,0,16,17,8,4,0,0,5,0,4
52,39,93,11,82,2,80,0,35,18,6,1,1,0,8,2,9
52,40,59,6,53,1,52,5,12,14,1,0,0,0,5,2,13
52,42,85,5,80,5,75,2,18,28,10,1,0,0,9,2,5
52,43,45,5,40,3,37,0,7,13,1,0,0,0,8,1,7
52,44,517,111,406,11,395,2,118,95,25,2,3,0,30,9,111
52,45,1668,301,1367,26,1341,21,292,414,136,8,8,5,107,24,326
52,47,101,21,80,3,77,2,20,22,8,3,1,0,5,1,15
52,50,1124,209,915,25,890,16,230,254,87,12,4,2,72,28,185
52,51,43,2,41,0,41,0,10,10,3,1,1,0,2,1,13
52,53,57,6,51,3,48,0,21,14,2,0,0,0,5,1,5
52,55,92,1,91,1,90,2,23,36,7,2,0,0,6,5,9
52,56,190,32,158,3,155,1,46,57,11,5,2,0,7,4,22
52,57,109,11,98,3,95,3,16,31,14,1,0,4,4,10,12
52,58,1417,215,1202,28,1174,25,259,329,94,20,14,2,86,24,321
52,59,109,23,86,2,84,1,29,24,4,1,0,0,6,3,16
52,60,1648,364,1284,27,1257,15,237,447,106,14,6,2,111,25,294
52,61,242,42,200,3,197,3,54,72,13,3,1,1,14,3,33
52,62,136,22,114,3,111,2,18,49,3,2,0,0,10,1,26
52,63,105,14,91,0,91,2,25,30,7,0,2,0,3,5,17
52,64,354,49,305,9,296,5,61,88,32,4,2,0,27,1,76
52,65,68,16,52,0,52,2,9,13,8,1,0,0,6,3,10
52,66,50,5,45,2,43,0,31,6,2,1,0,0,1,0,2
52,67,85,12,73,5,68,1,19,25,1,1,0,1,5,2,13
52,69,131,17,114,1,113,3,39,35,7,3,1,0,6,5,14
52,70,106,15,91,2,89,4,20,23,10,3,0,0,5,2,22
52,72,309,47,262,4,258,5,59,76,19,3,1,1,22,9,63
52,74,559,108,451,11,440,3,115,145,33,5,2,2,42,9,84
52,75,160,30,130,4,126,1,37,28,7,2,0,0,12,0,39
52,76,325,51,274,4,270,5,71,77,25,5,3,3,24,7,50
52,79,562,133,429,9,420,0,125,84,51,5,4,0,19,4,128
52,82,122,26,96,1,95,1,22,35,7,1,1,0,6,6,16
52,83,644,72,572,10,562,9,111,162,59,6,5,0,49,13,148
52,84,34,5,29,1,28,0,10,10,0,1,0,0,1,1,5
52,85,20,4,16,0,16,1,5,2,2,0,0,0,0,0,6
52,87,171,19,152,5,147,0,40,31,22,4,0,0,15,3,32
52,88,506,85,421,10,411,3,132,142,34,2,1,2,33,12,50
52,89,61,7,54,2,52,0,15,16,1,0,1,0,8,3,8
52,90,100,20,80,0,80,1,24,17,5,4,1,0,2,3,23
52,91,85,13,72,4,68,3,12,18,12,1,2,0,8,3,9
52,92,83,29,54,0,54,1,18,16,2,1,2,0,8,0,6
52,93,1833,264,1569,28,1541,19,334,276,186,26,7,4,117,53,519
52,94,176,30,146,3,143,3,27,51,11,0,1,0,18,4,28
52,95,191,35,156,2,154,1,45,57,14,0,1,0,9,2,25
52,97,39,6,33,3,30,1,8,10,2,0,0,1,3,3,2
52,99,546,97,449,10,439,5,168,99,49,8,2,2,20,9,77
52,101,54,14,40,1,39,0,5,12,3,0,0,0,9,0,10
52,102,312,43,269,5,264,1,50,73,18,3,0,0,33,6,80
52,103,116,27,89,2,87,0,30,48,0,0,0,1,4,1,3
52,104,874,96,778,17,761,7,205,223,80,6,5,0,69,15,151
52,105,217,27,190,8,182,0,25,57,13,0,2,0,25,8,52
52,106,106,14,92,4,88,2,27,18,8,1,0,0,12,1,19
52,107,160,16,144,5,139,1,34,48,7,1,1,0,12,6,29
52,108,126,17,109,0,109,0,27,35,10,0,0,0,17,2,18
52,109,9,0,9,0,9,0,0,3,0,0,0,0,1,0,5
52,110,152,37,115,1,114,4,39,29,9,2,1,0,8,6,16
52,113,206,45,161,2,159,2,44,47,6,2,0,2,21,1,34
52,114,1214,206,1008,14,994,17,280,281,117,21,2,2,69,24,181
52,115,103,17,86,1,85,2,14,23,5,1,3,0,8,1,28
52,116,45,2,43,0,43,0,15,11,4,0,0,0,4,2,7
52,118,271,56,215,6,209,1,69,52,25,4,2,0,19,5,32
52,119,271,46,225,3,222,2,38,21,19,4,3,0,28,7,100
52,120,166,38,128,6,122,0,30,15,16,2,6,0,7,5,41
52,121,16202,4191,12011,230,11781,248,2108,3166,1258,174,95,29,997,263,3443
52,122,118,26,92,2,90,0,32,34,8,1,1,0,4,0,10
52,123,1050,167,883,19,864,9,298,218,59,8,12,0,61,20,179
52,124,89,15,74,2,72,1,14,24,6,1,2,0,10,3,11
52,125,869,135,734,11,723,14,102,194,74,9,5,3,87,21,214
52,126,127,17,110,2,108,3,23,33,12,3,1,0,6,6,21
52,127,75,19,56,4,52,0,11,12,2,0,0,0,11,0,16
52,128,96,14,82,2,80,0,15,39,3,1,0,1,8,0,13
52,129,100,19,81,0,81,0,20,38,3,0,1,1,1,2,15
52,130,140,32,108,3,105,1,28,40,10,0,0,0,10,1,15
52,131,74,15,59,0,59,0,20,25,4,1,0,0,2,2,5
52,132,153,23,130,1,129,4,30,38,12,3,1,0,8,7,26
52,133,98,21,77,1,76,1,16,27,7,0,0,1,5,1,18
52,134,199,17,182,3,179,3,23,63,20,2,1,0,18,4,45
52,135,81,12,69,2,67,3,16,17,4,1,0,0,3,2,21
52,136,104,12,92,1,91,1,13,52,3,1,0,0,6,4,11
52,137,26,1,25,0,25,2,7,11,0,0,0,0,1,1,3
52,138,64,6,58,1,57,1,15,24,1,0,0,0,9,2,5
52,140,561,73,488,12,476,3,115,236,28,7,0,1,28,10,48
52,141,278,37,241,5,236,6,54,53,27,3,2,0,20,8,63
52,142,68,8,60,0,60,0,15,22,1,0,0,0,8,3,11
52,145,123,18,105,3,102,3,22,27,5,1,0,0,14,1,29
52,146,147,26,121,2,119,1,20,27,17,2,1,1,13,5,32
52,147,84,14,70,1,69,0,18,22,13,4,0,0,5,3,4
52,149,89,16,73,3,70,0,25,12,8,2,0,0,6,6,11
52,151,141,14,127,0,127,0,40,27,7,2,1,0,19,0,31
52,155,453,80,373,6,367,2,80,56,42,1,3,1,18,11,153
52,156,306,47,259,6,253,2,87,31,39,5,3,1,10,6,69
52,157,21,6,15,0,15,0,4,6,0,0,1,0,2,0,2
52,158,216,38,178,5,173,1,43,64,15,0,4,1,27,5,13
52,159,23,2,21,1,20,0,7,7,0,0,0,0,2,1,3
52,160,82,13,69,3,66,5,21,19,4,1,0,0,9,0,7
52,161,60,15,45,0,45,0,10,14,6,0,2,0,4,1,8
52,162,173,36,137,2,135,0,29,36,13,3,0,1,15,4,34
52,163,303,68,235,4,231,2,72,69,12,3,3,0,15,7,48
52,164,173,27,146,3,143,2,55,27,27,0,2,1,6,3,20
52,165,211,25,186,1,185,3,24,69,25,2,0,0,19,5,38
52,167,198,33,165,5,160,2,34,59,18,1,3,1,14,5,23
52,168,48,6,42,1,41,0,4,22,4,1,0,0,1,3,6
52,169,90,16,74,1,73,2,19,18,7,3,0,0,4,0,20
52,170,148,28,120,4,116,0,26,36,14,3,4,0,9,0,24
52,171,165,27,138,3,135,0,41,56,4,1,0,2,8,4,19
52,172,236,43,193,4,189,2,69,40,11,1,1,1,18,13,33
52,173,78,12,66,1,65,1,21,22,2,2,2,0,4,2,9
52,174,39,7,32,1,31,0,9,15,1,0,0,0,4,1,1
52,175,329,84,245,6,239,7,69,54,17,3,2,0,3,11,73
52,177,638,108,530,13,517,3,166,126,47,11,2,2,35,11,114
52,178,307,61,246,3,243,5,66,79,20,2,2,1,5,10,53
52,179,41,4,37,0,37,0,17,9,0,0,0,1,5,0,5
52,180,324,61,263,2,261,4,75,84,17,6,0,0,20,6,49
52,181,98,29,69,0,69,2,30,13,7,0,1,1,8,1,6
52,182,1578,277,1301,22,1279,5,433,342,107,16,19,4,91,28,234
52,183,34,4,30,0,30,0,5,22,2,0,1,0,0,0,0
52,184,61,7,54,2,52,0,14,21,2,0,0,0,10,2,3
52,185,79,17,62,1,61,2,18,24,1,1,0,0,7,2,6
52,187,117,30,87,3,84,0,28,27,4,4,0,0,12,5,4
52,189,323,41,282,6,276,11,47,90,21,5,5,1,42,10,44
52,190,269,35,234,3,231,12,58,49,34,5,1,0,18,4,50
52,193,247,26,221,5,216,0,41,73,15,2,2,0,20,10,53
52,194,1483,213,1270,26,1244,14,421,319,102,23,17,5,76,31,236
52,195,56,6,50,0,50,0,10,18,6,0,0,0,3,2,11
52,196,95,15,80,2,78,2,14,29,3,0,0,0,9,1,20
52,197,987,153,834,10,824,9,205,257,53,17,10,3,67,18,185
52,198,64,7,57,2,55,1,23,12,4,1,0,1,8,1,4
52,199,57,12,45,0,45,0,12,10,1,1,1,0,7,1,12
52,200,82,10,72,5,67,4,22,16,3,0,2,0,2,5,13
52,201,51,7,44,0,44,1,24,9,1,0,0,0,0,7,2
52,203,124,22,102,0,102,2,39,27,10,2,0,1,6,0,15
52,204,64,6,58,2,56,1,17,17,5,0,0,1,3,3,9
52,205,581,100,481,16,465,14,83,166,41,7,2,1,37,7,107
52,206,129,8,121,1,120,0,40,36,9,3,2,0,9,3,18
52,207,76,18,58,0,58,0,14,23,2,0,0,1,8,3,7
52,208,157,28,129,10,119,1,36,41,6,2,4,1,9,4,15
52,211,1263,182,1081,20,1061,10,245,221,91,12,7,2,74,12,387
52,212,253,56,197,7,190,1,56,46,12,8,2,0,15,14,36
52,213,131,19,112,4,108,2,31,41,5,0,0,0,8,4,17
52,214,25,2,23,1,22,1,11,3,2,0,0,0,4,0,1
52,216,38,9,29,0,29,2,7,11,2,1,1,0,4,0,1
52,217,88,14,74,0,74,2,24,16,7,2,2,0,12,1,8
52,218,56,7,49,0,49,1,12,15,2,1,1,0,4,3,10
52,219,20,0,20,0,20,0,2,10,0,0,0,0,7,0,1
52,220,129,22,107,0,107,1,17,38,15,0,1,0,15,5,15
52,221,98,15,83,0,83,2,10,37,6,0,0,0,13,3,12
52,222,28,6,22,0,22,0,7,8,1,0,0,1,1,0,4
52,223,56,9,47,1,46,0,7,16,1,1,0,0,5,1,15
52,225,224,30,194,4,190,0,55,64,9,4,1,0,16,7,34
52,227,181,20,161,3,158,1,22,74,13,1,2,0,18,6,21
52,228,64,14,50,1,49,2,15,20,1,2,0,0,1,2,6
52,229,119,9,110,2,108,0,41,17,13,0,2,0,5,2,28
52,230,282,45,237,4,233,6,65,58,15,4,4,1,17,8,55
52,231,81,8,73,1,72,2,24,13,7,0,0,0,12,3,11
52,232,35,7,28,0,28,0,17,6,2,1,0,0,1,0,1
52,233,101,15,86,0,86,3,19,26,13,1,3,0,5,0,16
52,234,25,3,22,0,22,0,3,16,0,0,0,0,1,0,2
52,235,232,42,190,3,187,1,73,46,30,3,3,0,11,2,18
52,237,221,37,184,6,178,1,67,25,15,1,2,0,14,0,53
52,239,246,35,211,4,207,3,51,58,18,1,2,0,19,0,55
52,240,167,31,136,1,135,2,30,25,10,4,0,1,26,5,32
52,242,821,141,680,12,668,7,171,180,52,3,6,0,61,13,175
52,243,118,13,105,2,103,0,23,33,8,2,0,0,10,0,27
52,244,554,101,453,8,445,1,151,134,39,5,2,0,26,3,84
52,245,64,10,54,2,52,0,22,6,1,0,0,0,4,3,16
52,246,460,85,375,6,369,7,103,109,39,1,3,1,24,7,75
52,247,210,40,170,3,167,0,37,46,14,2,0,0,13,4,51
52,248,415,75,340,5,335,3,88,123,14,3,3,0,25,4,72
52,249,126,15,111,3,108,0,21,32,9,1,0,0,21,4,20
52,250,2376,592,1784,26,1758,21,437,464,135,16,11,5,130,42,497
52,251,711,77,634,8,626,9,133,169,65,4,8,0,56,17,165
52,253,139,15,124,8,116,0,37,33,12,0,0,0,6,4,24
52,254,84,15,69,4,65,1,9,24,4,2,1,0,7,3,14
52,256,75,9,66,3,63,0,19,17,4,1,0,0,4,1,17
52,257,108,20,88,2,86,2,24,23,4,4,0,0,5,2,22
52,258,259,46,213,7,206,3,68,35,18,0,1,0,12,12,57
52,260,112,23,89,1,88,0,34,27,5,0,0,0,2,8,12
52,262,63,9,54,3,51,1,22,9,7,5,0,0,3,1,3
52,264,81,13,68,1,67,2,26,13,6,1,0,0,4,4,11
52,265,1178,231,947,12,935,1,348,216,64,10,7,2,49,15,223
52,266,48,6,42,1,41,0,9,23,1,1,0,0,4,1,2
52,267,161,31,130,1,129,0,39,39,7,0,3,0,11,7,23
52,269,5492,1345,4147,75,4072,89,745,1105,370,49,26,9,382,91,1206
52,271,167,29,138,5,133,2,30,38,12,0,0,0,17,1,33
52,272,118,19,99,0,99,0,32,39,6,1,1,0,4,1,15
52,273,116,26,90,0,90,2,25,25,4,0,0,0,7,1,26
52,274,257,62,195,4,191,5,44,65,23,2,1,1,21,2,27
52,275,67,9,58,0,58,1,14,18,7,0,1,0,8,0,9
52,276,190,26,164,4,160,4,25,56,11,3,3,0,10,9,39
52,277,67,15,52,2,50,0,21,14,1,0,0,0,7,2,5
52,278,77,16,61,0,61,1,14,18,6,0,1,0,9,2,10
52,280,194,30,164,1,163,0,35,42,11,4,1,0,27,6,37
52,282,268,30,238,3,235,4,52,91,13,5,1,0,9,5,55
52,284,79,17,62,0,62,1,30,23,2,0,2,0,0,3,1
52,285,58,8,50,1,49,2,18,10,5,1,0,0,1,1,11
52,286,75,17,58,3,55,0,18,24,0,3,2,0,2,1,5
52,287,94,16,78,0,78,1,14,25,1,5,1,0,8,0,23
52,288,100,17,83,1,82,1,32,29,5,0,1,0,6,4,4
52,289,242,29,213,6,207,3,58,57,10,4,5,1,13,3,53
52,290,102,19,83,0,83,1,23,25,6,0,0,1,8,4,15
52,291,60,12,48,1,47,1,11,18,0,0,0,3,4,2,8
52,292,492,80,412,7,405,1,91,112,33,12,0,3,46,14,93
52,293,366,51,315,11,304,1,83,106,23,5,0,1,26,12,47
52,294,520,90,430,10,420,4,141,109,48,8,5,1,19,4,81
52,295,102,14,88,4,84,1,23,28,6,0,1,0,3,1,21
52,296,258,35,223,3,220,6,58,82,19,3,0,0,22,7,23
52,297,228,28,200,8,192,2,52,36,23,4,1,0,18,2,54
52,298,71,11,60,2,58,2,16,17,9,0,0,0,4,1,9
52,300,135,17,118,0,118,5,30,28,10,0,0,1,16,1,27
52,301,67,4,63,0,63,1,21,9,7,0,0,1,15,1,8
52,302,162,28,134,2,132,1,45,49,7,2,0,0,12,1,15
52,303,80,11,69,1,68,1,23,12,3,0,0,0,3,0,26
52,304,53,6,47,2,45,0,10,9,6,0,0,0,3,0,17
52,305,413,75,338,6,332,2,89,90,16,2,2,1,24,6,100
52,306,353,78,275,5,270,2,87,64,13,2,2,0,15,7,78
52,307,157,15,142,3,139,5,26,48,25,1,0,0,6,2,26
52,308,382,84,298,12,286,4,94,76,28,1,0,0,12,6,65
52,310,96,10,86,1,85,1,21,39,4,3,0,1,5,2,9
52,311,199,39,160,5,155,0,45,38,13,3,0,1,12,5,38
52,312,43,2,41,1,40,0,11,14,0,0,0,1,2,0,12
52,313,133,15,118,1,117,2,18,42,12,1,0,1,15,6,20
52,315,237,27,210,1,209,1,48,53,29,2,3,0,27,9,37
52,316,51,19,32,0,32,0,6,8,5,0,0,0,6,2,5
52,318,219,50,169,2,167,1,43,44,15,1,1,1,8,4,49
52,319,75,18,57,0,57,0,16,16,8,2,0,0,5,1,9
52,320,106,24,82,1,81,0,27,9,6,3,1,1,3,1,30
52,321,170,25,145,2,143,0,60,42,5,1,0,1,3,5,26
52,322,110,22,88,2,86,1,22,21,14,2,0,0,6,1,19
52,325,93,11,82,3,79,0,14,33,10,1,1,1,8,2,9
52,326,40,11,29,0,29,0,10,12,1,0,0,0,1,1,4
52,327,357,28,329,7,322,2,96,88,37,3,0,0,31,7,58
52,328,34,11,23,1,22,1,6,3,1,3,0,0,0,2,6
52,330,75,21,54,1,53,1,8,21,6,2,2,1,3,2,7
52,331,1437,263,1174,26,1148,14,300,340,91,18,15,2,84,34,250
52,332,1495,334,1161,20,1141,16,289,358,87,22,13,1,101,32,222
52,335,97,11,86,4,82,0,24,23,10,3,0,0,4,1,17
52,336,114,15,99,3,96,0,42,17,9,0,0,1,8,1,18
52,337,60,14,46,0,46,0,22,15,0,0,1,0,3,3,2
52,340,71,8,63,0,63,9,10,16,13,2,0,0,0,2,11
52,341,106,19,87,0,87,3,24,28,6,1,1,0,6,8,10
52,342,32,3,29,1,28,0,11,10,2,0,0,0,3,2,0
52,344,26,1,25,2,23,0,5,12,0,0,0,0,4,0,2
52,346,274,46,228,6,222,1,79,52,5,2,1,1,12,3,66
52,347,198,32,166,1,165,1,54,41,10,5,0,0,9,2,43
52,348,513,79,434,10,424,11,104,98,34,9,1,0,33,7,127
52,349,298,31,267,4,263,5,42,94,20,3,0,0,18,2,79
52,350,75,11,64,2,62,0,22,23,4,1,1,0,3,0,8
52,351,80,17,63,0,63,1,14,14,10,2,0,0,1,2,19
52,352,77,11,66,0,66,0,17,31,2,0,0,0,7,1,8
52,353,2874,545,2329,55,2274,17,587,598,201,42,26,5,173,48,577
52,354,76,7,69,2,67,0,12,11,11,0,1,1,6,2,23
52,355,160,21,139,7,132,0,38,28,12,0,0,2,18,7,27
52,356,95,19,76,1,75,0,32,18,7,0,0,0,4,0,14
52,357,146,27,119,5,114,0,45,22,6,3,0,0,5,3,30
52,358,70,14,56,1,55,2,14,17,2,1,0,0,4,2,13
52,359,142,25,117,0,117,1,35,46,3,0,1,2,5,12,12
52,360,128,16,112,2,110,0,32,41,10,0,1,0,17,0,9
52,362,133,19,114,3,111,0,19,22,10,2,0,1,9,5,43
52,363,90,18,72,0,72,1,6,11,14,1,2,0,12,1,24
52,364,104,15,89,6,83,6,11,16,9,2,0,0,12,0,27
52,365,283,35,248,6,242,1,63,84,24,8,0,0,22,9,31
52,366,67,15,52,1,51,1,12,19,4,1,0,0,2,1,11
52,367,34,3,31,0,31,0,7,10,3,0,1,0,2,0,8
52,369,76,13,63,1,62,0,28,18,4,0,0,0,2,2,8
52,370,266,47,219,5,214,2,95,43,15,7,0,1,4,2,45
52,371,129,18,111,0,111,0,32,33,7,0,1,2,11,3,22
52,372,90,9,81,2,79,1,22,25,5,1,2,0,8,1,14
52,373,48,12,36,0,36,0,12,14,2,0,0,0,3,0,5
52,374,275,33,242,3,239,13,58,59,19,2,2,0,16,14,56
52,375,50,10,40,1,39,0,11,12,4,0,0,0,3,1,8
52,376,66,20,46,0,46,1,19,16,3,0,2,0,0,2,3
52,377,260,57,203,4,199,6,46,90,9,0,2,1,13,6,26
52,378,42,6,36,0,36,0,9,17,2,0,0,1,4,3,0
52,379,28,6,22,1,21,0,5,11,2,0,0,0,1,1,1
52,380,312,32,280,9,271,4,56,83,18,6,0,1,23,8,72
52,383,268,32,236,10,226,5,47,67,17,1,0,1,31,6,51
52,384,107,12,95,3,92,2,15,41,3,1,1,0,5,2,22
52,385,40,7,33,2,31,0,6,13,1,0,0,1,5,0,5
52,386,373,77,296,4,292,4,120,81,24,3,1,2,11,3,43
52,388,156,28,128,2,126,1,23,49,7,4,2,2,12,2,24
52,390,43,5,38,0,38,0,10,15,1,1,0,0,1,4,6
52,391,203,29,174,1,173,1,44,68,5,4,0,1,10,8,32
52,392,87,11,76,1,75,3,14,13,17,1,0,0,10,2,15
52,393,55,14,41,0,41,1,11,15,4,0,1,0,1,0,8
52,394,141,14,127,0,127,2,29,60,4,3,1,0,10,3,15
52,395,54,10,44,2,42,0,10,12,2,1,0,0,1,6,10
52,396,129,19,110,3,107,1,17,34,7,0,2,1,10,2,33
52,397,63,11,52,1,51,1,11,18,3,0,1,0,9,0,8
52,398,543,99,444,11,433,6,113,120,38,10,3,0,36,8,99
52,399,138,31,107,1,106,1,17,28,7,1,1,0,15,3,33
52,400,130,16,114,4,110,0,19,38,15,1,0,0,20,2,15
52,401,313,43,270,3,267,3,62,60,26,1,1,0,22,8,84
52,403,64,15,49,0,49,0,8,16,8,0,2,1,5,0,9
52,405,369,78,291,11,280,3,72,84,18,6,2,1,21,5,68
52,406,172,21,151,1,150,0,42,65,7,0,1,0,10,6,19
52,407,254,46,208,3,205,3,57,54,20,2,4,0,5,8,52
52,411,169,31,138,1,137,3,33,53,14,0,2,1,10,3,18
52,413,91,12,79,3,76,1,23,14,13,3,2,0,2,4,14
52,414,496,85,411,7,404,3,132,75,31,4,1,0,27,5,126
52,415,99,19,80,1,79,0,19,28,5,1,0,0,12,0,14
52,416,58,7,51,2,49,1,15,9,5,0,0,0,1,1,17
52,419,151,30,121,3,118,1,29,31,7,0,2,2,11,4,31
52,420,122,35,87,3,84,2,21,21,15,0,1,0,5,2,17
52,421,297,61,236,6,230,3,49,58,28,2,2,0,13,5,70
52,422,224,44,180,2,178,3,37,59,16,2,1,1,14,9,36
52,423,496,85,411,6,405,6,101,87,25,10,5,0,31,14,126
52,424,62,5,57,1,56,2,7,14,7,1,0,0,4,0,21
52,425,217,43,174,3,171,2,34,37,26,5,2,0,13,3,49
52,426,121,19,102,2,100,1,18,53,4,1,1,0,7,4,11
52,427,197,26,171,5,166,3,58,48,5,3,1,2,11,5,30
52,428,52,4,48,0,48,0,16,12,3,1,2,0,0,3,11
52,429,507,90,417,7,410,4,128,101,37,6,0,1,23,15,95
52,431,145,35,110,1,109,2,23,41,8,2,1,0,7,5,20
52,432,1287,252,1035,16,1019,12,262,286,78,11,8,1,100,16,245
52,433,121,19,102,1,101,1,32,39,1,2,0,1,6,0,19
52,436,45,3,42,1,41,0,7,23,3,0,1,0,1,0,6
52,437,30,6,24,1,23,1,4,10,3,0,0,0,0,0,5
52,438,108,17,91,0,91,0,19,19,15,4,0,0,12,1,21
52,439,93,10,83,2,81,2,19,22,8,0,0,0,7,3,20
52,440,294,46,248,6,242,1,89,59,26,4,3,2,11,4,43
52,442,229,26,203,5,198,0,46,58,14,0,1,1,18,6,54
52,443,42,12,30,0,30,1,10,6,1,1,0,1,0,2,8
52,444,260,43,217,8,209,1,65,72,16,0,4,0,14,4,33
52,445,61,10,51,2,49,0,4,14,4,2,0,0,5,0,20
52,446,167,29,138,4,134,1,43,25,15,2,1,1,17,2,27
52,447,136,14,122,3,119,4,33,35,9,0,0,1,15,2,20
52,448,16993,4802,12191,224,11967,130,3137,3166,1164,130,70,21,760,217,3172
52,449,772,95,677,21,656,4,150,195,46,7,3,0,92,20,139
52,450,118,17,101,0,101,8,18,42,4,3,0,0,7,3,16
52,452,81,12,69,2,67,0,24,18,4,0,0,0,6,1,14
52,453,129,18,111,0,111,1,28,18,17,3,1,0,11,3,29
52,455,214,36,178,0,178,0,45,60,14,2,1,1,15,2,38
52,456,557,99,458,10,448,6,149,110,24,9,4,2,34,20,90
52,457,124,13,111,2,109,1,28,26,11,0,1,1,9,3,29
52,459,83,14,69,3,66,0,21,16,6,0,0,0,6,2,15
52,461,287,57,230,9,221,1,49,80,12,3,1,0,30,8,37
52,463,32,2,30,0,30,1,5,14,0,0,0,0,3,3,4
52,464,78,13,65,1,64,1,13,25,7,0,1,0,5,1,11
52,465,101,8,93,0,93,1,20,37,5,2,0,0,8,1,19
52,467,50,4,46,2,44,0,9,18,4,1,0,0,4,2,6
52,468,98,14,84,2,82,0,15,32,5,0,0,0,3,8,19
52,469,452,69,383,5,378,4,104,117,38,4,4,0,30,16,61
52,470,398,87,311,12,299,3,82,103,23,7,1,0,21,5,54
52,472,101,21,80,1,79,0,31,24,5,3,0,0,8,3,5
52,473,90,13,77,1,76,0,22,30,9,0,0,0,4,1,10
52,474,51,7,44,0,44,0,13,17,1,0,1,1,3,0,8
52,475,46,8,38,1,37,2,11,18,2,0,0,0,2,1,1
52,476,66,6,60,1,59,1,12,15,6,1,0,0,1,1,22
52,479,543,82,461,8,453,9,148,119,51,5,3,0,26,10,82
52,480,288,39,249,8,241,4,61,69,11,3,1,0,31,7,54
52,482,77,17,60,2,58,0,12,7,3,1,0,0,11,2,22
52,483,62,5,57,0,57,1,12,19,1,0,1,0,4,2,17
52,484,274,61,213,7,206,2,75,71,7,4,2,0,9,5,31
52,486,67,11,56,1,55,0,11,21,5,0,1,0,2,3,12
52,487,73,6,67,3,64,0,26,24,0,0,0,0,5,2,7
52,488,227,23,204,2,202,3,63,39,27,0,8,0,8,1,53
52,489,32,6,26,0,26,2,5,12,1,0,0,0,2,1,3
52,490,652,143,509,11,498,6,181,102,41,10,6,1,37,7,107
52,491,81,12,69,4,65,0,19,19,5,2,0,0,11,0,9
52,492,474,95,379,7,372,9,68,70,42,7,3,0,28,4,141
52,493,39,5,34,2,32,1,8,12,2,0,0,0,3,0,6
52,494,213,41,172,5,167,1,38,56,11,5,3,1,14,3,35
52,495,60,9,51,0,51,0,16,18,1,1,0,0,10,2,3
52,497,344,61,283,5,278,2,93,88,14,3,3,0,16,7,52
52,499,53,9,44,0,44,1,15,13,1,0,0,0,2,2,10
52,500,546,98,448,9,439,4,130,123,47,2,2,3,32,20,76
52,502,52,9,43,1,42,2,14,13,4,0,0,0,1,0,8
52,503,26,10,16,0,16,1,3,4,0,0,0,0,0,3,5
52,504,282,48,234,3,231,5,61,41,36,5,3,0,12,2,66
52,505,34,6,28,0,28,0,1,14,0,0,0,2,6,0,5
52,506,96,14,82,1,81,1,16,30,10,1,1,1,9,2,10
52,507,58,10,48,5,43,2,10,10,5,0,1,0,2,1,12
52,509,484,56,428,10,418,9,66,136,32,7,4,1,57,16,90
52,510,317,47,270,6,264,2,74,63,24,4,7,2,20,10,58
52,511,51,1,50,0,50,1,20,10,3,2,0,0,5,2,7
52,512,415,85,330,8,322,4,85,33,41,6,5,1,13,4,130
52,513,80,18,62,3,59,1,18,13,6,0,0,0,9,0,12
52,514,254,33,221,6,215,4,39,64,30,0,0,0,30,4,44
52,515,89,14,75,1,74,0,18,25,4,0,1,0,6,0,20
52,516,36,5,31,2,29,0,4,12,2,1,0,0,6,0,4
52,517,106,19,87,2,85,2,23,30,8,0,0,3,9,1,9
52,518,106,22,84,2,82,1,14,28,4,2,1,0,5,1,26
52,519,54,6,48,2,46,0,5,15,9,1,0,0,8,3,5
52,520,159,23,136,1,135,1,29,43,16,2,6,0,10,1,27
52,522,248,18,230,2,228,1,51,59,19,2,3,0,24,5,64
52,523,47,3,44,0,44,2,5,9,5,0,1,0,7,3,12
52,524,212,39,173,1,172,2,51,47,13,4,1,0,9,3,42
52,525,86,9,77,1,76,0,19,32,4,1,0,0,7,3,10
52,526,91,11,80,3,77,0,13,31,7,2,1,0,6,1,16
52,528,130,30,100,8,92,2,36,17,11,0,2,0,6,2,16
52,529,683,116,567,13,554,6,119,201,51,9,6,0,42,7,113
52,534,1208,170,1038,22,1016,9,333,219,86,11,4,4,95,30,225
52,535,458,69,389,5,384,1,92,124,21,8,9,1,39,9,80
52,536,37,15,22,0,22,0,6,9,3,0,0,1,0,0,3
52,538,205,35,170,2,168,3,41,52,17,0,1,1,13,3,37
52,539,72,11,61,1,60,0,24,14,2,0,0,0,10,1,9
52,540,33,10,23,0,23,0,2,15,0,0,1,0,0,0,5
52,541,124,16,108,2,106,3,31,25,8,1,2,0,9,1,26
52,542,59,8,51,0,51,0,13,15,9,1,0,0,2,2,9
52,543,417,104,313,3,310,2,108,93,13,4,5,1,16,9,59
52,544,323,57,266,3,263,6,57,48,43,3,2,1,20,10,73
52,545,95,13,82,1,81,4,12,21,9,0,0,0,18,1,16
52,546,18,3,15,0,15,0,0,8,0,0,1,0,3,2,1
52,547,169,16,153,2,151,7,32,43,17,3,0,0,9,2,38
52,548,75,13,62,4,58,0,7,21,8,1,2,2,1,0,16
52,549,34,5,29,2,27,0,13,6,1,0,0,0,3,1,3
52,550,1978,358,1620,38,1582,19,414,353,185,22,21,4,120,28,416
53,1,1341,157,1184,16,1168,39,160,353,100,18,8,4,174,26,286
53,2,337,40,297,12,285,4,46,94,26,4,1,1,31,10,68
53,3,2143,345,1798,47,1751,30,210,526,146,31,17,8,239,32,512
53,4,363,61,302,5,297,3,49,124,22,2,2,0,35,9,51
53,5,1668,267,1401,25,1376,49,202,356,166,22,10,2,188,15,366
53,6,130,20,110,0,110,0,20,34,7,0,2,2,27,3,15
53,7,1975,234,1741,42,1699,41,258,439,161,28,19,3,233,35,482
53,8,1451,261,1190,34,1156,31,170,320,115,18,8,2,162,24,306
53,9,484,81,403,4,399,5,76,132,27,1,3,1,79,8,67
53,10,285,37,248,6,242,2,76,57,20,1,1,1,27,4,53
53,11,518,58,460,10,450,3,87,137,36,3,6,3,64,11,100
53,12,381,49,332,7,325,6,51,118,23,4,3,1,43,9,67
53,13,472,67,405,14,391,6,69,85,35,10,11,0,40,6,129
53,14,2774,392,2382,79,2303,57,273,734,186,49,20,10,378,46,550
53,15,1102,146,956,27,929,16,134,228,86,18,11,1,123,15,297
53,16,959,171,788,14,774,13,143,229,60,10,9,0,112,17,181
53,17,508,89,419,10,409,13,56,139,37,8,4,3,49,10,90
53,18,908,125,783,22,761,13,131,234,52,7,9,1,131,14,169
53,19,109,18,91,1,90,3,9,46,5,0,1,0,13,2,11
53,21,626,55,571,10,561,10,85,152,53,3,6,2,75,10,165
53,22,341,29,312,5,307,6,66,101,22,4,4,0,49,1,54
53,23,327,39,288,3,285,4,48,98,22,4,2,0,36,7,64
53,25,738,109,629,13,616,14,133,214,38,5,3,1,86,16,106
53,26,344,48,296,17,279,3,41,102,17,5,0,1,48,6,56
53,27,174,35,139,4,135,2,33,40,3,0,0,0,24,6,27
53,28,380,51,329,11,318,8,60,61,40,6,4,0,40,9,90
53,29,478,67,411,6,405,6,71,143,31,8,1,0,49,16,80
53,30,254,23,231,5,226,5,50,76,20,2,1,0,34,4,34
53,31,293,34,259,7,252,9,60,71,25,5,2,0,30,7,43
53,32,128,17,111,1,110,6,31,29,11,1,0,0,11,1,20
53,33,108,31,77,2,75,0,16,22,8,2,0,0,9,0,18
53,34,4658,563,4095,100,3995,71,510,1050,327,41,16,13,639,78,1250
53,35,372,52,320,3,317,7,25,111,38,2,0,2,52,8,72
53,36,708,128,580,8,572,23,112,175,46,6,9,2,52,11,136
53,37,521,50,471,25,446,1,104,122,37,10,6,2,50,11,103
53,38,140,25,115,1,114,9,24,32,13,2,0,0,10,1,23
53,39,1286,201,1085,42,1043,31,164,305,83,15,13,4,159,31,238
53,40,404,49,355,8,347,20,63,102,32,1,4,2,57,5,61
53,41,175,20,155,0,155,4,32,50,9,2,1,1,20,9,27
53,42,593,104,489,9,480,11,95,186,25,5,2,1,70,9,76
53,43,373,43,330,9,321,0,76,99,26,2,1,0,36,4,77
53,45,508,44,464,9,455,12,90,119,42,9,1,2,48,6,126
53,46,194,28,166,5,161,2,37,50,12,1,2,0,14,5,38
53,47,218,34,184,6,178,3,24,71,7,5,1,0,38,6,23
53,48,907,134,773,21,752,23,89,253,76,8,7,3,98,21,174
53,49,429,36,393,6,387,3,72,76,36,9,5,3,46,13,124
53,50,274,54,220,8,212,10,59,65,20,1,1,0,20,4,32
53,51,415,72,343,10,333,9,67,101,28,8,2,0,39,9,70
53,52,261,65,196,0,196,4,43,59,26,3,1,1,14,2,43
53,53,430,73,357,9,348,7,64,104,38,4,1,2,56,8,64
53,54,4519,632,3887,77,3810,94,396,1099,316,32,23,6,649,60,1135
53,55,424,51,373,9,364,7,50,107,25,6,2,2,55,6,104
53,56,605,54,551,13,538,6,89,128,52,10,2,2,82,10,157
53,57,386,56,330,10,320,4,74,89,31,4,2,1,48,5,62
53,58,237,27,210,7,203,6,31,77,16,3,0,0,20,1,49
53,59,264,17,247,9,238,8,51,86,24,0,2,2,19,7,39
53,61,345,55,290,6,284,3,64,115,21,4,0,1,29,6,41
53,62,7916,1430,6486,160,6326,110,633,2224,448,74,48,16,1017,113,1643
53,63,353,62,291,4,287,4,48,87,23,6,3,0,42,6,68
53,64,744,104,640,19,621,13,120,200,34,17,7,3,76,14,137
53,65,593,64,529,15,514,7,83,161,39,10,6,2,74,7,125
53,66,953,148,805,19,786,13,125,269,56,13,10,0,132,20,148
53,67,314,70,244,10,234,7,60,68,17,4,2,1,29,8,38
53,68,140,15,125,2,123,3,14,43,7,3,0,0,15,6,32
53,69,151,25,126,2,124,1,17,39,10,0,0,0,15,13,29
53,71,348,46,302,5,297,4,37,137,7,3,3,0,51,4,51
53,72,933,104,829,22,807,24,109,201,80,11,10,1,113,26,232
53,73,689,104,585,10,575,15,103,158,49,15,4,2,69,9,151
53,74,643,50,593,14,579,9,78,175,58,8,2,4,102,15,128
53,75,216,19,197,3,194,1,26,69,16,4,4,0,25,9,40
53,76,238,24,214,3,211,2,57,70,7,4,1,0,17,11,42
53,77,2236,295,1941,49,1892,35,260,654,153,23,10,1,250,38,468
53,78,546,69,477,14,463,14,68,136,36,8,11,0,73,14,103
53,79,242,40,202,3,199,2,32,85,18,0,2,0,20,7,33
53,80,101,21,80,0,80,3,10,34,7,1,0,0,4,2,19
53,82,431,52,379,13,366,8,56,114,29,2,5,0,54,7,91
53,83,694,91,603,16,587,12,98,194,36,21,2,2,92,18,112
53,84,3718,723,2995,63,2932,54,330,1071,190,36,19,5,444,71,712
53,85,173,21,152,4,148,1,28,57,11,1,0,2,17,2,29
53,86,444,52,392,10,382,8,82,123,20,7,5,2,49,14,72
53,87,166,14,152,3,149,4,15,45,15,0,2,2,22,5,39
53,88,695,100,595,9,586,3,95,257,24,12,4,0,78,20,93
53,89,398,89,309,9,300,9,47,98,26,2,1,3,39,2,73
53,90,104,10,94,0,94,2,12,36,5,1,0,0,16,3,19
53,91,381,59,322,9,313,4,48,133,15,4,0,1,58,8,42
53,92,140,19,121,3,118,2,23,28,10,2,1,1,22,4,25
53,93,237,41,196,6,190,0,28,72,13,2,2,0,37,3,33
53,94,1679,231,1448,52,1396,32,170,402,122,20,14,3,170,33,430
53,95,171,18,153,0,153,6,24,53,7,3,0,0,24,5,31
53,96,4252,675,3577,98,3479,66,495,1233,198,42,27,6,458,73,881
53,97,5339,1086,4253,113,4140,53,679,1301,293,54,38,5,520,77,1120
53,98,310,65,245,6,239,9,40,106,6,5,1,0,35,6,31
53,99,828,122,706,18,688,11,73,206,54,8,2,2,121,9,202
53,100,1048,186,862,35,827,8,155,340,37,3,7,2,100,24,151
53,101,608,72,536,17,519,13,93,186,27,6,6,0,84,10,94
53,102,129,21,108,2,106,2,26,39,7,2,0,0,16,6,8
53,103,1540,182,1358,32,1326,37,227,296,152,24,15,2,177,26,370
53,104,733,97,636,15,621,8,126,196,43,11,6,2,94,10,125
53,105,166,12,154,2,152,5,30,41,14,0,0,1,22,5,34
53,106,389,63,326,3,323,9,80,94,26,3,1,2,42,13,53
53,107,2115,379,1736,42,1694,19,239,649,125,30,13,2,218,33,366
53,108,340,41,299,9,290,7,79,86,20,3,3,0,39,7,46
53,109,417,42,375,9,366,16,71,92,32,8,6,0,50,5,86
53,110,769,175,594,11,583,14,113,183,49,5,7,1,70,17,124
53,111,364,43,321,11,310,11,31,99,32,7,3,2,41,11,73
53,112,300,48,252,14,238,2,42,88,18,2,4,1,35,7,39
53,113,445,51,394,10,384,16,52,133,44,16,4,3,62,8,46
53,114,167,34,133,3,130,1,38,42,9,5,1,0,8,2,24
53,115,268,40,228,6,222,6,33,79,7,1,2,1,34,7,52
53,116,585,74,511,4,507,12,77,224,20,9,1,2,91,10,61
53,117,323,34,289,8,281,5,37,85,23,7,1,0,55,1,67
53,118,185,24,161,7,154,2,29,53,9,6,1,0,25,3,26
53,119,3227,399,2828,77,2751,59,304,718,244,52,19,4,374,64,913
53,120,374,60,314,11,303,9,56,117,14,2,2,0,48,13,42
53,121,1077,182,895,12,883,14,162,349,58,8,8,1,121,18,144
53,122,544,76,468,26,442,12,70,154,43,5,2,0,46,11,99
53,123,1051,148,903,23,880,8,133,332,47,15,9,4,135,19,178
53,124,595,89,506,18,488,5,48,191,39,10,2,2,87,12,92
53,125,919,166,753,26,727,7,108,295,49,11,2,1,99,19,136
53,126,795,87,708,25,683,7,113,284,32,3,10,3,106,19,106
53,127,1753,245,1508,30,1478,25,204,559,92,15,6,6,216,26,329
53,128,229,29,200,2,198,3,29,84,8,2,2,0,29,5,36
53,129,280,25,255,9,246,12,43,71,19,6,0,1,30,10,54
53,130,32407,6162,26245,566,25679,731,2787,6920,2507,274,145,39,3268,425,8583
53,131,153,22,131,2,129,2,22,32,9,6,1,0,26,6,25
53,132,254,49,205,8,197,2,24,74,18,4,0,0,36,2,37
53,133,608,113,495,9,486,13,121,166,41,3,2,0,42,13,85
53,134,117,9,108,2,106,2,26,35,5,0,0,0,11,2,25
53,135,607,82,525,18,507,14,81,187,28,9,0,1,82,15,90
53,136,597,58,539,18,521,14,55,172,54,10,1,3,89,8,115
53,137,1108,149,959,25,934,16,185,261,87,18,6,0,118,29,214
53,138,244,38,206,4,202,13,34,40,27,4,5,0,28,2,49
53,139,321,55,266,5,261,8,54,70,26,2,1,0,37,6,57
53,140,2953,369,2584,68,2516,43,313,601,249,26,12,2,428,57,785
53,141,692,76,616,16,600,14,102,153,60,11,6,1,66,11,176
53,142,262,46,216,6,210,2,52,76,8,0,0,0,31,4,37
53,143,369,35,334,11,323,7,68,77,31,3,0,2,58,12,65
53,144,574,86,488,14,474,9,105,115,48,8,4,1,81,11,92
53,145,373,57,316,4,312,5,58,143,12,2,2,0,41,8,41
53,146,1200,125,1075,34,1041,12,176,316,86,17,8,3,151,27,245
53,147,9678,1849,7829,223,7606,172,1034,1883,710,91,66,21,854,143,2632
53,148,136,13,123,5,118,1,23,50,9,2,0,1,17,3,12
53,150,720,95,625,9,616,12,87,175,64,5,2,0,101,14,156
53,151,723,112,611,11,600,18,80,243,48,3,2,0,83,16,107
53,152,2027,352,1675,47,1628,15,233,656,110,20,6,2,205,29,352
53,153,482,58,424,8,416,5,81,89,41,4,9,3,64,8,112
53,154,688,97,591,19,572,19,82,239,29,5,6,1,77,16,98
53,155,1119,166,953,23,930,17,162,286,65,22,7,2,109,17,243
53,156,153,14,139,3,136,9,16,27,24,3,2,0,9,0,46
53,157,1007,99,908,25,883,16,102,253,78,9,14,3,132,26,250
53,158,721,93,628,17,611,16,94,193,49,11,7,2,95,12,132
53,159,232,30,202,7,195,4,27,64,17,1,1,0,26,0,55
53,160,299,38,261,11,250,7,50,64,26,5,3,0,48,11,36
53,161,1559,272,1287,33,1254,22,207,402,113,8,13,4,149,12,324
53,162,739,82,657,17,640,10,76,197,62,7,3,2,90,25,168
53,163,477,53,424,15,409,3,101,81,46,4,8,2,42,14,108
53,164,292,46,246,2,244,4,56,94,9,2,1,0,36,9,33
53,165,255,39,216,9,207,6,28,54,18,6,4,0,25,8,58
53,168,845,84,761,21,740,12,98,218,73,9,6,3,105,12,204
53,169,303,40,263,5,258,11,45,67,31,6,1,0,21,6,70
53,170,902,176,726,37,689,12,111,217,57,8,9,1,82,16,176
53,172,276,27,249,7,242,12,38,56,24,3,0,1,34,4,70
53,173,127,14,113,3,110,2,19,47,7,2,0,0,10,6,17
53,174,571,57,514,16,498,5,74,119,44,4,4,0,70,20,158
53,175,953,137,816,15,801,17,102,252,52,9,5,3,114,15,232
53,176,388,83,305,3,302,4,61,117,18,4,5,1,47,11,34
53,177,247,27,220,6,214,5,41,76,10,3,0,0,33,9,37
53,178,160,12,148,4,144,2,22,70,12,2,2,0,19,1,14
53,179,252,33,219,3,216,3,27,91,17,1,2,0,28,3,44
53,180,526,67,459,10,449,22,60,130,32,4,5,5,67,12,112
53,181,675,108,567,30,537,10,73,214,31,6,10,2,76,22,93
53,182,1302,225,1077,33,1044,14,194,220,114,26,18,4,77,26,351
53,184,123,12,111,0,111,2,14,41,13,2,1,0,16,0,22
53,185,1540,291,1249,27,1222,25,238,373,85,18,18,3,165,40,257
53,186,1488,218,1270,36,1234,21,151,484,94,22,4,6,193,32,227
53,187,167,14,153,6,147,4,27,40,21,1,1,0,5,3,45
53,188,1924,350,1574,39,1535,14,205,446,129,18,11,1,174,26,511
53,189,94,20,74,0,74,1,16,37,4,0,0,1,12,0,3
53,190,331,53,278,9,269,2,46,118,9,6,5,0,32,8,43
53,191,172,27,145,1,144,2,27,51,8,4,0,0,17,6,29
53,192,231,43,188,3,185,2,50,59,9,4,2,0,26,2,31
53,193,371,51,320,9,311,12,76,77,33,5,3,1,36,6,62
53,194,659,84,575,11,564,12,90,188,45,9,1,2,76,10,131
53,195,302,47,255,7,248,9,36,57,24,4,0,1,44,6,67
53,196,285,36,249,8,241,0,58,104,13,2,0,0,30,5,29
53,197,693,118,575,17,558,4,61,237,34,3,5,2,66,13,133
53,198,199,32,167,3,164,5,26,52,9,4,3,0,19,9,37
53,199,196,52,144,3,141,1,19,56,6,1,1,0,32,3,22
53,200,859,97,762,17,745,15,86,181,73,19,3,2,107,20,239
53,201,5481,711,4770,104,4666,91,514,1321,391,43,38,9,658,99,1502
53,202,267,44,223,7,216,5,22,79,11,3,1,1,48,4,42
53,203,381,53,328,3,325,7,64,91,33,5,1,1,38,6,79
53,204,275,56,219,5,214,5,41,73,17,3,1,1,36,3,34
53,205,390,49,341,5,336,6,87,71,26,5,2,1,45,14,79
53,206,177,27,150,3,147,3,24,45,17,5,5,0,15,1,32
53,207,561,97,464,8,456,2,111,123,56,3,7,3,52,12,87
53,208,384,81,303,7,296,7,69,88,18,6,2,1,46,4,55
53,209,403,58,345,10,335,8,47,141,12,4,3,1,48,11,60
53,210,1123,151,972,31,941,21,196,369,74,9,8,2,100,20,142
53,211,1179,172,1007,33,974,21,142,347,64,12,11,3,172,23,179
53,212,298,36,262,5,257,3,44,87,21,4,2,1,44,9,42
53,213,406,56,350,8,342,6,61,116,19,5,4,2,45,13,71
53,214,111,14,97,3,94,2,15,25,11,2,1,0,25,2,11
53,215,1293,163,1130,24,1106,15,109,401,76,9,7,1,195,25,268
53,216,678,99,579,8,571,14,115,135,47,5,4,1,78,17,155
53,218,670,130,540,22,518,20,95,141,47,6,8,1,65,15,120
53,219,1128,161,967,30,937,24,132,280,85,12,16,6,134,24,224
53,220,239,31,208,3,205,3,44,53,20,3,3,0,23,0,56
53,221,291,52,239,8,231,4,53,80,21,4,1,1,24,2,41
53,222,258,23,235,7,228,8,21,78,16,6,7,2,41,6,43
53,223,304,44,260,4,256,4,62,102,8,5,3,0,30,6,36
53,224,685,45,640,25,615,11,94,177,61,8,4,3,87,9,161
53,225,327,39,288,5,283,8,49,92,40,8,0,2,19,5,60
53,226,572,94,478,18,460,13,78,158,41,3,2,0,56,9,100
53,228,333,62,271,8,263,5,53,106,17,1,3,0,39,2,37
53,229,1078,91,987,26,961,40,123,229,95,15,4,0,128,30,297
53,230,201,35,166,2,164,2,46,61,6,4,1,0,12,5,27
53,231,156,23,133,3,130,0,32,38,8,4,2,1,17,1,27
53,232,244,48,196,7,189,5,68,30,21,2,2,0,20,3,38
53,233,256,41,215,3,212,2,50,53,31,2,3,0,17,8,46
53,234,262,31,231,5,226,4,31,59,25,5,7,1,33,5,56
53,235,171,21,150,5,145,6,33,56,19,0,0,0,13,1,17
53,236,132,30,102,2,100,0,18,33,10,2,0,0,12,0,25
53,237,332,52,280,9,271,1,43,98,26,5,3,1,32,7,55
53,238,474,74,400,7,393,6,58,112,29,7,6,5,68,11,91
53,239,347,70,277,8,269,3,46,98,27,5,3,0,29,9,49
53,240,383,65,318,6,312,6,38,83,32,4,1,1,61,6,80
53,241,123,19,104,0,104,1,16,42,12,0,0,0,15,0,18
53,242,175,30,145,9,136,2,25,40,5,2,1,1,29,5,26
53,243,1183,154,1029,30,999,26,149,308,98,12,8,4,128,23,243
53,244,160,19,141,3,138,2,25,46,11,1,2,0,18,3,30
53,245,734,104,630,21,609,9,99,220,34,7,7,2,106,21,104
53,246,1482,229,1253,46,1207,26,212,335,135,20,9,4,165,25,276
53,247,1493,216,1277,30,1247,22,277,361,97,18,9,6,132,21,304
53,248,102,17,85,0,85,3,8,22,8,1,1,0,20,0,22
53,249,409,62,347,6,341,10,78,105,24,5,2,2,47,6,62
53,250,304,50,254,8,246,6,36,101,12,1,2,0,38,5,45
53,251,293,25,268,1,267,11,42,72,20,3,3,0,51,3,62
53,252,322,56,266,11,255,5,54,74,22,3,5,0,37,5,50
53,253,333,46,287,3,284,3,35,92,24,7,2,0,39,9,73
53,254,161,11,150,0,150,8,19,54,5,5,0,0,24,6,29
53,255,755,105,650,11,639,5,112,205,51,9,3,0,88,10,156
53,256,171,26,145,1,144,2,26,47,13,2,0,1,25,2,26
53,257,223,47,176,4,172,4,37,63,10,2,1,1,27,4,23
53,258,628,123,505,15,490,5,68,189,24,6,8,2,76,9,103
53,259,235,34,201,3,198,1,35,101,7,1,2,0,30,3,18
53,260,261,27,234,9,225,3,43,88,21,5,0,1,34,12,18
53,261,127,23,104,1,103,0,25,38,10,0,1,0,15,1,13
53,262,762,92,670,17,653,11,128,212,49,5,2,1,95,10,140
53,263,229,37,192,8,184,3,37,57,20,1,1,1,28,6,30
53,264,128,21,107,1,106,3,18,33,12,2,0,0,17,5,16
53,265,552,97,455,11,444,15,88,142,45,4,4,0,51,6,89
53,266,185,34,151,5,146,2,17,72,13,2,3,2,19,0,16
53,267,796,127,669,20,649,6,160,216,44,8,3,0,88,15,109
53,269,443,55,388,11,377,6,88,99,25,3,3,2,67,9,75
53,270,107,15,92,2,90,0,9,48,2,1,0,0,17,0,13
53,271,2267,447,1820,56,1764,30,269,523,135,17,17,3,229,30,511
53,272,155,31,124,5,119,0,25,38,10,4,1,1,14,7,19
53,273,745,96,649,20,629,15,85,204,61,4,2,1,93,16,148
53,274,204,36,168,6,162,3,40,46,15,0,2,0,26,8,22
53,276,693,102,591,13,578,10,134,117,55,8,2,1,44,14,193
54,1,253,33,220,3,217,4,69,48,25,3,0,1,9,3,55
54,2,190,16,174,4,170,1,30,37,32,3,0,0,21,2,44
54,3,106,17,89,0,89,0,30,30,7,2,2,1,9,3,5
54,4,160,26,134,0,134,1,30,35,19,5,4,0,8,5,27
54,5,99,12,87,0,87,0,19,34,3,3,0,0,7,2,19
54,6,356,46,310,3,307,5,51,106,26,3,4,1,31,7,73
54,7,488,95,393,5,388,11,104,109,27,3,4,3,21,9,97
54,8,319,28,291,5,286,2,97,41,20,4,5,1,32,7,77
54,9,117,28,89,2,87,0,26,23,11,0,0,0,11,0,16
54,10,393,59,334,2,332,3,68,88,34,5,4,0,21,9,100
54,11,360,77,283,6,277,2,51,115,24,1,2,0,15,4,63
54,12,264,27,237,2,235,14,24,68,28,1,0,0,23,10,67
54,13,77,10,67,1,66,0,23,23,4,0,1,1,5,2,7
54,14,228,34,194,7,187,2,39,56,19,3,1,4,16,3,44
54,15,197,36,161,2,159,4,56,29,12,6,3,1,14,1,33
54,16,211,39,172,1,171,4,62,48,6,1,0,0,19,3,28
54,17,73,6,67,1,66,3,9,24,8,1,0,1,3,7,10
54,18,231,41,190,3,187,7,37,49,48,1,1,1,11,1,31
54,19,78,12,66,2,64,0,14,28,5,1,0,0,7,3,6
54,20,307,41,266,4,262,7,53,91,23,3,1,0,30,3,51
54,21,178,23,155,2,153,1,43,31,23,5,2,0,13,5,30
54,22,466,64,402,7,395,10,102,73,39,3,2,0,36,9,121
54,23,195,30,165,1,164,1,34,56,4,1,2,0,25,10,31
54,24,242,32,210,2,208,2,44,38,36,3,2,1,26,3,53
54,25,849,97,752,10,742,17,174,223,50,3,6,2,62,23,182
54,26,158,30,128,6,122,3,35,36,3,0,3,0,18,1,23
54,27,591,107,484,12,472,11,142,136,34,2,1,3,46,13,84
54,28,1879,427,1452,24,1428,16,255,147,368,16,9,1,60,18,538
54,29,1789,438,1351,19,1332,6,320,270,220,25,11,2,116,36,326
54,30,90,12,78,2,76,1,20,24,5,1,1,0,13,1,10
54,31,200,20,180,5,175,2,37,45,12,1,3,2,9,3,61
54,32,155,20,135,1,134,1,34,50,3,4,0,1,17,2,22
54,33,66,8,58,0,58,0,27,24,4,0,0,0,1,1,1
54,34,180,22,158,1,157,7,34,45,17,1,0,0,19,5,29
54,35,305,55,250,5,245,0,69,78,15,4,1,2,19,4,53
54,36,696,104,592,8,584,7,152,129,86,10,6,1,54,6,133
54,37,317,41,276,1,275,2,66,74,21,2,0,0,31,6,73
54,38,649,123,526,9,517,12,142,142,48,7,4,2,44,12,104
54,39,3094,676,2418,34,2384,29,696,569,189,30,16,7,196,53,599
54,40,1133,220,913,21,892,11,240,198,115,25,9,1,74,18,201
54,41,105,8,97,2,95,4,21,36,4,3,3,1,5,3,15
54,42,254,35,219,6,213,2,54,50,16,1,1,0,19,4,66
54,43,907,150,757,15,742,16,154,169,77,22,4,1,82,25,192
54,44,128,13,115,1,114,1,42,34,4,0,0,0,16,8,9
54,45,334,50,284,4,280,1,86,93,17,2,0,2,23,6,50
54,46,280,48,232,6,226,2,80,72,15,0,1,0,12,5,39
54,47,160,17,143,5,138,1,34,39,14,2,1,0,16,2,29
54,48,324,44,280,6,274,2,70,57,37,2,3,2,38,6,57
54,49,400,84,316,4,312,2,94,82,38,8,0,0,22,5,61
54,50,69,6,63,2,61,1,26,24,1,0,1,0,3,0,5
54,51,979,142,837,13,824,13,189,165,117,20,6,2,54,13,245
54,52,90,6,84,1,83,1,17,20,10,3,1,0,6,3,22
54,53,105,18,87,1,86,3,22,27,5,1,0,1,9,6,12
54,54,961,126,835,15,820,10,149,234,77,20,8,1,93,20,208
54,55,250,43,207,3,204,5,61,36,18,6,2,3,15,2,56
54,56,138,25,113,1,112,0,41,28,11,2,2,0,7,2,19
54,57,63,11,52,2,50,0,22,11,3,1,1,0,3,3,6
54,58,83,14,69,0,69,0,15,30,2,3,0,0,5,3,11
54,59,518,68,450,5,445,8,124,98,43,5,4,3,47,8,105
54,60,1029,198,831,14,817,5,214,191,71,10,9,3,63,15,236
54,61,402,56,346,7,339,11,107,68,23,2,2,2,29,11,84
54,62,487,62,425,10,415,9,96,132,27,7,2,0,41,8,93
54,63,161,18,143,2,141,3,36,60,7,1,0,0,13,0,21
54,64,276,46,230,3,227,4,64,48,17,2,2,1,13,7,69
54,65,910,146,764,14,750,2,297,172,68,20,6,0,45,16,124
54,66,237,32,205,1,204,2,54,36,37,3,0,0,6,0,66
54,67,472,79,393,4,389,8,82,105,67,6,1,1,28,6,85
54,68,107,24,83,0,83,0,30,27,3,0,0,0,10,0,13
54,69,277,46,231,4,227,4,64,76,14,3,2,0,18,3,43
54,70,119,14,105,2,103,2,32,33,8,3,1,0,5,4,15
54,71,149,24,125,2,123,0,35,45,6,0,0,1,11,1,24
54,72,178,24,154,2,152,2,48,27,28,0,2,0,10,2,33
54,73,712,107,605,13,592,7,177,171,45,11,1,1,45,14,120
54,74,24,5,19,0,19,1,6,3,3,0,0,0,2,2,2
54,75,118,16,102,1,101,8,14,21,12,3,0,0,13,8,22
54,76,3109,724,2385,44,2341,32,548,430,296,49,16,3,173,54,740
54,77,740,165,575,12,563,7,152,134,48,7,9,2,64,11,129
54,78,58,5,53,1,52,0,19,18,4,1,0,0,6,0,4
54,79,3209,727,2482,33,2449,22,682,494,311,25,11,5,173,41,685
54,80,768,134,634,11,623,3,207,143,57,8,7,0,48,12,138
54,81,362,75,287,6,281,7,67,69,38,3,8,0,13,5,71
54,82,164,16,148,1,147,1,35,40,19,6,2,0,11,6,27
54,83,145,28,117,2,115,2,20,31,9,4,1,0,8,5,35
54,84,658,133,525,9,516,6,142,108,79,15,5,1,23,6,131
54,85,80,13,67,1,66,1,25,16,5,0,0,0,9,1,9
54,86,297,52,245,8,237,3,65,81,24,4,1,1,30,2,26
54,87,95,8,87,2,85,4,19,15,7,1,0,0,6,2,31
54,88,158,12,146,2,144,6,35,46,5,1,1,0,9,5,36
54,89,1132,161,971,14,957,19,192,305,86,11,6,4,94,18,222
54,90,3170,496,2674,33,2641,51,548,640,276,30,14,9,241,49,783
54,91,196,27,169,0,169,1,55,56,12,2,0,0,22,2,19
54,92,57,11,46,0,46,0,7,9,5,3,0,0,5,1,16
54,93,134,17,117,0,117,3,32,34,16,0,1,0,12,3,16
54,94,147,10,137,2,135,2,33,49,3,2,2,0,13,6,25
54,95,28,3,25,1,24,0,5,8,2,2,0,0,3,1,3
54,96,240,39,201,1,200,3,56,50,24,2,1,0,26,1,37
54,97,126,5,121,24,97,0,30,21,8,1,0,0,12,5,20
54,98,135,14,121,2,119,4,22,29,10,1,1,0,15,5,32
54,99,3889,929,2960,45,2915,41,594,619,415,33,18,4,253,55,883
54,100,550,80,470,8,462,10,133,107,45,5,2,1,43,9,107
54,101,111,20,91,1,90,1,32,30,3,1,1,0,8,1,13
54,102,465,65,400,7,393,4,83,149,25,3,5,0,57,11,56
54,103,180,25,155,1,154,0,26,61,12,2,1,1,17,3,31
54,104,187,28,159,7,152,1,36,49,14,0,1,0,12,9,30
54,105,377,37,340,4,336,8,47,93,25,1,2,0,42,6,112
54,106,57,7,50,0,50,1,13,19,4,0,0,0,3,3,7
54,107,49,6,43,2,41,0,15,10,2,1,2,1,4,1,5
54,108,91,8,83,1,82,1,8,29,10,1,0,1,12,0,20
54,109,603,46,557,11,546,8,129,131,60,2,3,0,48,14,151
54,110,448,41,407,7,400,5,91,119,37,5,2,2,38,13,88
54,111,2245,400,1845,29,1816,28,450,328,224,31,15,7,129,30,574
54,112,445,74,371,5,366,2,128,109,25,5,2,0,29,7,59
54,113,872,107,765,11,754,15,145,230,58,11,5,2,86,21,181
54,114,271,34,237,2,235,3,78,53,25,6,4,2,16,6,42
54,115,4875,968,3907,58,3849,60,877,775,439,59,31,16,307,72,1213
54,116,1531,222,1309,14,1295,18,307,377,107,9,8,9,110,24,326
54,117,95,13,82,2,80,0,17,23,12,0,0,0,6,1,21
54,118,390,95,295,7,288,2,90,90,22,0,4,1,19,1,59
54,119,55,3,52,2,50,0,8,19,5,1,1,0,3,2,11
54,120,283,53,230,3,227,2,61,53,28,5,4,0,27,3,44
54,121,161,8,153,4,149,7,33,29,17,1,1,0,11,6,44
54,122,558,70,488,8,480,15,119,107,37,7,5,2,46,17,125
54,123,1257,177,1080,12,1068,22,227,248,120,19,7,2,82,10,331
54,124,36,1,35,3,32,1,13,10,0,0,0,0,3,0,5
54,125,351,41,310,4,306,0,105,74,22,8,2,0,16,4,75
54,126,186,28,158,1,157,3,38,43,22,1,4,2,11,2,31
54,127,495,66,429,3,426,2,84,135,75,3,1,0,38,11,77
54,128,587,109,478,8,470,6,154,143,33,6,2,0,35,8,83
54,129,1263,304,959,17,942,13,261,273,80,16,7,0,79,32,181
54,130,159,15,144,1,143,1,34,52,11,5,0,0,16,1,23
54,131,377,42,335,10,325,10,80,81,23,2,1,3,37,7,81
54,132,61,8,53,1,52,0,8,17,12,0,0,0,2,1,12
54,133,116,16,100,2,98,1,27,42,1,0,2,0,7,2,16
54,134,203,44,159,1,158,1,47,47,20,3,2,0,11,1,26
54,135,938,109,829,19,810,9,292,193,59,12,9,2,74,10,150
54,136,1829,309,1520,35,1485,22,288,262,304,21,15,3,100,21,449
54,137,459,99,360,5,355,4,82,87,53,6,4,0,22,13,84
54,138,1779,267,1512,28,1484,22,323,445,159,16,3,2,139,27,348
54,139,179,9,170,2,168,3,32,59,11,1,2,0,29,4,27
54,140,83,12,71,1,70,1,14,31,2,0,0,2,2,2,16
54,141,111,8,103,0,103,0,17,35,7,3,0,0,12,0,29
54,142,116,26,90,1,89,3,20,25,3,0,0,0,16,2,20
54,143,272,38,234,6,228,7,67,60,20,3,0,1,24,2,44
54,144,325,35,290,6,284,1,86,51,21,6,1,0,25,10,83
54,145,705,110,595,12,583,8,135,130,57,7,8,1,55,11,171
54,146,226,31,195,1,194,3,47,38,28,3,0,1,8,7,59
54,147,94,9,85,4,81,1,18,28,6,1,1,0,4,2,20
54,148,512,74,438,6,432,6,140,85,31,7,1,0,42,10,110
54,149,1194,287,907,15,892,9,166,110,269,16,6,0,45,18,253
54,150,2214,397,1817,24,1793,15,476,380,210,32,9,9,148,44,470
54,151,733,130,603,13,590,14,104,167,76,5,5,2,47,10,160
54,152,2423,360,2063,32,2031,23,499,326,370,40,17,7,143,42,564
54,153,58,6,52,1,51,2,16,10,8,1,0,0,9,1,4
54,154,425,67,358,6,352,2,111,96,21,4,4,0,25,11,78
54,155,276,32,244,2,242,3,69,60,19,6,1,1,31,2,50
54,156,404,66,338,7,331,5,75,103,40,2,2,1,31,5,67
54,157,3603,854,2749,31,2718,23,779,499,288,36,23,12,211,58,789
54,158,85,5,80,0,80,1,25,14,10,2,0,0,6,1,21
54,159,7334,1637,5697,90,5607,69,1581,1149,578,93,51,13,411,91,1571
54,160,274,32,242,5,237,5,64,55,29,4,1,0,23,7,49
54,161,234,41,193,2,191,0,48,82,14,2,0,0,13,1,31
54,162,951,159,792,11,781,20,199,199,72,10,1,2,82,21,175
54,163,210,38,172,5,167,3,50,58,16,0,3,2,7,8,20
54,164,68,12,56,3,53,3,5,21,3,3,0,0,3,4,11
54,165,557,80,477,5,472,4,51,228,30,2,1,0,55,8,93
54,166,30,2,28,0,28,1,12,9,1,0,1,0,1,1,2
54,167,1429,208,1221,24,1197,14,282,381,85,8,13,6,123,25,260
54,168,241,32,209,3,206,6,38,51,34,2,0,0,16,4,55
54,169,57,12,45,0,45,1,11,13,5,0,0,0,5,2,8
54,170,55,6,49,1,48,0,15,6,10,0,1,0,3,0,13
54,171,882,149,733,16,717,11,147,164,90,7,9,2,65,19,203
54,172,188,27,161,3,158,2,30,41,23,0,1,1,13,3,44
54,173,120,9,111,0,111,6,19,42,7,1,2,0,9,1,24
54,174,2651,442,2209,34,2175,27,569,596,209,38,9,6,167,47,507
54,175,258,51,207,2,205,3,62,35,24,7,1,1,20,4,48
54,176,925,109,816,19,797,5,228,165,76,17,4,2,75,21,204
54,177,191,26,165,2,163,1,58,36,16,4,1,1,9,10,27
54,178,96,12,84,1,83,1,20,40,2,3,1,0,6,0,10
54,179,234,35,199,4,195,2,42,62,17,4,3,0,29,5,31
54,180,68,5,63,1,62,1,14,21,3,0,0,0,9,2,12
54,181,487,91,396,5,391,6,81,50,86,6,5,4,27,8,118
54,182,253,32,221,3,218,1,59,84,19,4,5,2,18,0,26
54,183,81,8,73,0,73,1,20,31,1,0,1,1,11,0,7
54,184,6018,1306,4712,64,4648,79,851,1261,448,42,18,12,487,81,1369
54,185,50,6,44,0,44,4,9,9,6,1,0,0,3,1,11
54,186,784,84,700,10,690,18,121,171,94,4,3,5,85,13,176
54,187,82,12,70,1,69,1,23,19,7,1,0,0,9,0,9
54,188,899,146,753,12,741,10,198,156,78,12,4,0,83,14,186
54,189,450,98,352,6,346,7,93,86,33,4,3,3,32,9,76
54,190,87,11,76,1,75,0,19,28,4,0,0,0,13,1,10
54,191,118,23,95,0,95,0,27,39,5,1,0,1,7,2,13
54,192,206,21,185,3,182,4,38,78,15,1,1,0,11,4,30
54,193,58,3,55,0,55,1,18,14,4,0,1,0,4,2,11
54,194,346,44,302,9,293,5,62,94,42,5,0,0,25,6,54
54,195,155,6,149,1,148,3,43,25,19,0,0,1,13,4,40
54,196,1080,162,918,9,909,19,185,230,88,17,7,0,105,17,241
54,197,1960,255,1705,23,1682,16,278,480,170,17,12,5,208,41,455
54,198,230,47,183,2,181,4,42,40,27,4,1,0,11,1,51
54,199,292,53,239,7,232,6,67,64,14,3,3,0,30,4,41
54,200,142,26,116,0,116,1,32,49,7,1,0,3,10,2,11
54,201,256,25,231,6,225,6,71,80,8,6,0,0,19,6,29
54,202,244,25,219,3,216,3,26,95,16,1,0,2,28,5,40
54,203,128,12,116,3,113,6,20,45,8,1,1,0,13,2,17
54,204,89,12,77,0,77,3,16,25,11,1,0,0,6,5,10
54,205,2083,489,1594,20,1574,18,417,344,220,28,10,4,101,27,405
54,206,272,20,252,3,249,1,56,98,25,0,1,0,16,4,48
54,207,95,16,79,4,75,2,13,24,9,0,1,1,10,3,12
54,208,262,44,218,1,217,4,66,63,23,2,1,1,16,7,34
54,209,42,7,35,0,35,2,7,7,3,0,0,0,5,1,10
54,210,154,11,143,3,140,6,38,30,10,2,1,1,11,9,32
54,211,160,10,150,4,146,1,26,59,10,6,2,0,14,7,21
54,212,295,41,254,5,249,3,64,75,36,3,0,0,13,5,50
54,213,307,47,260,1,259,2,72,38,43,1,1,1,22,12,67
54,214,486,51,435,5,430,8,122,113,34,4,2,0,47,9,91
54,215,5057,1194,3863,59,3804,52,861,738,493,35,35,8,264,68,1250
54,216,109,12,97,4,93,5,17,23,8,2,2,0,6,2,28
54,217,132,15,117,1,116,1,42,37,8,0,1,0,7,3,17
54,218,62,10,52,1,51,4,9,22,4,2,0,1,0,0,9
54,219,42,3,39,1,38,0,8,16,5,0,1,0,4,1,3
54,220,68,15,53,0,53,2,16,15,0,0,0,0,3,3,14
54,221,178,25,153,4,149,1,44,38,13,3,1,0,15,3,31
54,222,923,144,779,9,770,4,213,207,54,9,6,2,58,13,204
54,223,161,16,145,1,144,2,49,43,7,1,0,2,10,1,29
54,224,87,21,66,0,66,0,9,28,6,0,1,1,10,2,9
54,225,139,12,127,1,126,0,23,35,16,0,1,0,12,1,38
54,226,104,11,93,1,92,1,31,26,5,1,0,0,9,3,16
54,227,933,156,777,11,766,8,194,93,129,10,3,2,75,15,237
54,228,49,7,42,0,42,0,13,7,0,0,0,0,7,4,11
54,229,287,37,250,2,248,1,77,82,14,4,2,0,19,3,46
54,230,47,5,42,1,41,0,7,14,2,1,0,0,5,0,12
54,231,120,17,103,1,102,4,30,29,12,1,0,0,10,4,12
54,232,2008,257,1751,40,1711,18,363,553,143,18,9,5,175,32,395
54,233,32,0,32,3,29,0,1,15,2,2,0,0,8,0,1
54,234,1537,365,1172,21,1151,13,293,265,146,18,15,1,82,17,301
54,235,308,32,276,2,274,2,75,68,20,4,1,0,37,9,58
54,236,258,39,219,2,217,2,50,86,16,2,0,0,21,4,36
54,237,78,9,69,3,66,2,25,14,3,0,0,1,10,0,11
54,238,202,37,165,5,160,4,34,36,19,6,3,0,18,6,34
54,239,94,11,83,1,82,1,36,32,3,0,0,0,2,0,8
54,240,56,9,47,1,46,3,13,14,6,1,0,0,4,0,5
54,241,67,8,59,1,58,0,12,21,4,3,0,0,5,3,10
54,242,158,13,145,3,142,2,36,42,17,3,0,0,18,3,21
54,243,153,25,128,4,124,2,39,32,5,5,4,0,14,2,21
54,244,88,11,77,0,77,2,24,14,15,0,1,0,3,1,17
54,245,33,1,32,0,32,0,4,17,7,0,0,0,3,0,1
54,246,64,5,59,1,58,1,17,9,11,1,0,0,10,2,7
54,247,144,18,126,4,122,3,24,47,9,2,2,1,10,3,21
54,248,89,16,73,2,71,2,17,20,7,1,0,1,4,0,19
54,249,220,46,174,3,171,0,48,68,15,3,4,0,12,0,21
54,250,560,87,473,9,464,14,124,125,34,5,1,1,29,14,117
54,251,106,22,84,4,80,0,20,26,7,2,0,0,9,6,10
54,252,241,27,214,3,211,6,41,63,17,3,0,0,21,5,55
54,253,548,80,468,6,462,6,119,64,74,6,2,3,37,9,142
54,254,2041,447,1594,27,1567,23,298,282,347,12,5,2,73,18,507
54,255,75,7,68,1,67,0,16,18,14,0,1,0,8,3,7
54,256,232,34,198,4,194,5,53,37,25,2,1,0,27,2,42
54,257,4880,885,3995,57,3938,76,691,1121,330,41,18,13,464,76,1108
54,258,122,13,109,2,107,1,32,31,5,1,2,0,11,0,24
54,259,181,18,163,1,162,1,47,48,9,2,0,1,20,6,28
54,260,672,86,586,9,577,9,137,142,45,7,5,1,71,15,145
54,261,2531,754,1777,26,1751,21,362,325,363,31,8,5,84,25,527
54,262,129,16,113,1,112,2,32,33,9,3,1,0,8,3,21
54,263,4200,913,3287,36,3251,33,662,335,839,49,26,5,111,39,1152
54,264,193,33,160,1,159,5,35,45,21,1,0,0,18,5,29
54,265,2004,346,1658,26,1632,24,258,459,104,14,8,3,204,38,520
54,266,325,38,287,4,283,8,82,37,31,1,1,1,32,14,76
54,268,134,20,114,4,110,0,20,36,10,0,0,0,13,6,25
54,269,289,37,252,2,250,3,54,80,23,2,1,5,25,1,56
54,270,2392,443,1949,34,1915,24,390,278,530,32,14,5,93,41,508
54,271,110,13,97,0,97,1,17,34,9,1,2,0,9,2,22
54,272,301,32,269,4,265,5,93,65,18,4,2,0,13,9,56
54,273,6510,1521,4989,85,4904,49,909,835,1055,73,34,5,332,67,1545
54,274,5558,1305,4253,78,4175,79,800,989,438,46,23,12,398,66,1324
54,275,167,18,149,6,143,4,52,31,11,0,1,0,7,4,33
54,276,555,96,459,5,454,4,153,84,43,6,4,0,35,13,112
54,277,346,86,260,2,258,1,56,46,44,3,2,0,22,7,77
54,278,65,15,50,0,50,0,12,14,2,2,0,0,4,2,14
54,279,744,120,624,10,614,11,207,125,59,13,4,2,47,9,137
54,280,4396,1141,3255,59,3196,32,698,466,689,51,29,6,134,38,1053
54,281,692,88,604,8,596,8,160,159,54,7,4,2,63,13,126
54,282,94,17,77,2,75,0,19,22,9,1,0,0,4,6,14
54,283,250,49,201,4,197,2,45,33,49,0,4,1,7,4,52
54,284,872,215,657,10,647,7,135,101,165,12,4,3,22,9,189
54,285,52,2,50,1,49,2,19,5,3,0,1,0,3,0,16
54,286,1220,222,998,12,986,12,235,166,162,17,5,2,61,5,321
54,287,196,31,165,3,162,4,66,40,12,0,0,1,11,4,24
54,288,379,55,324,6,318,12,86,86,22,5,4,0,28,10,65
54,289,310,48,262,3,259,8,54,72,25,0,2,2,36,5,55
54,290,161,35,126,4,122,4,28,33,7,2,0,2,9,1,36
54,291,209,31,178,4,174,2,38,57,15,4,0,1,23,11,23
54,292,162,12,150,2,148,1,43,43,11,1,1,0,18,6,24
54,293,82,15,67,1,66,0,28,15,2,3,0,0,6,1,11
54,294,120,12,108,1,107,1,26,33,5,2,0,3,7,1,29
54,295,705,147,558,7,551,8,144,108,72,7,0,1,34,3,174
54,296,339,42,297,5,292,10,55,93,30,2,2,2,28,10,60
54,297,252,46,206,3,203,0,58,43,20,3,2,1,16,4,56
54,298,107,11,96,5,91,2,23,27,16,2,1,1,3,0,16
54,299,171,26,145,1,144,5,35,38,3,0,1,1,15,1,45
54,300,4305,869,3436,60,3376,31,746,895,343,54,19,8,291,89,900
54,301,109,19,90,2,88,2,6,24,15,2,0,2,7,3,27
54,302,610,93,517,9,508,6,109,119,87,7,5,6,34,13,122
54,303,314,49,265,6,259,7,65,52,35,8,3,0,18,12,59
54,304,8939,1812,7127,113,7014,202,889,1928,724,82,31,17,782,102,2257
54,305,2023,363,1660,34,1626,39,234,506,165,18,13,2,165,35,449
54,306,263,32,231,3,228,3,77,26,33,1,1,1,9,3,74
54,307,122,19,103,2,101,2,22,33,7,2,0,0,10,7,18
54,308,133,21,112,0,112,1,28,36,10,0,1,2,2,0,32
54,309,263,33,230,6,224,5,54,61,20,2,0,1,24,3,54
54,310,8,4,4,0,4,1,0,2,0,0,0,0,1,0,0
54,311,453,57,396,5,391,5,97,107,33,8,1,0,53,11,76
54,312,439,73,366,10,356,5,83,79,33,2,2,1,43,6,102
54,313,156,13,143,1,142,2,33,30,15,1,1,0,20,7,33
54,314,2440,450,1990,34,1956,25,392,471,211,21,8,4,165,40,619
54,315,711,175,536,5,531,10,142,121,62,11,0,7,44,21,113
54,316,156,23,133,1,132,2,41,38,14,0,2,0,8,2,25
54,317,79,7,72,0,72,0,24,26,6,3,0,0,1,2,10
54,318,4495,910,3585,45,3540,50,732,836,392,45,31,10,303,70,1071
54,320,253,28,225,6,219,4,71,41,17,4,4,1,11,8,58
54,321,1484,385,1099,15,1084,14,202,177,258,14,8,1,45,10,355
54,322,4143,1089,3054,49,3005,28,817,702,345,63,16,4,229,46,755
54,323,8268,2394,5874,91,5783,95,994,1202,966,67,40,9,364,82,1964
54,324,94,11,83,3,80,1,24,18,9,1,0,0,8,0,19
54,325,79,13,66,2,64,1,9,13,8,1,0,0,14,2,16
54,326,187,22,165,2,163,1,65,36,23,1,1,0,12,3,21
54,327,455,50,405,17,388,7,88,105,31,6,3,0,39,13,96
54,328,5326,862,4464,69,4395,85,618,1150,446,36,16,9,590,92,1353
54,329,13107,3662,9445,171,9274,139,2110,2440,911,138,79,28,681,196,2552
54,330,307,47,260,4,256,5,50,109,14,5,1,0,30,8,34
54,331,249,34,215,4,211,2,55,85,10,3,1,0,19,3,33
54,332,1176,243,933,24,909,23,224,258,73,4,7,0,89,14,217
54,333,178,28,150,3,147,2,49,33,7,0,6,0,15,2,33
54,334,415,64,351,8,343,5,94,44,87,11,2,1,16,6,77
54,335,301,21,280,5,275,2,76,54,22,2,4,0,31,2,82
54,336,665,80,585,4,581,7,158,153,43,9,4,0,65,12,130
54,337,97,19,78,1,77,0,17,27,10,0,0,1,2,1,19
54,338,699,72,627,8,619,4,157,150,65,4,1,0,44,11,183
54,339,5409,1035,4374,59,4315,122,679,1045,504,45,24,12,416,76,1392
54,340,227,34,193,2,191,5,51,55,14,1,1,0,16,3,45
54,341,541,73,468,5,463,12,109,120,50,3,3,0,37,15,114
54,342,1231,237,994,28,966,13,217,124,240,17,9,2,41,10,293
54,343,144,17,127,3,124,3,35,31,17,4,1,0,10,2,21
54,344,180,36,144,6,138,0,40,34,14,1,3,0,13,2,31
54,345,214,22,192,4,188,2,54,56,9,2,0,1,17,7,40
54,346,188,14,174,0,174,2,55,46,16,0,3,0,18,1,33
54,348,183,21,162,1,161,1,34,55,14,1,2,1,12,3,38
54,349,142,16,126,1,125,1,40,31,11,0,0,0,16,4,22
54,350,512,73,439,10,429,4,142,108,40,3,1,1,26,7,97
54,351,1196,176,1020,16,1004,18,282,202,91,11,6,3,67,23,301
54,352,665,98,567,10,557,13,110,117,61,12,5,2,59,11,167
54,353,691,108,583,10,573,10,164,140,69,9,3,4,52,13,109
54,354,33,1,32,1,31,3,6,5,5,2,0,0,3,0,7
54,355,73,8,65,0,65,1,18,27,5,1,0,1,1,3,8
54,356,60,6,54,1,53,0,17,14,3,0,0,0,4,1,14
54,357,4203,792,3411,43,3368,62,748,707,407,43,35,12,261,59,1034
54,358,187,18,169,5,164,4,31,48,17,4,0,0,13,3,44
54,359,186,34,152,0,152,0,41,41,23,2,2,0,8,1,34
54,360,274,42,232,4,228,6,53,63,26,3,0,0,20,4,53
54,362,1036,260,776,11,765,6,230,118,84,24,5,1,48,10,239
54,363,194,27,167,3,164,4,38,47,23,2,0,0,18,2,30
54,364,1025,111,914,24,890,16,153,263,67,2,6,2,103,20,258
54,365,309,42,267,7,260,1,89,59,29,5,4,0,24,10,39
54,366,1283,189,1094,24,1070,18,224,248,122,14,6,2,73,19,344
54,367,1763,397,1366,24,1342,26,224,288,217,23,19,3,96,14,432
54,368,138,19,119,2,117,5,39,35,10,0,0,0,10,4,14
54,369,432,50,382,8,374,3,94,94,36,5,3,1,36,3,99
54,370,185,22,163,3,160,2,60,42,13,2,2,0,8,1,30
54,371,795,130,665,9,656,5,163,118,107,10,7,0,35,9,202
54,372,368,61,307,5,302,2,89,58,28,2,6,1,19,4,93
54,373,407,50,357,14,343,1,80,87,36,6,2,0,23,11,97
54,374,399,73,326,5,321,5,67,85,41,4,3,2,30,4,80
54,375,952,200,752,16,736,9,218,179,60,6,3,2,51,11,197
54,376,312,22,290,6,284,11,81,60,29,3,1,1,23,4,71
54,377,116,31,85,0,85,2,16,25,3,7,0,1,11,5,15
54,378,367,48,319,4,315,6,66,100,35,0,1,1,27,7,72
54,379,84,6,78,0,78,1,30,22,9,0,2,0,3,0,11
54,380,274,17,257,3,254,7,39,85,23,3,5,0,28,5,59
54,381,69,17,52,0,52,2,14,22,2,2,1,0,4,2,3
54,382,3995,1011,2984,49,2935,37,514,433,692,39,14,7,170,35,994
54,383,795,107,688,16,672,5,216,122,57,10,7,3,49,22,181
54,385,711,130,581,6,575,10,166,108,98,8,4,0,37,11,133
54,386,89,9,80,2,78,0,26,26,10,1,0,0,5,1,9
54,387,114,11,103,1,102,8,27,23,9,1,1,2,12,4,15
54,388,61,5,56,5,51,2,10,16,9,0,0,1,11,1,1
54,389,75,13,62,1,61,0,25,20,2,0,0,0,2,1,11
54,390,125,26,99,1,98,3,14,27,17,3,1,1,7,4,21
54,391,1375,283,1092,20,1072,11,243,111,220,21,7,2,44,22,391
54,392,218,14,204,8,196,3,48,58,16,0,2,0,20,2,47
54,393,428,67,361,3,358,1,105,80,40,4,2,0,22,10,94
54,394,191,24,167,5,162,3,50,51,10,6,0,0,8,4,30
54,395,54390,13065,41325,550,40775,1326,4301,11536,4891,454,179,148,4349,687,12904
54,396,166,23,143,2,141,1,50,33,14,0,5,0,7,0,31
54,397,4977,1090,3887,70,3817,61,899,763,459,63,37,9,276,63,1187
54,398,80,17,63,1,62,2,12,16,5,0,1,0,5,2,19
54,399,204,54,150,3,147,1,43,41,16,1,5,1,9,2,28
54,400,884,129,755,12,743,24,189,187,58,4,7,0,59,21,194
54,401,94,8,86,1,85,2,12,28,12,0,0,1,16,3,11
54,402,306,47,259,6,253,0,61,79,27,9,1,1,13,5,57
54,403,992,162,830,13,817,7,202,230,93,11,3,3,94,9,165
54,404,167,17,150,0,150,4,55,35,11,2,1,0,9,0,33
54,405,290,32,258,5,253,4,90,58,30,3,2,0,10,3,53
54,406,224,46,178,2,176,5,53,39,13,1,1,0,18,4,42
54,407,93,13,80,3,77,1,22,27,4,0,0,0,8,2,13
54,408,189,27,162,1,161,3,46,48,13,4,0,0,18,3,26
54,409,127,11,116,1,115,1,29,41,3,1,0,0,10,2,28
54,410,347,53,294,2,292,11,85,68,37,3,2,1,18,4,63
54,411,174,15,159,1,158,4,43,31,23,4,0,0,19,6,28
54,412,31,7,24,0,24,2,5,7,2,1,0,0,0,3,4
54,413,115,14,101,0,101,2,21,26,17,2,3,1,9,2,18
54,414,431,65,366,2,364,2,81,104,46,3,4,0,30,3,91
54,415,3227,647,2580,57,2523,29,666,583,296,28,26,8,193,64,630
54,416,126,17,109,2,107,4,26,24,9,0,1,0,13,7,23
54,417,181,29,152,2,150,3,50,46,10,2,0,2,10,1,26
54,418,158,24,134,3,131,1,23,50,5,1,1,1,15,2,32
54,419,68,8,60,2,58,0,21,14,2,1,0,0,6,3,11
54,420,68,12,56,0,56,2,12,15,4,1,1,0,3,1,17
54,421,286,50,236,3,233,4,67,72,13,1,3,1,15,10,47
54,422,54,5,49,0,49,0,13,20,5,0,0,0,3,0,8
54,423,310,46,264,4,260,1,90,57,27,6,4,2,14,8,51
54,424,37,7,30,0,30,2,6,13,2,0,0,0,4,0,3
54,425,1709,436,1273,20,1253,13,305,168,285,11,12,4,60,18,377
54,426,421,63,358,5,353,5,104,96,34,6,2,1,24,6,75
54,427,103,16,87,0,87,2,14,25,8,1,1,0,5,2,29
54,428,646,159,487,2,485,8,155,114,53,4,7,1,24,11,108
54,429,251,45,206,5,201,7,47,63,20,1,0,0,14,2,47
54,430,3259,723,2536,37,2499,47,608,440,290,28,16,9,187,45,829
54,431,9545,2537,7008,104,6904,116,1644,1718,720,86,55,21,533,132,1879
54,432,1450,305,1145,19,1126,15,277,216,105,15,12,2,106,32,346
54,433,195,35,160,4,156,4,46,49,11,1,0,0,15,4,26
54,434,197,25,172,3,169,3,40,56,12,2,4,0,16,4,32
54,435,312,49,263,3,260,4,42,53,26,4,0,1,22,9,99
54,436,114,18,96,2,94,1,23,18,17,2,2,1,14,1,15
54,437,952,124,828,12,816,18,198,159,75,14,10,1,71,18,252
54,438,59,8,51,0,51,2,8,13,6,0,0,0,7,3,12
54,439,3686,672,3014,52,2962,41,528,830,262,36,17,9,338,54,847
54,440,98,12,86,0,86,1,33,23,4,1,0,0,3,2,19
54,441,184,21,163,3,160,1,47,35,24,2,3,0,13,2,33
54,442,78,10,68,6,62,1,16,15,5,1,0,1,7,2,14
54,443,42,10,32,2,30,0,5,14,3,3,0,1,3,0,1
54,444,140,19,121,0,121,1,39,31,8,2,0,0,18,6,16
54,445,78,18,60,1,59,0,21,16,2,2,1,0,7,3,7
54,446,54,2,52,3,49,2,9,13,5,1,0,0,7,1,11
54,447,67,17,50,1,49,0,12,16,4,1,1,1,6,1,7
54,449,734,87,647,11,636,8,138,155,51,8,10,3,55,19,189
54,450,101,15,86,7,79,1,25,24,3,1,1,1,0,2,21
54,451,2472,629,1843,22,1821,29,380,414,266,23,11,0,131,43,524
54,452,71,8,63,2,61,14,6,2,7,3,2,0,11,1,15
54,453,152,16,136,5,131,4,31,21,18,0,2,0,15,1,39
54,455,134,25,109,4,105,0,21,35,12,0,1,1,13,4,18
54,456,362,38,324,5,319,5,90,88,11,0,2,2,42,15,64
54,457,39,6,33,0,33,0,4,13,2,0,0,0,7,2,5
54,458,90,14,76,0,76,1,22,24,5,1,0,1,8,2,12
54,459,2147,342,1805,24,1781,39,318,547,177,17,11,4,183,30,455
54,460,119,15,104,3,101,0,15,39,5,1,0,0,12,1,28
54,461,62,4,58,2,56,1,11,12,1,1,2,1,15,3,9
54,462,2033,376,1657,33,1624,35,394,369,194,21,16,7,145,46,397
54,463,172,8,164,1,163,1,44,46,11,0,1,3,10,4,43
54,464,65,3,62,2,60,0,17,21,1,0,1,0,4,3,13
54,465,499,68,431,5,426,4,116,107,46,7,6,1,26,8,105
54,466,251,40,211,0,211,3,74,40,23,2,3,1,9,6,50
54,467,142,17,125,0,125,3,35,40,11,3,0,1,9,5,18
54,468,105,8,97,1,96,2,25,38,2,1,1,0,10,2,15
54,469,275,38,237,4,233,4,62,53,24,5,1,2,24,6,52
54,470,57,7,50,1,49,0,11,18,9,0,1,0,2,0,8
54,471,68,11,57,4,53,0,19,18,2,0,1,0,6,0,7
54,472,724,157,567,1,566,4,191,111,72,5,2,6,35,13,127
54,473,172,15,157,3,154,2,37,63,10,3,1,1,9,2,26
54,474,142,18,124,5,119,3,32,29,13,1,0,0,24,3,14
54,475,134,30,104,2,102,5,24,31,10,2,0,0,10,3,17
54,476,247,33,214,1,213,0,71,41,24,4,3,1,15,10,44
54,477,126,18,108,1,107,0,31,34,13,3,0,0,6,3,17
54,478,131,17,114,1,113,5,22,38,6,0,0,0,7,7,28
54,479,83,15,68,1,67,1,16,22,4,0,1,0,11,1,11
54,480,65,13,52,2,50,2,23,5,3,0,0,0,11,1,5
54,481,85,9,76,0,76,2,24,21,3,1,0,0,3,5,17
54,482,7356,1778,5578,83,5495,124,852,1541,607,57,37,14,548,117,1598
54,483,5372,1147,4225,68,4157,77,1126,953,380,57,28,10,365,68,1093
54,484,163,24,139,4,135,4,47,35,8,1,1,1,9,2,27
54,485,202,41,161,2,159,9,38,33,19,1,2,0,16,1,40
54,486,249,30,219,2,217,4,60,59,15,3,0,1,20,7,48
54,487,70,10,60,0,60,2,21,17,6,1,0,0,8,0,5
54,488,41,6,35,1,34,4,5,5,5,0,1,0,2,1,11
54,489,129,24,105,2,103,3,28,25,10,3,0,1,9,6,18
54,490,1082,159,923,15,908,21,233,227,84,13,7,0,82,25,216
54,491,265,42,223,1,222,2,77,28,25,3,1,0,16,4,66
54,492,112,18,94,1,93,2,21,22,7,1,2,1,8,0,29
54,493,1702,330,1372,15,1357,18,313,220,328,13,11,4,73,22,355
54,494,73,13,60,0,60,2,27,11,7,0,0,0,2,2,9
54,495,3243,524,2719,39,2680,40,504,797,261,23,17,6,291,60,681
54,496,256,45,211,6,205,8,61,52,17,5,3,0,13,7,39
54,497,73,12,61,1,60,0,15,22,4,2,0,0,9,2,6
54,498,4115,751,3364,70,3294,83,612,919,303,27,21,9,311,71,938
54,499,77,6,71,1,70,0,20,38,2,0,0,0,4,1,5
54,500,139,18,121,0,121,4,26,35,12,1,0,0,10,2,31
54,501,77,9,68,1,67,1,21,18,9,0,0,0,8,3,7
54,502,176,24,152,2,150,0,54,34,9,0,0,0,20,2,31
54,504,464,69,395,6,389,5,109,69,70,14,2,0,34,10,76
54,505,484,46,438,2,436,9,102,103,46,5,3,0,35,11,122
54,506,261,21,240,4,236,3,57,87,14,1,1,0,22,3,48
54,507,117,22,95,2,93,2,38,21,10,0,0,0,2,1,19
54,508,183,18,165,2,163,4,40,44,15,4,1,0,22,4,29
54,509,733,108,625,8,617,8,166,102,77,20,16,0,52,18,158
54,510,213,32,181,0,181,3,63,46,23,2,3,0,15,4,22
54,511,119,21,98,1,97,1,25,17,7,2,0,0,21,2,22
54,512,99,24,75,1,74,0,21,31,3,0,0,1,1,9,8
54,513,478,80,398,8,390,9,115,88,30,1,4,4,33,10,96
54,514,373,58,315,6,309,3,53,96,40,1,3,0,32,5,76
54,515,236,30,206,5,201,4,38,61,17,4,1,0,18,4,54
54,516,15,2,13,0,13,0,5,4,3,0,0,0,1,0,0
54,517,167,31,136,3,133,7,38,47,9,1,1,0,6,5,19
54,518,738,152,586,12,574,4,166,159,47,10,3,1,47,15,122
54,519,425,63,362,10,352,9,99,101,23,5,4,1,29,15,66
54,520,300,33,267,3,264,4,67,66,25,3,2,0,32,3,62
54,521,1176,305,871,12,859,15,140,105,304,14,4,2,37,8,230
54,522,108,12,96,1,95,4,28,32,5,0,0,0,8,2,16
54,523,126,14,112,4,108,2,22,26,11,2,0,2,18,6,19
54,524,69,6,63,0,63,0,11,19,6,2,1,1,8,1,14
54,525,478,80,398,4,394,7,65,94,78,6,1,0,23,5,115
54,526,5458,1245,4213,77,4136,71,967,762,468,44,33,8,304,60,1419
54,527,548,71,477,5,472,6,100,123,67,6,4,2,35,16,113
54,528,10053,2661,7392,114,7278,125,1778,1900,657,90,48,26,572,110,1972
54,529,41,7,34,2,32,0,4,13,1,1,0,0,2,1,10
54,530,70,9,61,2,59,0,15,29,2,2,0,0,3,1,7
54,531,46,5,41,0,41,1,16,6,8,0,0,1,3,0,6
54,532,138,8,130,5,125,2,19,46,12,2,0,0,17,2,25
54,533,1599,259,1340,24,1316,16,316,203,238,24,9,3,51,17,439
54,534,399,69,330,7,323,5,112,82,26,0,1,0,20,6,71
54,535,166,26,140,3,137,6,33,47,8,6,0,0,17,3,17
54,536,2230,544,1686,21,1665,17,387,214,384,19,14,6,83,25,516
54,537,497,67,430,11,419,10,66,114,53,5,4,1,38,8,120
54,538,330,53,277,4,273,1,102,33,21,9,8,0,18,2,79
54,539,225,38,187,6,181,1,81,38,11,2,3,0,14,0,31
54,540,533,134,399,5,394,1,113,73,42,4,3,2,22,8,126
54,541,144,20,124,0,124,0,39,36,6,3,0,0,9,3,28
54,542,1790,295,1495,23,1472,16,309,214,325,21,8,4,69,35,471
54,543,120,19,101,3,98,5,23,27,8,0,3,1,9,1,21
54,544,120,14,106,0,106,3,27,25,7,0,2,0,10,5,27
54,545,168,25,143,2,141,3,31,32,19,0,3,1,11,3,38
54,546,650,67,583,11,572,5,169,144,49,12,4,1,55,18,115
54,547,15376,3287,12089,177,11912,256,1916,2795,1313,111,54,41,1074,170,4182
54,548,455,77,378,8,370,6,74,32,48,4,3,0,15,6,182
54,549,2841,523,2318,53,2265,32,586,439,285,27,19,1,165,32,679
54,550,250,23,227,4,223,3,57,51,17,4,0,3,31,10,47
54,551,60,3,57,0,57,1,15,20,2,2,0,0,5,3,9
54,552,81,16,65,1,64,0,15,18,6,2,0,0,16,0,7
54,553,159,21,138,2,136,2,33,24,9,0,1,0,13,6,48
54,554,59,2,57,6,51,1,17,20,3,0,0,0,3,3,4
54,555,70,12,58,1,57,2,17,15,10,2,0,0,3,2,6
54,556,103,18,85,0,85,0,23,27,12,0,0,0,6,2,15
54,557,1243,181,1062,21,1041,21,176,365,72,14,3,0,164,26,200
54,558,242,31,211,2,209,5,58,44,27,1,1,3,16,5,49
54,559,262,39,223,10,213,0,43,45,24,3,4,1,32,3,58
54,560,48,7,41,3,38,0,16,8,3,0,0,0,5,0,6
54,561,41,8,33,2,31,1,11,6,5,1,1,0,1,1,4
54,562,109,17,92,1,91,3,29,24,5,3,0,0,5,6,16
54,563,953,183,770,9,761,11,172,215,72,12,10,2,71,11,185
54,564,137,19,118,1,117,0,23,58,12,0,0,0,13,0,11
54,565,201,24,177,2,175,5,29,48,22,2,0,1,16,5,47
54,566,83,22,61,1,60,1,19,9,6,1,0,0,10,0,14
54,567,357,63,294,3,291,7,111,67,25,1,0,2,22,8,48
54,568,197,29,168,2,166,2,49,28,20,2,1,0,10,4,50
54,569,120,12,108,3,105,1,29,23,9,1,0,1,13,4,24
54,570,241,30,211,5,206,3,62,52,31,3,4,1,6,2,42
54,571,527,73,454,5,449,6,69,165,53,2,2,3,44,9,96
54,572,390,107,283,0,283,2,81,42,37,9,4,0,20,7,81
54,573,148,22,126,5,121,6,43,36,8,1,0,0,4,2,21
54,574,455,64,391,5,386,9,78,113,39,3,3,0,58,8,75
54,575,1141,151,990,16,974,10,199,237,144,9,4,3,82,19,267
54,576,84,11,73,3,70,0,9,30,7,0,0,1,8,4,11
54,577,81,10,71,2,69,0,21,23,7,2,2,0,1,2,11
54,578,11351,2384,8967,131,8836,272,1074,2536,836,79,25,33,1105,146,2730
54,579,280,42,238,3,235,10,82,54,17,2,0,0,21,2,47
54,580,5724,1346,4378,45,4333,50,704,643,1270,68,27,11,227,61,1272
54,581,229,29,200,3,197,1,40,32,49,4,3,1,14,4,49
54,582,142,37,105,2,103,1,25,28,13,6,1,1,4,6,18
54,583,317,31,286,4,282,13,39,66,29,2,1,2,33,8,89
54,584,836,102,734,2,732,12,154,226,67,6,1,4,79,4,179
54,585,349,35,314,2,312,13,84,71,33,3,0,1,36,10,61
54,586,558,79,479,6,473,16,116,126,33,9,1,3,51,14,104
54,587,156,28,128,7,121,1,25,30,15,3,1,1,16,1,28
54,588,306,36,270,5,265,2,62,64,19,4,1,1,25,4,83
54,589,100,7,93,1,92,2,39,21,7,0,0,0,8,2,13
54,590,455,87,368,11,357,3,101,110,30,5,4,1,27,5,71
54,591,261,11,250,6,244,1,57,77,22,2,0,1,21,9,54
54,592,198,13,185,4,181,6,31,46,8,0,1,3,28,7,51
54,593,310,46,264,3,261,3,93,41,31,4,8,2,11,6,62
54,594,97,10,87,1,86,0,34,24,5,0,0,0,5,2,16
54,595,430,42,388,6,382,5,109,81,39,3,1,1,34,6,103
54,596,611,77,534,12,522,13,119,135,47,14,2,2,55,7,128
54,597,360,52,308,1,307,11,92,60,18,2,4,0,31,3,86
54,598,204,42,162,1,161,2,41,41,20,1,0,0,9,1,46
54,599,98,16,82,2,80,0,28,20,7,1,0,0,6,3,15
54,600,102,11,91,3,88,1,19,30,3,2,1,0,23,2,7
54,601,100,15,85,3,82,1,28,22,5,5,0,0,7,5,9
54,602,93,12,81,3,78,1,31,29,6,1,0,0,3,2,5
55,1,250,40,210,1,209,1,69,65,15,2,2,0,13,5,37
55,2,88,8,80,0,80,0,24,27,10,2,1,1,8,2,5
55,4,66,5,61,1,60,1,22,18,4,0,0,0,5,2,8
55,5,46,5,41,1,40,2,5,17,5,0,0,1,2,4,4
55,7,211,31,180,3,177,9,41,42,14,6,0,0,17,0,48
55,8,128,14,114,2,112,1,27,51,11,0,2,1,9,3,7
55,9,422,74,348,8,340,9,79,69,29,4,2,0,29,6,113
55,10,2104,294,1810,30,1780,13,623,408,125,25,16,7,122,54,387
55,11,183,34,149,5,144,3,58,39,8,1,0,0,7,7,21
55,12,295,42,253,8,245,12,76,67,21,4,5,0,18,3,39
55,13,353,58,295,6,289,6,70,74,32,8,3,0,31,6,59
55,14,340,43,297,8,289,4,76,79,18,4,3,0,35,2,68
55,15,362,75,287,6,281,9,111,62,19,5,1,2,12,4,56
55,17,99,17,82,5,77,1,15,25,6,2,1,0,11,3,13
55,18,35,8,27,0,27,2,5,6,1,1,1,0,6,0,5
55,21,62,14,48,1,47,1,14,10,1,0,0,0,13,2,6
55,22,101,21,80,1,79,1,14,20,9,1,0,0,13,3,18
55,23,98,17,81,0,81,2,29,27,2,0,0,1,11,0,9
55,24,137,16,121,3,118,2,28,39,6,1,0,0,16,2,24
55,25,206,32,174,4,170,0,55,46,11,6,2,0,12,4,34
55,26,112,17,95,4,91,2,30,20,11,2,0,0,12,3,11
55,27,132,14,118,3,115,3,31,44,16,1,0,0,9,0,11
55,28,103,10,93,4,89,4,21,32,3,2,1,0,9,0,17
55,29,10586,2318,8268,131,8137,199,1502,1990,833,134,49,32,858,165,2375
55,30,65,12,53,0,53,0,17,18,1,0,0,0,4,2,11
55,31,378,58,320,4,316,6,101,89,14,0,0,2,27,4,73
55,32,45,4,41,4,37,0,11,20,1,0,0,1,1,1,2
55,33,16,3,13,1,12,0,3,3,0,1,0,0,4,0,1
55,34,80,14,66,1,65,1,16,15,7,0,1,0,6,1,18
55,35,145,25,120,1,119,4,35,30,5,1,0,0,20,4,20
55,36,70,7,63,1,62,0,24,12,3,3,2,0,2,2,14
55,37,119,14,105,2,103,0,25,38,2,2,0,0,11,2,23
55,38,46,11,35,1,34,2,6,17,2,0,0,0,2,0,5
55,40,229,30,199,3,196,1,30,73,19,1,0,1,43,1,27
55,41,589,81,508,4,504,5,101,139,41,3,4,0,67,8,136
55,42,362,28,334,7,327,4,75,85,35,4,0,0,26,9,89
55,43,2488,424,2064,43,2021,23,599,499,153,28,7,2,172,28,510
55,44,32,3,29,1,28,3,6,7,0,2,0,0,6,1,3
55,45,406,42,364,8,356,6,104,74,29,8,4,1,30,7,93
55,46,103,17,86,1,85,3,24,34,7,1,0,0,4,2,10
55,47,167,42,125,5,120,2,35,36,21,0,0,0,13,5,8
55,48,31,3,28,0,28,0,8,10,0,0,0,0,4,0,6
55,49,299,44,255,6,249,3,72,56,26,5,1,1,16,5,64
55,51,105,14,91,5,86,3,25,34,7,2,0,0,5,1,9
55,53,240,39,201,4,197,3,53,64,26,2,0,2,8,7,32
55,54,56,8,48,0,48,1,5,23,5,0,0,0,7,1,6
55,55,17,0,17,0,17,0,4,12,0,0,0,0,1,0,0
55,57,64,16,48,0,48,0,22,12,1,2,0,0,9,1,1
55,58,228,22,206,3,203,3,41,57,15,2,1,1,31,4,48
55,59,190,28,162,3,159,3,69,39,7,3,1,1,18,2,16
55,60,313,55,258,4,254,17,52,54,34,11,2,1,30,6,47
55,61,190,32,158,6,152,4,44,40,14,4,0,0,19,4,23
55,62,97,13,84,0,84,0,33,30,5,0,1,0,5,1,9
55,63,1864,393,1471,15,1456,12,319,217,388,16,12,2,50,18,422
55,64,84,12,72,1,71,2,29,19,3,1,2,0,12,1,2
55,65,111,14,97,3,94,1,26,27,5,0,1,0,19,2,13
55,66,111,6,105,3,102,1,32,37,3,3,1,2,5,3,15
55,67,98,17,81,5,76,5,16,23,7,3,0,0,8,3,11
55,68,78,18,60,0,60,0,5,18,8,0,1,0,8,3,17
55,69,190,24,166,1,165,2,26,58,13,1,3,1,21,6,34
55,70,90,10,80,3,77,4,18,31,9,0,1,0,2,1,11
55,71,130,27,103,1,102,0,25,36,5,4,1,0,9,2,20
55,72,79,12,67,1,66,1,18,30,5,1,0,0,3,1,7
55,73,534,51,483,14,469,1,94,143,35,4,4,1,76,18,93
55,75,127,27,100,3,97,3,39,14,11,1,1,1,8,1,18
55,76,133,11,122,1,121,1,38,31,8,4,0,0,11,2,26
55,77,143,34,109,0,109,1,36,27,9,1,1,0,15,2,17
55,78,267,53,214,1,213,5,69,61,9,5,4,1,17,5,37
55,79,427,46,381,6,375,9,78,109,26,6,5,1,52,5,84
55,80,87,9,78,0,78,1,22,33,1,0,0,0,8,1,12
55,81,55,5,50,1,49,1,11,11,2,0,1,0,11,0,12
55,82,48,2,46,1,45,0,2,21,7,0,0,0,5,0,10
55,83,122,23,99,2,97,0,27,28,8,1,0,0,11,2,20
55,84,70,16,54,2,52,0,11,16,4,0,3,0,5,1,12
55,85,204,29,175,2,173,2,64,32,12,4,1,0,25,0,33
55,87,70,13,57,1,56,0,13,20,7,0,2,0,7,1,6
55,88,108,23,85,1,84,1,15,28,7,2,2,0,10,1,18
55,89,68,6,62,0,62,1,19,27,5,3,0,0,2,0,5
55,93,227,26,201,3,198,11,25,71,10,4,1,1,29,12,34
55,94,409,52,357,8,349,5,107,90,47,5,1,0,21,0,73
55,95,128,28,100,2,98,1,35,17,11,2,0,1,7,1,23
55,96,86,13,73,1,72,2,22,23,5,0,0,0,7,0,13
55,97,252,41,211,2,209,5,52,66,10,3,1,2,15,6,49
55,99,107,21,86,3,83,6,25,18,4,3,1,0,7,0,19
55,100,80,14,66,3,63,3,16,24,6,3,0,0,2,1,8
55,101,259,36,223,3,220,4,62,61,21,5,1,0,29,6,31
55,102,437,76,361,5,356,3,70,129,36,8,2,1,42,4,61
55,103,29,4,25,1,24,0,5,10,2,1,2,0,0,0,4
55,104,79,8,71,0,71,5,24,19,5,0,0,1,9,3,5
55,105,112,14,98,1,97,2,28,25,5,2,2,0,10,0,23
55,106,131,22,109,4,105,5,29,25,8,4,2,0,12,3,17
55,107,44,6,38,1,37,0,11,15,3,0,0,0,5,0,3
55,108,128,14,114,1,113,9,22,45,5,0,2,1,14,0,15
55,109,144,25,119,0,119,1,29,27,8,1,1,0,9,5,38
55,110,164,36,128,5,123,0,50,21,4,0,3,0,6,0,39
55,111,405,59,346,9,337,4,83,106,24,9,4,2,36,5,64
55,113,120,16,104,1,103,1,18,33,9,1,1,0,8,5,27
55,114,158,21,137,4,133,0,41,47,8,5,0,0,9,1,22
55,115,43,5,38,1,37,1,7,16,3,0,0,0,6,0,4
55,116,41,6,35,0,35,1,5,10,6,0,1,0,3,0,9
55,117,1068,179,889,17,872,17,228,250,57,10,12,2,74,15,207
55,118,64,9,55,0,55,0,21,16,5,2,2,0,4,0,5
55,119,150,19,131,3,128,1,32,46,6,2,1,1,7,0,32
55,120,697,83,614,12,602,9,111,179,51,3,4,3,67,16,159
55,121,90,7,83,1,82,2,11,27,22,0,1,0,3,2,14
55,122,3775,842,2933,44,2889,35,617,599,342,43,15,10,234,42,952
55,123,586,91,495,5,490,17,162,126,36,8,6,0,43,7,85
55,124,222,41,181,3,178,0,52,75,11,2,1,0,9,5,23
55,125,564,96,468,13,455,5,158,99,33,14,1,0,26,10,109
55,127,33,1,32,1,31,6,7,12,0,1,0,0,3,0,2
55,128,42,2,40,0,40,1,5,15,2,0,0,0,13,0,4
55,129,50,13,37,0,37,1,15,6,1,0,0,0,5,1,8
55,132,1273,208,1065,14,1051,14,379,226,104,15,5,5,84,14,205
55,133,92,20,72,3,69,4,14,23,4,1,0,0,8,1,14
55,134,113,16,97,2,95,5,20,22,9,2,1,0,10,1,25
55,137,43,7,36,0,36,0,6,19,2,0,0,0,3,3,3
55,140,10,0,10,0,10,0,2,5,1,0,0,0,1,0,1
55,141,65,6,59,4,55,0,18,21,2,0,0,0,7,0,7
55,142,143,34,109,1,108,1,31,26,12,1,0,0,9,0,28
55,143,111,9,102,3,99,1,20,31,7,1,0,0,16,1,22
55,144,351,62,289,9,280,10,83,72,20,5,3,1,25,6,55
55,145,424,67,357,3,354,4,88,91,18,1,3,0,38,5,106
55,146,166,25,141,1,140,5,34,35,11,1,2,0,18,1,33
55,148,115,11,104,0,104,1,30,27,7,6,1,0,11,2,19
55,149,76,14,62,0,62,1,17,19,4,0,0,0,8,0,13
55,150,442,92,350,10,340,4,84,90,24,9,5,2,28,13,81
55,153,143,22,121,1,120,0,13,50,10,1,0,1,14,4,27
55,154,1091,199,892,8,884,15,251,191,79,17,7,0,89,14,221
55,155,326,40,286,4,282,3,78,94,13,3,2,0,23,10,56
55,156,116,25,91,4,87,0,32,31,3,2,1,2,4,6,6
55,157,43,10,33,1,32,0,14,9,5,0,1,0,0,0,3
55,158,567,94,473,8,465,3,154,82,64,11,6,3,16,7,119
55,159,298,64,234,3,231,1,72,56,20,7,3,0,21,1,50
55,160,46,1,45,0,45,0,13,17,3,1,0,2,6,0,3
55,162,35,4,31,1,30,0,9,5,3,2,1,0,2,1,7
55,163,61,5,56,2,54,0,10,22,7,2,0,0,6,1,6
55,164,6,0,6,0,6,0,2,4,0,0,0,0,0,0,0
55,165,323,47,276,5,271,2,67,69,21,4,1,1,22,7,77
55,166,1109,179,930,15,915,11,174,187,119,19,6,1,83,28,287
55,167,426,67,359,5,354,4,67,97,33,4,0,1,37,5,106
55,168,33,2,31,0,31,1,6,12,2,0,1,0,3,2,4
55,169,286,92,194,1,193,2,46,54,26,9,0,1,13,2,40
55,170,103,10,93,3,90,0,28,21,5,1,1,0,5,2,27
55,171,182,22,160,3,157,3,50,40,15,3,1,0,14,4,27
55,172,55,5,50,1,49,0,22,13,4,0,0,0,5,1,4
55,173,44,3,41,0,41,0,5,19,6,1,0,0,5,3,2
55,174,65,6,59,1,58,0,14,29,1,0,0,0,5,1,8
55,175,144,10,134,0,134,2,47,34,9,0,5,1,15,1,20
55,177,62,10,52,1,51,0,14,13,3,0,0,0,13,0,8
55,178,151,15,136,4,132,0,43,34,6,1,0,0,17,1,30
55,179,145,17,128,3,125,2,33,55,9,1,1,0,8,4,12
55,180,115,18,97,4,93,3,29,23,5,1,2,0,10,3,17
55,181,2467,489,1978,28,1950,20,530,522,192,25,17,3,132,52,457
55,182,171,38,133,5,128,3,31,43,17,4,0,0,9,5,16
55,183,44,7,37,1,36,0,8,11,2,2,0,0,4,2,7
55,184,1376,298,1078,14,1064,17,268,309,91,27,9,7,86,13,237
55,185,63,8,55,0,55,3,11,20,5,1,0,1,8,1,5
55,186,1722,249,1473,17,1456,25,339,361,116,16,6,1,141,31,420
55,188,33,13,20,1,19,0,3,5,5,4,0,0,1,0,1
55,191,184,33,151,0,151,6,23,48,19,2,1,1,17,5,29
55,192,44,12,32,1,31,0,8,8,3,0,0,0,4,0,8
55,193,98,8,90,1,89,1,17,40,3,0,0,0,6,2,20
55,194,53,10,43,4,39,1,5,18,2,0,0,0,9,0,4
55,195,119,20,99,1,98,1,30,22,5,1,0,1,9,0,29
55,196,83,10,73,0,73,3,21,26,5,1,0,0,2,6,9
55,197,122,13,109,3,106,0,23,35,9,0,2,0,10,3,24
55,198,520,75,445,10,435,10,109,138,26,6,1,0,41,12,92
55,199,80,19,61,1,60,3,10,18,11,1,0,0,3,2,12
55,200,206,45,161,2,159,1,36,53,13,3,1,0,14,6,32
55,201,51,9,42,0,42,1,7,13,6,1,0,0,5,0,9
55,202,139,38,101,0,101,3,25,27,14,0,1,0,9,1,21
55,204,179,25,154,4,150,2,34,30,24,5,2,1,10,3,39
55,206,126,15,111,3,108,0,23,40,7,2,0,3,13,4,16
55,207,37,7,30,0,30,0,13,2,8,0,0,0,2,0,5
55,208,42,5,37,1,36,0,8,17,1,0,0,0,3,0,7
55,210,41,7,34,0,34,0,9,12,3,0,1,0,2,0,7
55,211,53,8,45,0,45,0,16,14,1,1,1,0,4,0,8
55,212,79,17,62,2,60,2,14,10,7,1,0,1,7,0,18
55,214,224,22,202,4,198,8,52,45,14,11,1,0,20,3,44
55,215,763,141,622,14,608,4,139,182,69,7,1,0,53,7,146
55,216,40,7,33,0,33,0,18,4,2,2,0,0,2,0,5
55,217,96,12,84,0,84,1,24,24,12,1,0,1,6,4,11
55,218,22,1,21,0,21,0,6,7,1,0,0,0,3,2,2
55,219,74,3,71,0,71,1,22,29,2,1,0,0,2,0,14
55,220,73,9,64,0,64,0,18,12,7,1,0,0,5,1,20
55,221,234,46,188,3,185,5,52,32,16,3,0,1,18,3,55
55,222,32,0,32,0,32,2,6,15,2,0,0,0,3,2,2
55,224,476,80,396,7,389,6,147,82,28,5,5,1,29,11,75
55,225,119,17,102,0,102,2,30,21,6,0,0,0,15,2,26
55,226,79,9,70,2,68,0,16,11,6,0,0,0,10,1,24
55,228,450,104,346,13,333,8,74,89,38,3,3,2,38,4,74
55,229,223,43,180,6,174,1,66,39,9,0,0,0,21,5,33
55,232,104,14,90,1,89,1,41,15,8,3,0,0,8,1,12
55,236,677,88,589,6,583,7,162,161,59,5,3,2,62,7,115
55,237,194,50,144,4,140,0,54,26,17,4,1,1,12,3,22
55,241,70,12,58,1,57,4,18,18,3,1,0,0,7,1,5
55,242,98,12,86,2,84,0,21,18,11,0,2,1,10,0,21
55,243,132,11,121,5,116,8,24,34,13,2,2,0,8,1,24
55,244,197,41,156,4,152,2,39,75,6,1,1,0,13,2,13
55,245,156,22,134,2,132,4,20,50,12,2,1,1,13,2,27
55,246,107,12,95,0,95,0,30,27,7,0,2,0,9,0,20
55,247,57,9,48,1,47,0,13,17,4,0,0,0,1,0,12
55,248,270,34,236,5,231,1,66,72,28,0,4,1,20,1,38
55,250,164,24,140,3,137,4,34,41,16,0,0,0,16,4,22
55,251,83,11,72,1,71,1,36,19,0,1,0,0,8,1,5
55,252,106,24,82,0,82,2,29,26,6,1,5,0,7,1,5
55,253,562,107,455,7,448,5,148,108,27,4,5,0,48,8,95
55,254,92,16,76,1,75,0,15,24,6,2,1,0,13,0,14
55,255,181,40,141,5,136,2,59,38,4,2,0,0,9,1,21
55,256,106,24,82,0,82,0,30,20,4,2,0,2,10,2,12
55,257,55,8,47,0,47,3,9,15,5,2,0,0,6,2,5
55,258,438,72,366,6,360,4,107,80,35,8,3,1,37,10,75
55,260,60,5,55,4,51,1,9,20,3,0,1,0,6,1,10
55,261,104,10,94,1,93,1,28,19,5,1,1,0,12,4,22
55,262,164,34,130,3,127,2,39,30,9,1,0,1,12,1,32
55,263,121,5,116,2,114,2,30,25,10,1,1,0,12,5,28
55,264,210,39,171,4,167,3,59,26,14,1,1,0,18,7,38
55,265,101,17,84,1,83,0,18,20,19,2,0,0,11,3,10
55,266,55,5,50,0,50,0,20,9,1,1,0,0,4,1,14
55,267,204,29,175,2,173,9,42,49,15,2,0,0,24,6,26
55,268,502,63,439,6,433,11,130,127,37,6,1,1,34,13,73
55,269,89,16,73,2,71,0,20,8,7,2,1,1,8,0,24
55,270,24,4,20,1,19,0,2,7,2,0,0,2,1,0,5
55,271,315,42,273,5,268,12,94,69,9,1,1,0,28,4,50
55,272,350,36,314,6,308,5,61,54,23,6,3,1,46,12,97
55,274,260,37,223,6,217,3,70,57,19,3,1,0,17,1,46
55,275,67,13,54,1,53,0,10,9,6,0,1,1,5,3,18
55,276,169,23,146,3,143,0,32,32,20,2,0,0,11,4,42
55,278,137,16,121,0,121,0,36,40,4,5,1,0,10,4,21
55,279,306,49,257,6,251,4,66,60,13,5,0,0,25,7,71
55,280,51,13,38,0,38,2,11,19,1,0,0,0,3,1,1
55,281,65,10,55,0,55,1,14,12,4,0,1,1,11,2,9
55,282,73,4,69,0,69,2,19,18,4,2,0,0,12,3,9
55,284,72,13,59,1,58,2,25,14,3,0,0,0,0,2,12
55,285,133,15,118,8,110,0,20,28,15,0,3,1,20,0,23
55,286,164,15,149,2,147,0,64,32,6,1,1,0,10,6,27
55,288,986,136,850,19,831,7,196,174,104,13,9,0,60,13,255
55,289,39,1,38,1,37,0,11,18,0,0,0,0,6,0,2
55,290,45,10,35,2,33,0,7,6,1,0,2,1,5,0,11
55,291,3166,751,2415,60,2355,24,636,517,190,38,15,4,207,35,689
55,292,150,28,122,1,121,7,49,26,10,0,0,0,11,6,12
55,293,128,9,119,5,114,2,33,36,15,2,0,0,7,1,18
55,295,31,3,28,1,27,2,5,12,0,1,0,1,4,0,2
55,296,420,67,353,4,349,3,109,91,28,7,1,0,22,6,82
55,297,100,21,79,4,75,2,16,25,4,1,0,0,7,2,18
55,298,395,43,352,7,345,9,105,83,20,10,4,2,38,3,71
55,299,81,14,67,1,66,1,17,22,3,3,0,1,10,0,9
55,300,189,47,142,4,138,6,40,33,16,3,0,2,12,1,25
55,301,105,13,92,3,89,1,18,30,4,1,0,0,18,0,17
55,302,984,178,806,18,788,8,195,214,67,11,5,4,95,13,176
55,303,73,7,66,5,61,2,17,18,6,0,0,0,6,1,11
55,304,162,21,141,0,141,0,49,37,16,2,2,0,16,2,17
55,306,104,20,84,1,83,1,23,29,6,1,0,0,13,0,10
55,310,93,9,84,0,84,1,34,13,6,0,0,1,6,0,23
55,311,26,8,18,0,18,0,3,11,0,0,2,0,0,1,1
55,312,129,13,116,1,115,0,27,40,8,4,1,0,19,3,13
55,313,65,12,53,0,53,0,19,17,3,0,0,1,3,3,7
55,315,107,11,96,1,95,2,21,48,1,1,0,0,7,4,11
55,316,271,41,230,0,230,3,68,60,28,4,2,0,23,4,38
55,317,134,16,118,0,118,3,33,36,10,4,0,0,9,0,23
55,320,59,9,50,2,48,0,7,22,1,0,0,0,2,0,16
55,321,138,18,120,2,118,4,20,56,5,0,0,1,4,4,24
55,322,39,4,35,0,35,0,10,9,1,1,1,0,4,0,9
55,323,46,3,43,2,41,0,13,12,6,0,0,0,3,2,5
55,324,405,69,336,2,334,5,96,84,30,2,2,4,26,17,68
55,325,43,8,35,1,34,1,6,12,6,0,0,0,6,1,2
55,326,86,8,78,1,77,1,12,29,6,0,1,0,6,2,20
55,327,215,39,176,4,172,0,56,52,17,1,1,1,20,2,22
55,328,233,31,202,2,200,4,72,69,8,1,1,0,9,3,33
55,329,187,31,156,2,154,7,36,42,19,0,2,0,15,6,27
55,330,84,16,68,3,65,5,8,21,10,3,1,1,7,1,8
55,331,69,5,64,0,64,1,13,27,0,1,0,0,15,3,4
55,332,204,33,171,2,169,3,62,51,7,4,2,0,9,3,28
55,333,47,5,42,3,39,1,3,19,2,1,0,1,6,0,6
55,334,130,9,121,1,120,3,33,28,7,11,2,0,13,1,22
55,335,205,40,165,5,160,5,47,35,9,2,2,2,14,9,35
55,336,121,23,98,2,96,0,24,31,9,3,0,1,3,3,22
55,338,137,15,122,2,120,0,33,29,10,0,0,0,2,4,42
55,339,61,7,54,4,50,0,15,22,0,0,1,1,5,2,4
55,340,301,51,250,5,245,3,77,57,21,3,2,1,28,8,45
55,341,110,15,95,3,92,2,18,39,2,2,1,0,10,4,14
55,343,60,13,47,1,46,0,12,11,0,4,0,0,8,1,10
55,344,26,3,23,0,23,0,3,7,5,0,0,0,3,0,5
55,345,94,15,79,0,79,2,21,17,10,1,1,0,4,2,21
55,346,224,33,191,3,188,2,60,62,13,1,0,0,21,8,21
55,347,275,44,231,0,231,0,62,57,43,1,1,1,16,1,49
55,348,334,74,260,8,252,0,72,76,13,3,2,1,33,3,49
55,349,128,22,106,3,103,1,25,35,3,0,0,0,11,3,25
55,350,77,9,68,5,63,0,18,16,3,0,1,0,5,2,18
55,351,1167,254,913,10,903,8,212,238,82,7,4,4,95,16,237
55,352,158,31,127,3,124,2,28,54,3,2,0,0,6,1,28
55,353,54,6,48,1,47,0,6,16,2,1,0,0,8,5,9
55,355,136,22,114,3,111,2,29,28,9,1,2,0,16,1,23
55,356,81,19,62,0,62,0,16,21,2,1,0,0,4,1,17
55,357,79,19,60,0,60,0,14,23,5,2,0,0,2,1,13
55,358,194,19,175,2,173,2,36,66,15,2,1,2,12,5,32
55,359,147,37,110,3,107,1,33,33,8,0,1,4,9,1,17
55,360,90,17,73,0,73,1,27,15,7,0,0,1,11,2,9
55,361,95,10,85,1,84,1,27,23,7,0,1,0,7,2,16
55,362,146,28,118,1,117,0,43,29,7,2,3,0,7,2,24
55,363,82,10,72,2,70,0,30,9,8,0,2,1,9,1,10
55,364,553,81,472,11,461,7,117,83,40,6,4,2,32,6,164
55,365,144,28,116,2,114,1,29,31,8,0,1,0,2,1,41
55,366,744,69,675,12,663,12,180,153,49,7,3,3,76,17,163
55,367,81,11,70,0,70,0,9,39,2,0,1,0,5,1,13
55,368,121,19,102,5,97,1,36,33,1,1,0,0,11,2,12
55,369,665,93,572,11,561,8,136,142,48,5,1,1,38,9,173
55,370,155,35,120,2,118,4,32,36,13,2,1,0,6,5,19
55,371,53,2,51,0,51,0,13,14,3,0,0,1,11,1,8
55,372,302,48,254,5,249,4,54,66,18,6,3,0,31,5,62
55,373,59,3,56,1,55,1,15,12,4,0,1,0,7,0,15
55,374,81,21,60,2,58,1,10,16,9,1,0,0,4,0,17
55,375,61,4,57,0,57,1,17,31,0,0,0,0,4,0,4
55,376,73,9,64,2,62,1,22,19,4,1,0,0,6,0,9
55,377,62,15,47,0,47,1,13,18,1,0,0,0,7,0,7
55,378,242,66,176,3,173,0,56,42,16,2,1,0,10,5,41
55,379,64,5,59,0,59,3,16,12,3,1,0,0,2,1,21
55,380,66,11,55,2,53,4,4,25,1,2,0,0,12,1,4
55,381,134,32,102,1,101,1,30,33,7,3,0,0,6,1,20
55,382,268,41,227,16,211,4,56,61,16,6,2,1,19,8,38
55,383,164,15,149,3,146,1,41,49,10,3,7,0,10,2,23
55,384,115,21,94,1,93,2,14,28,12,0,0,1,13,2,21
55,385,367,32,335,4,331,3,78,98,25,7,2,2,32,6,78
55,386,138,14,124,0,124,1,43,35,4,0,1,1,18,3,18
55,387,201,39,162,4,158,3,48,57,12,2,1,0,14,2,19
55,388,205,39,166,1,165,7,47,44,14,0,3,0,31,1,18
55,389,190,20,170,5,165,2,47,49,7,2,2,1,24,9,22
55,391,132,13,119,1,118,5,24,36,13,1,0,1,6,1,31
55,394,13,4,9,0,9,0,1,5,0,0,0,0,0,2,1
55,395,46,9,37,0,37,1,3,15,2,0,0,0,8,1,7
55,396,159,20,139,4,135,1,36,37,16,0,2,0,6,0,37
55,397,177,36,141,4,137,1,39,46,8,2,0,0,16,2,23
55,398,743,114,629,13,616,5,211,120,61,10,7,2,45,9,146
55,399,101,14,87,0,87,2,32,25,4,3,0,0,8,1,12
55,400,47,8,39,2,37,0,11,10,0,0,0,0,1,0,15
55,401,321,26,295,7,288,6,57,96,23,4,1,1,26,10,64
55,403,47,5,42,0,42,0,12,15,2,0,1,0,5,1,6
55,404,211,23,188,1,187,7,28,49,23,4,1,1,26,1,47
55,405,179,32,147,0,147,2,45,44,7,4,0,0,15,4,26
55,406,77,13,64,1,63,0,8,23,5,1,0,0,12,0,14
55,407,137,18,119,0,119,2,25,43,15,0,1,0,10,1,22
55,408,166,32,134,3,131,4,38,33,17,4,0,0,13,4,18
55,409,48,5,43,0,43,0,7,20,4,1,0,1,1,1,8
55,410,117,27,90,5,85,1,14,26,13,1,2,0,11,3,14
55,411,77,18,59,1,58,0,28,19,2,2,0,0,4,0,3
55,412,123,10,113,2,111,2,40,32,5,2,1,0,12,3,14
55,414,150,19,131,2,129,0,37,45,9,2,0,0,6,6,24
55,415,67,11,56,0,56,1,18,15,7,1,1,1,6,0,6
55,416,180,25,155,1,154,4,19,49,23,5,0,0,18,3,33
55,419,161,44,117,2,115,1,39,37,6,0,0,0,9,6,17
55,420,75,12,63,1,62,3,24,11,6,0,0,0,8,0,10
55,421,50,11,39,1,38,4,17,6,1,0,0,0,4,1,5
55,422,42,2,40,0,40,1,6,10,2,0,0,1,2,1,17
55,423,296,48,248,5,243,2,52,81,18,3,2,0,36,11,38
55,424,55,5,50,2,48,0,10,27,1,0,1,0,4,1,4
55,425,118,25,93,1,92,2,38,14,11,0,1,0,7,1,18
55,426,354,43,311,4,307,5,56,66,38,7,2,2,31,11,89
55,427,2066,471,1595,24,1571,18,427,405,121,22,9,5,111,38,415
55,428,101,14,87,1,86,2,18,17,7,0,0,0,10,3,29
55,429,47,1,46,2,44,4,8,15,3,0,0,0,0,1,13
55,430,79,16,63,0,63,2,18,31,3,0,1,1,3,0,4
55,431,46,2,44,1,43,1,19,12,0,0,0,0,6,0,5
55,433,315,63,252,1,251,3,75,70,19,2,0,3,28,9,42
55,434,52,6,46,2,44,1,18,12,2,0,0,0,5,1,5
55,435,592,74,518,14,504,6,171,118,31,5,2,1,38,7,125
55,436,32,8,24,1,23,0,7,7,4,1,0,0,2,0,2
55,437,95,20,75,3,72,1,18,21,6,2,1,0,7,0,16
55,438,116,28,88,2,86,0,32,19,5,4,3,0,8,1,14
55,439,79,15,64,1,63,4,9,19,2,0,0,0,8,0,21
55,442,213,45,168,4,164,2,25,64,6,4,4,0,26,4,29
55,443,226,49,177,2,175,6,50,51,15,2,0,1,13,4,33
55,444,134,12,122,2,120,0,46,24,10,4,0,0,15,2,19
55,445,154,25,129,1,128,1,27,33,17,3,5,0,17,6,19
55,446,65,8,57,2,55,0,20,17,5,0,0,1,3,0,9
55,447,264,50,214,5,209,3,47,52,26,6,3,1,20,3,48
55,448,39,5,34,0,34,0,15,6,1,1,0,1,3,0,7
55,449,238,42,196,3,193,0,45,51,18,7,5,0,12,6,49
55,450,35,7,28,0,28,1,8,4,0,1,0,1,5,0,8
55,452,73,4,69,0,69,0,9,8,12,1,1,1,16,2,19
55,453,61,18,43,1,42,1,10,27,0,0,0,0,0,1,3
55,454,130,15,115,1,114,1,25,39,13,2,1,0,9,3,21
55,456,206,29,177,2,175,3,74,42,7,6,2,2,12,3,24
55,457,149,21,128,1,127,5,31,27,15,3,2,0,15,2,27
55,458,213,39,174,8,166,4,56,39,19,1,3,0,5,3,36
55,459,230,34,196,4,192,1,65,48,9,4,0,1,18,3,43
55,460,114,13,101,0,101,4,32,38,9,1,0,0,6,1,10
55,461,296,48,248,1,247,9,83,57,23,4,4,0,15,4,48
55,462,269,35,234,3,231,5,55,47,24,1,0,0,16,6,77
55,463,2638,559,2079,35,2044,19,551,530,168,27,14,4,175,46,510
55,464,127,18,109,3,106,1,28,31,4,3,1,1,20,3,14
55,465,60,6,54,3,51,4,18,9,2,1,0,0,7,0,10
55,466,248,15,233,13,220,6,49,45,24,1,1,0,27,6,61
55,467,573,93,480,10,470,9,122,86,36,8,10,2,35,14,148
55,468,64,6,58,1,57,0,15,29,0,1,0,0,2,1,9
55,469,84,17,67,1,66,1,32,8,2,2,1,0,3,0,17
55,470,154,17,137,5,132,2,47,32,8,6,2,0,10,1,24
55,471,79,9,70,1,69,1,14,18,9,1,0,0,6,4,16
55,472,112,20,92,6,86,0,32,34,2,0,0,0,12,2,4
55,473,107,17,90,2,88,1,30,35,4,0,0,0,4,1,13
55,474,205,20,185,6,179,3,47,55,15,1,1,0,11,7,39
55,475,55,8,47,0,47,0,19,9,4,0,0,0,2,1,12
55,476,386,54,332,8,324,1,56,88,37,4,0,1,37,4,96
55,477,346,55,291,5,286,2,89,64,22,7,2,2,18,7,73
55,479,166,16,150,1,149,5,41,30,25,6,0,0,4,3,35
55,481,204,37,167,1,166,3,59,48,11,1,2,0,7,0,35
55,482,75,11,64,1,63,2,24,9,2,3,1,0,7,1,14
55,484,45,6,39,2,37,1,9,21,0,0,2,0,2,0,2
55,485,70,8,62,2,60,3,7,19,2,2,0,1,5,2,19
55,487,88,12,76,5,71,0,18,16,3,2,0,1,5,0,26
55,488,150,19,131,2,129,0,29,25,19,3,1,2,19,4,27
55,489,222,35,187,4,183,3,38,47,15,2,1,1,23,6,47
55,490,269,53,216,4,212,2,54,59,14,5,5,2,14,8,49
55,492,618,122,496,15,481,7,141,93,50,9,4,0,45,8,124
55,493,180,52,128,6,122,1,42,30,9,1,2,0,8,1,28
55,494,412,74,338,6,332,5,104,71,40,10,0,0,25,11,66
55,495,175,23,152,0,152,3,44,47,6,3,0,1,13,0,35
55,496,751,120,631,10,621,11,226,131,51,10,3,1,47,7,134
55,497,267,40,227,5,222,2,44,69,23,5,1,1,27,8,42
55,498,260,54,206,7,199,4,52,76,19,1,3,0,15,8,21
55,500,521,65,456,8,448,5,118,132,45,5,1,0,35,11,96
55,501,314,42,272,9,263,2,70,89,17,1,2,1,19,3,59
55,502,1722,427,1295,21,1274,16,317,287,123,17,12,3,94,25,380
55,503,116,19,97,3,94,1,20,33,11,0,0,0,5,2,22
55,504,306,40,266,3,263,8,71,58,18,0,2,2,23,12,69
55,505,1952,368,1584,27,1557,23,403,418,140,22,13,5,138,38,357
55,506,35,7,28,1,27,2,7,8,6,0,0,0,1,1,2
55,507,159,24,135,1,134,2,24,34,19,4,0,0,5,8,38
55,508,97,26,71,1,70,1,18,20,7,2,1,1,7,0,13
55,509,187,36,151,1,150,1,46,37,14,1,1,0,13,3,34
55,510,90,21,69,0,69,0,19,24,1,1,1,0,7,1,15
55,511,96,23,73,0,73,0,14,15,11,2,1,0,10,6,14
55,512,225,37,188,0,188,1,50,43,20,4,2,0,15,3,50
55,514,470,62,408,9,399,10,139,79,26,7,3,0,33,9,93
55,515,58,5,53,0,53,1,18,11,4,3,0,0,2,0,14
55,516,489,91,398,8,390,4,123,76,23,8,4,2,31,5,114
55,517,403,70,333,9,324,4,91,95,24,4,5,2,50,5,44
55,518,99,13,86,0,86,0,17,36,6,1,0,0,14,0,12
55,519,1140,188,952,12,940,11,228,178,81,21,6,1,67,24,323
55,520,293,40,253,12,241,8,63,60,28,5,3,0,27,7,40
55,521,181,27,154,1,153,1,60,34,13,3,0,0,16,5,21
55,522,95,13,82,2,80,3,22,20,3,1,1,0,13,7,10
55,523,127,20,107,2,105,1,24,40,8,3,0,0,9,0,20
55,525,52,9,43,1,42,4,6,16,3,0,0,0,0,4,9
55,526,196,27,169,3,166,0,46,21,14,3,1,1,22,5,53
55,527,449,97,352,12,340,3,56,142,28,4,2,0,34,4,67
55,528,50,5,45,0,45,2,16,19,1,0,0,0,2,1,4
55,530,74,6,68,1,67,1,19,17,4,1,2,1,9,4,9
55,531,196,27,169,4,165,3,41,30,15,3,1,2,15,3,52
55,532,259,39,220,7,213,4,59,61,21,7,1,5,17,5,33
55,533,1335,276,1059,11,1048,6,271,309,81,8,4,3,76,15,275
55,534,53,7,46,0,46,2,11,8,6,0,1,0,5,0,13
55,535,48,11,37,1,36,2,5,11,2,0,0,0,3,0,13
55,536,24,1,23,0,23,0,1,12,1,0,0,0,4,0,5
55,537,59,4,55,1,54,1,7,20,5,1,1,0,9,1,9
55,540,51,15,36,0,36,0,16,5,3,0,0,0,5,0,7
55,541,397,45,352,3,349,3,77,80,25,4,2,3,54,7,94
55,543,808,139,669,16,653,6,197,159,50,7,8,3,63,17,143
55,544,83,23,60,1,59,0,14,13,9,0,0,0,2,0,21
55,545,12077,3558,8519,155,8364,136,1690,2496,754,106,44,26,775,162,2175
55,546,117,34,83,0,83,0,16,30,5,2,3,0,5,0,22
55,547,71,15,56,1,55,0,20,26,1,1,0,2,4,1,0
55,549,90,19,71,2,69,2,12,31,4,0,0,1,9,2,8
55,551,1132,181,951,10,941,27,242,218,97,8,4,2,106,31,206
55,552,51,10,41,0,41,1,14,16,1,3,0,0,4,1,1
55,553,970,135,835,19,816,8,183,202,91,11,3,4,57,15,242
55,554,135,14,121,3,118,5,30,21,11,4,1,1,15,1,29
55,555,24,0,24,3,21,0,5,7,2,0,0,0,5,0,2
55,556,48,7,41,1,40,1,12,19,3,2,0,0,1,1,1
55,557,113,20,93,1,92,2,30,29,9,1,0,1,11,0,9
55,559,30,6,24,1,23,0,4,4,1,0,0,0,3,0,11
55,560,111,13,98,1,97,2,19,33,5,1,1,0,10,4,22
55,561,68,9,59,1,58,3,13,21,5,0,1,0,6,0,9
55,562,118,27,91,3,88,2,18,35,12,1,0,3,7,1,9
55,563,67,11,56,0,56,0,18,12,4,3,0,0,6,1,12
55,565,57,9,48,2,46,0,12,11,6,0,1,0,5,0,11
55,566,199,28,171,3,168,2,38,39,20,3,3,0,7,6,50
55,567,81,12,69,3,66,0,10,22,5,1,1,0,12,3,12
55,568,253,29,224,13,211,5,75,43,9,5,2,1,15,7,49
55,569,133,18,115,4,111,2,49,31,7,2,2,0,8,1,9
55,570,155,20,135,3,132,1,20,54,4,7,1,0,18,0,27
55,571,150,22,128,1,127,3,39,23,20,2,1,0,13,3,23
55,572,69,12,57,0,57,0,16,24,2,1,1,0,7,0,6
55,573,1306,252,1054,20,1034,11,287,278,83,16,6,5,111,26,211
55,574,60,6,54,0,54,0,15,20,0,1,0,0,1,1,16
55,575,76,4,72,0,72,5,18,11,4,1,0,0,2,1,30
55,577,52,10,42,0,42,1,11,12,4,0,1,0,6,1,6
55,578,138,21,117,2,115,3,50,20,10,2,3,0,7,1,19
55,579,89,14,75,0,75,0,13,23,7,3,1,0,3,2,23
55,580,41,8,33,2,31,0,9,9,2,1,0,0,4,1,5
55,581,103,14,89,1,88,0,34,23,6,0,0,1,7,0,17
55,582,87,15,72,1,71,1,17,15,7,1,1,0,4,0,25
55,583,149,22,127,1,126,2,30,45,11,3,0,1,7,1,26
55,584,88,8,80,4,76,0,25,26,8,0,0,0,7,0,10
55,586,78,8,70,1,69,0,26,29,5,0,0,0,3,0,6
56,1,2647,333,2314,48,2266,65,330,643,230,39,14,10,240,43,652
56,2,1416,227,1189,23,1166,32,162,355,135,26,7,5,100,15,329
56,3,4504,532,3972,56,3916,165,302,1399,261,30,10,5,544,65,1135
56,4,1095,109,986,19,967,28,153,325,86,10,3,5,94,19,244
56,5,2147,280,1867,22,1845,41,209,854,117,18,5,4,183,29,385
56,6,1073,122,951,19,932,17,136,244,110,18,7,3,101,17,279
56,7,8800,1811,6989,114,6875,277,865,2009,722,87,41,18,754,106,1996
56,8,3639,483,3156,42,3114,103,427,1117,247,31,14,7,362,52,754
56,9,865,133,732,5,727,28,76,168,92,12,13,3,101,14,220
56,10,4396,602,3794,75,3719,76,627,821,460,50,31,14,402,77,1161
56,11,1083,149,934,12,922,37,186,287,82,15,8,0,78,12,217
56,12,971,90,881,10,871,24,144,219,90,12,5,3,93,19,262
56,13,3039,489,2550,42,2508,65,451,652,253,48,14,4,291,48,682
56,14,1142,152,990,41,949,19,208,215,93,15,8,0,94,30,267
56,15,1167,125,1042,31,1011,29,144,280,124,19,4,4,112,17,278
56,16,564,84,480,14,466,23,69,94,84,4,4,2,34,4,148
56,17,2127,301,1826,27,1799,32,430,476,148,34,6,6,234,32,401
56,18,664,81,583,6,577,12,83,154,74,14,3,2,67,4,164
56,19,316,37,279,3,276,1,70,84,15,3,1,0,34,3,65
56,20,526,50,476,14,462,17,68,80,45,15,5,4,70,10,148
56,21,920,125,795,23,772,17,135,197,64,17,8,3,67,17,247
56,22,924,127,797,14,783,39,151,216,91,18,6,1,69,13,179
56,23,4776,623,4153,79,4074,131,632,1096,424,55,26,10,457,85,1158
56,24,1713,222,1491,25,1466,18,258,544,94,24,8,2,159,29,330
56,25,170,28,142,3,139,0,24,36,25,2,2,2,14,2,32
56,26,1958,385,1573,31,1542,65,303,331,166,25,17,8,159,33,435
56,27,382,63,319,4,315,5,74,113,21,4,4,1,28,4,61
56,28,1194,173,1021,24,997,21,152,332,91,16,3,1,135,5,241
56,29,781,96,685,20,665,14,122,127,80,9,5,3,84,10,211
56,30,752,77,675,10,665,15,141,236,63,5,1,2,56,13,133
56,31,2260,332,1928,38,1890,58,361,388,223,26,15,7,141,39,632
56,32,1436,195,1241,23,1218,14,249,313,125,22,5,0,128,15,347
56,33,2096,358,1738,27,1711,37,287,567,162,30,10,2,198,43,375
56,34,4088,585,3503,58,3445,97,527,1462,198,38,15,10,396,61,641
56,35,913,134,779,15,764,11,112,246,64,15,3,1,115,14,183
56,36,5463,857,4606,103,4503,120,666,1337,420,64,35,15,516,91,1239
56,37,971,103,868,17,851,31,142,173,87,11,10,1,127,18,251
56,38,545,89,456,6,450,8,88,94,32,8,5,0,71,13,131
56,39,631,77,554,12,542,11,116,157,52,8,3,1,57,9,128
56,40,2613,348,2265,38,2227,51,395,515,242,33,13,4,231,51,692
56,41,2267,274,1993,46,1947,58,279,447,243,21,11,3,255,38,592
56,42,1596,191,1405,34,1371,32,272,346,129,29,17,3,149,26,368
56,43,557,68,489,9,480,32,70,121,62,3,3,0,29,7,153
56,44,599,66,533,9,524,16,78,123,54,13,4,1,64,10,161
56,45,421,32,389,8,381,10,80,77,57,3,4,1,30,7,112
56,46,2770,352,2418,30,2388,64,405,862,152,31,11,4,252,26,581
56,47,1029,102,927,30,897,8,171,302,67,13,7,2,107,23,197
56,48,585,113,472,7,465,12,68,111,51,8,5,1,44,10,155
56,49,122,17,105,3,102,1,25,30,7,0,1,0,15,1,22
56,50,598,61,537,11,526,9,105,187,38,8,7,0,56,7,109
56,51,475,61,414,7,407,6,103,138,25,7,1,0,52,9,66
56,52,1721,254,1467,16,1451,24,191,506,114,13,7,7,141,23,425
56,53,3893,547,3346,59,3287,72,521,923,301,49,22,6,416,50,927
56,54,2948,477,2471,36,2435,70,491,671,225,40,13,9,245,45,626
56,55,1857,310,1547,27,1520,47,229,445,163,18,7,3,159,25,424
56,56,160,22,138,1,137,2,22,37,24,3,0,0,10,1,38
56,57,2177,314,1863,46,1817,56,261,455,221,34,9,2,160,38,581
56,58,2287,331,1956,37,1919,39,316,521,216,31,13,9,223,49,502
56,59,376,67,309,4,305,11,49,120,18,1,3,1,21,12,69
56,60,722,69,653,14,639,16,93,189,59,6,5,1,102,8,160
56,61,1663,288,1375,19,1356,49,192,383,117,11,6,4,179,28,387
56,62,624,101,523,5,518,10,77,136,77,7,3,0,39,6,163
56,63,2047,254,1793,49,1744,42,270,414,191,28,9,9,213,46,522
56,64,661,70,591,12,579,6,102,169,48,15,5,4,46,5,179
56,65,448,66,382,7,375,1,57,84,20,3,8,0,58,5,139
56,66,3316,511,2805,73,2732,59,460,714,306,42,25,7,253,36,830
56,67,3790,557,3233,72,3161,91,524,912,293,24,24,9,465,62,757
56,68,243,28,215,2,213,6,43,79,25,1,1,0,9,4,45
56,69,2189,389,1800,27,1773,115,231,522,228,28,7,4,113,26,499
56,70,1775,262,1513,22,1491,20,320,492,90,15,14,4,139,39,358
56,71,637,79,558,8,550,6,142,177,33,6,3,5,56,8,114
56,72,391,62,329,10,319,13,60,100,19,4,9,0,27,3,84
56,73,772,137,635,13,622,18,74,146,100,15,2,3,60,11,193
56,74,1067,110,957,22,935,18,225,278,82,6,12,5,97,12,200
56,75,4180,601,3579,45,3534,58,671,1123,281,32,19,9,448,52,841
56,76,1022,139,883,15,868,28,169,148,125,10,8,0,89,21,270
56,77,642,81,561,15,546,15,101,147,56,6,8,1,70,11,131
56,78,8691,1195,7496,152,7344,270,1059,2328,600,103,28,27,846,131,1952
56,79,996,114,882,26,856,15,164,203,75,21,6,5,96,18,253
56,80,910,130,780,11,769,15,165,212,71,5,13,2,72,15,199
56,81,1998,386,1612,26,1586,29,336,319,169,29,8,8,153,27,508
56,82,245,26,219,4,215,4,42,58,26,6,3,0,18,11,47
56,83,11598,2053,9545,150,9395,280,1251,1924,1522,150,70,27,859,141,3171
56,84,622,82,540,11,529,28,70,124,58,6,1,1,63,19,159
56,85,144,20,124,2,122,2,19,48,16,1,0,0,8,1,27
56,86,338,83,255,2,253,7,19,107,32,9,3,0,14,1,61
56,87,621,89,532,11,521,9,28,281,24,1,1,3,52,6,116
56,88,287,31,256,6,250,14,12,104,23,0,0,1,26,2,68
56,89,1615,244,1371,22,1349,32,273,268,202,25,14,3,127,31,374
56,90,4995,845,4150,60,4090,115,550,703,606,69,29,12,358,66,1582
56,91,1638,275,1363,27,1336,24,230,445,123,12,2,3,152,17,328
56,92,604,88,516,15,501,12,103,122,47,15,7,2,57,8,128
56,93,528,76,452,11,441,9,94,119,33,5,2,2,64,10,103
56,94,4453,468,3985,77,3908,123,610,1043,412,59,24,12,418,77,1130
56,96,1647,224,1423,22,1401,27,247,329,156,27,18,3,153,47,394
56,97,2508,383,2125,53,2072,65,438,442,224,35,23,9,240,43,553
56,98,16538,3226,13312,264,13048,341,2077,2297,2178,199,103,34,1067,227,4525
56,99,274,41,233,3,230,13,32,47,46,5,0,0,25,7,55
56,100,1530,292,1238,20,1218,36,208,268,135,15,5,5,155,22,369
56,101,5697,792,4905,92,4813,121,876,1091,591,65,32,16,544,110,1367
56,102,1397,223,1174,28,1146,15,205,387,81,15,10,4,132,24,273
56,103,239,31,208,4,204,5,31,57,10,3,3,0,34,8,53
56,104,669,120,549,7,542,23,103,133,69,9,1,0,47,10,147
56,105,925,147,778,15,763,24,125,151,120,12,7,4,58,12,250
56,106,923,144,779,17,762,17,83,319,62,14,2,3,89,10,163
56,107,7406,1097,6309,73,6236,197,660,2438,491,48,17,17,628,91,1649
56,108,687,102,585,15,570,11,116,116,72,14,4,0,58,21,158
56,109,693,92,601,11,590,13,123,146,71,4,4,2,68,10,149
56,110,733,149,584,10,574,14,87,148,48,11,3,1,53,6,203
56,111,1022,158,864,15,849,17,154,268,75,13,7,8,86,20,201
56,112,589,71,518,11,507,10,69,143,55,8,1,1,64,18,138
56,113,662,70,592,14,578,5,103,123,70,13,8,0,57,6,193
56,114,781,120,661,13,648,28,66,195,81,16,8,3,70,11,170
56,115,968,97,871,14,857,27,175,181,93,13,2,1,122,21,222
56,116,1594,243,1351,17,1334,47,204,518,106,15,5,6,134,24,275
56,117,2771,464,2307,59,2248,36,365,723,210,33,14,6,248,40,573
56,118,3207,524,2683,35,2648,92,417,615,345,47,15,5,171,45,896
56,119,2574,366,2208,49,2159,54,410,552,239,40,16,8,252,29,559
56,120,1128,127,1001,14,987,25,163,292,102,11,6,2,114,22,250
56,121,38388,8270,30118,535,29583,1063,4042,7024,3576,428,173,97,2596,468,10116
56,122,1256,188,1068,16,1052,15,209,290,110,18,11,2,118,18,261
56,123,1717,263,1454,43,1411,22,226,416,172,21,16,3,163,23,349
56,124,1999,293,1706,28,1678,47,179,621,115,19,12,8,217,22,438
56,125,1420,174,1246,31,1215,38,195,218,189,20,5,3,133,26,388
56,126,1608,254,1354,29,1325,17,235,453,116,16,7,3,119,27,332
56,127,2482,433,2049,38,2011,30,354,618,170,23,13,6,174,28,595
56,128,1190,161,1029,18,1011,44,193,214,145,12,8,3,112,20,260
56,129,1210,175,1035,24,1011,15,169,337,81,15,5,0,99,20,270
56,130,2225,235,1990,49,1941,49,407,442,201,33,20,5,192,47,545
56,131,1122,161,961,30,931,23,203,223,90,19,5,4,93,20,251
56,132,1513,148,1365,24,1341,33,177,361,108,9,8,6,150,32,457
56,133,848,115,733,27,706,20,105,201,71,11,5,3,98,18,174
56,134,754,129,625,5,620,10,155,208,44,2,5,0,70,19,107
56,135,1059,154,905,21,884,37,179,212,116,17,17,0,62,22,222
56,136,528,74,454,9,445,7,113,135,29,3,5,1,35,7,110
56,137,2194,270,1924,40,1884,52,346,456,196,26,7,5,212,43,541
56,138,262,41,221,6,215,0,48,62,10,4,3,0,29,7,52
56,139,290,27,263,3,260,9,50,45,29,3,0,0,21,3,100
56,140,2660,329,2331,72,2259,21,555,613,172,42,18,3,255,45,535
56,141,1254,165,1089,17,1072,26,210,301,102,20,5,1,118,22,267
56,142,501,72,429,13,416,10,63,89,44,12,5,1,56,4,132
56,143,3774,500,3274,35,3239,85,401,1059,333,35,13,6,380,53,874
56,144,1391,205,1186,17,1169,7,255,325,113,10,13,2,130,30,284
56,145,787,122,665,12,653,16,120,173,49,8,2,0,66,18,201
56,146,1124,136,988,20,968,24,197,220,88,7,10,3,159,24,236
56,147,3173,454,2719,68,2651,48,409,962,232,32,13,10,293,54,598
56,148,1094,131,963,30,933,39,141,205,125,8,5,0,111,15,284
56,149,1848,208,1640,20,1620,30,254,426,163,27,8,6,178,28,500
56,150,636,64,572,3,569,14,56,183,52,8,1,2,65,12,176
56,151,2808,345,2463,77,2386,41,420,656,219,36,20,5,363,45,581
56,152,1990,345,1645,18,1627,88,169,416,258,34,7,6,144,30,475
56,153,2007,326,1681,34,1647,48,303,518,140,25,15,3,187,28,380
56,154,1404,159,1245,27,1218,56,172,326,130,11,8,2,166,34,313
56,155,1789,271,1518,21,1497,40,251,513,109,11,11,7,132,29,394
56,156,256,52,204,5,199,16,40,39,21,6,1,1,17,4,54
56,157,1345,177,1168,21,1147,20,211,364,100,20,8,3,160,26,235
56,158,3924,628,3296,64,3232,111,420,825,290,49,16,6,455,56,1004
56,159,1331,145,1186,15,1171,21,211,369,117,30,11,2,139,30,241
56,160,869,118,751,19,732,8,198,215,56,17,6,2,67,12,151
56,161,2115,285,1830,27,1803,49,346,539,162,19,13,5,222,32,416
56,162,15819,3022,12797,275,12522,444,1690,3657,1327,134,63,36,1295,183,3693
56,163,957,149,808,13,795,27,135,165,97,17,1,5,62,12,274
56,164,4564,514,4050,54,3996,82,562,1187,360,29,15,9,536,82,1134
56,165,6840,1174,5666,123,5543,130,749,1746,508,65,49,18,685,82,1511
56,166,4071,569,3502,78,3424,56,606,948,369,47,26,15,410,78,869
56,167,1845,196,1649,32,1617,59,224,447,153,23,6,4,208,36,457
56,168,1705,245,1460,26,1434,42,263,502,121,12,5,5,150,46,288
56,169,4312,582,3730,70,3660,83,750,979,430,71,17,13,328,73,916
56,170,797,121,676,14,662,18,103,136,85,14,6,5,50,13,232
56,171,1108,162,946,15,931,32,181,236,114,16,4,4,99,21,224
56,172,2039,325,1714,25,1689,29,377,525,152,15,12,3,210,22,344
56,173,2625,355,2270,52,2218,52,440,539,240,34,21,10,219,45,618
56,174,1858,245,1613,25,1588,27,282,518,152,35,14,2,160,37,361
56,175,2744,401,2343,41,2302,71,441,643,177,30,17,12,278,43,590
56,176,4057,563,3494,74,3420,109,516,848,328,57,27,14,416,80,1025
56,177,5512,876,4636,98,4538,121,787,1175,495,77,32,6,539,82,1224
56,178,9266,1582,7684,120,7564,233,1056,1963,820,89,33,17,904,130,2319
56,179,2618,471,2147,48,2099,67,326,542,221,24,10,8,261,60,580
56,180,502,84,418,5,413,2,89,102,38,7,2,1,41,11,120
56,181,2265,354,1911,30,1881,56,243,600,225,28,10,2,141,26,550
56,182,851,155,696,13,683,18,109,204,62,11,7,3,60,22,187
56,183,424,71,353,9,344,5,62,136,26,7,0,0,33,7,68
56,184,5386,818,4568,116,4452,123,631,1158,511,57,27,10,468,64,1403
56,185,7368,1203,6165,113,6052,137,909,1572,660,86,38,19,638,120,1873
56,186,4689,871,3818,49,3769,90,616,1571,282,46,13,10,295,67,779
56,187,244,37,207,0,207,9,41,46,17,4,0,0,20,4,66
56,188,1093,165,928,20,908,49,173,174,126,17,4,1,96,16,252
56,189,729,78,651,14,637,1,202,189,36,7,4,0,61,14,123
56,190,1272,151,1121,26,1095,15,258,367,69,14,17,4,107,25,219
56,191,289,47,242,4,238,2,42,65,33,11,5,0,11,7,62
56,192,744,104,640,13,627,15,158,202,41,14,6,2,63,16,110
56,193,4083,566,3517,55,3462,108,612,869,434,51,22,5,278,61,1022
56,194,2381,366,2015,48,1967,48,332,415,220,24,14,3,196,43,672
56,195,519,75,444,5,439,22,48,137,51,4,1,1,51,7,117
56,196,413,39,374,4,370,18,43,108,41,7,3,3,40,4,103
56,197,755,107,648,10,638,16,97,176,61,13,3,1,66,15,190
56,198,1236,161,1075,22,1053,18,160,300,106,9,7,2,111,25,315
56,199,565,80,485,11,474,11,102,112,49,5,4,2,46,12,131
56,200,1128,163,965,23,942,10,145,376,68,12,11,5,113,19,183
56,201,524,84,440,14,426,19,61,104,63,7,8,2,49,6,107
56,202,408,46,362,4,358,7,34,95,52,5,2,1,47,13,102
56,203,481,71,410,9,401,16,54,85,72,5,0,0,35,5,129
56,204,465,67,398,6,392,2,87,100,34,4,2,0,48,11,104
56,205,816,120,696,7,689,26,68,221,77,6,0,1,71,12,207
56,206,8067,1206,6861,118,6743,163,829,1894,590,83,27,10,803,119,2225
56,207,903,101,802,17,785,14,144,200,72,5,3,3,55,7,282
56,208,268,34,234,3,231,3,34,75,15,3,1,1,11,2,86
56,209,132,11,121,2,119,11,17,22,18,3,1,1,5,0,41
56,210,376,65,311,6,305,7,80,73,17,7,1,1,28,7,84
56,211,586,79,507,11,496,6,79,198,48,5,5,0,34,6,115
56,212,1700,213,1487,28,1459,36,242,374,125,15,12,4,194,27,430
56,213,805,101,704,24,680,14,159,163,66,8,3,1,82,14,170
56,214,1777,211,1566,21,1545,37,176,639,99,15,7,4,177,37,354
56,215,831,111,720,12,708,3,145,187,64,19,5,1,88,15,181
56,216,260,29,231,2,229,1,33,84,23,6,0,0,25,9,48
56,218,552,63,489,6,483,7,124,131,63,6,3,0,31,13,105
56,219,853,99,754,10,744,14,163,192,67,9,6,3,91,11,188
56,220,932,106,826,17,809,26,160,220,87,11,4,2,95,16,188
56,221,1226,163,1063,25,1038,26,177,340,95,14,10,0,102,22,252
56,222,2036,304,1732,31,1701,36,378,476,133,24,15,7,183,22,427
56,223,1123,135,988,18,970,29,146,198,110,6,11,2,112,20,336
56,224,299,20,279,5,274,5,40,85,32,1,0,0,22,9,80
56,225,145,18,127,0,127,7,19,35,26,2,0,0,6,0,32
56,226,332,43,289,0,289,7,65,65,24,3,2,0,42,10,71
56,227,398,57,341,8,333,1,72,118,21,2,1,0,36,9,73
56,228,827,111,716,19,697,6,91,199,88,7,3,2,81,21,199
56,229,1049,134,915,23,892,21,187,321,54,11,2,1,92,31,172
56,230,363,45,318,8,310,3,53,92,23,2,4,3,51,10,69
56,231,3086,406,2680,43,2637,97,340,673,275,32,20,2,334,49,815
56,232,918,116,802,17,785,22,95,139,110,11,7,0,92,9,300
56,233,1298,124,1174,18,1156,37,153,503,76,19,2,3,109,26,228
56,234,2355,373,1982,28,1954,51,349,750,155,21,11,4,170,50,393
56,236,675,74,601,15,586,19,94,173,39,13,2,1,65,12,168
56,237,1529,187,1342,22,1320,31,184,323,139,24,15,4,172,26,402
56,238,300,56,244,5,239,10,23,67,22,2,1,1,23,3,87
56,239,1071,145,926,18,908,23,126,217,83,12,8,0,130,24,285
56,240,6751,926,5825,80,5745,172,759,2140,403,65,18,16,610,114,1448
56,241,757,133,624,5,619,36,65,213,93,6,7,1,48,18,132
56,242,556,82,474,8,466,22,62,135,66,7,3,0,45,7,119
56,243,7230,1016,6214,98,6116,228,612,1753,596,76,21,21,769,107,1933
56,244,2293,338,1955,20,1935,44,397,487,154,35,21,6,251,36,504
56,245,299,45,254,4,250,19,50,40,32,3,1,1,18,5,81
56,246,1644,208,1436,35,1401,31,232,299,181,14,14,4,132,27,467
56,247,2486,341,2145,45,2100,77,349,463,246,44,17,6,248,43,607
56,248,2917,378,2539,32,2507,65,460,759,260,26,9,7,284,51,586
56,249,1757,249,1508,27,1481,45,230,416,131,20,8,1,201,30,399
56,250,473,67,406,7,399,12,76,85,49,3,2,1,37,11,123
56,251,5160,668,4492,103,4389,110,622,1289,420,46,10,17,555,83,1237
56,252,1044,166,878,9,869,24,143,298,76,21,4,2,75,16,210
56,253,492,87,405,5,400,8,54,138,32,6,4,1,44,12,101
56,254,848,110,738,14,724,8,166,180,72,7,1,1,64,17,208
56,255,1449,161,1288,22,1266,40,239,345,118,17,7,3,137,29,331
56,256,121,13,108,3,105,8,16,11,13,4,1,0,5,0,47
56,257,568,123,445,7,438,1,103,128,25,8,3,2,50,10,108
56,258,1692,233,1459,19,1440,36,183,746,51,6,1,5,161,22,229
56,259,887,125,762,16,746,23,147,172,85,15,4,2,84,14,200
56,260,35070,6464,28606,382,28224,904,3125,9150,2338,285,117,72,3476,479,8278
56,261,964,111,853,15,838,24,142,205,101,8,3,3,98,19,235
56,262,1864,267,1597,23,1574,82,177,467,165,14,6,7,206,29,421
56,263,1788,242,1546,22,1524,29,235,519,99,31,6,3,210,35,357
56,264,286,35,251,2,249,8,59,84,31,1,1,0,11,4,50
57,1,276,57,219,2,217,3,54,55,26,5,3,1,20,1,49
57,2,55,12,43,0,43,0,22,7,2,1,0,0,5,1,5
57,3,1085,184,901,17,884,20,264,289,55,15,6,2,87,16,130
57,4,76,15,61,0,61,2,25,10,4,2,0,0,10,3,5
57,6,786,132,654,19,635,6,214,165,53,11,10,3,73,29,71
57,7,97,13,84,0,84,1,28,27,3,1,0,0,11,2,11
57,8,190,38,152,2,150,2,49,33,8,2,0,0,16,1,39
57,9,72,6,66,0,66,3,16,17,3,2,1,2,4,3,15
57,10,107,20,87,0,87,3,32,28,2,1,1,0,10,0,10
57,11,470,98,372,9,363,4,94,116,27,4,0,0,40,5,73
57,12,4359,1297,3062,60,3002,36,759,577,552,42,27,6,183,40,780
57,13,1695,386,1309,24,1285,13,405,344,56,19,24,4,159,44,217
57,14,330,63,267,2,265,4,73,64,33,4,6,0,34,8,39
57,15,440,47,393,5,388,10,97,92,17,15,8,1,49,7,92
57,16,319,47,272,10,262,7,71,66,30,5,1,1,29,15,37
57,17,1708,269,1439,23,1416,22,414,378,131,13,8,1,104,29,316
57,18,100,9,91,1,90,0,24,36,7,2,3,0,2,0,16
57,19,7840,1475,6365,132,6233,72,1949,1196,724,132,49,11,432,163,1505
57,20,224,26,198,4,194,2,69,51,12,2,3,0,15,4,36
57,21,1149,168,981,15,966,46,166,250,84,12,2,5,94,15,292
57,22,992,238,754,13,741,2,201,174,67,8,4,3,58,22,202
57,24,123,19,104,0,104,1,8,44,15,4,1,1,7,3,20
57,25,376,58,318,7,311,3,105,80,23,5,3,0,33,5,54
57,26,672,139,533,1,532,22,101,121,65,6,8,1,66,13,129
57,27,105,19,86,5,81,2,24,30,3,0,0,0,5,3,14
57,28,1042,150,892,20,872,15,167,259,85,15,3,1,79,13,235
57,29,197,34,163,5,158,1,52,45,8,2,1,0,13,3,33
57,30,399,41,358,8,350,4,97,91,25,4,7,0,33,8,81
57,31,648,71,577,11,566,12,96,167,50,8,1,2,70,9,151
57,32,3647,888,2759,63,2696,38,729,518,280,35,16,4,188,49,839
57,33,443,82,361,9,352,9,107,104,11,1,1,2,58,7,52
57,34,34,8,26,0,26,0,6,11,4,0,0,1,3,0,1
57,35,102,17,85,4,81,3,15,23,3,0,0,4,11,2,20
57,36,92,14,78,0,78,1,11,31,8,1,0,0,6,0,20
57,37,182,27,155,2,153,3,40,53,10,2,0,0,8,3,34
57,38,4360,1170,3190,51,3139,58,574,612,726,44,23,4,205,35,858
57,39,1408,229,1179,17,1162,18,247,385,89,13,3,2,123,16,266
57,40,163,18,145,1,144,2,25,53,6,1,5,0,16,2,34
57,41,1813,418,1395,26,1369,28,302,263,297,14,8,6,69,21,361
57,42,472,71,401,10,391,2,109,120,24,9,6,1,26,10,84
57,43,1272,172,1100,18,1082,16,299,335,80,16,8,2,89,15,222
57,44,88,18,70,1,69,4,24,21,5,0,0,1,5,1,8
57,45,89,19,70,2,68,2,25,23,3,1,0,1,5,1,7
57,46,630,144,486,4,482,16,138,127,22,10,12,0,48,14,95
57,47,815,137,678,14,664,9,213,158,55,11,11,2,60,13,132
57,48,61,13,48,2,46,0,13,17,2,0,0,0,3,1,10
57,49,3013,631,2382,39,2343,60,416,757,194,12,9,5,263,44,583
57,50,95,13,82,2,80,0,18,30,10,0,0,0,4,12,6
57,51,263,35,228,2,226,2,71,64,19,1,1,2,18,2,46
57,52,431,55,376,8,368,3,126,98,27,5,7,0,21,12,69
57,53,103,13,90,1,89,0,38,17,5,4,1,1,4,1,18
57,54,148,24,124,2,122,0,40,43,5,0,0,0,6,0,28
57,55,415,30,385,7,378,9,74,119,43,6,2,1,43,7,74
57,56,153,23,130,7,123,4,30,41,7,0,0,0,15,7,19
57,57,375,61,314,9,305,1,63,100,33,6,2,0,32,1,67
57,58,5035,1604,3431,62,3369,31,789,405,416,38,21,6,137,38,1488
57,59,47,6,41,0,41,0,8,14,4,0,0,0,5,0,10
57,60,429,91,338,7,331,3,81,87,20,5,2,1,32,12,88
57,61,1049,263,786,15,771,19,236,202,64,9,13,4,48,18,158
57,62,301,32,269,3,266,11,48,80,22,8,1,0,37,2,57
57,63,194,30,164,6,158,3,52,51,10,4,0,0,20,1,17
57,64,227,45,182,5,177,6,41,54,9,2,1,0,32,4,28
57,65,180,26,154,3,151,7,61,30,12,2,0,1,23,5,10
57,66,400,64,336,7,329,9,124,80,8,2,13,0,31,4,58
57,67,2055,383,1672,23,1649,34,325,437,152,19,12,7,204,28,431
57,69,325,77,248,8,240,6,79,43,17,7,2,1,19,5,61
57,70,146,28,118,2,116,1,40,27,7,4,3,0,12,2,20
57,71,336,37,299,10,289,3,86,81,19,10,2,2,37,2,47
57,72,492,79,413,8,405,5,91,110,39,10,1,4,32,14,99
57,73,669,102,567,10,557,10,152,193,46,6,5,0,41,13,91
57,74,660,144,516,8,508,9,175,123,26,6,5,2,69,5,88
57,75,198,18,180,2,178,4,49,45,16,3,1,0,16,1,43
57,76,379,78,301,6,295,10,54,85,32,3,1,0,37,11,62
57,77,67,8,59,2,57,1,17,20,3,0,0,0,4,0,12
57,79,328,39,289,4,285,9,110,68,23,4,1,0,31,11,28
57,80,60,6,54,3,51,0,11,18,3,1,1,0,6,1,10
57,81,112,16,96,4,92,2,30,22,3,3,2,0,11,6,13
57,82,249,25,224,4,220,0,77,46,22,7,1,0,25,6,36
57,83,937,181,756,16,740,7,227,175,66,11,5,7,111,22,109
57,84,237,30,207,3,204,1,49,59,17,0,1,0,18,2,57
57,85,318,51,267,7,260,2,77,76,17,4,2,2,21,5,54
57,86,219,31,188,0,188,2,63,61,7,4,4,2,22,6,17
57,87,210,43,167,5,162,2,36,55,5,7,3,0,17,2,35
57,88,250,37,213,4,209,5,51,64,11,2,6,0,30,8,32
57,89,3265,752,2513,39,2474,43,537,795,171,37,21,10,330,45,485
57,90,99,9,90,3,87,1,22,34,2,0,2,0,10,3,13
57,91,817,155,662,15,647,9,183,185,36,7,8,3,66,12,138
57,92,450,104,346,8,338,3,100,101,12,9,3,5,38,10,57
57,93,475,108,367,7,360,5,104,124,25,7,0,0,40,6,49
57,95,441,89,352,5,347,3,102,78,22,7,5,0,33,11,86
57,96,1570,268,1302,22,1280,14,255,190,249,19,12,2,94,20,425
57,97,4014,1035,2979,44,2935,37,900,716,258,44,21,5,228,54,672
57,98,206,39,167,1,166,4,68,22,16,3,0,3,17,5,28
57,99,163,17,146,2,144,1,55,46,8,2,3,0,12,6,11
57,100,120,31,89,2,87,2,22,30,7,0,0,0,14,2,10
57,101,893,155,738,9,729,5,252,217,41,6,6,1,72,12,117
57,102,2361,362,1999,47,1952,36,429,526,173,21,14,5,204,40,504
57,103,100,12,88,3,85,2,18,35,4,5,1,0,10,0,10
57,104,821,148,673,11,662,15,142,215,54,9,3,5,75,18,126
57,105,110,13,97,1,96,0,22,33,6,2,1,0,20,0,12
57,106,2382,512,1870,31,1839,25,491,536,148,16,8,7,131,34,443
57,107,94,22,72,1,71,0,19,24,4,0,0,1,7,0,16
57,108,236,38,198,1,197,2,61,68,7,3,3,0,21,10,22
57,109,435,88,347,6,341,17,86,105,29,5,2,1,37,13,46
57,110,298,52,246,6,240,2,79,53,15,3,0,0,31,3,54
57,111,484,77,407,9,398,7,70,66,55,4,5,0,30,10,151
57,112,70,15,55,0,55,1,12,23,8,0,0,0,4,0,7
57,113,685,86,599,9,590,12,179,174,35,15,4,0,49,17,105
57,114,354,62,292,6,286,7,66,81,19,4,5,0,37,3,64
57,115,92,10,82,3,79,2,26,20,1,0,0,1,7,3,19
57,116,77,9,68,2,66,0,15,19,6,2,1,0,12,0,11
57,117,409,64,345,4,341,4,88,65,51,5,2,3,34,6,83
57,118,160,25,135,0,135,0,43,43,14,2,0,0,9,2,22
57,119,861,135,726,14,712,12,204,222,40,7,5,3,92,8,119
57,120,127,23,104,1,103,0,43,41,2,1,1,1,4,3,7
57,121,161,22,139,2,137,5,49,27,10,2,1,0,15,4,24
57,122,526,82,444,10,434,5,138,117,32,9,4,1,37,10,81
57,123,2449,553,1896,38,1858,26,666,358,161,32,14,5,139,58,399
57,124,1828,384,1444,30,1414,22,313,441,126,21,8,4,166,35,278
57,125,295,58,237,6,231,6,37,69,26,2,4,1,26,5,55
57,126,282,41,241,2,239,4,67,67,21,1,1,0,12,6,60
57,127,103,11,92,0,92,1,34,25,6,2,1,2,7,1,13
57,128,183,23,160,1,159,3,40,47,13,1,3,0,10,0,42
57,129,515,60,455,10,445,11,93,138,44,3,0,2,47,12,95
57,130,82,19,63,4,59,2,16,16,6,0,0,0,5,3,11
57,131,171,32,139,2,137,4,32,44,12,0,2,0,19,2,22
57,132,1666,332,1334,22,1312,14,345,410,90,18,11,2,105,29,288
57,133,98,14,84,1,83,2,16,25,12,1,2,0,5,1,19
57,134,1422,188,1234,20,1214,26,201,383,112,22,6,2,133,25,304
57,136,353,70,283,3,280,1,65,86,15,10,5,0,31,4,63
57,137,477,69,408,4,404,2,100,144,20,8,2,0,49,6,73
57,138,55,11,44,0,44,0,9,14,1,0,1,0,7,2,10
57,139,252,58,194,5,189,2,39,66,10,4,0,0,21,4,43
57,140,408,63,345,2,343,12,68,110,26,5,2,2,44,6,68
57,141,86,7,79,0,79,1,17,33,1,2,0,2,9,5,9
57,142,337,38,299,8,291,1,73,98,21,7,2,0,26,6,57
57,143,2624,684,1940,40,1900,25,468,421,222,25,19,5,130,30,555
57,144,2688,580,2108,53,2055,20,740,391,194,25,20,6,110,35,514
57,145,249,43,206,8,198,7,51,47,18,2,0,2,28,1,42
57,146,579,72,507,3,504,14,128,149,42,7,2,1,63,9,89
57,147,254,30,224,6,218,6,33,85,13,3,0,2,26,4,46
57,148,291,39,252,2,250,8,59,66,23,5,0,2,44,3,40
57,149,155,28,127,0,127,0,23,37,14,0,2,0,22,2,27
57,150,466,73,393,4,389,6,115,115,23,3,1,0,43,6,77
57,151,143,23,120,1,119,0,36,32,7,3,2,0,13,0,26
57,152,348,86,262,6,256,9,59,85,16,5,1,0,33,7,41
57,153,1634,208,1426,15,1411,19,320,447,108,14,6,2,141,27,327
57,154,557,100,457,6,451,4,145,122,44,6,3,0,40,7,80
57,155,2255,499,1756,23,1733,35,388,496,137,31,12,2,198,33,401
57,156,836,95,741,9,732,16,152,214,64,10,8,2,89,18,159
57,158,183,23,160,4,156,2,36,36,22,0,0,0,18,1,41
57,159,3059,692,2367,47,2320,30,751,465,201,40,23,2,154,50,604
57,160,8266,1942,6324,98,6226,66,1734,1312,601,108,46,9,510,90,1750
57,161,100,24,76,2,74,0,17,29,3,1,0,0,6,3,15
57,162,595,72,523,7,516,10,117,193,38,7,2,0,55,12,82
57,163,2312,431,1881,31,1850,23,739,453,94,23,27,4,205,36,246
57,165,412,80,332,5,327,5,73,98,27,7,1,2,39,6,69
57,166,93,14,79,2,77,2,27,22,3,0,1,0,3,6,13
57,167,259,51,208,1,207,1,72,58,22,4,1,0,12,1,36
57,168,471,59,412,25,387,20,109,93,34,5,3,3,52,5,63
57,169,426,63,363,6,357,7,85,110,30,3,4,3,44,14,57
57,171,657,83,574,9,565,8,120,197,44,9,3,4,67,12,101
57,172,205,24,181,5,176,4,54,49,11,3,1,0,19,4,31
57,173,82,11,71,3,68,1,22,20,1,1,0,1,12,3,7
57,174,75,7,68,4,64,2,11,22,10,1,1,0,6,0,11
57,175,171,33,138,1,137,9,38,38,12,2,3,0,14,2,19
57,176,1323,257,1066,25,1041,16,301,278,66,17,4,3,125,29,202
57,177,2020,438,1582,32,1550,21,371,482,120,32,9,3,135,38,339
57,178,282,42,240,12,228,2,63,73,8,7,3,0,35,5,32
57,179,1267,250,1017,14,1003,16,225,280,79,21,12,7,107,32,224
57,180,270,41,229,2,227,2,78,66,9,1,5,1,23,5,37
57,181,82,9,73,0,73,1,14,26,4,0,1,0,11,1,15
57,182,92,15,77,0,77,0,38,14,5,3,1,0,3,1,12
57,183,174,20,154,2,152,1,36,50,4,0,3,0,31,9,18
57,184,136,21,115,0,115,4,26,28,15,1,0,0,6,2,33
57,186,573,101,472,14,458,10,158,112,32,11,0,1,47,14,73
57,187,277,35,242,6,236,2,91,55,20,1,0,1,28,4,34
57,188,349,62,287,6,281,7,104,83,17,1,2,1,16,8,42
57,189,174,34,140,2,138,2,29,48,16,1,0,0,15,0,27
57,190,299,46,253,9,244,6,53,73,17,6,1,1,41,2,44
57,191,580,97,483,7,476,9,155,97,63,8,5,2,37,10,90
57,192,1057,210,847,24,823,17,252,190,64,21,16,1,103,18,141
57,193,1441,199,1242,14,1228,31,306,318,124,20,9,5,101,31,283
57,194,973,152,821,19,802,22,152,230,103,11,0,3,104,17,160
57,195,422,72,350,9,341,4,98,117,20,9,5,2,40,8,38
57,196,339,50,289,8,281,2,81,103,11,3,3,3,22,11,42
57,197,393,60,333,4,329,9,95,90,30,1,3,1,46,6,48
57,198,170,23,147,1,146,4,38,48,9,5,1,0,15,2,24
57,199,418,89,329,6,323,5,80,100,43,2,3,1,25,4,60
57,200,313,44,269,1,268,11,61,79,23,4,0,1,20,8,61
57,201,663,111,552,11,541,5,160,161,19,12,6,3,83,16,76
57,202,795,149,646,7,639,14,190,191,40,9,3,1,72,12,107
57,203,154,53,101,3,98,2,15,50,7,3,0,0,6,4,11
57,204,432,49,383,9,374,6,81,117,23,3,2,1,47,8,86
57,205,1742,400,1342,25,1317,17,377,288,121,23,13,4,96,23,355
57,206,8601,1932,6669,117,6552,90,1307,1124,787,111,42,14,367,79,2631
57,207,3519,1171,2348,35,2313,18,405,264,284,21,21,4,110,28,1158
57,208,1147,242,905,18,887,16,302,231,66,13,7,4,63,16,169
57,209,3991,1022,2969,47,2922,37,844,625,291,41,23,17,219,68,757
57,210,560,98,462,5,457,14,123,135,21,5,5,1,45,11,97
57,211,711,86,625,9,616,16,148,148,65,3,8,1,55,15,157
57,212,513,112,401,8,393,7,61,157,37,2,2,0,39,6,82
57,213,634,132,502,16,486,3,136,127,43,11,4,2,47,10,103
57,214,286,53,233,2,231,1,44,77,22,1,2,0,25,7,52
57,215,248,41,207,6,201,3,47,84,5,1,3,1,33,2,22
57,216,82,16,66,0,66,1,13,27,6,0,0,0,11,2,6
57,217,653,89,564,13,551,12,163,124,46,14,4,3,59,8,118
57,218,892,126,766,4,762,16,88,270,71,4,6,2,94,13,198
57,219,426,63,363,2,361,4,79,100,39,5,2,1,34,14,83
57,220,109,22,87,1,86,2,11,42,5,0,1,0,9,0,16
57,221,8424,2016,6408,117,6291,80,1616,1196,743,94,56,11,368,95,2032
57,222,1038,171,867,16,851,17,260,207,74,7,3,3,112,12,156
57,224,2989,783,2206,31,2175,25,620,418,218,40,12,2,158,30,652
57,225,111,8,103,5,98,0,38,29,5,2,0,0,5,2,17
57,226,2176,412,1764,35,1729,24,396,361,277,30,13,10,118,29,471
57,227,13913,4467,9446,147,9299,119,2425,2391,864,93,64,26,616,132,2569
57,228,112,11,101,2,99,1,21,18,12,1,1,1,10,4,30
57,229,144,19,125,1,124,4,30,33,23,0,1,0,8,3,22
57,230,147,12,135,0,135,3,42,51,5,0,1,0,10,3,20
57,231,80,11,69,3,66,2,21,16,7,0,0,1,7,2,10
57,232,550,104,446,4,442,5,117,145,43,9,3,3,37,14,66
57,233,74,8,66,2,64,2,15,19,6,2,0,0,9,0,11
57,234,422,99,323,16,307,7,89,92,30,6,0,2,31,13,37
57,235,861,149,712,24,688,10,255,162,53,15,7,1,60,16,109
57,236,45,6,39,1,38,0,15,16,1,2,0,0,2,1,1
57,237,249,39,210,3,207,3,52,75,14,3,3,0,17,3,37
57,238,138,18,120,2,118,2,24,39,4,0,2,0,22,3,22
57,239,329,50,279,4,275,5,81,93,24,4,1,0,32,13,22
57,240,9163,2424,6739,108,6631,83,2250,1353,595,87,51,15,436,91,1670
57,241,137,10,127,2,125,1,37,51,7,0,2,0,16,2,9
57,242,2152,438,1714,30,1684,21,474,320,163,29,19,3,128,27,500
57,244,426,78,348,4,344,3,95,116,28,11,2,0,27,10,52
57,245,446,62,384,7,377,10,93,106,29,3,1,6,33,7,89
57,246,200,36,164,6,158,1,35,57,20,3,2,1,16,5,18
57,247,97,14,83,0,83,5,32,17,7,0,0,0,3,0,19
57,248,87,21,66,0,66,2,21,16,3,4,1,0,9,4,6
57,249,222,35,187,8,179,4,39,39,10,1,2,0,22,7,55
57,250,1350,303,1047,21,1026,20,303,205,101,20,11,3,86,15,262
57,251,285,57,228,2,226,3,68,54,21,2,3,0,27,4,44
57,252,427,78,349,8,341,2,94,88,26,7,1,1,50,5,67
57,253,370,61,309,6,303,5,87,92,20,4,3,0,33,6,53
57,254,725,133,592,16,576,14,147,138,56,5,6,0,57,7,146
57,255,505,86,419,8,411,8,134,100,25,12,8,1,50,7,66
57,256,587,98,489,2,487,6,121,166,49,5,3,0,31,5,101
57,257,89,15,74,2,72,0,19,28,3,3,1,0,4,0,14
57,258,120,28,92,1,91,0,27,31,6,0,0,1,7,3,16
57,259,264,59,205,3,202,4,30,71,11,3,2,0,42,8,31
57,260,2259,510,1749,41,1708,28,471,489,142,22,13,1,168,33,341
57,261,1049,186,863,21,842,5,282,237,51,16,9,2,83,10,147
57,262,513,94,419,15,404,6,100,145,17,5,6,0,56,7,62
57,263,525,106,419,7,412,4,140,122,16,6,3,3,35,13,70
57,264,333,68,265,1,264,4,89,57,22,4,3,1,27,10,47
57,265,38,7,31,2,29,0,8,5,0,0,1,0,7,0,8
57,266,127,20,107,1,106,4,29,31,12,4,4,1,12,1,8
57,267,721,139,582,17,565,11,185,137,40,20,9,2,56,13,92
57,268,132,43,89,2,87,1,37,10,8,2,0,0,15,1,13
57,269,5482,1304,4178,75,4103,43,1011,726,508,53,51,15,311,73,1312
57,270,455,75,380,7,373,6,112,86,27,14,5,2,29,6,86
57,271,533,81,452,6,446,3,145,129,32,13,5,0,41,4,74
57,272,80,17,63,0,63,2,19,16,6,1,0,0,7,0,12
57,273,243,57,186,2,184,7,44,54,14,4,1,0,14,9,37
57,274,685,104,581,9,572,6,157,121,56,7,2,0,59,20,144
57,275,769,111,658,15,643,14,182,167,42,12,6,2,69,6,143
57,276,215,25,190,5,185,4,45,71,13,1,0,2,13,4,32
57,277,122,15,107,2,105,5,10,18,8,2,1,0,10,2,49
57,278,49,4,45,1,44,0,5,28,0,0,0,0,8,0,3
57,280,297,43,254,6,248,1,70,69,22,6,3,0,31,9,37
57,281,157,35,122,2,120,1,34,47,3,3,2,0,13,2,15
57,282,206,52,154,1,153,10,32,53,8,0,0,0,24,4,22
57,283,6974,1496,5478,106,5372,90,1298,1100,658,93,45,16,411,75,1586
57,284,100,18,82,2,80,2,29,17,12,0,0,0,3,4,13
57,286,213,47,166,3,163,1,41,44,20,0,3,0,22,3,29
57,287,1746,328,1418,35,1383,25,307,400,104,20,14,3,156,29,325
57,288,1971,371,1600,37,1563,25,489,359,134,23,13,2,133,34,351
57,289,2148,372,1776,41,1735,33,578,490,113,17,15,3,166,35,285
57,290,155,32,123,0,123,2,22,41,9,2,0,0,9,1,37
57,291,233,36,197,5,192,1,78,55,10,0,4,0,22,2,20
57,292,15,4,11,0,11,1,2,3,1,0,0,0,3,1,0
57,293,175,21,154,4,150,1,50,30,12,1,0,0,15,3,38
57,294,147,29,118,1,117,0,43,25,4,2,1,2,11,2,27
57,295,113,19,94,2,92,5,18,28,5,1,1,0,12,2,20
57,296,760,120,640,11,629,8,212,131,45,6,3,2,61,15,146
57,297,170,28,142,4,138,3,28,39,14,6,1,0,18,0,29
57,298,296,58,238,1,237,7,74,56,20,4,2,1,22,3,48
57,299,749,113,636,19,617,7,215,181,42,8,9,0,50,18,87
57,300,256,37,219,6,213,3,70,65,14,5,0,0,15,8,33
57,301,250,40,210,4,206,1,59,46,13,2,2,0,27,7,49
57,302,162,34,128,4,124,2,33,58,7,2,0,1,9,2,10
57,303,423,83,340,7,333,5,77,83,35,6,6,0,23,13,85
57,304,268,45,223,3,220,5,71,59,23,2,3,2,21,3,31
57,305,310,62,248,5,243,12,44,69,30,3,5,0,18,8,54
57,306,11294,3099,8195,140,8055,107,2164,1498,1097,137,71,18,513,136,2314
57,307,180,21,159,5,154,4,27,57,15,2,0,0,18,2,29
57,308,99,8,91,2,89,0,21,37,1,2,2,0,8,3,15
57,309,300,51,249,5,244,5,60,72,14,2,5,0,12,7,67
57,310,163,38,125,2,123,4,55,40,6,0,1,1,7,5,4
57,311,466,66,400,6,394,6,93,126,34,8,4,1,51,8,63
57,312,359,58,301,10,291,4,77,79,27,8,2,0,39,7,48
57,313,121,18,103,0,103,2,14,35,5,1,0,0,14,4,28
57,314,354,85,269,10,259,2,73,60,14,8,2,1,32,2,65
57,315,514,66,448,11,437,12,126,145,17,8,4,3,48,12,62
57,316,618,116,502,8,494,4,180,145,25,4,1,1,54,11,69
57,317,95,9,86,0,86,3,11,44,2,0,0,0,15,3,8
57,318,198,29,169,4,165,4,37,59,13,1,1,0,14,4,32
57,319,380,47,333,2,331,6,88,82,27,4,2,0,24,10,88
57,320,166,32,134,3,131,0,51,45,8,0,2,0,5,0,20
57,321,487,79,408,7,401,5,108,130,28,5,4,2,52,6,61
57,322,355,62,293,4,289,2,75,66,26,6,2,1,38,2,71
57,323,5430,1137,4293,68,4225,94,848,1356,351,46,18,14,469,79,950
57,324,474,68,406,9,397,3,132,114,25,6,9,0,49,7,52
57,325,633,86,547,8,539,7,186,153,38,12,5,4,46,21,67
57,326,214,28,186,4,182,0,67,51,15,5,3,0,12,1,28
57,328,52,10,42,0,42,0,10,13,3,0,0,1,6,1,8
57,329,326,56,270,10,260,6,86,78,21,3,0,0,29,4,33
57,330,1007,205,802,10,792,8,272,169,72,11,8,0,75,13,164
57,331,359,64,295,4,291,4,78,84,25,5,3,1,24,1,66
57,332,4924,1150,3774,78,3696,44,1173,766,301,42,33,12,280,48,997
57,333,695,122,573,12,561,8,169,150,27,5,4,2,80,19,97
57,334,311,58,253,3,250,2,84,79,21,6,4,4,19,5,26
57,335,171,30,141,2,139,2,42,46,11,5,0,0,16,6,11
57,336,3846,963,2883,45,2838,31,1099,541,224,55,28,10,217,53,580
57,337,525,100,425,15,410,8,124,88,37,5,5,0,44,16,83
57,338,487,98,389,11,378,5,112,139,25,4,2,1,41,11,38
57,339,325,55,270,5,265,4,87,61,20,4,5,0,21,7,56
57,340,1211,247,964,28,936,15,285,258,58,6,13,7,105,16,173
57,341,571,106,465,10,455,6,82,140,50,10,0,2,60,9,96
57,342,75,16,59,1,58,1,23,18,1,1,0,0,7,1,6
57,343,1668,253,1415,30,1385,26,277,390,133,24,14,6,138,31,346
57,344,589,124,465,10,455,9,148,142,28,6,4,3,44,9,62
57,345,320,46,274,4,270,5,80,85,25,2,1,1,31,4,36
57,346,484,67,417,8,409,3,138,99,23,13,9,0,46,8,70
57,347,162,42,120,1,119,5,36,40,13,2,1,0,7,4,11
57,348,647,129,518,22,496,5,138,144,41,2,2,2,54,18,90
57,349,116,24,92,3,89,2,14,28,9,1,1,0,8,4,22
57,350,1236,173,1063,14,1049,21,218,346,60,7,5,2,130,30,230
57,351,718,76,642,10,632,13,126,172,49,12,3,1,93,18,145
57,352,430,70,360,8,352,15,52,120,33,2,4,0,49,7,70
57,353,75,10,65,0,65,0,19,18,8,1,0,0,9,1,9
57,354,93,26,67,0,67,0,17,16,7,3,1,0,6,2,15
57,355,676,103,573,22,551,7,199,130,33,8,8,1,77,16,72
57,356,821,156,665,20,645,14,100,230,56,9,10,1,83,13,129
57,357,337,50,287,11,276,5,90,73,19,4,2,1,31,5,46
57,358,884,179,705,15,690,12,168,213,63,6,6,1,74,10,137
57,359,114,27,87,4,83,3,23,28,3,3,0,0,12,3,8
57,360,768,101,667,12,655,7,170,170,68,7,3,1,76,15,138
57,361,431,70,361,10,351,7,73,119,19,2,5,0,44,10,72
57,362,112,20,92,1,91,1,20,37,8,1,1,0,3,2,18
57,364,232,47,185,6,179,5,41,72,9,3,1,0,24,2,22
57,365,367,45,322,5,317,3,57,122,23,9,3,0,44,8,48
57,366,94,17,77,2,75,0,21,13,11,3,0,0,12,6,9
57,367,183,37,146,6,140,3,44,33,13,4,3,1,8,2,29
57,368,2397,712,1685,27,1658,28,427,314,269,31,13,5,92,21,458
57,370,1691,383,1308,35,1273,22,346,360,102,20,13,2,149,32,227
57,371,423,74,349,14,335,6,118,78,25,7,3,0,37,12,49
57,372,920,139,781,23,758,20,151,143,77,14,3,4,89,18,239
57,373,571,55,516,10,506,15,143,122,34,7,3,1,50,6,125
57,374,170,24,146,2,144,3,51,40,14,2,0,1,8,6,19
57,375,163,18,145,3,142,4,33,58,5,2,0,0,15,2,23
57,376,433,89,344,7,337,3,116,65,18,12,4,2,33,2,82
57,377,191,36,155,5,150,2,44,52,8,3,2,1,9,4,25
57,379,212,38,174,3,171,6,52,57,15,0,2,0,12,3,24
57,380,81,11,70,1,69,1,28,21,3,1,0,1,4,1,9
57,381,201,29,172,5,167,5,58,38,14,1,0,0,12,0,39
57,382,401,69,332,9,323,1,102,122,15,3,5,0,26,7,42
57,383,151,22,129,3,126,6,30,39,7,1,2,2,23,0,16
57,384,419,64,355,5,350,7,94,106,38,5,0,2,29,10,59
57,385,828,74,754,13,741,13,153,205,72,13,4,0,85,20,176
57,386,293,46,247,3,244,5,57,58,28,1,1,0,33,2,59
57,387,223,58,165,2,163,1,64,42,15,2,1,0,15,2,21
57,388,160,42,118,4,114,3,23,28,7,2,0,1,23,1,26
57,389,389,43,346,9,337,5,116,93,21,8,4,0,30,11,49
57,390,1123,224,899,21,878,19,283,215,71,10,5,2,83,15,175
57,391,61,7,54,3,51,0,10,17,6,0,1,1,3,0,13
57,392,247,30,217,3,214,2,60,59,25,3,0,1,18,2,44
57,393,171,23,148,11,137,1,36,48,9,2,3,0,20,0,18
57,394,231,46,185,4,181,1,48,49,18,2,1,0,18,4,40
57,395,147,21,126,3,123,1,37,41,13,1,1,2,10,2,15
57,396,650,69,581,13,568,15,70,221,46,3,4,0,72,4,133
57,397,104,11,93,1,92,4,15,40,6,1,1,0,11,1,13
57,398,364,47,317,3,314,5,128,92,15,1,2,1,37,5,28
57,399,72,19,53,2,51,1,9,19,6,0,0,1,8,1,6
57,401,77,13,64,2,62,0,32,15,4,0,0,0,5,1,5
57,402,81,22,59,1,58,3,9,23,2,1,1,0,7,0,12
57,403,119,16,103,1,102,2,24,44,4,2,0,0,12,1,13
57,404,223,44,179,5,174,1,41,44,15,3,1,1,21,6,41
57,405,44,4,40,2,38,1,11,8,4,0,0,0,4,0,10
57,406,110,14,96,0,96,4,18,32,14,0,2,0,12,0,14
57,407,417,69,348,13,335,6,136,90,18,6,2,0,33,3,41
57,408,715,146,569,20,549,6,145,139,44,11,8,2,83,27,84
57,409,596,121,475,4,471,2,135,137,29,4,8,1,64,15,76
57,410,97,27,70,4,66,0,22,23,2,1,2,0,7,0,9
57,411,223,39,184,6,178,1,61,43,12,4,1,0,18,3,35
57,412,2932,703,2229,33,2196,59,393,733,193,27,15,9,254,30,483
57,413,2865,592,2273,42,2231,43,740,531,172,44,16,5,215,52,413
57,414,870,180,690,21,669,17,191,182,39,8,10,3,52,13,154
57,415,1376,221,1155,20,1135,42,156,372,100,6,1,3,132,19,304
57,416,470,49,421,3,418,4,105,123,28,3,4,3,49,13,86
57,417,64,4,60,1,59,0,16,27,5,1,2,0,7,0,1
57,418,227,41,186,3,183,2,70,36,5,6,2,1,30,1,30
57,419,855,169,686,10,676,16,206,160,49,5,3,4,79,8,146
57,421,114,34,80,5,75,0,19,22,6,4,1,1,9,2,11
57,422,657,116,541,8,533,10,134,180,40,7,4,0,51,13,94
57,423,51,1,50,1,49,1,19,12,3,0,1,1,5,0,7
57,424,200,37,163,3,160,1,44,38,12,4,3,2,16,10,30
57,425,451,76,375,3,372,10,102,123,26,3,1,0,22,9,76
57,426,694,110,584,8,576,14,160,151,47,11,3,0,67,6,117
57,427,540,112,428,3,425,7,124,143,26,6,6,0,48,4,61
57,428,2471,523,1948,37,1911,25,501,522,172,19,17,2,200,22,431
57,430,242,51,191,0,191,0,59,36,17,3,1,1,27,8,39
57,431,241,27,214,7,207,6,31,53,32,1,2,0,31,3,48
57,432,134,11,123,3,120,0,33,44,11,0,0,0,13,0,19
57,433,7795,1654,6141,87,6054,64,1395,1247,666,83,54,16,422,113,1994
57,434,336,42,294,4,290,5,88,67,35,11,3,0,30,7,44
57,436,112,14,98,5,93,2,25,27,8,3,0,0,12,0,16
57,437,450,72,378,6,372,5,80,114,31,4,4,2,32,11,89
57,438,334,42,292,4,288,2,42,121,22,1,1,0,36,6,57
57,439,348,70,278,11,267,11,47,108,17,4,6,0,27,6,41
57,440,113,18,95,2,93,1,37,28,8,1,2,1,6,0,9
57,441,2443,657,1786,53,1733,37,277,493,184,20,16,2,197,31,476
57,442,207,32,175,1,174,3,48,39,15,2,0,0,21,3,43
57,443,4423,816,3607,64,3543,71,855,671,404,50,22,9,278,66,1117
57,444,243,39,204,4,200,2,78,48,15,3,0,0,24,4,26
57,445,588,91,497,8,489,22,88,150,45,6,4,0,63,7,104
57,446,45,7,38,0,38,0,7,16,2,1,0,0,2,1,9
57,447,8491,1686,6805,106,6699,119,1148,2467,450,65,29,18,759,120,1524
57,448,227,33,194,2,192,4,39,53,21,1,0,0,22,11,41
57,449,402,74,328,10,318,0,74,84,30,4,1,1,43,3,78
57,451,157,19,138,2,136,1,43,37,10,2,5,0,8,1,29
57,452,715,109,606,6,600,8,122,209,59,5,4,2,68,4,119
57,453,247,42,205,4,201,5,69,53,10,5,2,0,18,5,34
57,454,997,125,872,12,860,23,165,301,81,10,2,5,94,20,159
57,455,156,35,121,2,119,2,35,21,13,0,1,2,5,0,40
57,456,622,97,525,15,510,11,122,145,41,7,10,1,44,5,124
57,457,103,16,87,0,87,1,29,21,9,0,1,0,6,4,16
57,459,154,32,122,1,121,2,30,50,5,0,2,0,7,3,22
57,460,1063,275,788,11,777,5,249,191,51,10,7,4,83,17,160
57,461,236,48,188,6,182,1,74,40,13,1,2,0,14,2,35
57,462,242,45,197,8,189,1,62,65,6,0,0,0,17,1,37
57,463,70833,19792,51041,790,50251,1286,8677,13432,5499,549,276,131,5065,810,14526
57,464,643,91,552,13,539,6,122,154,37,6,4,0,41,13,156
57,465,1434,240,1194,37,1157,17,255,356,114,13,8,3,123,23,245
57,466,525,129,396,9,387,9,99,113,33,8,6,1,33,8,77
57,467,220,37,183,2,181,5,24,58,20,5,0,0,21,1,47
57,468,558,104,454,5,449,9,148,127,15,2,6,0,46,9,87
57,469,471,96,375,9,366,8,111,123,17,7,5,0,37,6,52
57,470,11,0,11,1,10,0,3,0,0,0,0,0,1,6,0
57,471,212,27,185,1,184,1,54,56,15,4,1,0,20,2,31
57,472,101,23,78,1,77,0,18,21,2,0,0,0,12,1,23
57,473,63,15,48,0,48,0,17,12,1,0,1,0,4,1,12
57,474,4139,928,3211,65,3146,29,799,691,341,52,30,9,239,62,894
57,475,346,95,251,3,248,10,45,83,22,4,2,0,20,6,56
57,476,266,51,215,6,209,4,64,71,12,3,0,2,16,6,31
57,477,1289,216,1073,26,1047,23,277,308,70,17,7,1,110,33,201
57,478,66,11,55,1,54,2,12,15,11,1,0,0,2,1,10
57,479,340,57,283,12,271,13,70,77,18,6,2,2,44,2,37
57,480,15989,3689,12300,199,12101,254,2402,3448,1216,150,88,32,1234,209,3068
57,481,1886,356,1530,30,1500,14,369,267,181,22,7,3,100,14,523
57,482,900,126,774,11,763,6,155,248,48,10,3,2,88,11,192
57,483,2347,572,1775,48,1727,19,387,437,179,17,18,3,134,13,520
57,484,1987,456,1531,26,1505,12,486,390,108,15,13,0,115,21,345
57,485,88,12,76,1,75,0,16,29,4,0,2,0,12,1,11
57,486,108,26,82,3,79,0,20,24,10,1,0,0,10,1,13
57,487,3794,809,2985,52,2933,55,587,886,306,37,23,7,270,57,705
57,488,469,82,387,7,380,9,131,95,21,7,5,5,24,7,76
57,489,230,43,187,4,183,1,58,31,18,2,3,0,23,2,45
57,490,245,30,215,7,208,6,46,72,18,4,1,1,15,5,40
57,491,5807,1600,4207,51,4156,49,1040,499,726,79,34,9,218,50,1452
57,492,379,73,306,5,301,5,89,71,28,7,3,1,19,9,69
57,493,192,35,157,3,154,1,36,33,13,1,1,1,20,3,45
57,494,190,36,154,4,150,2,50,42,11,1,3,0,17,3,21
57,495,105,17,88,0,88,4,15,38,1,0,0,0,9,0,21
57,496,266,61,205,4,201,4,49,47,20,5,0,1,14,3,58
57,497,253,60,193,2,191,1,67,72,7,6,2,0,12,1,23
57,498,1884,329,1555,29,1526,15,383,348,193,22,11,6,121,39,388
57,499,1046,195,851,22,829,17,218,247,60,14,9,2,103,22,137
57,500,34,3,31,0,31,0,6,9,4,2,0,1,2,1,6
57,501,48,14,34,1,33,0,11,5,3,1,0,0,5,0,8
57,502,193,46,147,3,144,6,25,38,13,4,1,2,22,4,29
57,504,249,57,192,5,187,1,68,49,19,2,1,0,15,5,27
57,505,910,147,763,16,747,6,239,240,39,9,7,0,70,18,119
57,506,230,46,184,5,179,1,57,62,6,3,3,1,14,1,31
57,507,185,28,157,4,153,1,36,56,9,3,0,0,28,3,17
57,508,3983,1219,2764,49,2715,33,671,467,440,40,30,8,143,37,846
57,509,430,63,367,11,356,3,82,116,22,3,3,4,31,8,84
57,510,849,115,734,12,722,8,162,214,62,8,4,2,71,14,177
57,511,877,161,716,6,710,16,150,173,77,5,6,4,66,13,200
57,512,390,52,338,5,333,6,68,114,22,0,1,0,29,10,83
57,513,125,17,108,4,104,4,37,24,4,4,1,0,14,1,15
57,514,872,139,733,18,715,16,219,200,40,9,6,3,74,10,138
57,515,1422,287,1135,26,1109,27,274,239,114,17,20,1,112,38,267
57,516,335,62,273,9,264,3,62,51,24,4,1,1,32,6,80
57,517,231,38,193,2,191,5,60,55,9,6,1,1,23,6,25
57,518,274,33,241,7,234,4,67,72,20,2,3,0,25,4,37
57,519,136,22,114,2,112,2,36,31,12,1,0,0,12,1,17
57,520,41,9,32,1,31,1,6,7,4,2,1,0,3,0,7
57,521,1772,308,1464,28,1436,23,407,497,92,10,7,2,116,35,247
57,523,455,68,387,4,383,7,91,104,31,7,3,1,41,11,87
57,524,80,18,62,2,60,0,13,18,1,0,0,0,13,1,14
57,525,51,10,41,0,41,0,6,19,5,0,0,1,2,1,7
57,526,263,50,213,3,210,1,63,57,18,7,3,1,20,8,32
57,527,248,43,205,1,204,6,45,71,10,5,1,2,25,3,36
57,528,94,22,72,2,70,1,16,18,5,2,0,0,10,3,15
57,529,1924,474,1450,30,1420,17,346,252,270,32,14,2,89,23,375
57,530,333,43,290,5,285,4,98,76,16,1,2,0,32,2,54
57,531,601,104,497,12,485,10,130,116,46,12,4,0,58,15,94
57,532,174,32,142,1,141,6,36,45,11,2,2,0,13,2,24
57,533,822,128,694,10,684,22,115,222,59,4,8,0,69,18,167
57,534,1369,170,1199,14,1185,26,213,388,94,7,4,8,144,27,274
57,535,1253,226,1027,28,999,10,284,307,59,20,9,1,123,25,161
57,536,181,25,156,1,155,2,34,56,14,2,4,0,25,1,17
57,537,4340,1169,3171,49,3122,44,1065,727,280,50,13,7,210,46,680
57,538,230,30,200,3,197,1,48,64,30,2,1,1,21,1,28
57,539,47,7,40,2,38,0,13,10,4,0,0,0,4,1,6
57,540,3310,752,2558,52,2506,53,601,825,155,29,14,8,264,69,488
57,541,454,81,373,12,361,4,122,92,16,6,7,2,44,9,59
57,542,621,90,531,5,526,10,180,92,63,8,6,1,61,12,93
57,543,1114,163,951,18,933,14,221,228,78,5,5,2,90,15,275
57,544,447,70,377,7,370,6,122,103,31,6,1,2,47,5,47
57,545,1841,320,1521,17,1504,43,190,553,95,8,8,6,216,14,371
57,546,632,62,570,13,557,12,77,221,39,2,3,1,60,7,135
57,547,577,102,475,6,469,11,116,146,28,4,5,1,52,4,102
57,548,354,72,282,9,273,9,76,62,23,6,2,1,22,8,64
57,549,608,118,490,4,486,9,125,143,40,5,2,0,39,11,112
57,550,2227,432,1795,28,1767,27,498,481,155,15,13,4,191,23,360
57,551,144,21,123,5,118,2,24,32,14,3,2,0,19,4,18
57,552,602,102,500,15,485,7,83,165,44,3,3,1,66,14,99
57,553,524,63,461,6,455,3,117,160,25,3,1,0,41,10,95
57,554,463,64,399,5,394,7,82,139,20,3,1,1,41,5,95
57,555,91,6,85,1,84,2,20,18,6,0,0,0,16,2,20
57,556,2105,448,1657,36,1621,13,516,413,132,20,16,4,123,30,354
57,557,591,117,474,8,466,10,122,164,29,5,3,0,46,13,74
57,558,81,23,58,2,56,0,14,19,2,0,0,0,8,0,13
57,559,158,24,134,1,133,3,34,25,19,4,0,0,13,2,33
57,560,425,52,373,6,367,5,93,100,26,8,3,0,33,5,94
57,561,667,113,554,8,546,3,191,172,23,16,8,3,63,15,52
57,562,614,109,505,10,495,10,119,145,48,10,2,3,44,5,109
57,563,185,22,163,3,160,4,38,33,8,2,2,0,15,6,52
57,564,560,146,414,12,402,6,127,79,26,3,4,1,42,6,108
57,565,618,171,447,3,444,8,82,94,96,5,2,1,40,9,107
57,566,1943,337,1606,48,1558,20,446,483,89,21,14,7,182,34,262
57,567,140,24,116,2,114,2,38,19,10,0,1,1,17,0,26
57,568,1104,160,944,16,928,13,284,247,67,8,11,4,109,14,171
57,569,220,34,186,3,183,8,52,58,7,9,1,0,21,3,24
57,570,336,79,257,6,251,2,85,66,22,1,1,1,31,4,38
57,571,782,134,648,11,637,8,205,161,44,12,5,2,59,16,125
57,572,1668,274,1394,28,1366,27,338,412,98,22,9,3,169,30,258
57,573,109,23,86,5,81,0,24,25,4,0,1,0,14,1,12
57,574,307,82,225,3,222,4,37,75,11,4,1,0,36,7,47
57,575,1100,157,943,16,927,16,196,290,80,12,4,5,117,12,195
57,576,533,70,463,10,453,9,112,134,21,8,7,0,47,12,103
57,577,337,65,272,7,265,5,67,105,17,2,1,0,29,5,34
57,578,293,36,257,2,255,2,65,78,27,5,4,0,26,6,42
57,579,99,26,73,0,73,1,11,43,0,0,1,0,2,1,14
57,580,161,36,125,1,124,2,34,27,7,3,0,0,12,0,39
57,581,273,39,234,3,231,3,83,60,14,8,0,2,21,11,29
57,582,1535,347,1188,30,1158,12,304,293,102,13,1,2,115,13,303
57,583,108,20,88,1,87,2,28,36,4,1,0,0,11,0,5
57,584,391,62,329,4,325,5,73,100,20,7,2,0,56,9,53
57,585,129,44,85,3,82,2,10,30,5,2,1,0,12,6,14
57,586,141,25,116,3,113,3,37,28,11,0,0,1,11,3,19
57,587,192,29,163,0,163,6,41,52,17,3,2,0,10,3,29
57,588,752,115,637,11,626,17,81,170,55,12,3,3,123,8,154
57,589,1696,312,1384,34,1350,30,392,403,62,18,16,2,164,24,239
57,590,178,44,134,4,130,1,34,48,8,5,2,0,16,4,12
57,591,6564,1610,4954,86,4868,69,1145,947,628,84,42,12,328,65,1548
57,592,309,54,255,9,246,6,84,74,12,2,1,1,23,7,36
57,593,705,92,613,4,609,15,186,124,75,3,6,2,33,14,151
57,594,88,20,68,0,68,0,31,21,6,0,0,0,4,0,6
57,595,48,10,38,0,38,0,21,7,0,0,0,0,1,2,7
57,596,609,166,443,5,438,4,142,146,28,2,2,1,34,4,75
57,597,2020,541,1479,26,1453,23,443,210,206,34,11,0,74,12,440
57,598,1565,294,1271,35,1236,31,338,270,113,34,14,1,112,33,290
57,599,291,41,250,5,245,3,67,68,17,4,2,1,21,9,53
57,600,815,152,663,6,657,26,124,242,46,11,6,1,68,13,120
57,601,1142,222,920,12,908,16,155,339,55,5,5,2,112,15,204
57,602,1811,275,1536,24,1512,19,338,429,131,32,7,5,160,39,352
57,603,759,152,607,9,598,10,125,154,81,5,4,0,46,15,158
57,604,407,82,325,7,318,3,59,107,33,6,4,0,36,8,62
57,605,210,45,165,3,162,5,39,34,22,2,2,1,20,1,36
57,606,11967,2859,9108,123,8985,152,2400,2185,939,127,61,29,775,159,2158
57,607,600,77,523,6,517,14,106,167,40,7,2,2,57,16,106
57,609,93,12,81,1,80,0,13,14,9,0,2,0,11,4,27
57,610,187,44,143,5,138,3,45,36,9,1,1,0,12,7,24
57,611,177,24,153,1,152,7,41,59,5,2,0,0,8,3,27
57,612,187,32,155,0,155,5,40,53,16,1,0,0,13,2,25
57,613,268,54,214,3,211,2,36,109,7,3,2,2,18,6,26
57,614,221,40,181,2,179,4,65,48,8,2,1,0,22,3,26
57,615,690,127,563,10,553,5,190,162,27,5,2,0,54,6,102
57,616,2479,477,2002,40,1962,61,291,727,159,21,13,7,208,50,425
57,617,238,37,201,2,199,4,54,50,30,0,2,0,21,5,33
57,618,573,106,467,10,457,9,156,93,26,7,6,0,66,17,77
57,619,433,92,341,11,330,5,92,78,35,6,6,0,36,10,62
57,620,2846,519,2327,43,2284,15,550,485,295,17,13,4,159,35,711
57,621,96,26,70,2,68,4,24,11,4,2,0,0,7,0,16
57,622,1327,242,1085,10,1075,14,257,207,110,16,7,1,92,19,352
57,623,575,155,420,11,409,10,116,100,44,12,3,2,31,13,78
57,624,459,76,383,4,379,10,37,163,22,7,2,3,45,6,84
57,625,135,26,109,4,105,0,31,27,6,2,0,1,14,6,18
57,626,458,78,380,13,367,7,83,92,39,9,5,2,49,9,72
57,627,283,29,254,4,250,6,74,45,20,3,1,0,32,7,62
57,628,3059,689,2370,46,2324,39,699,589,198,39,25,11,218,47,459
57,629,614,110,504,13,491,8,152,144,24,6,7,0,57,9,84
57,630,7876,1853,6023,123,5900,133,1294,1972,381,72,31,25,594,113,1285
57,631,14910,4013,10897,188,10709,197,2668,2873,904,145,73,30,1007,194,2618
57,633,973,189,784,15,769,11,227,209,47,12,5,1,88,18,151
57,634,1199,154,1045,15,1030,21,206,322,85,4,3,4,143,10,232
57,635,269,48,221,4,217,0,53,92,10,2,0,0,30,5,25
57,636,302,54,248,8,240,3,56,85,17,5,3,0,25,9,37
57,637,272,40,232,2,230,2,73,71,15,0,1,1,18,6,43
57,638,1585,283,1302,26,1276,28,410,326,89,17,7,3,85,18,293
57,639,456,81,375,8,367,3,92,130,15,6,9,5,53,9,45
57,640,317,36,281,9,272,5,47,112,35,2,2,2,26,3,38
57,641,209,24,185,3,182,2,45,69,13,5,3,0,23,1,21
57,642,2149,414,1735,28,1707,40,318,598,142,23,9,2,199,22,354
57,643,149,26,123,1,122,1,42,36,10,0,0,1,17,1,14
57,644,1484,243,1241,31,1210,15,343,298,101,13,10,4,106,21,299
57,645,728,100,628,6,622,9,150,163,49,5,7,5,62,11,161
57,647,3242,762,2480,61,2419,29,607,427,267,34,18,5,142,52,838
57,648,295,34,261,3,258,3,67,71,17,3,0,1,37,6,53
57,649,358,45,313,3,310,13,72,86,30,5,2,0,29,7,66
57,650,1303,335,968,21,947,22,221,264,96,15,8,2,115,18,186
57,651,521,97,424,14,410,2,113,123,25,7,6,0,47,14,73
57,652,341,47,294,4,290,8,49,109,21,2,0,0,35,7,59
57,653,35,5,30,1,29,0,10,8,1,1,0,0,6,2,1
57,654,597,88,509,7,502,6,112,145,40,7,3,5,66,15,103
57,655,794,144,650,13,637,5,168,186,42,12,0,1,47,19,157
57,656,254,38,216,3,213,4,57,49,22,2,3,0,18,4,54
57,657,22,3,19,0,19,1,7,7,1,1,0,0,0,0,2
57,658,1028,207,821,32,789,5,234,223,62,20,2,2,56,21,164
57,659,1976,369,1607,33,1574,28,418,445,78,11,16,2,187,32,357
57,660,8294,2186,6108,116,5992,61,1982,1281,493,95,60,10,345,96,1569
57,661,137,25,112,1,111,1,31,27,5,0,0,0,13,5,29
57,662,90,5,85,0,85,0,5,34,14,2,0,0,11,1,18
57,663,5584,1551,4033,82,3951,41,893,662,587,60,29,15,286,65,1313
57,664,67,11,56,1,55,3,23,17,1,1,1,0,2,0,7
57,665,886,148,738,13,725,9,242,196,60,6,9,2,75,12,114
57,666,5045,1224,3821,75,3746,80,749,841,477,56,28,11,329,62,1113
57,667,489,71,418,10,408,3,125,92,37,4,3,2,29,5,108
57,668,987,154,833,12,821,11,206,190,75,15,7,3,75,15,224
57,669,1631,279,1352,26,1326,14,363,320,101,11,17,1,87,22,390
57,670,124,11,113,5,108,0,35,30,12,0,2,0,8,1,20
57,671,125,15,110,4,106,2,33,41,6,1,2,1,9,0,11
57,672,26719,6216,20503,333,20170,460,3458,6089,2092,238,106,57,2078,336,5256
57,673,34,3,31,3,28,0,3,9,3,3,1,0,7,0,2
57,674,141,21,120,2,118,3,28,36,7,4,2,2,11,2,23
57,675,132,29,103,0,103,4,39,25,4,0,0,0,9,2,20
57,676,84,7,77,0,77,0,23,33,6,0,0,0,5,0,10
57,677,877,133,744,16,728,5,173,190,78,10,10,1,59,19,183
57,678,1502,305,1197,21,1176,24,225,281,159,21,4,1,85,20,356
57,679,402,68,334,5,329,9,91,87,35,5,2,0,25,3,72
57,680,1070,202,868,16,852,13,305,222,60,13,6,6,67,25,135
57,681,265,48,217,3,214,1,44,47,25,6,5,0,29,3,54
57,682,37,7,30,0,30,2,5,11,0,2,0,0,7,0,3
57,683,3969,1080,2889,63,2826,32,622,481,381,48,21,7,138,58,1038
57,684,411,50,361,15,346,5,106,91,35,2,4,1,42,0,60
57,685,101,8,93,2,91,0,25,43,4,0,0,0,10,1,8
57,686,199,37,162,1,161,3,32,60,13,3,1,0,18,6,25
57,687,186,23,163,5,158,0,59,57,15,6,1,0,10,0,10
57,689,188,43,145,3,142,1,28,43,17,3,2,0,15,3,30
57,690,2380,547,1833,30,1803,21,464,502,156,18,11,7,143,26,455
57,691,72,3,69,5,64,1,11,27,6,0,0,0,8,4,7
57,692,62,10,52,3,49,2,11,17,1,3,2,0,5,1,7
57,693,751,141,610,12,598,8,84,173,40,7,5,2,99,8,172
57,694,261,27,234,3,231,6,40,75,16,3,0,0,32,9,50
57,695,365,34,331,6,325,6,80,114,21,1,0,2,43,9,49
57,696,744,120,624,5,619,10,199,163,45,8,4,3,56,13,118
57,697,233,30,203,3,200,4,48,67,19,2,0,0,21,5,34
57,698,275,40,235,6,229,2,81,63,22,3,1,0,17,3,37
57,700,410,73,337,5,332,4,97,85,38,4,3,3,45,4,49
57,701,707,124,583,5,578,11,91,208,48,4,0,0,68,10,138
57,702,85,12,73,1,72,1,17,28,4,0,0,0,9,0,13
57,703,206,23,183,4,179,1,65,45,14,4,2,0,26,4,18
57,704,535,86,449,11,438,6,129,108,47,10,2,0,39,13,84
57,705,189,34,155,7,148,0,45,41,9,2,2,0,10,7,32
57,706,439,67,372,10,362,5,119,89,17,6,3,2,23,11,87
57,707,530,96,434,25,409,12,126,105,32,5,2,2,32,8,85
57,708,1494,214,1280,20,1260,13,313,381,110,10,6,4,137,26,260
57,709,192,25,167,3,164,3,65,47,4,2,1,0,14,5,23
57,711,350,63,287,9,278,6,83,93,10,9,6,1,28,5,37
57,712,1019,175,844,17,827,12,161,214,100,11,7,4,80,7,231
57,713,177,32,145,1,144,1,54,36,11,1,1,0,24,1,15
57,714,333,55,278,3,275,4,85,68,17,4,1,0,37,11,48
57,715,268,55,213,7,206,1,62,43,16,2,1,1,23,4,53
57,716,1182,155,1027,12,1015,18,254,302,82,8,5,4,112,15,215
57,717,165,26,139,3,136,5,36,31,18,2,3,0,18,3,20
57,718,181,21,160,5,155,1,45,44,7,1,3,2,24,1,27
57,719,46,7,39,0,39,0,11,6,3,3,0,0,3,3,10
57,720,261,53,208,3,205,4,80,58,10,4,1,1,16,4,27
57,721,308,73,235,6,229,2,85,64,5,2,4,0,26,5,36
57,722,134,38,96,2,94,0,28,23,10,0,1,1,10,6,15
57,723,216,40,176,2,174,8,36,59,8,1,3,0,39,6,14
57,724,2025,386,1639,23,1616,27,432,317,231,29,14,4,107,29,426
57,725,247,31,216,7,209,4,65,69,15,2,2,2,27,5,18
57,726,292,31,261,5,256,5,71,81,23,1,3,1,19,5,47
57,727,95,13,82,0,82,2,25,32,3,1,0,0,8,1,10
57,728,179,21,158,6,152,5,41,30,8,1,1,0,14,5,47
57,730,401,67,334,4,330,8,82,62,42,8,6,1,32,9,80
57,731,1503,335,1168,24,1144,28,256,305,126,10,7,2,107,21,282
57,732,636,108,528,13,515,8,172,173,25,4,0,1,49,15,68
57,733,1151,179,972,16,956,15,224,252,85,11,7,6,95,23,238
57,734,363,53,310,7,303,2,108,70,25,1,2,0,34,7,54
57,736,428,76,352,3,349,8,93,107,23,6,1,0,30,3,78
57,737,33,1,32,0,32,0,13,11,0,1,0,0,6,0,1
57,738,285,53,232,5,227,5,74,67,14,2,0,1,28,6,30
57,739,335,57,278,8,270,1,70,72,14,2,3,3,38,6,61
57,740,427,87,340,9,331,3,87,82,20,9,0,3,49,7,71
57,741,352,50,302,8,294,1,64,105,10,13,1,0,52,6,42
57,742,1308,245,1063,16,1047,20,354,299,62,15,14,5,124,15,139
57,743,199,26,173,5,168,1,46,66,12,2,1,0,21,2,17
57,745,834,118,716,21,695,4,193,187,41,13,3,4,73,16,161
57,746,1133,223,910,18,892,17,297,228,56,7,6,3,79,25,174
57,747,211,42,169,5,164,1,54,60,10,6,0,0,14,2,17
57,748,676,117,559,17,542,5,196,124,34,9,6,2,36,5,125
57,749,133,16,117,4,113,2,37,27,9,1,0,0,19,2,16
57,750,545,84,461,7,454,8,147,147,23,6,7,0,38,13,65
57,751,7836,1909,5927,102,5825,80,1471,1090,685,73,33,11,414,68,1900
57,752,2270,482,1788,27,1761,29,540,498,88,29,18,4,163,41,351
57,753,54,4,50,0,50,0,11,22,2,0,0,0,7,3,5
57,754,93,8,85,1,84,0,13,43,0,2,0,0,11,3,12
57,755,61,7,54,0,54,1,14,17,5,1,0,0,7,2,7
57,756,226,35,191,5,186,1,67,40,11,5,3,0,17,3,39
57,757,12594,3517,9077,197,8880,193,1757,2228,926,140,75,17,960,180,2404
57,759,58,11,47,2,45,0,12,15,1,2,0,0,8,1,6
57,760,687,104,583,12,571,19,154,141,40,7,5,1,69,12,123
57,761,209,20,189,3,186,1,52,77,12,2,1,1,20,3,17
57,762,452,82,370,5,365,3,135,90,29,7,2,2,31,6,60
57,763,33,3,30,0,30,0,0,8,0,0,0,0,13,0,9
57,764,618,112,506,8,498,7,89,151,45,8,4,1,62,12,119
57,765,913,176,737,13,724,7,236,189,61,9,10,1,55,23,133
57,767,747,104,643,18,625,13,111,180,53,10,5,1,80,13,159
58,1,111,22,89,2,87,0,26,28,8,0,1,0,3,0,21
58,2,738,140,598,14,584,13,174,115,79,8,5,1,38,20,131
58,3,558,124,434,9,425,8,106,109,34,3,2,0,41,10,112
58,4,319,51,268,5,263,1,70,54,22,1,3,0,28,6,78
58,5,192,31,161,4,157,3,37,52,10,0,1,0,10,3,41
58,6,228,57,171,7,164,3,41,44,11,3,0,0,17,4,41
58,7,257,37,220,8,212,4,74,50,27,1,3,0,17,5,31
58,8,155,27,128,2,126,2,25,30,12,0,0,0,11,3,43
58,9,123,24,99,2,97,6,14,23,11,1,0,1,2,1,38
58,10,625,104,521,13,508,5,116,76,90,5,2,1,26,12,175
58,11,240,36,204,3,201,4,54,29,22,2,0,1,26,6,57
58,12,474,120,354,4,350,5,92,82,34,7,4,1,34,15,76
58,13,97,10,87,0,87,0,19,30,7,0,0,1,5,2,23
58,14,78,21,57,2,55,0,14,18,8,0,1,0,2,0,12
58,15,137,33,104,5,99,5,9,15,10,7,2,0,7,3,41
58,16,152,26,126,7,119,1,29,35,10,2,1,0,7,2,32
58,17,242,58,184,8,176,3,36,51,12,2,2,1,17,1,51
58,18,45,10,35,1,34,3,8,10,6,0,0,0,2,1,4
58,19,67,7,60,3,57,0,11,5,3,1,0,1,1,1,34
58,20,223,44,179,3,176,3,41,34,19,2,0,0,17,5,55
58,21,159,25,134,1,133,3,28,41,9,5,1,0,9,6,31
58,22,186,17,169,3,166,1,41,23,35,3,0,0,16,0,47
58,23,173,31,142,1,141,6,22,46,13,1,0,0,11,5,37
58,24,226,41,185,2,183,3,32,76,15,1,0,0,14,2,40
58,25,131,21,110,3,107,3,25,21,15,1,1,0,5,3,33
58,26,36,3,33,0,33,1,8,10,7,0,0,0,1,1,5
58,27,97,12,85,2,83,1,25,19,3,0,0,0,2,2,31
58,28,99,10,89,1,88,6,16,30,6,0,0,0,13,1,16
58,29,86,17,69,2,67,0,13,14,12,0,2,0,4,0,22
58,30,235,48,187,3,184,7,34,42,12,3,3,0,15,7,61
58,31,263,53,210,6,204,6,53,41,25,3,2,0,20,3,51
58,32,332,54,278,4,274,2,71,61,39,3,0,1,19,11,67
58,33,271,41,230,3,227,15,55,45,26,5,3,1,13,8,56
58,34,159,27,132,9,123,3,35,36,6,1,0,0,13,1,28
58,35,295,57,238,4,234,8,37,53,22,4,1,0,15,4,90
58,36,402,60,342,6,336,3,70,113,24,5,2,2,25,11,81
58,37,531,86,445,9,436,11,82,91,58,12,4,0,29,6,143
58,38,135,26,109,4,105,1,23,27,15,4,1,1,3,0,30
58,39,248,36,212,4,208,4,49,50,10,1,1,0,16,4,73
58,40,121,15,106,2,104,0,21,48,6,1,0,3,4,3,18
58,41,173,27,146,3,143,3,23,47,12,2,2,1,11,1,41
58,42,123,22,101,2,99,1,15,25,11,2,0,0,7,5,33
58,43,41,6,35,1,34,0,7,8,8,0,0,0,1,0,10
58,44,614,96,518,5,513,4,167,97,47,5,5,0,30,15,143
58,45,140,22,118,2,116,4,24,21,11,3,3,1,6,5,38
58,46,1524,307,1217,31,1186,19,198,243,134,19,17,3,93,17,443
58,47,491,84,407,8,399,2,73,93,48,9,3,1,27,9,134
58,48,119,20,99,4,95,4,28,23,12,1,3,0,6,1,17
58,49,83,16,67,1,66,4,11,19,9,0,1,0,3,0,19
58,50,67,14,53,0,53,0,8,9,6,0,0,0,2,0,28
58,51,1097,151,946,16,930,10,213,201,108,6,5,1,69,18,299
58,52,48,7,41,1,40,2,12,8,2,0,1,0,2,1,12
58,53,280,48,232,0,232,3,47,51,23,3,0,0,16,4,85
58,54,52,8,44,0,44,1,6,19,2,0,0,1,3,2,10
58,55,662,128,534,17,517,1,78,99,57,6,3,2,50,14,207
58,56,239,39,200,3,197,4,36,43,30,3,2,0,15,6,58
58,57,863,122,741,13,728,9,155,159,93,6,5,5,60,18,218
58,58,271,44,227,2,225,7,44,51,38,2,0,1,21,4,57
58,59,3581,742,2839,58,2781,66,474,662,359,45,19,6,208,49,893
58,60,459,66,393,4,389,1,105,78,47,5,1,1,29,5,117
58,61,131,28,103,3,100,6,23,29,4,2,0,0,9,0,27
58,62,1284,259,1025,14,1011,18,193,154,93,13,2,3,58,22,455
58,63,553,80,473,12,461,2,87,80,70,3,8,2,41,10,158
58,64,471,87,384,5,379,3,66,118,43,5,7,1,33,13,90
58,65,710,131,579,7,572,3,98,137,46,4,2,2,48,8,224
58,66,105,25,80,0,80,3,18,10,16,0,3,1,8,1,20
58,67,1104,179,925,17,908,22,162,163,143,16,10,2,84,14,292
58,68,220,43,177,5,172,3,29,36,23,5,4,0,8,1,63
58,69,149,24,125,1,124,2,35,31,8,1,0,0,5,1,41
58,70,61,19,42,1,41,0,10,8,10,2,0,1,4,1,5
58,71,159,26,133,1,132,3,23,43,7,1,2,0,4,3,46
58,72,478,58,420,7,413,2,99,84,44,0,1,1,27,6,149
58,73,120,27,93,0,93,5,12,20,13,2,0,0,7,2,32
58,74,282,34,248,5,243,10,38,59,15,3,2,0,23,9,84
58,75,236,40,196,5,191,2,40,60,16,4,1,0,12,3,53
58,76,57,14,43,0,43,0,6,18,6,0,0,0,3,1,9
58,77,365,55,310,5,305,2,71,69,51,4,4,0,34,8,62
58,78,47,7,40,1,39,0,10,9,2,1,0,0,1,1,15
58,79,2724,680,2044,33,2011,35,358,414,286,28,15,2,114,34,725
58,80,148,24,124,2,122,3,32,39,8,0,0,0,2,1,37
58,81,280,61,219,5,214,6,42,49,33,7,0,0,25,8,44
58,82,293,40,253,5,248,4,46,28,43,3,3,2,22,1,96
58,83,1205,249,956,20,936,18,129,282,84,14,9,1,64,14,321
58,84,95,14,81,3,78,0,17,19,11,0,0,0,2,3,26
58,85,551,119,432,9,423,7,74,96,62,3,3,0,23,12,143
58,86,7930,1744,6186,113,6073,97,1246,1585,649,61,44,17,450,128,1796
58,87,589,107,482,14,468,3,121,93,46,3,3,0,34,9,156
58,88,2996,567,2429,47,2382,56,410,468,267,24,8,7,200,43,899
58,89,208,27,181,4,177,1,47,57,12,2,2,0,11,2,43
58,90,185,24,161,4,157,0,41,43,13,0,0,1,10,2,47
58,92,360,52,308,4,304,7,61,78,21,0,1,2,31,2,101
58,93,140,21,119,1,118,2,17,47,7,2,0,0,17,2,24
58,94,393,82,311,9,302,3,75,69,49,7,4,1,28,8,58
58,95,4129,867,3262,67,3195,47,507,652,344,46,28,9,261,40,1261
58,96,395,64,331,6,325,7,67,62,33,3,0,0,27,6,120
58,97,92,8,84,2,82,0,19,31,4,0,0,0,14,2,12
58,98,105,22,83,0,83,1,17,26,7,3,2,0,5,4,18
58,99,161,23,138,4,134,0,32,31,6,2,1,0,11,2,49
58,100,61,15,46,0,46,0,8,6,6,0,1,0,8,1,16
58,101,139,25,114,2,112,1,19,37,25,0,1,0,11,3,15
58,102,1265,245,1020,20,1000,26,199,272,91,14,16,3,91,33,255
58,103,431,81,350,6,344,0,82,73,46,2,0,0,24,4,113
58,104,996,173,823,21,802,12,160,175,95,13,7,4,63,24,249
58,105,259,36,223,6,217,3,38,50,26,3,0,1,10,4,82
58,106,324,55,269,8,261,1,60,79,23,4,1,0,16,2,75
58,107,154,18,136,2,134,3,31,24,16,4,2,1,8,4,41
58,108,83,14,69,3,66,3,16,16,7,0,0,1,3,1,19
58,109,658,104,554,9,545,4,115,183,42,8,6,2,36,17,132
58,110,187,29,158,2,156,2,45,21,13,1,1,0,16,2,55
58,111,109,20,89,2,87,1,21,10,10,1,1,0,2,1,40
58,112,494,71,423,9,414,7,97,68,60,4,1,0,30,10,137
58,113,105,20,85,1,84,2,20,26,5,0,0,0,10,0,21
58,114,88,6,82,5,77,2,10,24,9,0,0,0,8,1,23
58,115,188,37,151,1,150,1,36,26,21,0,2,1,8,4,51
58,116,119,14,105,3,102,1,29,22,9,0,2,1,5,1,32
58,117,3104,749,2355,46,2309,25,488,401,349,42,20,6,123,51,804
58,118,571,90,481,9,472,7,83,103,65,8,1,0,38,9,158
58,119,54,6,48,2,46,1,13,11,3,0,0,0,7,0,11
58,120,234,40,194,5,189,8,26,58,16,5,3,2,13,8,50
58,121,2770,479,2291,39,2252,20,515,321,454,30,12,10,106,38,746
58,122,372,79,293,5,288,8,60,85,27,11,0,0,27,7,63
58,123,124,15,109,2,107,0,21,57,5,2,1,0,3,2,16
58,124,591,58,533,8,525,12,134,93,74,9,4,0,30,10,159
58,125,94,11,83,0,83,2,12,7,9,5,0,0,5,1,42
58,126,319,45,274,8,266,7,66,39,24,3,0,0,19,4,104
58,127,193,33,160,4,156,3,39,34,27,2,0,0,12,0,39
58,128,97,17,80,1,79,3,12,9,13,1,0,0,5,0,36
58,129,177,37,140,4,136,2,24,33,15,2,0,0,8,6,46
58,130,119,19,100,1,99,2,25,26,9,0,0,0,6,0,31
58,131,1902,333,1569,30,1539,22,307,242,256,20,6,1,103,35,547
58,132,212,43,169,1,168,3,30,45,24,4,1,0,17,1,43
58,133,68,17,51,1,50,0,11,17,3,0,0,1,7,1,10
58,134,2670,612,2058,45,2013,14,367,287,359,32,15,3,80,32,824
58,135,104,14,90,4,86,3,9,40,8,0,0,0,10,0,16
58,136,66,6,60,0,60,0,14,21,4,1,0,0,4,2,14
58,137,57,11,46,0,46,0,11,15,1,2,2,0,6,2,7
58,138,275,40,235,2,233,1,44,66,14,3,2,0,30,9,64
58,139,114,13,101,2,99,1,20,33,11,5,2,0,5,2,20
58,140,227,44,183,2,181,8,20,55,12,5,1,0,21,1,58
58,141,67,12,55,0,55,0,11,8,13,1,0,0,4,1,17
58,142,199,32,167,1,166,4,29,42,18,3,2,0,15,4,49
58,143,126,29,97,4,93,7,25,21,10,4,0,1,7,2,16
58,144,526,113,413,10,403,9,82,83,46,10,5,2,31,7,128
58,145,987,183,804,15,789,18,161,154,91,9,5,3,63,21,264
58,146,789,169,620,18,602,8,163,149,82,9,5,5,51,14,116
58,147,273,44,229,2,227,3,53,48,28,1,3,0,16,2,73
58,148,436,80,356,7,349,7,70,63,40,5,5,3,35,14,107
58,149,1587,240,1347,45,1302,10,175,364,105,14,16,2,78,24,514
58,150,103,15,88,1,87,3,26,16,8,6,0,0,5,0,23
58,151,2758,675,2083,31,2052,21,426,362,268,20,18,8,106,23,800
58,152,1053,150,903,20,883,12,153,194,79,9,3,1,90,20,322
58,153,68,14,54,4,50,0,9,13,9,0,0,0,6,0,13
58,154,124,21,103,3,100,0,20,31,15,1,0,0,6,0,27
58,155,481,91,390,5,385,16,86,75,51,6,1,3,23,16,108
58,156,152,18,134,3,131,1,33,34,25,2,2,0,8,0,26
58,157,319,96,223,7,216,6,43,38,29,2,1,2,23,2,70
58,158,210,18,192,2,190,3,46,44,19,3,1,0,13,5,56
58,159,152,27,125,1,124,2,32,30,10,5,0,0,11,1,33
58,160,2910,484,2426,54,2372,44,404,580,249,25,12,7,206,47,798
58,161,138,29,109,3,106,1,30,28,5,0,1,0,3,2,36
58,162,112,24,88,1,87,4,19,25,10,3,0,0,4,3,19
58,163,178,20,158,3,155,5,28,39,25,2,2,0,10,7,37
58,164,483,60,423,3,420,4,109,97,40,3,6,0,30,9,122
58,165,146,19,127,2,125,2,27,44,5,0,0,1,14,4,28
58,166,241,47,194,1,193,6,43,55,16,3,0,0,11,8,51
58,167,60,2,58,1,57,0,4,17,6,0,0,0,11,0,19
58,168,375,60,315,7,308,6,43,87,33,6,6,0,29,5,93
58,169,29,1,28,0,28,1,4,7,2,0,0,0,6,1,7
58,170,110,24,86,1,85,1,18,16,4,0,1,0,5,2,38
58,171,256,58,198,4,194,4,32,66,13,3,1,0,8,7,60
58,172,116,15,101,2,99,1,21,20,12,0,1,0,18,2,24
58,173,135,31,104,5,99,0,21,28,7,2,0,0,7,2,32
58,174,124,19,105,2,103,1,23,29,14,2,2,1,9,4,18
58,175,169,22,147,0,147,2,30,52,9,2,2,0,4,8,38
58,176,421,54,367,6,361,8,57,72,37,3,2,1,40,5,136
58,177,272,47,225,7,218,3,32,64,17,3,0,1,19,8,71
58,178,140,10,130,5,125,2,18,48,5,5,3,2,12,6,24
58,179,251,40,211,3,208,2,54,50,19,2,1,0,18,3,59
58,180,459,106,353,8,345,4,75,82,33,1,3,0,30,3,114
58,181,114,17,97,1,96,0,17,30,13,4,1,0,9,2,20
58,182,1163,215,948,24,924,8,158,236,93,8,6,0,55,18,342
58,183,85,12,73,1,72,1,14,12,11,1,0,0,8,0,25
58,184,104,15,89,2,87,0,23,32,2,0,0,0,7,4,19
58,185,542,110,432,3,429,4,116,118,30,3,5,2,32,17,102
58,186,69,9,60,3,57,0,20,13,4,0,0,0,4,1,15
58,187,420,79,341,5,336,2,84,84,25,8,4,0,10,5,114
58,188,104,14,90,0,90,4,18,16,6,1,1,0,9,2,33
58,189,393,52,341,5,336,3,71,77,50,3,1,0,31,7,93
58,190,115,28,87,2,85,1,30,26,5,0,0,0,7,2,14
58,191,116,32,84,0,84,0,17,27,4,3,1,0,3,2,27
58,192,180,34,146,4,142,6,37,23,24,4,0,0,9,1,38
58,193,1098,200,898,13,885,8,229,218,75,15,11,5,71,27,226
58,194,23461,6074,17387,400,16987,363,2618,3807,2030,183,91,37,1356,229,6273
58,195,255,36,219,5,214,0,41,60,29,2,2,0,11,7,62
58,196,318,70,248,3,245,1,68,40,26,7,0,3,9,5,86
58,197,117,12,105,0,105,5,12,32,19,0,1,0,17,1,18
58,198,278,53,225,4,221,4,45,49,33,6,1,1,17,2,63
58,199,135,15,120,2,118,0,18,24,11,2,6,0,12,2,43
58,200,163,26,137,2,135,1,34,28,22,0,1,1,9,3,36
58,201,136,25,111,0,111,3,23,32,9,1,0,0,9,2,32
58,202,37,8,29,2,27,0,6,7,2,0,0,1,0,1,10
58,203,82,13,69,2,67,1,8,20,4,2,2,0,4,3,23
58,204,239,39,200,1,199,4,42,45,32,3,3,0,13,7,50
58,205,594,169,425,9,416,7,83,83,47,0,2,0,28,6,160
58,206,42,11,31,1,30,0,9,8,2,1,0,0,3,0,7
58,207,816,134,682,10,672,14,143,123,95,8,2,3,43,16,225
58,208,268,37,231,7,224,0,37,76,18,1,0,0,19,6,67
58,209,165,32,133,2,131,3,52,34,11,2,0,0,10,2,17
58,210,247,45,202,2,200,0,37,43,19,1,1,0,8,5,86
58,211,131,19,112,3,109,0,16,44,9,0,0,0,10,3,27
58,212,255,32,223,2,221,3,68,38,21,1,2,0,11,3,74
58,213,369,68,301,4,297,4,87,89,28,5,2,2,13,7,60
58,214,1776,265,1511,27,1484,22,283,380,171,14,7,3,133,38,433
58,215,1336,237,1099,20,1079,9,226,352,99,6,9,4,96,23,255
58,216,152,31,121,1,120,4,24,12,15,2,1,0,6,1,55
58,217,171,31,140,4,136,1,29,32,23,1,1,3,4,2,40
58,218,1543,309,1234,21,1213,15,281,262,175,12,13,1,74,14,366
58,219,182,38,144,5,139,0,21,61,15,1,1,0,8,1,31
58,220,544,86,458,7,451,10,74,86,85,3,4,3,24,10,152
58,221,142,32,110,0,110,1,17,41,8,2,0,0,9,7,25
58,222,187,36,151,1,150,3,29,23,26,1,0,0,9,7,52
58,223,463,61,402,1,401,5,98,84,37,9,2,4,31,14,117
58,224,99,15,84,6,78,0,17,22,6,0,0,0,11,0,22
58,225,321,55,266,6,260,7,70,60,32,0,2,0,17,4,68
58,226,139,15,124,0,124,3,40,26,23,2,2,0,7,2,19
58,227,1048,222,826,17,809,20,188,189,100,9,7,2,79,16,199
58,228,450,68,382,7,375,5,76,160,27,7,2,1,23,6,68
58,229,272,58,214,3,211,6,48,44,21,5,1,1,18,5,62
58,230,75,14,61,1,60,6,17,17,4,1,0,1,4,2,8
58,231,352,59,293,3,290,11,47,69,53,5,3,0,14,9,79
58,232,953,150,803,12,791,11,162,186,79,8,10,4,68,14,249
58,233,169,40,129,3,126,2,25,26,19,2,3,0,8,0,41
58,234,62,8,54,0,54,0,15,14,11,0,2,0,1,0,11
58,235,258,51,207,4,203,2,33,31,29,3,4,1,16,2,82
58,236,102,16,86,5,81,0,29,17,4,1,0,2,5,0,23
58,237,30,2,28,1,27,0,8,10,1,0,0,0,0,2,6
58,238,1648,242,1406,22,1384,18,273,287,157,20,10,0,118,25,476
58,239,128,16,112,2,110,1,14,33,13,2,3,2,3,3,36
58,240,80,10,70,1,69,1,14,19,9,0,1,1,5,2,17
58,241,255,28,227,8,219,1,44,42,12,0,0,1,22,7,90
58,242,108,14,94,0,94,4,28,29,7,1,2,0,2,0,21
58,243,100,22,78,2,76,0,12,31,8,0,2,0,5,2,16
58,244,207,29,178,2,176,3,38,45,16,2,3,0,20,5,44
58,245,153,26,127,4,123,1,20,26,12,0,3,2,7,3,49
58,246,639,105,534,19,515,4,110,149,65,4,4,2,31,6,140
58,247,406,66,340,10,330,1,73,77,33,2,1,1,35,5,102
58,248,165,17,148,1,147,0,39,33,16,2,2,0,9,4,42
58,249,202,28,174,3,171,4,25,36,22,5,3,1,20,1,54
58,250,1545,339,1206,25,1181,22,206,214,149,23,12,4,72,16,463
58,251,403,62,341,9,332,4,99,59,46,8,2,1,24,7,82
58,252,141,17,124,0,124,2,29,32,17,2,0,1,9,3,29
58,253,90,15,75,2,73,2,16,29,3,0,0,0,7,4,12
58,254,444,45,399,8,391,2,81,110,51,6,0,1,25,17,98
58,255,285,47,238,1,237,9,64,40,30,3,1,0,16,6,68
58,256,320,50,270,3,267,4,78,54,25,4,3,3,33,6,57
58,257,57,7,50,0,50,0,8,27,2,0,0,0,1,0,12
58,258,411,69,342,10,332,2,82,76,37,4,1,2,25,5,98
58,259,158,33,125,2,123,0,27,28,15,0,2,0,8,3,40
58,260,968,111,857,10,847,11,153,185,109,10,2,0,91,14,272
58,261,970,166,804,24,780,7,175,202,101,11,7,4,72,21,180
58,262,234,41,193,0,193,1,44,71,6,1,3,0,13,4,50
58,263,161,18,143,1,142,3,42,60,3,0,0,0,9,2,23
58,264,1403,248,1155,12,1143,12,235,277,90,15,12,4,103,32,363
58,265,110,21,89,2,87,4,7,30,7,1,0,1,14,1,22
58,266,170,30,140,3,137,3,31,43,7,2,1,0,13,0,37
58,267,579,77,502,12,490,7,104,138,46,3,3,2,48,15,124
58,268,191,37,154,5,149,0,25,50,6,1,1,0,23,4,39
58,269,358,49,309,6,303,13,75,67,33,6,2,1,13,4,89
58,270,349,68,281,6,275,15,71,47,33,12,5,0,11,10,71
58,271,117,21,96,2,94,3,15,27,10,2,0,0,10,2,25
58,272,98,13,85,0,85,0,11,18,14,0,1,0,2,1,38
58,273,1160,155,1005,13,992,10,183,216,104,12,5,2,90,22,348
58,274,86,15,71,0,71,1,13,17,4,1,1,0,4,0,30
58,275,227,35,192,2,190,9,44,56,25,6,5,0,6,0,39
58,276,225,50,175,6,169,3,36,41,16,2,1,0,14,4,52
58,277,191,24,167,8,159,2,15,56,9,2,0,1,9,5,60
58,278,1189,157,1032,17,1015,12,196,206,120,20,13,1,67,22,358
58,279,156,22,134,1,133,1,44,31,18,1,3,0,2,4,29
58,280,542,92,450,8,442,6,90,110,51,2,3,1,13,10,156
58,281,503,90,413,8,405,5,85,111,37,4,7,1,46,8,101
58,282,342,66,276,6,270,2,60,71,44,1,0,2,19,2,69
58,283,80,12,68,0,68,9,11,27,8,0,0,0,5,0,8
58,284,55,8,47,0,47,0,8,12,2,0,0,0,2,1,22
58,285,163,24,139,0,139,2,37,36,12,3,0,0,7,0,42
58,286,468,81,387,10,377,2,79,133,21,1,2,0,34,7,98
58,287,196,36,160,5,155,1,31,52,16,2,0,1,10,2,40
58,288,94,14,80,1,79,0,11,28,9,0,0,0,1,1,29
58,289,150,41,109,1,108,2,18,31,12,0,0,0,16,3,26
58,290,50,7,43,0,43,0,11,10,2,2,0,3,4,1,10
58,291,177,43,134,6,128,3,17,32,20,0,0,0,5,2,49
58,292,172,34,138,3,135,2,18,42,15,4,0,0,13,1,40
58,293,357,57,300,5,295,1,62,61,37,9,1,0,20,6,98
58,294,114,15,99,2,97,1,22,35,9,0,0,0,2,2,26
58,295,738,91,647,15,632,7,162,135,47,10,4,3,55,19,190
58,296,139,30,109,0,109,2,24,40,3,1,1,1,6,4,27
58,297,175,30,145,4,141,1,33,23,22,1,2,3,6,0,50
58,298,255,31,224,3,221,2,47,50,30,5,0,0,15,6,66
58,299,210,34,176,2,174,1,48,25,26,3,2,1,13,5,50
58,300,1314,158,1156,16,1140,19,196,193,177,13,4,3,101,28,406
58,301,304,44,260,3,257,5,59,42,31,4,3,1,21,4,87
58,302,625,99,526,9,517,14,117,95,73,10,5,1,28,12,162
58,303,7558,1357,6201,115,6086,98,958,970,1041,100,38,16,458,118,2289
58,304,838,154,684,10,674,5,153,150,76,10,7,0,46,15,212
58,305,103,26,77,2,75,4,6,23,6,0,0,0,4,1,31
58,306,252,48,204,1,203,5,41,49,35,3,0,0,11,3,56
58,307,143,23,120,0,120,4,30,22,9,0,1,1,13,1,39
58,308,72,7,65,0,65,2,19,7,6,2,1,1,8,2,17
58,309,372,53,319,8,311,3,56,52,48,4,4,1,8,7,128
58,310,48,10,38,0,38,0,11,4,2,0,0,0,1,0,20
58,311,243,35,208,4,204,4,47,41,20,3,1,0,8,9,71
58,312,260,37,223,2,221,3,40,48,27,3,0,1,12,3,84
58,313,82,20,62,1,61,0,11,13,11,0,0,0,6,2,18
59,1,344,37,307,8,299,0,62,87,39,2,1,3,27,3,75
59,2,2783,587,2196,33,2163,24,656,359,344,46,20,4,82,42,586
59,3,249,45,204,2,202,2,73,51,20,3,1,1,14,4,33
59,4,836,89,747,11,736,8,149,311,55,8,6,1,62,11,125
59,5,2609,460,2149,30,2119,31,412,528,257,29,11,4,177,41,629
59,6,174,28,146,6,140,6,40,39,11,4,0,1,14,6,19
59,7,708,111,597,8,589,8,182,82,103,11,3,1,27,11,161
59,8,6646,1704,4942,72,4870,51,1332,674,1104,57,53,5,218,58,1318
59,9,39676,8274,31402,528,30874,981,4249,7059,4729,304,164,58,2725,368,10237
59,10,182,17,165,6,159,0,47,43,8,1,3,0,10,6,41
59,11,7067,1457,5610,146,5464,85,1359,1222,573,49,33,15,408,69,1651
59,12,2236,494,1742,39,1703,17,448,326,191,27,18,2,88,41,545
59,13,995,149,846,15,831,28,135,226,119,9,5,2,53,5,249
59,14,8579,2428,6151,104,6047,75,1780,959,907,61,47,14,295,72,1837
59,15,2151,313,1838,22,1816,8,539,381,307,15,16,4,111,26,409
59,16,1875,241,1634,32,1602,11,408,372,153,24,12,4,111,22,485
59,17,17007,4349,12658,211,12447,232,2781,2426,1639,159,91,33,774,169,4143
59,18,1173,133,1040,22,1018,13,210,280,100,7,5,5,99,19,280
59,19,761,143,618,11,607,16,151,147,68,2,2,5,54,8,154
59,21,1296,192,1104,23,1081,10,328,183,115,22,8,2,53,9,351
59,22,1819,306,1513,26,1487,25,332,456,151,11,8,4,113,29,358
59,23,398,79,319,4,315,6,90,67,43,4,1,0,17,12,75
59,24,3447,796,2651,47,2604,27,657,396,470,25,16,6,133,39,835
59,25,1315,193,1122,25,1097,26,206,403,77,4,5,2,121,36,217
59,26,892,135,757,13,744,3,273,152,70,7,3,1,49,10,176
59,27,1150,198,952,18,934,16,197,273,117,13,7,1,79,20,211
59,28,5089,962,4127,70,4057,31,1118,473,893,45,23,12,116,49,1297
59,29,1098,150,948,21,927,13,146,329,122,4,12,1,100,15,185
59,31,265,59,206,3,203,0,58,62,22,1,2,0,23,2,33
59,32,4782,1082,3700,51,3649,43,875,692,574,31,25,6,185,43,1175
59,33,6684,1711,4973,84,4889,50,1164,672,1305,60,28,11,193,77,1329
59,34,2058,337,1721,31,1690,32,304,639,147,16,6,7,152,39,348
59,35,1971,454,1517,22,1495,18,361,395,190,12,13,5,92,33,376
59,36,2989,833,2156,38,2118,35,367,587,345,23,17,3,136,19,586
59,37,2605,477,2128,38,2090,24,516,301,614,19,6,0,88,39,483
59,38,1012,151,861,17,844,10,260,186,140,9,2,1,52,10,174
59,39,590,67,523,14,509,7,110,135,47,1,4,1,52,6,146
59,41,1874,432,1442,25,1417,17,418,199,359,23,16,3,61,21,300
59,42,1150,176,974,13,961,19,160,321,103,8,13,3,95,26,213
59,43,11195,2299,8896,176,8720,128,1953,2266,828,111,60,19,686,141,2528
59,44,3523,636,2887,49,2838,68,525,936,246,23,13,5,292,46,684
59,45,112,33,79,1,78,2,17,34,2,2,1,0,7,0,13
59,46,553,84,469,6,463,9,123,147,23,9,2,3,40,5,102
59,47,286,69,217,2,215,1,66,54,26,5,6,1,15,5,36
59,48,357,53,304,9,295,4,71,58,37,3,0,0,34,7,81
59,49,318,92,226,4,222,5,79,39,18,0,3,1,15,8,54
59,50,255,35,220,2,218,2,48,82,15,1,1,0,18,9,42
59,51,4423,1000,3423,58,3365,38,893,746,338,48,26,9,215,64,988
59,52,4047,833,3214,63,3151,46,857,553,425,46,27,9,182,50,956
59,53,2355,462,1893,42,1851,24,491,487,163,21,15,4,133,40,473
59,54,728,84,644,15,629,15,141,168,61,5,6,1,51,12,169
59,55,421,69,352,8,344,5,75,118,31,3,5,0,19,4,84
59,56,697,85,612,7,605,9,82,272,27,2,1,0,88,9,115
59,57,421,53,368,1,367,15,83,102,42,7,4,1,35,5,73
59,58,782,128,654,15,639,11,180,225,44,4,2,2,42,20,109
59,59,331,60,271,5,266,0,71,47,32,2,3,0,12,3,96
59,60,162,20,142,2,140,2,53,29,11,0,2,0,10,2,31
59,61,192,42,150,9,141,0,42,42,8,3,1,0,7,7,31
59,62,118,22,96,1,95,0,28,27,9,1,1,0,8,0,21
59,63,1591,276,1315,26,1289,8,360,252,161,14,9,2,66,23,394
59,64,932,157,775,13,762,7,151,178,103,9,4,2,82,23,203
59,65,635,164,471,16,455,3,135,107,36,9,5,0,34,6,120
59,66,109,23,86,1,85,0,24,34,9,0,1,2,3,0,12
59,67,3063,596,2467,40,2427,47,607,646,201,31,21,8,162,33,671
59,68,2424,486,1938,40,1898,30,482,435,276,30,26,3,120,26,470
59,69,526,80,446,4,442,4,112,104,41,4,0,0,31,8,138
59,70,289,53,236,4,232,11,56,77,22,5,4,1,23,4,29
59,71,1780,262,1518,17,1501,21,262,556,117,13,8,2,150,32,340
59,72,217,38,179,2,177,3,37,80,16,0,0,1,4,5,31
59,73,434,51,383,4,379,11,69,122,34,1,0,2,43,6,91
59,74,1609,272,1337,24,1313,15,358,278,160,22,12,1,74,22,371
59,75,532,64,468,9,459,2,124,124,43,8,5,1,29,14,109
59,76,209,36,173,1,172,1,46,37,17,1,0,0,22,4,44
59,77,174,27,147,1,146,4,46,34,10,1,0,1,11,2,37
59,78,429,78,351,3,348,6,95,89,42,2,3,0,24,6,81
59,79,4488,1166,3322,68,3254,25,929,537,578,39,23,3,142,40,938
59,80,2241,332,1909,39,1870,26,389,473,201,16,12,4,172,26,551
59,81,415,52,363,6,357,3,99,65,38,7,4,0,27,9,105
59,82,1322,173,1149,14,1135,10,275,300,96,14,6,3,91,24,316
59,83,175,28,147,2,145,0,22,68,8,0,2,0,15,5,25
59,84,1592,234,1358,24,1334,9,356,321,120,23,14,1,104,31,355
59,85,274,44,230,6,224,5,68,55,13,4,3,0,17,11,48
59,86,1729,313,1416,30,1386,34,331,309,107,15,4,1,117,23,445
59,87,578,97,481,8,473,5,113,97,40,6,7,2,25,14,164
59,88,1228,181,1047,21,1026,12,160,446,88,10,2,1,114,13,180
59,89,1039,149,890,13,877,14,196,318,51,11,7,0,92,20,168
59,90,8520,1631,6889,82,6807,117,636,4210,206,27,8,12,730,78,783
59,91,418,39,379,17,362,5,77,127,34,6,3,1,32,6,71
59,92,3023,578,2445,36,2409,29,597,508,383,19,11,9,141,50,662
59,93,241,29,212,3,209,2,54,75,9,1,1,0,18,3,46
59,94,5218,1262,3956,91,3865,39,1119,853,376,75,31,7,235,63,1067
59,96,1185,149,1036,13,1023,16,138,411,77,8,1,1,128,18,225
59,97,229,32,197,5,192,1,65,55,11,1,2,0,7,3,47
59,98,3647,758,2889,45,2844,56,568,1101,197,24,15,3,283,46,551
59,99,1314,223,1091,27,1064,13,300,194,134,16,11,5,58,20,313
59,100,241,37,204,1,203,9,52,75,13,1,1,0,19,3,30
59,101,245,55,190,2,188,0,51,61,14,0,0,0,15,4,43
59,102,337,36,301,4,297,4,87,94,30,0,3,0,15,6,58
59,103,355,52,303,3,300,3,74,81,36,6,6,1,13,10,70
59,104,2264,477,1787,27,1760,15,497,320,381,15,18,4,68,17,425
59,105,1269,212,1057,20,1037,22,179,324,131,6,6,3,120,21,225
59,106,556,64,492,5,487,16,74,187,33,2,3,3,67,7,95
59,107,3939,868,3071,52,3019,43,743,845,251,38,20,18,177,49,835
59,108,528,70,458,5,453,7,95,68,122,5,5,2,20,5,124
59,109,598,90,508,10,498,8,88,177,41,8,4,1,55,8,108
59,110,1089,156,933,21,912,10,254,253,68,14,7,0,79,12,215
59,111,265,51,214,3,211,0,53,63,14,9,1,1,20,2,48
59,112,7921,1961,5960,116,5844,55,1909,1008,798,80,58,9,234,61,1632
59,113,914,122,792,15,777,9,198,105,247,3,1,4,44,9,157
59,114,1236,264,972,14,958,21,294,192,160,9,8,2,59,18,195
59,115,500,67,433,8,425,6,112,85,59,2,0,3,40,7,111
59,116,280,44,236,2,234,3,40,82,20,3,0,0,19,11,56
59,117,741,98,643,12,631,4,178,136,95,6,3,0,42,10,157
59,118,1779,335,1444,21,1423,22,436,319,149,20,11,4,65,32,365
59,119,397,50,347,1,346,8,95,106,43,3,1,1,23,4,62
59,120,1412,227,1185,27,1158,14,244,390,81,13,7,0,115,35,259
59,121,414,67,347,11,336,8,88,85,41,7,1,1,36,10,59
59,122,23001,6301,16700,346,16354,250,3404,4627,1659,154,128,42,1261,322,4507
59,123,1435,248,1187,25,1162,21,240,334,111,14,2,3,137,21,279
59,124,1593,249,1344,15,1329,36,217,493,109,15,8,3,154,15,279
59,125,351,54,297,5,292,5,93,91,19,6,1,0,25,2,50
59,126,1115,151,964,14,950,10,285,215,86,9,4,6,71,12,252
59,127,122,17,105,3,102,1,20,26,9,1,2,0,7,5,31
59,128,1295,208,1087,26,1061,18,190,419,83,6,2,3,103,15,222
59,129,1601,211,1390,24,1366,22,271,438,111,11,13,3,140,24,333
59,130,883,175,708,10,698,11,203,184,73,10,11,1,66,9,130
59,131,6324,1112,5212,126,5086,45,1485,769,694,79,67,14,232,90,1611
59,132,817,120,697,19,678,12,214,148,57,5,6,1,52,18,165
59,133,754,103,651,13,638,14,119,174,65,4,9,3,52,20,178
59,134,866,139,727,17,710,12,170,278,47,10,7,1,61,20,104
59,135,1767,305,1462,28,1434,34,237,458,171,24,16,4,116,21,353
59,136,4607,963,3644,67,3577,31,841,837,460,32,27,5,163,44,1137
59,137,621,100,521,7,514,3,124,136,67,3,1,0,23,4,153
59,138,506,77,429,8,421,7,100,111,35,6,1,2,23,12,124
59,139,10365,2931,7434,157,7277,92,1737,1457,872,111,76,14,411,138,2369
59,140,358,46,312,5,307,4,92,49,37,5,2,1,20,5,92
59,141,429,69,360,3,357,5,73,100,31,1,0,2,18,9,118
59,142,475,79,396,9,387,2,149,102,30,5,3,0,12,6,78
59,143,6213,1260,4953,85,4868,79,1057,1519,426,57,34,8,417,93,1178
59,144,614,109,505,8,497,9,114,151,65,4,1,2,38,10,103
59,145,567,71,496,8,488,12,93,166,34,5,4,2,49,9,114
59,146,2507,325,2182,37,2145,58,295,803,185,11,5,3,225,24,536
59,147,56,7,49,2,47,2,10,14,3,0,0,0,10,1,7
59,148,249,62,187,2,185,0,44,55,22,3,1,0,14,6,40
59,149,884,164,720,14,706,4,190,209,61,6,7,1,38,25,165
59,150,426,53,373,10,363,13,49,135,24,0,0,0,55,9,78
59,151,1218,232,986,9,977,13,334,271,88,13,4,2,73,25,154
59,152,9725,2458,7267,116,7151,91,1747,1967,827,75,57,13,544,127,1703
59,153,6077,1708,4369,114,4255,47,1103,832,628,54,31,7,213,55,1285
59,154,1043,153,890,16,874,13,162,263,77,3,10,1,107,15,223
59,155,16293,2971,13322,301,13021,168,3485,2498,1564,221,118,27,771,231,3938
59,156,1945,354,1591,31,1560,11,425,308,207,19,10,3,78,23,476
59,157,1643,352,1291,9,1282,15,400,373,92,15,5,2,67,20,293
59,158,2091,325,1766,16,1750,29,390,539,194,18,3,5,181,32,359
59,159,434,60,374,10,364,7,131,60,38,7,4,0,21,4,92
59,160,2973,730,2243,39,2204,19,601,439,337,26,20,2,122,50,588
59,161,558,84,474,10,464,9,121,133,39,7,4,4,37,10,100
59,162,524,61,463,7,456,8,94,147,28,3,2,0,50,5,119
59,163,14746,3670,11076,159,10917,207,1710,3780,1086,94,61,27,1032,166,2754
59,164,180,39,141,0,141,2,35,45,14,1,1,0,3,3,37
59,165,5121,962,4159,63,4096,45,844,851,552,42,24,7,324,62,1345
59,166,1003,181,822,8,814,10,187,266,74,2,1,0,61,13,200
59,167,157,23,134,2,132,0,33,49,12,0,6,0,8,7,17
59,168,3608,636,2972,24,2948,70,496,993,257,25,14,9,285,35,764
59,169,174,30,144,1,143,0,33,61,10,0,1,0,5,3,30
59,170,3556,801,2755,50,2705,31,686,350,516,36,19,4,98,29,936
59,171,32,1,31,0,31,0,11,9,0,1,0,0,4,1,5
59,172,10747,2796,7951,158,7793,82,2018,1111,1211,59,83,14,296,77,2842
59,173,1309,241,1068,23,1045,21,253,405,48,11,6,1,101,13,186
59,174,254,30,224,0,224,2,71,62,17,0,1,2,23,4,42
59,175,246,42,204,4,200,4,43,60,20,3,2,0,22,4,42
59,176,239,37,202,2,200,1,49,62,10,1,4,2,15,5,51
59,177,711,112,599,4,595,13,167,161,59,6,2,2,34,21,130
59,178,27642,8058,19584,284,19300,303,3904,4565,2655,191,116,47,1475,268,5776
59,179,7441,1978,5463,106,5357,45,1555,720,1063,69,34,14,211,58,1588
59,180,1051,117,934,19,915,16,195,328,84,12,3,1,71,16,189
59,181,432,77,355,5,350,4,91,103,32,0,0,1,41,7,71
59,182,212,26,186,7,179,0,50,58,16,3,1,0,13,0,38
59,183,64865,14920,49945,1122,48823,873,11342,10972,5536,660,424,129,3159,700,15028
59,184,483,76,407,10,397,3,105,104,29,8,5,1,41,7,94
59,185,1365,254,1111,12,1099,10,316,169,204,15,15,3,40,15,312
59,186,69,10,59,0,59,0,11,22,2,0,0,0,3,3,18
59,187,215,32,183,4,179,1,29,62,20,1,1,1,12,1,51
59,188,91,12,79,1,78,4,29,22,8,0,0,0,4,0,11
59,189,901,124,777,20,757,12,190,225,71,8,4,2,86,17,142
59,190,729,86,643,7,636,7,168,202,65,3,6,0,43,9,133
59,191,483,90,393,4,389,1,115,116,38,9,5,0,24,7,74
59,192,740,140,600,9,591,1,157,83,163,12,4,0,29,9,133
59,193,2487,382,2105,27,2078,48,358,586,254,23,19,6,225,32,527
59,194,953,179,774,13,761,11,189,151,78,8,5,0,55,18,246
59,195,414,51,363,4,359,4,86,143,21,4,2,1,29,2,67
59,196,991,155,836,10,826,17,120,375,50,2,5,1,116,16,124
59,197,1639,216,1423,11,1412,30,235,474,116,8,6,2,130,18,393
59,198,154,33,121,2,119,4,16,39,14,2,1,0,6,2,35
59,199,596,55,541,13,528,12,121,163,72,7,2,1,37,9,104
59,200,337,50,287,7,280,0,81,81,25,7,4,0,11,9,62
59,201,366,41,325,9,316,9,42,121,22,4,3,1,46,6,62
59,202,3550,595,2955,59,2896,47,656,784,286,44,23,12,265,46,733
59,203,1079,168,911,10,901,12,272,118,168,9,4,2,65,16,235
59,204,363,47,316,5,311,0,96,70,39,5,2,0,17,4,78
59,205,6053,1601,4452,61,4391,37,1141,564,911,51,32,14,170,54,1417
59,206,2552,531,2021,36,1985,13,461,429,273,32,19,4,113,29,612
59,207,3083,880,2203,58,2145,18,653,319,435,22,11,5,83,46,553
59,208,251,23,228,0,228,4,21,131,6,2,2,0,28,1,33
59,209,508,92,416,6,410,5,117,93,22,0,3,1,35,7,127
59,210,1734,269,1465,22,1443,23,339,435,99,19,13,1,128,29,357
59,211,603,87,516,15,501,7,128,134,67,6,0,1,31,9,118
59,212,4642,962,3680,72,3608,28,994,875,317,43,24,5,261,64,997
59,213,367,43,324,7,317,6,69,102,17,1,0,0,37,1,84
59,214,805,82,723,13,710,19,144,168,99,6,9,0,63,7,195
59,215,771,100,671,21,650,9,129,201,46,7,2,1,81,25,149
59,216,273,32,241,4,237,3,64,66,22,3,1,0,12,5,61
59,217,275,42,233,0,233,10,47,82,25,1,0,4,25,5,34
59,218,970,189,781,20,761,10,198,268,60,16,5,3,57,17,127
59,219,483,63,420,8,412,6,112,105,48,6,4,0,29,14,88
59,220,12388,2938,9450,132,9318,196,1695,2197,1099,93,58,25,911,127,2917
59,221,1769,355,1414,20,1394,27,295,387,142,17,10,4,144,30,338
59,222,1688,270,1418,26,1392,28,312,445,141,10,3,3,148,22,280
59,223,354,54,300,7,293,4,85,80,46,2,3,0,18,6,49
59,224,1268,240,1028,5,1023,4,272,223,176,10,9,1,69,12,247
59,225,4418,942,3476,76,3400,35,991,663,455,43,25,6,181,60,941
59,226,891,173,718,18,700,6,169,184,78,8,8,1,50,12,184
59,227,3980,811,3169,50,3119,38,804,403,740,42,29,4,130,44,885
59,228,1124,158,966,11,955,16,271,217,100,15,4,3,77,21,231
59,229,471,90,381,9,372,9,85,107,38,4,5,1,26,8,89
59,230,3605,688,2917,51,2866,30,856,638,306,28,31,5,134,57,781
59,231,779,108,671,11,660,5,201,151,76,7,2,1,43,8,166
59,232,268,40,228,1,227,4,68,59,13,3,1,1,24,9,45
59,233,305,58,247,2,245,6,77,44,27,2,0,1,20,6,62
59,234,3664,643,3021,63,2958,18,851,487,423,33,19,5,167,47,908
59,236,198,47,151,1,150,1,35,38,17,0,2,0,14,3,40
59,237,667,91,576,12,564,10,130,179,44,8,3,2,48,8,132
59,238,1265,296,969,18,951,24,253,247,135,10,2,2,68,16,194
59,239,4249,688,3561,67,3494,56,816,916,528,36,38,10,263,66,765
59,240,104,15,89,3,86,2,16,32,6,1,0,0,9,0,20
59,241,399,61,338,3,335,7,107,99,21,2,4,0,12,12,71
59,242,536,61,475,11,464,2,161,119,34,1,3,1,28,9,106
59,243,849,131,718,13,705,8,205,144,94,6,6,0,46,12,184
59,244,1298,207,1091,24,1067,10,265,318,83,2,8,3,79,21,278
59,246,371,40,331,6,325,2,97,86,36,4,0,1,19,1,79
59,247,1235,215,1020,15,1005,17,168,325,72,11,4,5,112,10,281
59,249,9099,2707,6392,115,6277,74,1553,1257,929,108,109,11,307,118,1811
59,250,1711,241,1470,25,1445,21,225,554,120,15,9,3,163,26,309
59,251,237,23,214,2,212,0,49,59,29,7,5,0,22,2,39
59,252,1913,285,1628,23,1605,35,348,572,129,14,10,4,189,27,277
59,253,5195,1413,3782,76,3706,47,1312,610,555,54,32,8,150,46,892
59,254,684,100,584,11,573,6,149,109,75,3,2,2,59,5,163
59,255,429,77,352,5,347,1,121,60,37,5,1,1,29,5,87
59,256,2463,369,2094,38,2056,41,378,542,244,21,8,5,188,19,610
59,257,767,108,659,8,651,8,152,252,44,10,1,3,74,16,91
59,258,1712,250,1462,31,1431,43,241,471,122,15,11,3,173,31,321
59,259,375,42,333,9,324,5,53,85,39,0,3,0,44,8,87
59,260,2508,470,2038,39,1999,22,495,490,179,28,14,0,143,43,585
59,261,1330,296,1034,26,1008,5,292,211,124,19,10,5,43,18,281
59,262,1529,190,1339,25,1314,27,262,352,115,13,11,0,139,24,371
59,263,880,122,758,18,740,13,165,209,96,7,4,3,61,14,168
59,264,579,126,453,6,447,1,118,144,44,4,3,1,34,8,90
59,265,1622,267,1355,31,1324,17,294,323,156,7,9,2,147,27,342
59,266,3016,415,2601,45,2556,55,449,672,269,22,18,10,278,63,720
59,267,231,36,195,10,185,0,65,45,20,1,2,0,12,4,36
59,268,4193,778,3415,71,3344,36,923,726,384,58,35,5,215,64,898
59,269,1029,160,869,9,860,8,249,203,83,11,12,1,53,18,222
59,270,363,62,301,4,297,1,83,63,41,8,4,0,16,8,73
59,271,14916,3906,11010,254,10756,123,2428,1295,1963,152,111,36,436,128,4084
59,272,4213,791,3422,79,3343,26,1039,567,288,41,25,14,152,55,1136
59,273,9208,1877,7331,157,7174,76,1916,1240,772,102,67,20,469,97,2415
59,274,342,56,286,9,277,10,73,88,34,2,2,0,18,7,43
59,275,915,86,829,7,822,7,71,438,47,4,2,0,103,15,135
59,276,3702,778,2924,65,2859,21,673,310,725,38,17,4,144,22,905
59,277,168,30,138,1,137,4,28,46,15,2,2,1,3,0,36
59,278,3039,519,2520,35,2485,52,570,641,296,25,15,6,229,52,599
59,279,14565,3478,11087,222,10865,165,2710,2941,1116,104,94,28,803,166,2738
59,280,607,70,537,8,529,6,157,111,80,3,1,1,35,9,126
59,281,786,83,703,22,681,16,143,148,94,13,4,5,64,18,176
59,282,279,39,240,4,236,3,51,67,23,1,4,0,24,3,60
59,283,451,71,380,7,373,9,116,96,41,2,2,0,25,8,74
59,284,2945,589,2356,44,2312,34,586,523,392,34,23,4,154,43,519
59,285,2207,380,1827,33,1794,13,489,274,305,16,14,3,104,32,544
59,286,9680,2070,7610,131,7479,117,1919,1541,998,98,72,25,523,121,2065
59,287,173,29,144,6,138,1,44,48,5,0,0,0,4,3,33
59,288,1619,252,1367,31,1336,11,370,255,231,11,6,2,64,18,368
59,289,1201,207,994,10,984,14,233,204,182,11,8,4,39,17,272
59,290,286,46,240,5,235,3,49,70,23,3,0,0,12,9,66
59,291,9654,2989,6665,91,6574,57,1828,1402,883,100,40,8,292,86,1878
59,292,2145,473,1672,43,1629,19,443,195,393,23,9,3,63,16,465
59,293,1088,150,938,19,919,18,231,232,88,11,4,2,83,14,236
59,294,228,37,191,2,189,5,46,61,25,1,1,1,20,5,24
59,295,16882,3884,12998,259,12739,192,2834,3012,1310,174,117,23,992,202,3883
59,296,273,43,230,3,227,1,53,61,30,4,1,1,18,7,51
59,297,1361,312,1049,19,1030,11,312,227,105,4,10,5,58,17,281
59,299,13334,2910,10424,145,10279,184,1539,3275,1051,90,59,10,955,124,2992
59,300,382,42,340,5,335,0,129,61,40,5,1,0,20,4,75
59,301,3425,947,2478,62,2416,31,680,532,332,30,7,6,162,41,595
59,302,2793,571,2222,42,2180,27,593,353,432,30,21,4,128,43,549
59,303,1666,239,1427,28,1399,26,290,434,140,18,2,4,169,20,296
59,304,310,36,274,3,271,5,47,87,18,3,1,2,43,9,56
59,305,1151,152,999,14,985,9,234,334,66,15,11,7,89,21,199
59,306,212,43,169,3,166,5,31,46,19,5,1,0,10,3,46
59,307,699,156,543,14,529,6,179,91,52,7,0,5,29,12,148
59,308,714,83,631,10,621,4,119,206,47,9,4,2,77,20,133
59,309,2948,626,2322,49,2273,22,561,605,201,44,11,9,134,43,643
59,310,523,84,439,6,433,8,115,125,39,4,0,0,44,10,88
59,311,350,57,293,7,286,2,74,65,35,8,4,0,20,4,74
59,312,512,92,420,10,410,3,127,103,49,7,8,2,26,10,75
59,313,1091,139,952,17,935,4,265,177,171,8,5,4,47,18,236
59,314,2511,444,2067,24,2043,30,498,289,323,29,18,4,94,24,734
59,315,656,139,517,14,503,8,131,145,47,4,1,0,40,6,121
59,316,2581,328,2253,31,2222,43,475,548,257,27,9,1,172,33,657
59,317,5836,1447,4389,57,4332,61,1034,955,526,55,41,15,267,73,1305
59,318,780,151,629,12,617,9,168,193,57,10,5,3,37,14,121
59,319,2728,439,2289,33,2256,27,539,620,223,26,7,2,182,44,586
59,320,1073,154,919,12,907,18,231,259,75,14,11,3,73,10,213
59,321,565,131,434,6,428,1,138,98,28,5,0,0,28,11,119
59,322,2338,399,1939,41,1898,23,581,331,241,15,12,4,105,33,553
59,323,862,150,712,8,704,20,141,230,65,1,2,1,71,18,155
59,324,6812,2175,4637,70,4567,42,1169,881,648,60,36,13,217,56,1445
59,325,722,105,617,11,606,14,128,178,46,4,0,1,61,18,156
59,326,725,84,641,12,629,18,154,190,41,7,3,3,50,16,147
59,327,4458,995,3463,56,3407,33,1024,469,707,47,31,7,157,40,892
59,328,20294,4127,16167,205,15962,481,1846,5716,1574,128,54,52,2004,205,3902
59,329,3890,655,3235,65,3170,45,720,789,360,37,14,2,272,62,869
59,330,1862,283,1579,19,1560,29,317,543,139,10,5,5,148,24,340
59,331,2652,482,2170,48,2122,23,559,461,253,20,14,4,153,31,604
59,332,1278,392,886,14,872,12,179,218,101,10,7,4,78,17,246
59,333,221,38,183,5,178,2,46,59,23,4,3,1,14,1,25
59,334,1443,260,1183,14,1169,8,313,256,183,15,8,3,83,24,276
59,335,2227,431,1796,14,1782,48,429,539,157,21,18,5,168,33,364
59,336,1074,186,888,13,875,5,290,125,142,10,6,1,37,15,244
59,337,468,64,404,7,397,5,82,141,34,5,1,0,30,10,89
59,338,488,42,446,12,434,6,101,123,23,5,5,0,54,7,110
59,339,8147,1720,6427,107,6320,88,1413,1986,579,53,33,13,519,111,1525
59,340,3754,702,3052,70,2982,86,642,712,309,44,24,12,206,42,905
59,341,316,41,275,8,267,1,55,74,19,1,2,1,14,8,92
59,342,158,15,143,3,140,1,28,53,8,1,4,0,20,0,25
59,343,4704,784,3920,73,3847,76,789,1128,355,38,19,13,402,75,952
59,344,1852,353,1499,28,1471,16,399,188,381,12,20,5,61,20,369
59,345,1942,360,1582,25,1557,16,364,274,456,13,11,4,84,21,314
59,346,2629,480,2149,31,2118,81,381,428,348,25,14,5,150,22,664
59,347,403,68,335,3,332,13,74,84,32,6,6,0,27,10,80
59,348,1011,132,879,27,852,6,247,156,127,15,6,4,45,21,225
59,349,1310,210,1100,18,1082,7,310,269,105,13,10,4,63,21,280
59,350,122616,31992,90624,1327,89297,3482,11968,18951,13768,891,487,228,7365,917,31240
59,351,462,98,364,8,356,2,122,118,21,4,3,0,22,4,60
59,352,6274,1201,5073,111,4962,78,958,1811,324,44,20,7,494,82,1144
59,353,238,42,196,1,195,3,62,51,26,3,6,1,13,3,27
59,354,622,80,542,13,529,8,125,130,74,2,5,0,32,14,139
59,356,1834,240,1594,19,1575,43,156,748,94,11,2,4,226,28,263
59,357,1518,290,1228,16,1212,15,354,346,123,16,4,4,78,18,254
59,358,929,138,791,20,771,16,205,201,63,15,9,0,52,18,192
59,359,4649,804,3845,92,3753,24,1128,818,394,56,34,11,196,51,1041
59,360,12570,3224,9346,154,9192,188,2061,1793,1206,127,73,33,586,128,2997
59,361,2176,526,1650,33,1617,5,402,209,335,17,9,2,44,22,572
59,363,757,123,634,3,631,9,141,167,72,3,2,2,50,11,174
59,364,647,90,557,11,546,17,48,188,64,5,1,2,67,4,150
59,365,3916,988,2928,51,2877,13,708,424,615,20,22,7,85,10,973
59,366,542,79,463,4,459,3,113,133,43,5,5,1,44,4,108
59,367,9064,1697,7367,140,7227,110,1751,1927,716,60,47,16,571,110,1919
59,368,15390,3805,11585,164,11421,382,1480,3545,1228,112,64,31,1188,162,3229
59,369,3069,704,2365,37,2328,29,507,602,322,26,17,3,196,43,583
59,370,562,86,476,7,469,4,118,174,41,3,1,0,32,9,87
59,371,520,69,451,9,442,11,78,192,25,0,4,0,52,16,64
59,372,413,75,338,5,333,4,97,131,20,4,5,2,19,6,45
59,374,364,55,309,8,301,2,76,73,34,5,3,0,26,7,75
59,375,3619,707,2912,50,2862,43,657,692,398,29,14,10,190,57,772
59,377,1488,229,1259,18,1241,20,335,278,133,28,8,4,93,22,320
59,378,28330,5662,22668,317,22351,534,2403,10074,1708,138,83,67,2484,335,4525
59,379,494,52,442,6,436,8,122,82,67,2,5,0,27,5,118
59,381,707,139,568,7,561,6,122,163,48,3,4,1,45,16,153
59,382,952,143,809,10,799,4,270,178,96,15,8,0,35,15,178
59,383,8537,1957,6580,145,6435,81,1404,1339,1067,63,45,14,433,98,1891
59,384,1181,273,908,15,893,17,225,234,102,17,5,2,69,12,210
59,385,1790,424,1366,23,1343,16,404,252,175,9,16,2,83,20,366
59,386,7389,1624,5765,119,5646,110,1180,1487,607,60,34,13,524,100,1531
59,387,1143,196,947,18,929,10,270,161,129,11,3,3,46,17,279
59,388,1521,228,1293,25,1268,21,283,355,187,19,11,2,99,27,264
59,389,1947,364,1583,25,1558,22,391,239,271,22,20,3,79,28,483
59,390,2960,640,2320,46,2274,28,556,337,475,21,21,6,116,30,684
59,391,693,92,601,11,590,7,173,153,58,3,2,3,37,10,144
59,392,20052,5853,14199,223,13976,167,3225,2843,1893,133,106,31,716,151,4711
59,393,791,184,607,12,595,16,139,169,71,7,4,0,45,12,132
59,394,261,49,212,7,205,0,74,42,14,5,1,2,5,2,60
59,395,240,48,192,4,188,2,67,58,13,2,3,0,9,3,31
59,396,440,67,373,4,369,10,118,89,26,2,0,0,26,7,91
59,397,481,70,411,1,410,4,138,118,36,2,4,3,34,4,67
59,398,1963,244,1719,19,1700,25,228,813,113,5,3,2,171,45,295
59,399,755,80,675,6,669,14,137,227,50,6,5,3,63,9,155
59,400,7225,1554,5671,134,5537,73,1469,1144,617,97,44,10,326,104,1653
59,401,1661,227,1434,29,1405,23,263,492,112,13,7,6,163,26,300
59,402,576,74,502,17,485,10,132,130,38,11,3,0,33,13,115
59,403,529,82,447,12,435,7,95,132,44,1,5,0,30,11,110
59,404,679,119,560,7,553,4,148,168,51,10,9,0,51,16,96
59,405,345,55,290,2,288,4,112,67,21,2,4,0,19,4,55
59,406,324,68,256,4,252,2,71,69,29,3,0,3,13,7,55
59,407,435,55,380,7,373,4,90,114,39,6,11,0,25,6,78
59,408,1159,200,959,15,944,16,199,264,88,10,2,4,102,25,234
59,409,1866,306,1560,35,1525,20,428,234,344,21,11,3,77,7,380
59,410,12948,2889,10059,185,9874,258,1767,2010,1404,125,66,29,684,104,3427
59,411,1679,297,1382,24,1358,39,225,472,95,12,6,6,127,34,342
59,412,234,26,208,5,203,1,63,38,26,2,1,1,4,7,60
59,413,470,83,387,9,378,1,94,108,27,5,5,2,31,9,96
59,414,3270,668,2602,66,2536,32,591,440,445,40,22,8,136,51,771
59,415,197,29,168,5,163,2,50,33,34,2,1,0,4,1,36
59,416,2048,308,1740,31,1709,42,358,454,190,18,10,3,187,32,415
59,418,1148,326,822,16,806,4,260,156,129,9,5,3,43,11,186
59,419,1065,176,889,22,867,16,160,296,78,7,8,4,94,14,190
59,420,37,6,31,0,31,1,6,11,2,0,0,0,0,0,11
59,421,10475,1946,8529,102,8427,157,1110,4235,497,45,25,16,995,123,1224
59,422,516,82,434,10,424,1,80,101,44,8,1,0,45,10,134
59,423,968,122,846,22,824,8,168,222,76,13,7,2,59,22,247
59,424,848,168,680,8,672,10,217,113,102,8,8,0,31,7,176
59,425,226,23,203,3,200,10,34,70,17,1,1,2,17,3,45
59,426,8192,1665,6527,107,6420,110,1476,2254,466,45,25,13,620,127,1284
59,427,534,66,468,4,464,9,82,173,23,2,2,0,51,9,113
59,428,2860,635,2225,59,2166,22,550,469,227,30,20,4,161,45,638
59,429,1982,327,1655,44,1611,18,472,226,426,9,10,5,53,24,368
59,430,759,111,648,11,637,3,203,163,70,3,9,0,24,13,149
59,431,6409,1449,4960,80,4880,92,1077,1359,496,69,27,11,429,83,1237
59,432,444,67,377,9,368,4,77,124,32,2,0,0,33,11,85
59,433,760,128,632,16,616,7,202,94,58,10,8,1,49,13,174
59,434,965,129,836,16,820,20,178,240,110,10,4,4,63,13,178
59,435,2031,333,1698,31,1667,25,318,598,138,13,4,5,205,31,330
59,436,602,77,525,11,514,8,125,160,45,10,10,1,39,13,103
59,437,688,94,594,7,587,12,98,183,63,7,1,0,76,19,128
59,438,547,66,481,5,476,3,135,118,34,2,5,1,36,9,133
59,439,255,44,211,5,206,1,65,48,19,2,2,1,23,2,43
59,440,565,78,487,6,481,4,115,135,88,3,1,3,15,9,108
59,441,516,69,447,10,437,5,89,147,35,3,2,0,44,9,103
59,442,209,23,186,1,185,1,53,59,16,4,0,0,19,2,31
59,443,260,18,242,6,236,8,58,85,21,0,0,0,19,3,42
59,444,733,216,517,9,508,8,166,102,61,2,5,2,41,4,117
59,445,955,210,745,16,729,6,225,172,74,7,4,3,49,9,180
59,446,417,60,357,4,353,6,68,119,37,6,2,0,26,7,82
59,447,6285,1584,4701,69,4632,44,1215,853,789,70,42,6,266,86,1261
59,448,381,70,311,9,302,8,96,70,28,4,1,1,14,8,72
59,449,6157,1120,5037,115,4922,77,1116,1091,636,62,58,9,379,97,1397
59,450,532,82,450,8,442,1,110,119,53,2,7,2,25,2,121
59,451,405,51,354,6,348,0,72,121,38,4,0,0,33,11,69
59,452,3671,869,2802,52,2750,28,688,512,303,35,19,8,126,39,992
59,453,513,1,512,77,435,11,103,131,34,5,6,1,42,8,94
59,454,390,54,336,5,331,1,74,107,25,2,0,0,40,8,74
59,455,742,101,641,8,633,8,175,136,81,4,3,2,41,8,175
59,456,4366,989,3377,53,3324,43,887,529,595,31,31,7,138,53,1010
59,457,5927,1271,4656,97,4559,91,1036,1237,496,51,37,9,386,84,1132
59,458,615,67,548,7,541,13,77,215,42,3,0,0,69,17,105
59,459,3837,787,3050,35,3015,35,947,508,544,28,35,9,143,55,711
59,461,218,24,194,3,191,4,55,63,14,0,2,0,16,4,33
59,462,3624,570,3054,46,3008,61,558,865,301,43,16,17,304,64,779
59,463,702,81,621,10,611,11,169,224,46,3,1,0,45,7,105
59,464,1469,289,1180,27,1153,7,327,228,123,16,10,1,57,14,370
59,465,518,76,442,10,432,1,121,101,53,3,1,0,26,12,114
59,466,1893,316,1577,19,1558,19,318,399,187,9,14,4,165,37,406
59,467,1818,390,1428,19,1409,12,341,291,239,19,8,2,103,21,373
59,468,307,63,244,11,233,7,40,86,16,2,1,0,9,7,65
59,469,247,40,207,2,205,0,46,62,19,7,1,1,20,3,46
59,470,1555,225,1330,16,1314,35,253,451,112,10,6,4,126,25,292
59,471,1486,267,1219,16,1203,11,228,327,192,14,5,3,112,19,292
59,472,627,93,534,5,529,8,85,85,93,11,12,2,37,11,185
59,473,209,35,174,2,172,5,33,57,13,2,1,0,23,3,35
59,474,820,143,677,12,665,10,173,220,52,9,4,2,46,11,138
59,475,1646,264,1382,24,1358,13,366,261,250,18,17,1,101,22,309
59,476,2842,562,2280,61,2219,32,467,631,195,35,17,4,193,62,583
59,477,3041,598,2443,51,2392,21,696,462,260,33,28,2,168,43,679
59,478,966,179,787,13,774,13,189,306,32,11,3,4,65,9,142
59,479,2568,615,1953,38,1915,21,536,427,249,24,16,7,146,37,452
59,480,649,77,572,10,562,8,121,158,54,3,4,0,44,12,158
59,481,3727,873,2854,59,2795,52,650,593,303,42,19,3,194,52,887
59,482,5330,1169,4161,66,4095,96,827,1379,354,44,22,6,437,69,861
59,483,118,20,98,3,95,0,16,45,2,2,1,1,3,3,22
59,484,3903,1090,2813,45,2768,12,715,460,493,23,14,4,104,29,914
59,485,1387,269,1118,16,1102,3,289,222,157,7,22,2,68,17,315
59,486,2064,434,1630,35,1595,20,421,340,198,12,8,4,112,31,449
59,487,1122,168,954,6,948,19,148,419,58,6,3,2,113,24,156
59,488,1782,355,1427,31,1396,10,345,386,122,19,9,1,117,14,373
59,489,3166,607,2559,40,2519,25,655,567,352,27,18,10,181,36,648
59,490,168,40,128,2,126,1,33,43,4,0,1,0,24,4,16
59,491,9863,2755,7108,127,6981,52,1967,1074,1540,93,56,21,335,94,1749
59,492,462,52,410,4,406,3,126,82,42,3,4,1,30,8,107
59,493,192,39,153,3,150,1,34,45,14,3,1,0,15,5,32
59,494,124,25,99,0,99,1,24,15,14,1,0,0,7,2,35
59,495,1710,477,1233,25,1208,9,389,240,176,10,11,4,57,11,301
59,496,185,18,167,6,161,7,40,56,17,1,2,2,3,3,30
59,497,1769,295,1474,39,1435,29,343,418,119,16,19,1,123,28,339
59,498,251,28,223,5,218,4,52,49,22,2,3,1,19,5,61
59,499,1462,276,1186,17,1169,12,295,318,103,17,11,2,103,22,286
59,500,307,33,274,4,270,4,86,84,18,2,2,1,13,8,52
59,501,1152,209,943,16,927,17,214,170,176,7,4,2,60,17,260
59,502,1032,138,894,17,877,15,184,146,182,12,5,3,52,17,261
59,503,135,18,117,2,115,0,33,26,18,1,1,1,14,0,21
59,504,2721,505,2216,40,2176,19,665,316,464,11,27,7,67,26,574
59,505,549,90,459,9,450,4,142,124,36,5,7,2,35,6,89
59,506,312,49,263,3,260,1,72,88,12,1,1,2,21,2,60
59,507,12951,3107,9844,155,9689,227,1879,2085,1324,99,59,19,798,140,3059
59,508,10673,2250,8423,130,8293,127,1701,3039,634,81,48,12,779,147,1725
59,509,4772,1006,3766,69,3697,30,1048,692,534,33,21,5,158,47,1129
59,511,1486,219,1267,25,1242,29,274,334,125,21,9,4,119,32,295
59,512,46047,14474,31573,528,31045,576,4834,5383,4658,311,178,75,1824,296,12910
59,513,317,41,276,5,271,6,58,75,33,4,1,0,20,4,70
59,514,2898,505,2393,51,2342,32,627,604,243,24,16,5,140,49,602
59,515,461,67,394,1,393,2,130,69,66,11,1,0,18,6,90
59,516,648,85,563,8,555,6,115,201,56,4,1,0,46,14,112
59,517,559,74,485,7,478,6,106,158,41,9,5,3,32,14,104
59,518,355,54,301,3,298,6,84,66,31,7,2,1,27,3,71
59,519,1287,246,1041,22,1019,13,241,353,102,13,5,4,96,21,171
59,520,1160,209,951,20,931,6,198,236,139,15,8,5,48,24,252
59,521,341,56,285,4,281,0,60,87,18,4,3,2,28,6,73
59,522,1450,247,1203,16,1187,24,149,558,64,10,3,3,124,11,241
59,523,2092,251,1841,27,1814,45,276,744,120,9,9,2,210,26,373
59,524,4265,768,3497,91,3406,56,687,883,440,47,20,9,271,56,937
59,525,2046,410,1636,30,1606,18,392,360,186,20,16,11,98,34,471
59,526,12421,2887,9534,186,9348,137,2213,2039,1659,104,62,25,624,132,2353
59,527,7823,1807,6016,108,5908,144,948,1620,661,59,22,7,814,69,1564
59,528,1181,172,1009,13,996,10,246,186,158,13,10,4,62,16,291
59,529,290,29,261,6,255,7,60,78,29,2,3,1,25,5,45
59,530,286,52,234,1,233,3,62,68,22,2,1,0,18,4,53
59,531,268,42,226,4,222,3,74,44,35,2,5,0,10,5,44
59,532,220,18,202,5,197,3,57,53,19,2,4,3,9,5,42
59,533,1236,210,1026,16,1010,17,228,184,200,14,8,1,49,15,294
59,534,609,113,496,10,486,6,129,117,50,0,7,0,45,10,122
59,535,1296,152,1144,28,1116,15,195,355,95,11,10,4,171,24,236
59,536,633,53,580,6,574,20,95,176,54,3,6,0,58,13,149
59,537,407,59,348,6,342,7,75,86,45,2,3,0,22,7,95
59,538,309,44,265,4,261,2,67,58,22,6,3,0,5,9,89
59,539,718,105,613,17,596,10,146,149,60,5,13,1,42,13,157
59,541,757,135,622,15,607,6,144,113,91,4,6,1,32,7,203
59,542,380,82,298,10,288,1,91,76,34,2,2,0,20,7,55
59,543,902,170,732,18,714,6,206,184,68,11,4,0,51,18,166
59,544,8422,1771,6651,117,6534,133,1373,1825,731,64,55,21,609,111,1612
59,545,951,177,774,17,757,12,235,157,91,4,9,2,39,12,196
59,546,912,139,773,19,754,20,167,232,52,2,1,2,61,7,210
59,547,628,85,543,8,535,5,114,92,149,3,3,0,32,5,132
59,548,486,58,428,10,418,7,114,103,47,10,3,1,47,10,76
59,549,237,35,202,2,200,2,62,58,8,2,1,0,11,2,54
59,550,2191,400,1791,26,1765,15,447,329,254,28,20,3,128,37,504
59,551,1203,213,990,17,973,14,205,336,84,11,4,0,96,15,208
59,552,155,16,139,2,137,5,45,44,12,0,1,0,9,1,20
59,553,4563,893,3670,61,3609,85,678,1129,330,41,19,12,378,75,862
59,554,398,69,329,6,323,8,67,116,30,7,0,1,24,3,67
59,555,996,218,778,15,763,8,196,167,100,8,10,2,45,18,209
59,556,217,40,177,1,176,4,56,55,29,0,1,1,15,4,11
59,557,1563,258,1305,21,1284,11,266,324,188,14,12,2,90,33,344
59,558,1398,237,1161,24,1137,16,267,228,199,9,8,0,76,24,310
59,559,1506,228,1278,17,1261,20,246,503,85,8,4,3,128,39,225
59,560,8829,1917,6912,113,6799,132,1517,1571,1194,83,39,20,522,93,1628
59,562,416,94,322,4,318,15,88,80,23,5,2,0,31,11,63
59,563,178,19,159,2,157,1,36,49,15,4,1,1,12,4,34
59,564,2394,700,1694,28,1666,11,463,252,286,8,14,3,85,16,528
59,565,435,54,381,2,379,5,94,117,36,3,3,0,26,7,88
59,566,3018,535,2483,38,2445,42,624,688,228,18,14,7,211,42,571
59,567,275,38,237,13,224,2,68,69,13,3,1,1,22,2,43
59,568,298,45,253,3,250,3,59,88,21,3,3,0,22,4,47
59,569,10861,2536,8325,174,8151,86,2025,1407,1514,94,70,12,431,104,2408
59,570,803,97,706,17,689,12,88,310,42,15,0,1,72,6,143
59,571,3446,735,2711,42,2669,23,691,598,364,32,30,3,125,35,768
59,572,1401,298,1103,22,1081,15,257,275,116,16,3,1,69,20,309
59,573,92,18,74,0,74,2,12,27,9,1,0,0,2,1,20
59,574,9146,2335,6811,121,6690,75,1741,879,1544,84,51,7,320,83,1906
59,575,292,39,253,1,252,4,58,52,31,5,1,0,25,5,71
59,576,1240,147,1093,21,1072,8,283,261,114,16,9,2,71,13,295
59,577,514,69,445,16,429,5,112,126,23,2,2,0,43,6,110
59,578,1269,155,1114,22,1092,19,250,264,107,11,9,3,125,17,287
59,579,1047,163,884,16,868,5,222,246,92,5,7,4,74,18,195
59,580,3176,510,2666,39,2627,50,566,831,166,33,22,5,251,58,645
59,581,2648,382,2266,46,2220,56,517,666,184,20,20,4,216,38,499
59,582,603,82,521,14,507,4,132,121,47,8,1,1,55,14,124
59,583,413,89,324,4,320,9,119,66,28,5,3,1,23,6,60
59,584,623,143,480,6,474,3,154,180,32,4,6,2,28,5,60
59,585,2734,561,2173,36,2137,43,443,605,220,13,7,3,199,37,567
59,586,4878,945,3933,58,3875,94,740,1211,382,40,20,10,389,68,921
59,587,486,56,430,9,421,10,85,140,42,6,6,1,51,14,66
59,588,5687,947,4740,81,4659,84,824,1569,424,61,16,10,492,83,1096
59,589,1983,454,1529,21,1508,10,433,277,300,9,14,4,91,23,347
59,590,648,97,551,10,541,6,147,139,52,0,2,2,39,9,145
59,591,608,123,485,8,477,4,155,104,63,4,2,0,23,7,115
59,592,2910,542,2368,53,2315,37,587,625,212,23,13,4,173,42,599
59,593,514,70,444,11,433,4,110,119,40,5,1,0,23,9,122
59,594,728,109,619,16,603,10,142,147,99,4,1,2,57,9,132
59,595,379,42,337,19,318,2,77,86,36,2,2,1,12,5,95
59,596,387,72,315,7,308,4,59,108,25,3,0,0,46,7,56
59,597,447,39,408,7,401,0,88,122,52,3,0,0,42,11,83
59,598,3235,591,2644,43,2601,47,641,780,209,21,14,8,253,55,573
59,599,61009,19319,41690,811,40879,803,8699,9167,5205,492,312,91,2774,532,12804
59,600,526,48,478,9,469,5,87,177,23,1,3,2,42,11,118
59,601,1993,491,1502,31,1471,6,431,327,159,21,18,10,86,23,390
59,602,1039,143,896,14,882,16,114,326,92,10,1,3,107,15,198
59,603,4858,1121,3737,64,3673,33,1090,496,858,55,26,8,155,63,889
59,604,592,93,499,10,489,8,99,138,57,2,3,1,29,10,142
59,605,1004,137,867,11,856,16,184,234,88,9,2,2,75,14,232
59,606,24526,6060,18466,277,18189,364,3400,5507,2195,148,104,43,1579,289,4560
59,607,369,57,312,7,305,3,62,82,26,2,1,1,31,9,88
59,608,819,105,714,11,703,6,168,215,48,9,4,0,64,18,171
59,609,1350,234,1116,29,1087,21,188,389,88,5,5,2,107,13,269
59,610,709,85,624,6,618,7,157,154,61,9,4,1,39,11,175
59,611,1850,277,1573,19,1554,29,218,756,94,13,6,7,180,22,229
59,612,417,66,351,6,345,7,81,94,41,0,4,0,27,8,83
59,613,977,202,775,16,759,11,243,163,76,9,6,2,41,16,192
59,614,1154,183,971,9,962,6,237,187,239,14,12,2,32,15,218
59,615,1780,245,1535,40,1495,26,301,484,127,20,8,8,163,31,327
59,616,7633,2195,5438,93,5345,55,1570,965,923,80,41,14,238,68,1391
59,617,428,70,358,5,353,3,111,86,26,6,3,0,38,9,71
59,618,591,118,473,2,471,9,137,124,36,3,6,2,20,7,127
59,619,742,141,601,9,592,7,139,171,39,10,1,0,50,8,167
59,620,471,45,426,7,419,10,109,98,58,7,3,0,20,7,107
59,622,929,138,791,10,781,3,213,148,112,5,5,1,49,21,224
59,623,552,80,472,8,464,7,184,99,29,4,4,1,37,18,81
59,624,1603,342,1261,25,1236,14,380,416,101,7,12,2,82,44,178
59,625,325,49,276,0,276,6,59,75,24,3,0,0,30,8,71
59,626,930,120,810,15,795,13,123,244,83,3,8,3,88,17,213
59,627,795,189,606,12,594,7,163,177,55,8,7,4,44,22,107
59,628,432,57,375,9,366,7,102,122,12,5,1,2,29,3,83
59,629,1033,163,870,18,852,13,205,181,106,12,2,2,72,11,248
59,630,1854,345,1509,25,1484,16,356,322,135,15,12,4,101,22,501
59,631,1571,329,1242,25,1217,12,358,317,110,20,13,1,74,18,294
59,632,4055,860,3195,50,3145,35,835,720,432,40,34,8,191,48,802
59,633,179,33,146,2,144,2,38,40,15,2,3,0,12,3,29
59,634,661,71,590,12,578,9,86,226,44,6,1,2,67,9,128
59,635,273,27,246,1,245,8,45,72,32,2,2,1,29,3,51
59,636,7719,1746,5973,125,5848,103,1003,2215,493,42,42,8,580,101,1261
59,637,988,199,789,15,774,9,200,168,92,9,2,2,66,20,206
59,638,784,67,717,11,706,10,148,204,70,5,4,0,71,13,181
59,639,766,125,641,16,625,12,156,177,57,9,1,0,59,17,137
59,640,560,71,489,4,485,4,120,143,42,8,3,0,55,4,106
59,641,1715,309,1406,36,1370,21,325,402,118,13,14,5,108,28,336
59,642,377,47,330,4,326,4,70,75,45,3,1,5,41,3,79
59,643,194,37,157,1,156,1,35,67,9,1,0,0,14,5,24
59,645,455,68,387,2,385,4,95,107,40,3,1,1,21,6,107
59,646,15136,3430,11706,177,11529,205,1860,4042,1182,103,54,22,1237,197,2627
59,647,1951,333,1618,26,1592,16,528,244,158,18,18,1,74,20,515
59,648,9047,1880,7167,118,7049,134,1344,1874,812,71,34,12,604,101,2063
59,649,196,27,169,4,165,2,29,67,14,4,0,1,23,3,22
59,650,30318,8365,21953,394,21559,286,5996,4074,2446,266,176,51,1175,291,6798
59,651,842,7,835,19,816,10,220,126,188,4,3,1,34,15,215
59,652,277,33,244,4,240,2,64,69,28,1,6,0,15,3,52
59,653,5854,1143,4711,91,4620,94,1051,1071,502,50,31,11,403,96,1311
59,654,4945,1231,3714,57,3657,35,861,408,1065,41,27,8,116,33,1063
59,655,166,27,139,3,136,5,23,41,11,3,0,2,16,3,32
59,656,3224,658,2566,30,2536,45,536,872,215,34,15,5,184,44,586
59,657,442,62,380,9,371,4,94,106,32,5,5,0,35,8,82
59,658,287,38,249,5,244,4,41,99,24,1,3,0,17,5,50
59,659,2176,485,1691,39,1652,18,504,329,197,22,14,3,61,35,469
59,660,2264,398,1866,31,1835,46,350,610,130,19,3,3,159,27,488
59,661,98,21,77,0,77,4,14,18,16,2,1,3,8,2,9
59,662,903,118,785,18,767,13,159,245,62,7,11,1,77,17,175
59,663,4344,750,3594,84,3510,55,791,1032,299,47,31,9,311,52,883
59,664,232,38,194,3,191,0,55,48,12,1,2,0,15,0,58
59,665,218,39,179,5,174,1,58,51,10,4,2,1,11,4,32
59,666,1106,178,928,24,904,10,252,264,69,12,9,3,77,22,186
59,667,156,15,141,4,137,2,27,50,8,0,1,0,17,3,29
59,668,1125,139,986,18,968,19,207,235,100,17,7,1,71,22,289
59,669,438,56,382,8,374,5,91,111,38,5,0,0,35,4,85
59,670,953,136,817,26,791,14,189,181,81,3,5,2,71,16,229
60,1,456,62,394,6,388,2,151,95,15,9,5,0,14,11,86
60,2,579,100,479,7,472,11,132,153,29,4,2,0,44,6,91
60,3,423,55,368,5,363,5,105,92,28,3,3,1,29,14,83
60,4,271,26,245,4,241,3,77,69,16,0,0,0,23,9,44
60,5,586,149,437,9,428,3,130,109,46,10,2,0,30,7,91
60,6,904,165,739,10,729,12,195,185,60,4,7,1,42,11,212
60,7,2199,307,1892,42,1850,31,426,568,202,13,14,7,131,39,419
60,8,298,34,264,2,262,4,66,68,21,5,2,0,21,12,63
60,9,1170,160,1010,15,995,16,226,320,87,13,10,2,76,23,222
60,10,1203,228,975,25,950,11,266,260,124,5,7,1,61,23,192
60,11,282,47,235,1,234,0,93,50,35,3,1,0,14,5,33
60,12,2297,496,1801,33,1768,19,513,411,183,26,11,2,118,42,443
60,13,1086,190,896,14,882,17,279,218,80,12,7,1,66,17,185
60,14,153,19,134,1,133,4,35,32,15,1,4,0,13,0,29
60,15,868,120,748,11,737,13,238,189,76,1,8,0,66,20,126
60,16,207,29,178,4,174,1,51,46,14,1,1,0,20,6,34
60,17,760,99,661,13,648,7,181,171,59,11,8,0,41,19,151
60,18,403,75,328,4,324,2,87,103,20,2,0,0,43,10,57
60,19,324,60,264,2,262,6,79,59,36,4,1,0,16,7,54
60,20,194,31,163,2,161,2,50,43,14,3,3,0,13,2,31
60,21,357,56,301,7,294,1,96,68,34,3,2,0,19,5,66
60,22,583,48,535,8,527,9,62,275,20,2,1,1,65,11,81
60,23,425,55,370,4,366,5,77,114,38,1,3,3,29,6,90
60,24,620,82,538,12,526,7,172,89,61,6,5,0,44,9,133
60,25,1398,279,1119,18,1101,12,269,326,109,4,8,3,72,22,276
60,26,355,49,306,1,305,5,89,82,34,5,4,1,21,9,55
60,27,356,66,290,4,286,3,59,95,22,5,1,0,21,11,69
60,28,452,67,385,5,380,5,38,203,20,2,0,1,55,4,52
60,29,2018,421,1597,31,1566,14,480,390,138,34,12,6,107,33,352
60,30,433,55,378,8,370,4,113,125,24,7,7,0,32,6,52
60,31,203,41,162,2,160,5,37,55,13,2,2,4,8,5,29
60,32,578,112,466,7,459,2,164,93,43,5,5,0,29,8,110
60,33,758,127,631,8,623,8,87,278,29,6,1,0,82,7,125
60,34,857,127,730,13,717,11,213,168,84,6,4,3,44,17,167
60,35,178,21,157,1,156,2,45,44,24,0,1,0,11,3,26
60,36,269,26,243,3,240,2,62,70,21,5,2,0,17,2,59
60,37,368,48,320,4,316,4,84,104,31,3,3,0,23,7,57
60,38,332,43,289,6,283,3,86,77,23,6,2,1,22,10,53
60,39,327,47,280,6,274,4,73,73,36,4,6,4,9,6,59
60,40,487,74,413,11,402,3,143,93,36,5,1,1,21,13,86
60,41,1452,190,1262,20,1242,18,364,249,105,17,13,0,66,30,380
60,42,1098,161,937,16,921,15,252,227,105,7,5,2,70,19,219
60,43,527,97,430,9,421,5,111,82,61,7,9,1,28,13,104
60,44,1215,270,945,15,930,9,274,237,118,5,11,2,47,15,212
60,45,377,57,320,7,313,8,50,135,15,7,3,0,17,11,67
60,46,206,26,180,2,178,3,78,40,13,0,1,1,13,3,26
60,47,559,61,498,11,487,2,104,173,26,2,2,1,32,17,128
60,48,239,45,194,3,191,4,54,61,7,1,0,0,8,1,55
60,49,111,9,102,1,101,6,22,28,10,2,0,0,10,2,21
60,50,238,23,215,2,213,2,53,61,15,1,2,1,20,4,54
60,51,152,20,132,4,128,1,45,43,9,1,1,0,5,1,22
60,52,82,9,73,1,72,0,26,22,7,3,0,0,4,0,10
60,53,326,48,278,5,273,1,100,75,26,2,2,0,19,11,37
60,54,270,33,237,4,233,1,73,81,15,6,0,0,21,1,35
60,55,229,26,203,7,196,2,66,41,21,5,1,0,19,1,40
60,56,57,10,47,1,46,0,11,12,2,2,1,0,6,2,10
60,57,33242,8154,25088,423,24665,461,4867,6017,2844,321,231,68,1783,394,7679
60,58,212,24,188,2,186,5,42,57,16,2,1,1,11,1,50
60,59,173,23,150,2,148,3,32,39,13,0,0,1,16,0,44
60,60,438,69,369,8,361,7,84,103,37,4,1,1,29,7,88
60,61,67,9,58,1,57,3,12,15,7,2,0,0,8,0,10
60,62,240,47,193,0,193,1,73,57,15,2,0,0,5,3,37
60,63,680,109,571,5,566,12,142,152,72,9,6,3,47,8,115
60,64,724,125,599,16,583,5,171,147,55,11,5,1,33,13,142
60,65,1140,181,959,13,946,7,308,224,92,12,7,0,77,18,201
60,66,201,28,173,3,170,4,32,58,13,2,1,0,22,3,35
60,67,784,135,649,10,639,16,178,141,65,10,6,3,47,11,162
60,68,2126,451,1675,21,1654,28,474,334,219,20,14,4,98,39,424
60,69,719,97,622,4,618,6,148,146,58,14,6,1,43,11,185
60,70,358,68,290,2,288,8,67,67,29,2,3,1,14,6,91
60,71,127,14,113,4,109,1,30,38,8,0,0,0,7,3,22
60,72,229,44,185,0,185,5,55,44,19,3,3,1,16,5,34
60,73,420,59,361,5,356,5,136,93,33,2,3,0,21,6,57
60,74,839,129,710,14,696,6,194,206,68,4,2,0,49,23,144
60,75,97,17,80,1,79,1,23,18,7,3,2,1,7,4,13
60,76,413,61,352,3,349,4,115,103,17,5,6,1,20,8,70
60,77,275,46,229,3,226,4,56,84,16,0,0,0,15,4,47
60,78,70,9,61,0,61,0,15,24,0,3,1,1,1,1,15
60,79,644,98,546,4,542,3,149,121,75,7,5,0,44,7,131
60,80,135,15,120,1,119,1,35,45,10,1,3,0,4,4,16
60,81,271,30,241,6,235,0,63,74,20,2,1,1,13,8,53
60,82,647,103,544,4,540,5,166,154,22,8,9,2,43,19,112
60,83,706,130,576,8,568,11,202,136,63,5,3,2,31,10,105
60,84,137,22,115,0,115,3,38,39,7,2,0,0,6,2,18
60,85,170,33,137,1,136,1,41,41,12,8,5,0,5,1,22
60,86,1509,257,1252,11,1241,18,305,402,101,20,5,3,86,25,276
60,87,224,23,201,3,198,4,23,106,6,4,0,1,14,2,38
60,88,2545,565,1980,33,1947,25,537,499,218,15,20,2,114,26,491
60,89,303,53,250,2,248,10,62,71,21,2,1,0,23,7,51
60,90,263,29,234,1,233,6,55,73,30,2,1,0,23,3,40
60,91,289,39,250,2,248,2,84,70,14,1,1,2,16,9,49
60,92,146,26,120,0,120,0,52,15,14,1,1,0,7,2,28
60,93,322,46,276,1,275,5,75,67,33,4,7,1,25,8,50
60,94,217,35,182,7,175,5,39,41,23,3,0,0,7,9,48
60,95,299,34,265,3,262,9,66,76,25,2,1,0,22,4,57
60,96,66,1,65,1,64,0,20,25,2,2,0,0,2,1,12
60,97,191,27,164,5,159,0,44,74,9,0,0,0,13,1,18
60,98,157,26,131,3,128,1,28,60,9,0,0,0,15,3,12
60,99,132,25,107,2,105,3,22,22,12,3,0,0,14,3,26
60,100,94,14,80,1,79,3,16,33,7,1,1,0,11,1,6
60,101,399,62,337,8,329,2,129,82,35,2,4,0,13,11,51
60,102,1598,321,1277,31,1246,13,319,281,126,14,10,4,98,30,351
60,103,2934,659,2275,38,2237,19,718,507,221,27,29,5,130,55,526
60,104,2882,708,2174,51,2123,20,558,550,148,32,29,3,158,39,586
60,105,281,57,224,5,219,3,79,62,20,6,3,0,13,6,27
60,106,1688,289,1399,24,1375,19,343,285,200,16,13,4,117,40,338
60,107,2267,322,1945,34,1911,41,374,536,214,17,13,3,147,30,536
60,108,237,30,207,2,205,4,76,54,8,5,0,0,8,3,47
60,109,184,27,157,1,156,0,62,40,17,1,0,0,12,3,21
60,110,179,40,139,3,136,0,38,39,7,1,0,0,11,1,39
60,111,96,10,86,3,83,1,27,24,4,1,2,2,3,1,18
60,112,250,33,217,5,212,3,46,49,35,10,1,0,15,4,49
60,113,120,21,99,0,99,4,29,27,4,2,0,0,10,5,18
60,114,124,15,109,0,109,2,31,30,8,2,0,0,16,1,19
60,115,634,109,525,6,519,7,163,119,47,8,6,2,35,12,120
60,116,2025,349,1676,29,1647,11,555,326,203,16,16,3,122,32,363
60,117,220,31,189,3,186,3,64,47,14,4,0,0,10,5,39
60,118,350,61,289,3,286,3,100,59,22,5,1,1,19,11,65
60,119,1497,360,1137,18,1119,11,309,218,152,20,16,2,74,25,292
60,120,803,88,715,12,703,10,211,182,69,8,5,1,49,14,154
60,121,115,17,98,4,94,0,27,26,11,1,0,0,7,3,19
60,122,369,45,324,7,317,0,96,99,17,10,5,1,37,7,45
60,123,295,38,257,7,250,2,99,67,16,4,5,0,8,1,48
60,124,222,49,173,3,170,2,53,50,10,1,2,0,18,6,28
60,125,591,74,517,23,494,13,141,140,41,9,6,3,34,5,102
60,126,421,90,331,5,326,9,90,83,33,8,1,2,23,4,73
60,127,266,52,214,2,212,3,68,57,21,0,4,0,13,4,42
60,128,149,23,126,1,125,1,50,25,10,2,1,0,6,5,25
60,129,1124,237,887,14,873,24,257,180,116,17,8,1,57,9,204
60,130,818,143,675,19,656,6,172,182,68,9,9,1,56,7,146
60,131,97,6,91,2,89,4,31,24,6,2,1,0,6,3,12
60,132,146,19,127,0,127,1,33,40,13,2,1,0,12,0,25
60,133,438,72,366,6,360,3,106,96,39,8,0,1,15,10,82
60,134,1725,276,1449,28,1421,16,410,356,136,16,12,3,86,33,353
60,135,1059,144,915,17,898,9,269,262,72,6,11,4,67,20,178
60,136,344,45,299,2,297,10,93,71,26,0,1,0,23,4,69
60,137,173,22,151,4,147,1,52,27,9,1,0,0,17,6,34
60,138,669,115,554,4,550,6,92,255,33,4,2,1,40,11,106
60,139,6327,1237,5090,76,5014,72,1160,1006,594,77,36,13,351,89,1616
60,140,280,43,237,7,230,3,56,67,28,1,0,0,16,7,52
60,141,7857,2012,5845,86,5759,121,910,2277,421,45,19,18,620,93,1235
60,142,1824,244,1580,24,1556,21,365,480,137,13,5,4,165,34,332
60,143,2039,386,1653,31,1622,17,394,447,177,18,16,2,124,35,392
60,144,132,15,117,2,115,3,33,38,7,2,0,0,6,4,22
60,145,363,61,302,2,300,4,61,100,22,5,0,0,28,6,74
60,146,276,40,236,3,233,2,87,68,12,4,2,0,11,5,42
60,147,625,99,526,10,516,3,107,140,67,9,8,0,55,11,116
60,148,331,69,262,2,260,4,87,81,16,3,3,2,21,11,32
60,149,1310,189,1121,23,1098,19,251,347,103,26,9,4,76,27,236
60,150,870,172,698,12,686,5,216,153,73,12,6,4,53,14,150
60,151,2553,396,2157,35,2122,35,426,659,172,24,22,6,238,48,492
60,152,170,24,146,1,145,3,31,50,15,0,2,1,6,2,35
60,153,89,13,76,0,76,5,21,31,4,0,0,0,4,1,10
60,154,1218,174,1044,14,1030,13,280,304,89,7,8,2,75,26,226
60,155,2275,443,1832,25,1807,27,451,463,225,20,14,8,136,32,431
60,156,1489,224,1265,18,1247,27,269,360,124,17,9,2,101,28,310
60,157,6534,1554,4980,74,4906,79,1124,1053,609,78,59,15,337,90,1462
60,158,196,26,170,7,163,3,55,46,11,1,2,0,8,4,33
60,159,24764,6121,18643,290,18353,363,2875,5963,1662,185,118,44,1700,302,5141
60,160,453,77,376,5,371,3,116,94,32,3,3,1,32,11,76
60,161,74,16,58,1,57,0,16,25,3,0,0,0,4,0,9
60,162,245,36,209,4,205,4,54,77,14,2,2,0,13,4,35
60,163,260,31,229,1,228,1,83,57,17,5,0,1,18,3,43
60,164,600,130,470,12,458,5,144,145,26,12,1,1,33,11,80
60,165,410,91,319,3,316,3,106,97,16,3,1,0,18,9,63
60,166,737,106,631,16,615,4,173,120,72,7,8,0,37,9,185
60,167,354,67,287,14,273,1,84,64,21,6,3,0,26,7,61
60,168,131,19,112,0,112,2,49,30,4,1,1,0,4,1,20
60,169,634,99,535,11,524,8,132,146,57,3,2,3,48,11,114
60,170,501,9,492,76,416,5,68,190,24,2,5,2,42,3,75
60,171,153,24,129,2,127,0,44,33,8,1,1,0,1,2,37
60,172,2825,499,2326,31,2295,83,322,844,178,15,4,9,266,43,531
60,173,402,51,351,14,337,4,106,79,42,8,3,0,32,4,59
60,174,124,26,98,3,95,0,31,23,10,0,2,1,3,1,24
60,175,15003,3838,11165,186,10979,186,1942,1531,1450,101,95,23,503,112,5036
60,176,10323,2280,8043,123,7920,133,1997,1714,861,78,43,26,580,165,2323
60,177,291,44,247,2,245,3,81,59,12,5,4,0,21,8,52
60,178,2384,452,1932,72,1860,17,586,441,145,29,18,5,130,29,460
60,179,82,16,66,1,65,1,19,10,13,4,0,0,4,0,14
60,180,349,46,303,3,300,4,85,73,35,9,3,2,19,8,62
60,181,723,169,554,9,545,3,145,120,97,14,4,1,24,7,130
60,182,126,25,101,3,98,0,28,30,11,2,1,0,4,3,19
60,183,199,34,165,4,161,1,36,66,12,5,1,0,7,1,32
60,184,175,22,153,2,151,2,41,40,14,4,1,0,13,6,30
60,185,734,168,566,6,560,3,144,172,37,5,2,0,46,19,132
60,186,179,37,142,1,141,0,38,44,14,0,0,0,3,4,38
60,187,735,139,596,9,587,2,204,159,46,7,3,0,41,13,112
60,188,1605,373,1232,26,1206,22,285,258,122,11,13,4,102,15,374
60,189,677,131,546,8,538,7,140,164,42,7,1,1,39,18,119
60,190,229,30,199,4,195,3,42,61,15,1,0,1,12,4,56
60,191,468,100,368,13,355,2,137,93,18,8,5,0,18,12,62
60,192,178,42,136,3,133,2,30,36,11,1,1,1,10,6,35
60,193,164,35,129,4,125,2,57,24,9,0,2,0,7,2,22
60,194,212,25,187,0,187,2,46,62,13,3,0,0,9,3,49
60,195,451,84,367,6,361,3,80,121,28,9,1,0,36,9,74
60,196,349,53,296,5,291,3,101,77,30,3,1,0,20,6,50
60,197,635,137,498,4,494,8,137,151,62,2,2,1,41,6,84
60,198,284,34,250,9,241,1,63,55,29,5,6,1,22,4,55
60,199,189,32,157,1,156,4,41,51,17,3,2,0,7,4,27
60,200,126,26,100,2,98,1,31,32,7,2,0,0,5,2,18
60,201,179,29,150,2,148,2,57,27,8,1,0,0,13,4,36
60,203,296,42,254,4,250,2,83,68,22,1,1,0,20,4,49
60,204,218,45,173,3,170,2,51,58,9,3,1,2,12,4,28
60,205,46,8,38,1,37,2,9,8,1,0,0,0,5,0,12
60,206,678,92,586,9,577,7,128,150,81,5,3,3,57,7,136
60,207,216,23,193,1,192,7,56,45,21,6,0,1,14,5,37
60,208,114,16,98,3,95,0,13,49,8,1,0,0,9,3,12
60,209,147,13,134,2,132,1,36,46,6,1,2,0,11,4,25
60,210,200,21,179,8,171,5,50,53,13,4,1,0,10,7,28
60,211,423,79,344,10,334,6,75,77,48,6,5,2,29,6,80
60,212,973,148,825,15,810,11,230,216,82,20,8,3,59,29,152
60,213,608,95,513,9,504,19,87,229,32,5,1,0,49,10,72
60,214,149,20,129,3,126,1,43,32,11,2,4,1,5,0,27
60,215,408,52,356,12,344,7,67,74,38,6,4,1,36,2,109
60,216,129,14,115,2,113,2,23,28,11,1,1,0,8,4,35
60,217,197,35,162,0,162,0,37,66,11,1,1,2,15,2,27
60,218,825,108,717,22,695,13,171,234,56,14,4,0,40,20,143
60,219,121,24,97,1,96,0,32,37,3,0,1,0,8,3,12
60,220,371,58,313,7,306,4,90,98,18,4,3,0,34,3,52
60,221,547,114,433,13,420,4,102,89,45,5,7,0,21,8,139
60,222,411,59,352,3,349,2,108,93,35,7,5,1,24,7,67
60,223,2742,564,2178,39,2139,21,595,513,202,31,19,6,180,44,528
60,224,97,25,72,2,70,5,16,11,10,2,1,0,9,2,14
60,225,583,80,503,7,496,2,143,109,69,6,5,4,33,5,120
60,226,270,42,228,1,227,3,56,78,17,0,0,0,13,6,54
60,227,140,22,118,4,114,1,36,30,11,1,2,0,8,1,24
60,228,294,17,277,4,273,5,77,80,17,2,1,0,15,5,71
60,229,175,23,152,3,149,8,41,42,14,3,4,0,5,0,32
60,230,373,37,336,12,324,3,116,88,31,7,6,1,23,1,48
60,231,320,28,292,4,288,4,58,67,29,2,1,0,29,9,89
60,232,364,64,300,3,297,2,100,55,40,4,2,1,18,8,67
60,233,1105,220,885,17,868,6,296,155,55,16,17,1,59,21,242
60,234,1735,328,1407,25,1382,13,366,290,173,14,8,5,110,23,380
60,235,612,138,474,6,468,11,128,123,50,4,7,2,39,12,92
60,236,157,23,134,4,130,0,55,30,17,0,0,0,4,3,21
60,237,83,9,74,0,74,0,24,18,3,1,0,0,8,3,17
60,238,1390,180,1210,13,1197,29,250,445,59,8,6,3,138,28,231
60,239,351,65,286,6,280,2,82,87,13,3,0,0,26,9,58
60,240,225,46,179,1,178,0,66,62,6,1,3,0,8,4,28
60,241,280,47,233,1,232,2,26,122,16,0,1,1,29,4,31
60,242,322,59,263,7,256,5,84,55,24,3,2,2,28,9,44
60,243,129,19,110,4,106,1,21,36,15,1,1,0,8,4,19
60,244,132,18,114,1,113,1,41,40,4,1,1,0,8,0,17
60,245,1507,294,1213,31,1182,8,381,312,76,17,16,2,73,21,276
60,246,628,163,465,6,459,3,145,129,33,5,5,0,40,10,89
60,247,79,10,69,1,68,1,33,14,7,1,1,0,5,0,6
60,248,141,22,119,4,115,0,36,26,5,1,0,0,15,1,31
60,249,157,19,138,1,137,9,31,38,10,1,0,1,11,3,33
60,250,371,38,333,5,328,5,71,89,21,3,1,1,32,4,101
60,251,228,32,196,3,193,5,47,68,15,1,1,0,8,5,43
60,252,422,71,351,6,345,9,88,95,45,7,1,1,18,14,67
60,253,346,45,301,4,297,3,107,84,22,8,4,2,21,2,44
60,254,357,43,314,7,307,6,77,101,23,6,4,0,21,8,61
60,255,244,59,185,3,182,4,53,50,21,3,0,1,13,4,33
60,256,552,66,486,4,482,7,132,134,58,7,2,0,53,6,83
60,257,329,58,271,5,266,3,87,66,42,4,4,0,20,3,37
60,258,111,11,100,3,97,0,32,24,5,2,1,0,10,0,23
60,259,665,118,547,5,542,7,139,163,69,11,0,0,38,20,95
60,260,486,109,377,10,367,6,108,92,38,6,1,1,37,8,70
60,261,347,45,302,8,294,6,52,106,16,3,1,2,26,10,72
60,262,171,24,147,4,143,3,44,49,9,0,1,0,7,6,24
60,263,200,46,154,2,152,1,32,49,16,0,2,1,19,0,32
60,264,354,41,313,3,310,5,77,73,29,2,3,0,26,9,86
60,265,689,95,594,15,579,6,188,127,58,17,5,2,46,7,123
60,267,112,14,98,2,96,2,37,24,5,0,0,0,5,3,20
60,268,274,64,210,2,208,3,68,64,15,2,2,0,9,2,43
60,269,268,53,215,9,206,1,66,43,14,6,2,0,22,7,45
60,270,220,32,188,1,187,3,59,53,16,2,0,0,20,7,27
60,271,107,13,94,3,91,2,14,41,1,3,0,0,12,1,17
60,272,405,58,347,6,341,3,106,89,37,4,5,0,22,13,62
60,273,428,44,384,4,380,3,93,86,43,1,3,0,24,7,120
60,274,335,49,286,2,284,6,71,79,28,3,1,1,25,5,65
60,275,158,23,135,3,132,2,36,27,17,0,0,0,16,3,31
60,276,138,13,125,2,123,1,44,32,14,0,1,0,6,3,22
60,277,1027,151,876,17,859,14,212,240,73,9,6,3,62,16,224
60,278,314,48,266,4,262,1,93,55,35,7,3,2,11,4,51
60,279,174,15,159,0,159,2,52,32,22,4,0,0,6,7,34
60,280,103,6,97,3,94,0,23,24,11,0,1,0,7,1,27
60,281,433,65,368,4,364,11,78,105,28,6,4,1,29,3,99
60,282,6646,1261,5385,68,5317,143,848,2162,330,45,18,9,614,111,1037
60,283,30,5,25,0,25,0,0,10,5,0,0,0,0,2,8
60,284,1238,213,1025,14,1011,30,303,234,93,14,5,1,92,17,222
60,285,243,30,213,3,210,3,54,62,15,2,3,0,10,6,55
60,286,2162,530,1632,26,1606,15,522,434,101,23,16,2,101,22,370
60,287,223,21,202,4,198,2,81,36,20,0,2,0,8,6,43
60,288,313,37,276,3,273,2,89,88,15,7,3,0,23,7,39
60,289,192,25,167,0,167,2,67,47,12,7,4,0,10,0,18
60,290,321,55,266,2,264,4,90,78,25,3,2,2,25,1,34
60,291,1300,359,941,11,930,9,304,224,87,18,10,2,55,22,199
60,292,161,37,124,1,123,0,39,23,14,1,1,0,8,6,31
60,293,268,41,227,7,220,4,49,75,14,4,1,0,29,2,42
60,294,45,5,40,1,39,0,13,6,11,1,1,0,0,5,2
60,295,343,54,289,8,281,3,98,68,10,3,4,0,23,2,70
60,296,110,12,98,3,95,2,23,35,3,2,1,0,7,6,16
60,297,132,13,119,0,119,0,59,22,9,0,1,0,8,1,19
60,298,467,83,384,18,366,3,125,81,33,6,2,0,26,12,78
60,299,401,66,335,6,329,1,106,69,29,1,1,2,21,10,89
60,300,95,9,86,2,84,0,19,23,9,0,1,0,11,0,21
60,301,108,13,95,2,93,4,21,21,7,1,2,0,11,1,25
60,302,663,116,547,8,539,6,160,128,47,9,6,2,49,14,118
60,303,108,17,91,0,91,1,31,25,2,0,2,0,9,0,21
60,304,222,25,197,4,193,3,38,72,20,2,7,1,12,5,33
60,305,225,26,199,1,198,0,50,45,27,2,1,0,14,3,56
60,306,123,24,99,1,98,1,30,25,10,1,1,1,4,0,25
60,307,429,65,364,6,358,3,92,91,43,2,2,3,28,4,90
60,308,308,53,255,3,252,3,68,73,27,3,2,1,27,12,36
60,309,594,121,473,9,464,7,124,146,43,2,5,0,34,11,92
60,310,469,73,396,9,387,2,109,99,34,4,2,1,38,4,94
60,311,144,24,120,1,119,1,43,17,8,6,2,0,10,4,28
60,312,81,18,63,0,63,0,19,19,3,0,2,0,3,3,14
60,313,1614,306,1308,25,1283,6,489,248,113,10,12,3,84,29,289
60,314,171,20,151,7,144,0,54,33,12,2,1,0,10,0,32
60,315,371,63,308,9,299,5,79,78,38,7,4,0,21,2,65
60,316,159,10,149,4,145,1,52,53,5,1,4,0,5,4,20
60,317,459,82,377,7,370,6,109,102,40,1,5,2,18,5,82
60,318,487,82,405,9,396,7,99,94,28,3,6,3,37,11,108
60,319,421,81,340,5,335,2,107,91,21,5,5,0,18,9,77
60,320,174,18,156,5,151,3,53,30,14,2,3,3,15,4,24
60,321,458,81,377,5,372,8,96,103,31,5,2,1,31,14,81
60,322,226,39,187,3,184,2,57,63,13,2,0,0,9,1,37
60,323,503,108,395,8,387,1,121,97,32,2,6,3,20,12,93
60,324,599,104,495,7,488,3,158,102,55,8,6,2,32,12,110
60,325,1407,182,1225,23,1202,16,299,356,95,14,10,5,112,31,264
60,326,495,56,439,10,429,9,89,178,30,2,1,2,43,6,69
60,327,681,111,570,5,565,5,175,147,60,10,5,0,30,17,116
60,328,236,34,202,6,196,1,48,55,14,9,1,0,17,5,46
60,329,156,28,128,1,127,3,47,29,6,3,0,0,11,3,25
60,330,905,138,767,18,749,8,219,197,69,10,10,0,58,19,159
60,331,376,78,298,5,293,2,57,103,27,3,2,2,27,6,64
60,332,352,49,303,5,298,1,77,75,27,3,1,0,17,8,89
60,333,1136,196,940,20,920,14,277,244,73,17,3,4,64,24,200
60,334,699,130,569,6,563,7,168,160,59,5,2,4,52,13,93
60,335,128,14,114,1,113,2,25,30,17,1,0,0,13,6,19
60,336,156,18,138,1,137,0,26,63,15,0,0,0,14,1,18
60,337,530,85,445,6,439,11,93,134,24,6,4,1,53,11,102
60,338,3247,477,2770,41,2729,41,638,741,224,23,17,8,266,45,726
60,339,267,46,221,1,220,3,70,51,16,5,3,3,15,5,49
60,340,354,60,294,6,288,0,71,71,28,12,3,1,33,3,66
60,341,1417,218,1199,24,1175,28,281,348,107,14,5,2,88,33,269
60,342,2848,586,2262,38,2224,18,618,482,281,15,21,2,142,39,606
60,343,513,76,437,8,429,3,129,93,49,19,5,6,28,8,89
60,344,386,73,313,7,306,1,99,88,18,3,2,0,26,9,60
60,345,154,19,135,4,131,1,40,28,14,1,2,1,5,1,38
60,346,6830,1384,5446,60,5386,88,914,2640,260,33,15,12,522,98,804
60,347,183,28,155,2,153,4,55,54,9,0,2,0,8,1,20
60,348,318,58,260,4,256,2,73,65,30,6,2,2,22,4,50
60,350,1027,204,823,17,806,11,261,162,105,16,8,1,47,15,180
60,351,93,16,77,2,75,2,18,19,7,2,0,0,4,1,22
60,352,113,14,99,1,98,1,29,34,2,0,1,0,13,2,16
60,353,150,28,122,2,120,7,38,37,9,2,4,1,6,0,16
60,354,38,0,38,0,38,0,16,13,3,1,0,0,4,0,1
60,355,814,115,699,11,688,11,184,206,56,6,13,0,59,12,141
60,356,340,46,294,7,287,5,62,98,31,5,2,0,23,6,55
60,357,349,41,308,7,301,2,101,63,31,4,3,0,14,7,76
60,358,606,87,519,9,510,13,152,123,42,3,3,1,38,14,121
60,359,129,10,119,2,117,2,26,36,18,1,1,0,9,3,21
60,360,3777,780,2997,64,2933,34,761,551,434,44,23,13,182,53,838
60,361,460,49,411,5,406,5,92,98,60,7,3,1,41,13,86
60,362,177,39,138,0,138,2,40,29,12,5,0,0,13,2,35
60,363,179,31,148,1,147,4,25,56,6,3,0,1,18,7,27
60,364,479,74,405,11,394,2,103,96,49,8,2,3,30,8,93
60,365,312,34,278,6,272,2,71,76,35,7,2,1,22,5,51
60,366,288,44,244,10,234,7,92,60,11,4,3,1,17,1,38
60,367,208,25,183,3,180,1,52,60,4,0,0,1,18,2,42
60,368,1757,356,1401,11,1390,8,364,295,210,19,6,1,107,29,351
60,369,1272,209,1063,29,1034,11,306,255,102,17,12,2,79,21,229
60,370,897,150,747,11,736,12,247,188,75,12,10,0,32,22,138
60,371,128,11,117,1,116,0,31,49,5,0,0,0,8,5,18
60,372,432,54,378,11,367,4,119,117,23,3,3,3,25,13,57
60,373,583,115,468,9,459,2,117,98,44,3,5,1,47,10,132
60,374,1780,216,1564,33,1531,13,464,233,133,24,26,2,84,28,524
60,375,260,27,233,2,231,5,59,74,20,5,2,1,10,2,53
60,376,114,16,98,3,95,3,22,25,12,3,0,0,9,3,18
60,377,258,35,223,5,218,3,78,48,13,5,2,1,21,3,44
60,378,320,46,274,9,265,0,59,72,22,3,1,1,19,11,77
60,379,478,68,410,6,404,6,126,67,56,6,5,2,31,11,94
60,380,970,176,794,20,774,12,281,161,98,6,8,1,51,14,142
60,381,192,44,148,1,147,1,51,31,12,3,1,0,5,3,40
60,382,5136,1227,3909,55,3854,107,763,980,404,37,41,16,363,84,1059
60,383,383,69,314,12,302,2,90,79,34,3,1,1,32,5,55
60,385,473,110,363,6,357,5,115,98,41,2,4,1,18,7,66
60,386,329,40,289,6,283,5,66,86,27,1,4,1,18,15,60
60,387,862,150,712,16,696,9,239,133,59,16,11,1,31,16,181
60,388,109,0,109,14,95,1,29,16,9,2,0,0,20,6,12
60,389,133,36,97,0,97,0,25,24,5,1,3,0,7,3,29
60,390,184,26,158,6,152,3,44,44,18,3,2,0,25,0,13
60,391,186,29,157,0,157,1,59,42,9,3,0,1,11,3,28
60,392,542,85,457,8,449,8,125,92,44,2,3,2,35,10,128
60,393,351,45,306,8,298,5,73,59,38,2,1,2,24,1,93
60,394,72,12,60,3,57,1,21,19,4,0,0,1,4,2,5
60,395,7215,1493,5722,114,5608,51,1229,1209,638,71,28,9,305,106,1962
60,396,450,46,404,8,396,2,149,82,37,6,3,2,23,6,86
60,397,89,8,81,2,79,0,19,31,10,0,0,0,4,1,14
60,398,1607,279,1328,28,1300,16,346,319,139,12,7,3,120,41,297
60,399,121,21,100,2,98,5,30,18,8,1,1,0,7,2,26
60,400,191,40,151,4,147,3,45,42,8,2,2,0,6,7,32
60,401,560,93,467,5,462,9,142,89,52,9,4,1,40,6,110
60,402,1472,197,1275,25,1250,29,321,331,119,20,8,0,109,29,284
60,403,1228,184,1044,13,1031,19,264,293,101,23,6,6,76,16,227
60,404,998,171,827,15,812,15,255,164,87,16,1,1,47,13,213
60,405,726,123,603,14,589,5,212,132,51,13,7,0,32,10,127
60,406,602,76,526,12,514,4,144,125,37,8,1,1,50,9,135
60,407,171,16,155,1,154,0,56,33,12,1,6,1,20,2,23
60,408,535,102,433,7,426,12,103,113,43,4,1,0,41,7,102
60,409,1434,263,1171,25,1146,17,316,222,174,14,6,4,84,26,283
60,410,191,31,160,0,160,2,47,43,13,2,1,0,9,5,38
60,411,584,94,490,8,482,7,103,155,51,5,1,3,46,15,96
60,412,452,74,378,8,370,14,73,117,32,9,2,0,33,10,80
60,413,338,41,297,2,295,5,70,89,23,4,1,1,17,4,81
60,414,6868,1471,5397,75,5322,66,1156,666,1229,74,43,11,190,62,1825
60,415,133,14,119,2,117,3,25,61,6,0,0,0,6,3,13
60,416,131,23,108,1,107,1,34,19,8,4,0,0,6,2,33
60,417,105,17,88,0,88,0,34,34,3,0,0,1,7,0,9
60,418,297,48,249,2,247,7,70,65,32,0,1,1,13,8,50
60,420,369,49,320,8,312,6,64,112,32,2,1,1,32,3,59
60,421,324,54,270,1,269,4,70,98,23,1,1,0,13,5,54
60,422,166,12,154,5,149,1,26,62,5,1,0,0,23,1,30
60,423,866,147,719,11,708,7,170,151,78,9,7,5,54,21,206
60,424,177,23,154,1,153,0,37,43,25,1,0,2,9,3,33
60,425,381,55,326,4,322,2,85,85,31,9,1,2,25,6,76
60,426,179,24,155,4,151,1,34,54,11,0,1,1,15,1,33
60,427,161,36,125,1,124,0,40,45,6,0,3,0,10,3,17
60,428,459,43,416,3,413,5,78,177,23,5,5,0,39,8,73
60,429,243,23,220,4,216,5,50,86,24,1,1,2,15,2,30
60,430,823,155,668,10,658,11,142,185,72,6,8,1,46,13,174
60,431,401,63,338,7,331,3,85,80,49,6,0,0,11,6,91
60,432,597,111,486,7,479,17,90,186,32,5,0,1,60,5,83
60,433,609,125,484,4,480,6,127,128,35,6,3,1,45,10,119
60,434,171,30,141,4,137,2,38,45,6,2,0,0,16,3,25
60,435,352,49,303,11,292,7,102,88,18,3,1,0,15,12,46
60,436,92,18,74,2,72,2,24,20,6,1,0,0,6,1,12
60,437,69,12,57,0,57,0,14,27,7,0,0,0,4,1,4
60,438,153,26,127,3,124,1,46,22,8,1,1,1,11,4,29
60,439,3565,918,2647,44,2603,32,765,538,346,45,17,4,163,39,654
60,440,469,72,397,13,384,3,114,111,34,2,1,1,32,13,73
60,441,429,55,374,7,367,8,79,130,21,4,9,2,30,12,72
60,442,97,17,80,2,78,0,25,27,7,0,1,0,4,1,13
60,443,418,84,334,5,329,5,121,60,30,4,3,2,21,6,77
60,444,118,17,101,0,101,1,29,43,3,0,0,0,5,8,12
60,445,187,23,164,0,164,2,36,57,7,0,1,1,13,6,41
60,446,2328,460,1868,29,1839,24,521,390,215,23,11,3,144,26,482
60,447,523,75,448,5,443,8,126,135,42,3,6,0,32,6,85
60,448,271,54,217,1,216,4,71,56,19,5,0,1,11,10,39
60,449,190,35,155,0,155,0,36,37,26,4,2,0,11,5,34
60,450,2134,429,1705,37,1668,40,474,493,125,16,10,3,135,40,332
60,451,1191,160,1031,10,1021,21,280,235,116,16,7,4,80,13,249
60,452,399,71,328,7,321,7,91,115,13,3,1,2,25,1,63
60,453,227,29,198,1,197,5,57,75,15,0,0,0,10,4,31
60,454,807,126,681,10,671,7,173,157,84,3,2,6,45,19,175
60,455,212,28,184,3,181,4,63,56,11,3,1,0,13,2,28
60,456,679,69,610,7,603,6,170,166,55,7,1,0,44,9,145
60,457,131,18,113,1,112,0,39,33,5,1,3,0,10,1,20
60,458,244,42,202,4,198,5,60,60,12,4,1,0,22,6,28
60,459,166,23,143,3,140,1,36,23,20,6,1,1,13,1,38
60,460,128,15,113,3,110,1,33,31,11,0,1,1,8,2,22
60,461,161,23,138,4,134,3,28,48,9,3,1,0,15,1,26
60,462,2043,542,1501,28,1473,20,389,415,157,12,6,5,95,22,352
60,463,10870,2794,8076,111,7965,85,1692,1523,1028,83,59,14,503,112,2866
60,464,814,87,727,11,716,8,194,165,63,5,6,0,55,9,211
60,465,130,13,117,2,115,2,37,28,4,2,0,1,8,2,31
60,466,158,19,139,3,136,1,29,46,14,2,2,0,14,2,26
60,468,252,34,218,6,212,0,70,67,12,6,1,1,18,5,32
60,469,286,43,243,3,240,5,73,91,18,3,1,2,17,4,26
60,470,565,65,500,6,494,6,156,131,26,7,8,0,35,10,115
60,471,7521,2075,5446,127,5319,59,1214,1408,612,70,27,18,338,90,1483
60,472,82,9,73,2,71,0,23,32,8,1,0,1,1,0,5
60,473,207,41,166,2,164,3,40,39,18,0,0,0,8,2,54
60,474,205,30,175,0,175,1,73,46,15,3,1,0,2,1,33
60,475,136,30,106,2,104,0,11,46,15,0,1,0,5,3,23
60,476,128,24,104,3,101,0,32,48,3,2,0,0,8,2,6
60,477,993,158,835,12,823,17,246,190,64,26,8,3,67,19,183
60,478,201,29,172,1,171,3,69,38,11,2,2,0,16,4,26
60,479,490,81,409,7,402,4,113,103,31,6,1,0,41,4,99
60,480,444,63,381,0,381,4,103,99,34,8,7,0,39,10,77
60,481,373,36,337,4,333,6,89,62,39,4,2,0,28,10,93
60,482,2703,377,2326,27,2299,77,427,738,203,15,15,5,223,62,534
60,483,369,51,318,3,315,1,101,101,26,0,3,0,21,12,50
60,484,197,29,168,3,165,2,52,47,14,4,3,0,14,8,21
60,485,156,17,139,2,137,1,36,51,11,4,1,0,6,2,25
60,486,483,126,357,4,353,5,102,86,42,4,5,1,27,4,77
60,487,286,44,242,3,239,10,57,75,17,2,0,2,17,3,56
60,488,217,32,185,0,185,3,46,41,26,1,0,1,13,3,51
60,489,704,93,611,8,603,8,197,138,77,6,1,3,42,15,116
60,490,314,33,281,3,278,6,87,73,20,5,2,3,29,13,40
60,491,1397,231,1166,15,1151,32,222,362,93,10,4,1,125,20,282
60,492,563,95,468,3,465,12,154,88,53,8,7,1,30,8,104
60,493,296,45,251,5,246,2,85,69,17,3,1,0,17,5,47
60,494,1054,0,1054,22,1032,21,242,368,78,6,7,1,80,18,211
60,495,268,23,245,4,241,7,79,43,25,0,1,1,25,5,55
60,496,136,29,107,1,106,0,26,19,13,3,1,0,9,1,34
60,497,142,14,128,0,128,1,44,42,8,0,0,0,6,5,22
60,498,411,72,339,12,327,3,94,66,35,2,4,1,16,0,106
60,499,195,44,151,5,146,5,40,27,22,3,0,1,13,3,32
60,500,2381,643,1738,19,1719,22,449,388,189,22,13,2,129,33,472
60,501,1105,185,920,29,891,26,203,194,96,14,9,3,76,28,242
60,502,87,13,74,2,72,0,31,17,8,0,1,2,2,1,10
60,503,100,15,85,1,84,1,19,16,9,0,0,0,5,7,27
60,504,779,132,647,6,641,10,204,163,63,13,6,1,61,16,104
60,505,530,66,464,9,455,2,126,144,39,1,3,1,50,8,81
60,506,478,110,368,7,361,4,96,77,40,4,1,0,25,4,110
60,507,318,37,281,2,279,4,89,80,20,6,3,2,16,8,51
60,508,2286,338,1948,42,1906,27,493,522,165,25,7,6,177,35,449
60,509,7772,1898,5874,94,5780,88,1482,1184,696,79,47,15,398,112,1679
60,510,252,28,224,3,221,3,61,71,13,2,3,2,16,9,41
60,511,275,69,206,4,202,6,69,41,19,2,1,0,9,8,47
60,512,126,21,105,2,103,1,19,45,14,1,0,0,10,1,12
60,513,2546,528,2018,38,1980,33,444,628,189,17,8,11,190,35,425
60,514,137,15,122,3,119,0,37,42,4,1,2,0,4,6,23
60,515,287,55,232,7,225,5,80,57,15,3,2,0,19,5,39
60,516,331,63,268,4,264,4,93,61,29,6,0,1,14,3,53
60,517,652,156,496,15,481,10,136,117,62,10,4,1,36,13,92
60,518,169,18,151,3,148,2,37,30,19,5,3,0,14,4,34
60,519,145,23,122,2,120,0,40,39,10,2,1,0,7,0,21
60,520,150,15,135,2,133,0,44,51,7,1,5,0,4,2,19
60,521,308,47,261,7,254,5,76,91,19,4,3,2,15,4,35
60,522,185,28,157,0,157,1,57,40,18,3,0,0,9,3,26
60,523,721,92,629,11,618,15,164,167,50,8,7,1,62,11,133
60,524,1603,303,1300,35,1265,17,337,252,187,14,18,6,76,35,323
60,525,102,11,91,3,88,2,13,40,3,1,0,0,14,1,14
60,526,882,119,763,11,752,8,219,128,73,15,9,0,51,18,231
60,527,115,12,103,0,103,0,31,33,9,1,0,0,7,0,22
60,528,140,29,111,0,111,6,19,49,3,1,1,0,10,1,21
60,529,71,14,57,0,57,0,16,23,7,0,0,0,2,3,6
60,530,178,29,149,2,147,1,29,49,14,1,2,0,19,2,30
60,531,1358,210,1148,11,1137,13,281,296,121,25,5,5,116,20,255
60,532,90,13,77,1,76,0,23,28,6,1,1,0,5,4,8
60,533,1108,188,920,21,899,16,264,203,96,11,1,3,58,14,233
60,534,557,83,474,10,464,14,77,156,51,3,6,5,45,7,100
60,535,210,31,179,3,176,2,63,43,11,1,2,0,14,4,36
60,536,110,16,94,2,92,0,13,43,5,1,1,0,7,2,20
60,537,2605,472,2133,37,2096,25,587,368,359,23,15,6,138,26,549
60,538,158,18,140,1,139,3,41,32,23,2,1,2,7,6,22
60,539,1122,186,936,25,911,14,236,225,67,14,7,2,61,23,262
60,540,378,89,289,2,287,8,83,82,16,5,1,0,32,4,56
60,541,279,45,234,6,228,3,84,63,20,2,4,0,8,3,41
60,542,627,71,556,9,547,10,170,138,49,4,5,0,49,12,110
60,543,90,7,83,1,82,0,13,30,6,1,0,0,10,1,21
60,544,144,26,118,1,117,2,27,33,7,3,1,1,13,5,25
60,545,363,61,302,8,294,5,69,81,17,12,3,0,21,3,83
60,546,88,14,74,2,72,0,11,42,4,1,0,0,6,2,6
60,547,467,69,398,9,389,8,110,116,39,1,5,1,36,6,67
60,548,323,45,278,5,273,4,85,71,22,2,1,0,21,3,64
60,549,151,21,130,3,127,3,39,35,10,1,0,3,7,0,29
60,550,157,18,139,3,136,2,27,37,11,0,1,0,7,6,45
60,551,239,39,200,2,198,4,65,54,15,2,1,0,25,4,28
60,552,219,39,180,1,179,2,38,61,9,1,1,1,22,4,40
60,553,209,34,175,2,173,1,41,37,20,1,7,2,14,7,43
60,554,290,44,246,7,239,2,91,59,14,1,2,1,18,4,47
60,555,40,6,34,0,34,1,13,9,2,0,0,0,2,3,4
60,556,177,26,151,5,146,2,32,44,14,2,0,1,10,2,39
60,557,252,20,232,2,230,3,66,60,14,4,3,0,24,7,49
60,558,316,45,271,3,268,3,90,61,25,7,1,0,13,5,63
60,559,571,118,453,8,445,7,130,116,29,7,7,2,30,12,105
60,560,602,104,498,7,491,5,79,215,43,4,5,2,46,8,84
60,561,166,32,134,5,129,1,50,30,18,1,0,0,13,2,14
60,562,1107,159,948,17,931,9,268,313,74,5,6,4,73,21,158
60,563,413,63,350,7,343,7,108,88,20,2,7,1,16,6,88
60,564,189,26,163,2,161,1,61,40,12,1,0,0,11,2,33
60,565,438,60,378,6,372,2,133,75,20,4,4,0,38,17,79
60,566,168,27,141,2,139,1,41,28,9,3,2,0,15,6,34
60,567,692,116,576,13,563,9,172,135,41,16,3,1,33,18,135
60,568,236,20,216,2,214,3,47,63,31,4,3,0,18,4,41
60,569,234,50,184,2,182,5,30,94,9,2,1,0,13,3,25
60,570,836,119,717,15,702,8,205,194,73,13,2,3,41,17,146
60,571,66,10,56,1,55,3,18,16,4,2,1,0,2,0,9
60,572,269,36,233,5,228,8,60,60,14,0,1,2,24,7,52
60,573,252,46,206,3,203,3,44,70,17,1,0,1,16,4,47
60,574,401,68,333,7,326,3,114,46,44,10,3,0,21,7,78
60,575,1943,388,1555,24,1531,19,485,382,125,25,27,3,107,34,324
60,576,347,48,299,4,295,9,75,89,22,0,2,0,24,8,66
60,577,1385,336,1049,17,1032,15,358,291,88,9,11,2,58,22,178
60,578,616,113,503,7,496,13,148,91,65,5,6,2,26,12,128
60,579,298,20,278,4,274,11,44,139,12,0,1,1,28,4,34
60,581,4002,895,3107,53,3054,26,735,638,361,64,46,7,171,46,960
60,582,657,106,551,6,545,10,133,113,67,10,4,2,54,12,140
60,583,315,59,256,3,253,4,91,64,15,3,0,1,15,4,56
60,584,3377,679,2698,37,2661,47,652,606,397,36,16,6,192,33,676
60,585,220,37,183,3,180,1,55,45,22,2,0,1,8,1,45
60,586,771,126,645,7,638,22,161,152,66,8,2,1,65,17,144
60,587,1074,178,896,16,880,6,272,233,70,6,3,3,69,16,202
60,588,308,56,252,5,247,2,78,59,23,7,5,0,18,8,47
60,589,1841,410,1431,25,1406,17,397,270,252,13,9,3,110,30,305
60,590,712,116,596,11,585,11,163,161,48,10,6,0,42,16,128
60,591,1246,195,1051,19,1032,13,240,359,93,5,8,2,91,17,204
60,592,471,82,389,3,386,1,139,121,20,6,3,1,27,10,58
60,593,105,26,79,1,78,1,31,17,6,2,3,0,1,2,15
60,594,251,36,215,7,208,3,61,61,18,1,0,0,11,0,53
60,595,301,47,254,1,253,4,84,36,32,2,2,0,26,9,58
60,596,209,40,169,7,162,3,67,38,6,4,2,1,8,7,26
60,597,1257,208,1049,19,1030,29,286,245,106,9,7,5,67,22,254
60,598,735,91,644,12,632,10,193,187,53,7,7,1,54,10,110
60,599,215,39,176,1,175,0,54,46,7,3,3,1,21,7,33
60,600,470,80,390,1,389,3,107,108,33,4,5,2,33,10,84
60,601,667,131,536,4,532,3,216,109,49,5,5,0,40,6,99
60,602,50,3,47,1,46,2,15,16,1,0,1,0,3,3,5
60,603,678,105,573,13,560,5,169,176,33,4,4,1,43,13,112
60,604,216,29,187,2,185,2,79,50,4,2,2,0,8,1,37
60,605,256,26,230,1,229,0,78,68,13,2,0,2,14,2,50
60,608,87,15,72,0,72,1,23,30,3,0,0,0,2,0,13
60,609,550,64,486,6,480,14,109,137,42,7,3,3,51,6,108
60,610,565,71,494,8,486,5,115,142,37,6,4,2,36,9,130
60,611,507,88,419,6,413,3,131,123,46,8,6,0,23,8,65
60,612,10880,2381,8499,110,8389,180,1550,3324,660,64,46,17,839,147,1562
60,613,235,36,199,2,197,6,39,47,31,5,1,0,23,4,41
60,614,176,31,145,0,145,3,30,51,6,2,0,1,20,4,28
60,615,89,12,77,2,75,1,19,26,7,1,0,0,2,0,19
60,616,2005,391,1614,37,1577,11,428,334,251,26,17,5,75,46,384
60,617,206,26,180,4,176,1,52,50,18,8,0,0,16,2,29
60,618,229,39,190,4,186,8,40,47,23,4,1,0,19,4,40
60,619,745,109,636,12,624,9,167,184,64,10,5,3,38,6,138
60,620,347,39,308,5,303,9,76,98,16,7,6,0,39,3,49
60,621,74,9,65,0,65,1,22,22,3,0,0,0,3,1,13
60,622,325,40,285,3,282,4,95,76,14,3,0,2,14,5,69
60,623,799,123,676,7,669,9,186,181,59,8,6,3,62,13,142
60,624,145,20,125,2,123,0,38,28,6,4,3,0,11,2,31
60,625,442,97,345,6,339,0,82,98,40,3,3,4,31,7,71
60,626,482,61,421,6,415,4,149,105,32,2,4,1,26,6,86
60,627,200,38,162,0,162,4,35,48,12,3,1,0,8,5,46
60,628,673,101,572,12,560,10,157,140,56,9,5,1,40,13,129
60,629,157,26,131,1,130,1,41,28,12,1,2,0,11,2,32
60,630,133,12,121,1,120,0,21,54,10,0,0,0,11,3,21
60,631,814,132,682,9,673,13,158,252,49,3,2,3,58,6,129
60,632,542,121,421,9,412,8,124,86,56,6,3,0,26,6,97
60,633,264,49,215,4,211,1,76,62,13,3,2,3,15,2,34
60,634,302,38,264,3,261,5,78,82,17,2,9,1,13,4,50
60,635,640,132,508,7,501,11,131,96,123,5,2,3,20,9,101
60,636,3549,749,2800,43,2757,23,704,499,484,51,31,7,177,47,734
60,637,355,62,293,5,288,3,86,60,25,6,6,2,14,3,83
60,638,532,95,437,7,430,5,137,113,31,4,2,0,42,7,89
60,639,853,156,697,11,686,7,197,210,54,10,8,2,44,16,138
60,640,126,12,114,8,106,3,20,28,19,0,0,1,13,0,22
60,641,1262,223,1039,12,1027,31,254,260,109,20,5,1,90,16,241
60,642,768,99,669,14,655,6,174,137,70,8,11,3,59,20,167
60,643,1055,206,849,12,837,3,278,161,60,29,4,1,47,14,240
60,644,1035,176,859,14,845,5,208,270,66,5,5,2,80,21,183
60,645,270,45,225,9,216,8,46,64,28,7,2,0,10,7,44
60,646,937,174,763,11,752,7,179,245,58,6,9,1,82,12,153
60,647,1454,241,1213,30,1183,14,261,330,119,7,7,3,115,21,306
60,648,269,24,245,8,237,1,73,59,23,3,7,0,19,4,48
60,649,157,10,147,1,146,1,17,73,11,0,0,0,15,6,23
60,650,365,45,320,4,316,6,77,85,31,5,3,0,36,9,64
60,651,1347,224,1123,16,1107,9,337,301,117,14,4,4,90,27,204
60,652,710,151,559,11,548,8,195,113,65,6,3,0,38,9,111
60,653,217,32,185,8,177,2,56,47,13,4,2,1,17,3,32
60,654,218,33,185,4,181,0,45,36,43,2,1,0,15,6,33
60,655,299,51,248,4,244,3,66,62,22,2,2,2,19,11,55
60,656,206,56,150,1,149,3,48,39,16,3,0,0,17,1,22
60,657,233,56,177,3,174,0,71,33,15,1,0,0,16,4,34
60,658,485,94,391,4,387,5,130,71,34,6,5,1,25,8,102
60,659,144,12,132,1,131,2,25,53,22,0,0,1,7,3,18
60,660,261,42,219,3,216,2,45,63,21,0,1,2,26,8,48
60,661,541,105,436,5,431,3,155,86,55,3,2,1,17,6,103
60,662,389,83,306,8,298,6,90,94,22,1,2,1,18,10,54
60,663,185,10,175,1,174,3,57,46,19,0,1,1,12,4,31
60,664,393,67,326,7,319,2,132,61,21,5,1,1,20,9,67
60,665,1809,296,1513,32,1481,23,366,384,136,16,9,3,109,28,407
60,666,776,133,643,10,633,12,183,170,56,2,2,0,60,13,135
60,667,2703,651,2052,37,2015,20,644,491,199,28,12,2,149,40,430
60,668,616,78,538,13,525,8,118,169,55,5,3,3,45,16,103
60,669,432,52,380,9,371,5,67,103,35,3,8,3,25,8,114
60,670,3222,486,2736,40,2696,39,610,830,229,30,11,7,234,59,647
60,671,272,37,235,3,232,5,42,104,14,1,0,1,11,1,53
60,672,251,37,214,5,209,2,59,53,23,3,0,1,19,1,48
60,673,140,23,117,6,111,2,25,47,1,4,1,0,8,6,17
60,674,510,73,437,6,431,13,71,169,41,1,0,1,33,8,94
60,675,326,31,295,5,290,5,64,77,34,3,2,1,20,8,76
60,676,549,89,460,12,448,6,152,76,34,5,3,0,44,11,117
60,677,175,22,153,3,150,4,29,41,7,2,2,1,21,3,40
60,678,937,176,761,13,748,6,223,175,77,9,7,2,74,19,156
60,679,130,22,108,3,105,0,45,27,7,1,2,0,3,2,18
60,680,479,74,405,10,395,4,116,123,17,5,2,1,37,8,82
60,681,407,56,351,4,347,1,95,115,20,2,6,0,37,4,67
60,682,445,46,399,4,395,8,45,203,20,2,0,0,56,6,55
60,683,251,29,222,2,220,2,61,61,18,3,3,0,18,6,48
60,684,3742,62,3680,760,2920,39,664,502,387,33,15,3,137,36,1104
60,685,647,124,523,18,505,5,133,132,40,10,7,1,29,14,134
60,686,1680,273,1407,21,1386,15,308,403,152,9,8,2,132,32,325
60,687,274,49,225,3,222,2,80,68,14,1,2,0,12,3,40
60,688,137,20,117,2,115,3,39,30,14,4,1,1,4,1,18
60,689,1061,158,903,13,890,20,160,393,47,10,4,2,88,21,145
60,690,282,56,226,2,224,2,59,68,21,1,1,0,15,3,54
60,691,107,27,80,1,79,5,17,30,2,0,2,3,7,1,12
60,692,128,19,109,3,106,2,31,29,6,1,2,0,2,5,28
60,693,275,48,227,4,223,2,71,58,15,4,3,0,17,4,49
60,694,228,31,197,3,194,2,53,47,23,1,0,0,16,7,45
60,695,1164,237,927,15,912,20,143,382,59,8,3,0,89,19,189
60,697,38,2,36,0,36,0,6,23,1,0,0,0,4,0,2
60,698,233,36,197,4,193,4,69,47,14,0,1,0,11,2,45
60,699,134,9,125,0,125,1,32,35,13,1,2,0,8,1,32
60,700,903,131,772,14,758,10,183,278,48,7,6,1,52,16,157
60,701,834,116,718,17,701,5,189,166,82,10,3,2,27,13,204
60,702,174,18,156,1,155,4,49,49,8,0,1,1,4,3,36
60,703,607,94,513,8,505,9,139,125,53,8,5,1,32,13,120
61,1,15962,3653,12309,221,12088,275,1764,3171,1291,189,83,22,1253,197,3843
61,2,520,75,445,13,432,15,88,124,44,13,6,0,26,16,100
61,3,151,21,130,4,126,0,28,42,10,4,2,1,7,5,27
61,4,102,14,88,2,86,0,16,28,5,2,0,0,8,5,22
61,5,201,24,177,4,173,4,34,56,8,4,4,1,25,6,31
61,6,9350,2070,7280,142,7138,115,1187,1609,956,97,43,20,611,118,2382
61,7,2054,289,1765,38,1727,43,331,454,164,35,18,6,224,50,402
61,8,892,168,724,15,709,1,146,152,68,11,3,0,82,16,230
61,9,229,24,205,4,201,3,40,63,15,6,2,0,20,7,45
61,10,87,13,74,2,72,4,12,24,8,2,0,0,5,2,15
61,11,321,23,298,3,295,2,30,87,20,6,2,0,49,13,86
61,12,132,27,105,1,104,2,34,27,10,2,1,0,11,2,15
61,13,124,12,112,9,103,2,29,17,11,1,1,1,14,1,26
61,14,227,33,194,3,191,3,26,47,17,5,1,0,20,3,69
61,15,214,47,167,3,164,1,34,61,11,2,0,0,18,9,28
61,16,128,11,117,1,116,2,31,43,10,0,1,0,8,1,20
61,17,49,7,42,2,40,3,4,9,2,1,1,0,5,3,12
61,18,64,9,55,0,55,0,17,25,3,0,0,0,4,0,6
61,19,50,8,42,0,42,3,14,7,2,1,0,0,4,0,11
61,20,194,19,175,2,173,1,25,54,12,5,2,0,26,2,46
61,21,117,26,91,1,90,3,17,27,7,1,1,2,9,3,20
61,23,539,67,472,11,461,5,110,134,43,7,2,0,40,14,106
61,24,458,54,404,8,396,3,105,81,39,5,4,1,42,10,106
61,25,302,52,250,4,246,3,57,91,19,1,1,0,27,6,41
61,26,169,26,143,0,143,4,34,50,15,1,2,1,12,0,24
61,27,135,21,114,0,114,7,20,31,13,5,0,0,5,4,29
61,28,329,49,280,4,276,6,62,74,34,1,5,0,34,4,56
61,29,660,91,569,14,555,10,138,209,30,7,1,0,53,13,94
61,30,202,30,172,4,168,3,52,36,18,1,2,0,17,3,36
61,31,164,18,146,3,143,4,30,52,16,2,2,0,14,3,20
61,32,280,26,254,1,253,5,54,59,22,3,1,1,38,3,67
61,33,127,20,107,2,105,2,22,44,1,1,1,0,18,1,15
61,34,169,15,154,3,151,0,51,57,10,3,1,0,11,1,17
61,35,202,29,173,3,170,6,30,46,20,1,4,1,28,4,30
61,36,140,17,123,2,121,2,39,42,7,3,0,0,7,2,19
61,37,121,9,112,4,108,2,28,41,10,0,0,1,12,2,12
61,38,1084,233,851,23,828,10,131,313,49,11,5,4,114,19,172
61,39,99,9,90,0,90,5,23,27,11,0,1,0,7,1,15
61,40,813,129,684,28,656,9,164,177,57,13,4,3,72,18,139
61,41,170,33,137,5,132,8,35,30,23,3,1,0,7,4,21
61,42,363,41,322,8,314,8,69,90,33,7,3,1,35,4,64
61,43,872,145,727,15,712,8,178,206,56,8,14,3,60,17,162
61,44,374,72,302,8,294,3,87,52,30,7,1,4,29,5,76
61,45,74,10,64,0,64,0,4,35,7,0,0,0,5,4,9
61,46,112,18,94,2,92,7,29,22,5,2,1,0,9,3,14
61,47,142,33,109,1,108,1,21,49,4,1,0,0,12,4,16
61,48,103,13,90,1,89,1,25,23,12,1,0,0,13,1,13
61,49,100,16,84,0,84,2,21,27,8,2,0,0,8,0,16
61,50,298,38,260,2,258,13,51,57,31,4,1,0,23,9,69
61,51,246,26,220,5,215,6,59,63,13,1,1,0,26,7,39
61,52,130,19,111,2,109,2,29,36,12,1,0,0,8,1,20
61,53,203,26,177,4,173,3,38,43,18,2,2,2,15,10,40
61,54,182,30,152,4,148,1,43,59,10,0,0,0,14,6,15
61,55,455,62,393,11,382,4,82,153,26,3,1,1,41,9,62
61,56,126,11,115,5,110,5,20,28,19,2,0,0,15,1,20
61,57,317,41,276,3,273,5,41,67,34,5,3,2,23,15,78
61,58,120,14,106,1,105,3,13,25,15,4,0,0,10,0,35
61,59,34,6,28,0,28,2,0,8,6,0,0,0,2,1,9
61,60,117,17,100,3,97,0,34,23,12,2,0,1,7,1,17
61,61,1030,169,861,9,852,14,215,277,74,13,6,2,75,22,154
61,62,69,12,57,1,56,0,21,14,4,1,0,0,3,2,11
61,63,1247,219,1028,15,1013,24,165,331,73,8,4,4,102,35,267
61,64,83,9,74,0,74,2,15,20,18,1,0,0,6,2,10
61,65,107,13,94,1,93,3,15,32,14,0,0,0,5,6,18
61,66,89,13,76,1,75,0,25,22,5,1,0,0,8,3,11
61,67,148,14,134,3,131,6,30,50,8,1,1,0,13,5,17
61,68,159,27,132,2,130,0,28,28,12,1,1,0,19,6,35
61,69,135,20,115,1,114,2,31,26,12,0,1,0,8,5,29
61,70,698,102,596,12,584,10,117,114,51,12,11,1,75,11,182
61,71,164,21,143,3,140,1,27,64,8,2,2,1,6,6,23
61,72,146,27,119,1,118,2,22,42,11,4,2,0,13,4,18
61,73,402,62,340,6,334,21,78,75,32,6,5,0,40,12,65
61,74,513,102,411,8,403,4,116,117,29,11,2,0,34,11,79
61,75,992,137,855,21,834,10,150,299,65,14,2,0,127,23,144
61,76,102,8,94,2,92,3,21,27,15,1,1,1,8,4,11
61,77,549,64,485,7,478,7,74,123,49,9,0,2,63,12,139
61,78,562,81,481,6,475,7,104,127,42,7,0,2,44,11,131
61,79,1334,257,1077,18,1059,18,266,399,93,16,7,4,79,19,158
61,80,83,12,71,0,71,1,25,16,3,0,0,0,7,0,19
61,81,401,44,357,4,353,2,116,82,29,2,4,0,24,9,85
61,82,66,8,58,1,57,2,11,27,2,0,0,0,6,0,9
61,83,327,45,282,10,272,6,65,82,21,5,4,1,24,6,58
61,84,104,8,96,0,96,2,16,35,6,2,1,0,10,5,19
61,85,26,0,26,0,26,0,2,19,2,0,0,0,2,0,1
61,86,100,22,78,0,78,2,27,31,1,0,0,0,7,0,10
61,87,148,17,131,2,129,5,25,48,9,1,0,0,10,4,27
61,88,45,9,36,0,36,1,12,11,0,1,0,0,5,1,5
61,89,83,15,68,1,67,1,19,23,2,0,1,0,3,4,14
61,90,90,20,70,0,70,2,13,29,7,0,0,0,6,1,12
61,91,763,121,642,13,629,16,129,161,64,10,0,2,63,22,162
61,92,534,89,445,4,441,3,106,139,38,11,1,2,30,10,101
61,93,935,115,820,15,805,15,170,194,51,12,4,3,117,21,218
61,94,424,41,383,8,375,3,54,94,39,5,3,0,57,10,110
61,95,399,51,348,10,338,4,79,69,25,3,0,2,48,12,96
61,96,1127,182,945,22,923,6,162,311,63,15,8,1,134,21,202
61,97,489,72,417,11,406,8,99,133,38,6,2,1,39,10,70
61,98,304,25,279,6,273,5,61,66,27,2,0,1,27,9,75
61,99,250,51,199,2,197,16,49,48,17,7,1,0,19,5,35
61,100,219,30,189,4,185,2,36,73,5,0,0,0,30,7,32
61,101,163,31,132,2,130,0,33,40,9,3,2,0,14,3,26
61,102,287,32,255,6,249,2,59,65,21,6,1,0,22,5,68
61,103,147,25,122,3,119,1,34,39,3,2,1,0,12,5,22
61,104,50,5,45,1,44,1,9,18,3,1,0,0,2,0,10
61,105,174,26,148,9,139,5,48,38,5,3,3,1,13,5,18
61,106,133,18,115,2,113,3,23,40,14,1,0,1,8,4,19
61,107,330,45,285,8,277,5,53,89,22,7,3,1,35,4,58
61,108,172,38,134,0,134,7,25,37,15,2,0,0,7,2,39
61,109,94,11,83,1,82,2,26,12,7,1,1,1,8,5,19
61,110,123,23,100,0,100,2,19,36,9,1,1,0,12,0,20
61,111,292,27,265,4,261,6,47,90,15,1,0,1,38,2,61
61,112,207,36,171,2,169,3,35,54,13,0,1,2,10,7,44
61,113,60,8,52,1,51,1,9,20,0,1,0,0,11,1,8
61,114,114,15,99,2,97,1,22,34,8,0,0,0,8,3,21
61,115,323,47,276,9,267,10,45,95,21,5,1,1,33,1,55
61,116,855,117,738,19,719,12,178,178,56,11,9,2,69,21,183
61,117,1708,238,1470,24,1446,31,233,308,169,20,9,3,194,31,448
61,118,122,13,109,1,108,4,20,31,6,2,0,0,21,0,24
61,120,84,22,62,0,62,1,15,26,0,0,0,0,5,2,13
61,121,238,39,199,3,196,4,50,68,15,1,1,0,19,7,31
61,122,74,10,64,0,64,0,11,29,2,1,1,0,4,0,16
61,123,164,17,147,4,143,2,25,53,12,0,1,0,10,4,36
61,124,393,37,356,10,346,7,73,98,32,7,5,1,42,7,74
61,125,323,46,277,3,274,6,73,82,13,6,2,0,14,9,69
61,126,347,53,294,5,289,7,63,129,26,5,0,2,17,5,35
61,127,51,6,45,1,44,7,8,9,10,0,0,0,5,0,5
61,128,143,22,121,4,117,6,31,44,6,1,0,0,14,0,15
61,129,286,38,248,9,239,1,52,95,11,2,4,2,22,14,36
61,130,376,37,339,2,337,7,87,99,27,4,7,4,30,6,66
61,131,100,24,76,1,75,0,23,31,1,1,0,0,10,0,9
61,133,535,78,457,6,451,7,106,141,27,1,5,1,60,9,94
61,135,704,103,601,15,586,7,95,198,52,13,12,2,83,12,112
61,136,147,22,125,1,124,1,18,68,7,0,1,0,9,3,17
61,137,132,17,115,3,112,4,37,28,17,2,1,0,7,5,11
61,138,173,24,149,3,146,1,23,48,10,3,1,0,16,7,37
61,139,213,35,178,3,175,4,34,77,7,6,0,1,11,3,32
61,140,733,90,643,13,630,7,159,198,49,5,4,1,57,21,129
61,141,314,28,286,5,281,2,37,101,25,2,1,1,42,10,60
61,142,139,14,125,2,123,2,16,50,5,0,2,0,14,1,33
61,143,2134,281,1853,35,1818,30,236,488,139,30,9,4,248,32,602
61,144,298,48,250,4,246,7,61,74,16,1,0,0,27,7,53
61,145,2955,698,2257,49,2208,32,344,706,164,37,20,7,292,76,530
61,146,297,48,249,4,245,3,65,68,11,2,3,1,22,5,65
61,147,311,60,251,3,248,8,52,71,16,3,2,3,33,8,52
61,148,194,23,171,4,167,13,25,44,14,4,2,0,21,4,40
61,149,285,32,253,3,250,3,54,51,29,2,1,1,30,5,74
61,150,593,105,488,7,481,2,114,148,35,5,5,3,68,14,87
61,151,270,38,232,1,231,3,58,69,17,5,0,0,29,10,40
61,152,107,12,95,3,92,4,21,45,0,0,0,1,8,3,10
61,153,927,151,776,18,758,10,137,251,70,8,4,2,77,25,174
61,154,109,18,91,0,91,3,11,33,6,0,0,0,17,0,21
61,155,133,32,101,3,98,0,6,36,9,0,1,0,14,9,23
61,156,406,42,364,5,359,10,80,105,31,3,2,1,47,9,71
61,157,191,21,170,3,167,9,41,58,16,2,2,0,12,3,24
61,158,115,23,92,1,91,1,19,47,5,1,0,0,8,1,9
61,159,63,8,55,1,54,1,9,16,1,0,1,2,12,4,8
61,160,179,17,162,2,160,1,23,62,8,1,0,1,17,3,44
61,161,215,29,186,6,180,3,26,80,17,2,4,0,12,1,35
61,162,158,19,139,8,131,1,27,57,8,1,0,0,15,4,18
61,163,1131,184,947,16,931,15,182,246,80,14,8,0,87,22,277
61,164,161,26,135,1,134,1,26,60,8,0,0,0,18,2,19
61,165,546,79,467,22,445,6,96,133,41,6,7,2,48,5,101
61,166,162,24,138,0,138,1,38,36,11,3,1,0,24,2,22
61,167,479,107,372,5,367,3,66,128,40,6,2,1,42,11,68
61,168,3810,668,3142,82,3060,79,476,859,314,40,31,4,332,76,849
61,169,9846,2329,7517,113,7404,143,1168,1820,804,103,66,27,697,124,2452
61,170,195,24,171,4,167,4,33,57,10,3,2,0,17,8,33
61,171,93,15,78,1,77,4,17,25,8,2,1,0,5,3,12
61,172,211,21,190,6,184,9,25,44,24,6,3,0,27,6,40
61,173,239,31,208,2,206,6,35,58,13,4,1,0,28,5,56
61,174,149,13,136,0,136,5,32,36,9,1,1,0,20,4,28
61,175,197,26,171,3,168,2,32,65,17,3,0,0,16,4,29
61,176,141,18,123,1,122,0,21,39,16,2,0,0,13,3,28
61,177,609,78,531,14,517,10,91,137,42,11,3,2,70,16,135
61,178,55,12,43,2,41,1,2,15,3,2,0,0,1,2,15
61,179,165,13,152,5,147,4,29,47,8,3,1,1,11,3,40
61,180,80,8,72,4,68,1,24,21,5,0,0,0,5,1,11
61,181,1372,327,1045,31,1014,14,201,328,74,12,14,3,102,29,237
61,182,312,42,270,7,263,0,80,81,20,4,2,0,28,7,41
61,183,97,14,83,1,82,3,20,17,8,1,0,0,6,7,20
61,184,408,54,354,4,350,3,73,90,34,1,3,3,43,15,85
61,185,115,17,98,2,96,2,17,35,8,3,1,0,6,2,22
61,186,224,24,200,1,199,2,53,63,14,4,2,1,23,3,34
61,187,159,36,123,2,121,2,33,39,7,3,0,0,7,2,28
61,188,93,13,80,2,78,0,19,39,5,1,1,0,3,2,8
61,189,310,51,259,8,251,6,59,65,31,0,2,0,21,12,55
61,190,66,9,57,1,56,2,10,23,2,0,2,0,7,1,9
61,191,395,112,283,4,279,5,80,82,15,9,3,1,25,12,47
61,192,83,9,74,1,73,2,14,16,7,3,1,0,14,0,16
61,193,244,25,219,2,217,3,54,73,18,3,2,0,17,13,34
61,194,294,26,268,5,263,2,49,75,26,2,4,0,36,11,58
61,195,171,26,145,6,139,1,27,60,6,0,1,0,8,4,32
61,196,613,98,515,16,499,8,118,160,43,9,6,0,39,14,102
61,197,113,9,104,6,98,3,16,33,2,3,0,0,21,10,10
61,198,103,17,86,2,84,6,19,28,2,2,0,0,7,4,16
61,199,262,34,228,2,226,3,49,70,20,2,0,0,30,9,43
61,200,184,17,167,1,166,2,48,47,5,2,0,0,19,4,39
61,201,476,52,424,12,412,6,65,125,35,12,9,2,64,14,80
61,202,361,31,330,4,326,9,72,99,28,6,3,1,34,5,69
61,203,778,121,657,14,643,15,101,179,67,15,4,2,85,17,158
61,204,228,28,200,2,198,4,43,57,21,4,5,1,14,3,46
61,205,176,33,143,1,142,0,40,53,14,6,1,0,7,2,19
61,206,193,18,175,5,170,4,51,55,7,0,1,0,15,1,36
61,207,584,117,467,10,457,6,123,142,32,9,3,1,35,18,88
61,208,454,82,372,4,368,2,89,120,29,6,4,1,30,8,79
61,209,341,43,298,6,292,7,64,112,16,3,2,0,29,10,49
61,210,203,35,168,2,166,4,26,53,10,0,1,0,20,8,44
61,211,791,166,625,15,610,14,154,183,34,5,7,1,70,10,132
61,212,74,8,66,1,65,0,13,20,9,0,0,0,3,1,19
61,213,209,25,184,2,182,5,49,70,6,1,2,0,12,2,35
61,214,5028,1105,3923,70,3853,38,729,1188,300,58,21,8,324,66,1121
61,215,303,52,251,5,246,5,68,78,18,5,4,0,32,4,32
61,216,140,28,112,1,111,2,16,24,22,1,0,0,13,4,29
61,217,51,11,40,0,40,0,7,21,4,0,0,0,3,0,5
61,218,1412,219,1193,23,1170,21,219,296,95,10,3,2,131,23,370
61,219,122,13,109,3,106,2,27,27,10,1,0,0,8,7,24
61,220,166,35,131,0,131,3,31,42,13,1,2,1,11,4,23
61,221,357,46,311,8,303,3,73,56,26,4,3,0,37,7,94
61,222,622,100,522,13,509,10,86,117,47,13,8,4,70,10,144
61,223,228,37,191,4,187,3,52,48,6,2,0,0,23,9,44
61,224,344,43,301,10,291,7,45,69,28,12,0,0,50,8,72
61,225,39,5,34,0,34,1,5,24,0,0,0,0,1,0,3
61,226,140,27,113,2,111,2,30,27,11,0,1,0,8,3,29
61,227,125,24,101,0,101,2,17,40,9,4,0,0,7,0,22
61,228,124,11,113,1,112,6,14,28,20,1,1,0,9,7,26
61,229,120,20,100,3,97,1,17,28,5,6,2,0,7,1,30
61,230,1069,209,860,17,843,7,222,304,57,11,4,0,89,16,133
61,231,93,6,87,0,87,2,27,18,8,2,0,0,10,2,18
61,232,943,165,778,19,759,8,159,265,57,13,7,3,105,21,121
61,233,199,29,170,3,167,0,39,58,16,5,1,0,17,5,26
61,234,770,53,717,14,703,7,107,173,74,12,1,1,97,20,211
61,235,105,9,96,2,94,2,23,27,11,2,0,0,6,0,23
61,236,93,12,81,3,78,0,5,27,8,1,0,0,14,2,21
61,237,255,36,219,5,214,12,60,59,7,2,0,0,16,10,48
61,238,70,9,61,1,60,1,22,21,2,3,0,0,4,0,7
61,239,75,14,61,2,59,1,12,25,2,0,0,0,11,1,7
61,240,332,57,275,9,266,2,58,53,32,6,2,1,30,10,72
61,241,308,57,251,4,247,3,66,69,13,3,2,1,37,5,48
61,242,214,26,188,3,185,5,36,69,12,6,1,2,19,3,32
61,243,1187,187,1000,17,983,17,224,307,90,23,7,3,133,17,162
61,244,232,46,186,2,184,3,43,66,17,1,1,1,16,5,31
61,245,64,3,61,0,61,2,12,19,3,1,0,0,8,1,15
61,246,481,70,411,9,402,3,90,104,33,5,4,0,34,17,112
61,247,91,14,77,1,76,0,29,14,6,7,0,0,4,0,16
61,248,454,89,365,8,357,4,52,164,15,0,4,0,61,9,48
61,249,150,22,128,4,124,3,29,43,9,1,0,0,9,3,27
61,250,180,20,160,7,153,1,49,36,15,2,1,1,9,5,34
61,251,117,14,103,5,98,0,17,41,9,3,0,0,6,2,20
61,252,98,19,79,1,78,0,9,31,6,0,2,0,14,1,15
61,253,127,12,115,2,113,2,19,38,15,0,2,0,11,1,25
61,255,496,86,410,10,400,6,82,111,47,15,4,2,39,10,84
61,256,108,15,93,6,87,0,12,17,6,1,2,1,13,3,32
61,257,74,9,65,1,64,0,10,31,3,0,0,0,4,2,14
61,258,523,97,426,6,420,6,71,148,32,7,3,2,54,12,85
61,259,60,4,56,0,56,2,21,16,3,0,0,0,9,1,4
61,260,378,42,336,9,327,11,68,107,24,6,5,0,29,6,71
61,261,136,28,108,1,107,4,28,16,6,3,0,0,14,5,31
61,262,104,12,92,2,90,0,8,42,5,2,0,0,9,1,23
61,263,172,17,155,1,154,3,30,57,8,1,1,2,22,3,27
61,264,54,3,51,1,50,0,9,23,3,1,1,0,8,1,4
61,265,145,21,124,1,123,2,23,38,12,2,0,0,20,6,20
61,266,83,6,77,2,75,0,25,33,3,0,0,0,7,0,7
61,267,144,32,112,0,112,3,29,33,10,0,0,0,15,2,20
61,268,100,13,87,2,85,2,13,33,4,2,2,0,8,2,19
61,269,347,32,315,3,312,8,58,70,43,12,4,0,34,5,78
61,270,81,7,74,1,73,7,12,22,9,1,0,0,10,1,11
61,271,68,10,58,0,58,2,11,22,4,1,0,0,8,2,8
61,272,32,7,25,0,25,0,11,10,2,0,0,0,1,0,1
61,273,47,9,38,0,38,1,5,14,2,3,1,1,7,0,4
61,274,154,18,136,3,133,2,31,42,5,2,0,0,15,5,31
61,275,708,112,596,6,590,4,133,206,40,9,1,1,66,24,106
61,276,130,17,113,3,110,1,17,27,11,2,1,0,11,3,37
61,277,242,19,223,8,215,3,54,88,10,1,2,1,25,5,26
61,278,1595,187,1408,35,1373,26,277,333,114,28,12,2,148,36,397
61,279,469,51,418,8,410,10,85,104,48,6,6,1,56,5,89
61,280,79,13,66,1,65,2,7,30,8,0,0,1,7,2,8
61,281,178,23,155,2,153,2,23,51,16,3,0,0,14,6,38
61,282,175,29,146,0,146,2,40,49,8,0,0,0,15,12,20
61,283,259,24,235,2,233,1,62,60,15,4,1,2,22,11,55
61,284,175,17,158,3,155,8,49,52,7,2,0,0,16,2,19
61,285,297,42,255,6,249,3,58,61,30,4,1,0,25,2,65
61,286,92,11,81,0,81,0,16,24,6,0,0,0,15,4,16
61,287,620,97,523,11,512,11,107,78,72,14,6,0,45,11,168
61,288,349,23,326,3,323,9,79,71,46,11,1,0,17,8,81
61,289,48,3,45,0,45,0,12,9,1,1,0,0,7,2,13
61,290,101,8,93,5,88,2,25,30,4,0,0,1,9,1,16
61,291,77,10,67,0,67,1,18,26,5,0,0,0,5,3,9
61,292,375,44,331,2,329,5,60,76,33,2,1,0,56,8,88
61,293,2676,551,2125,34,2091,44,390,707,136,18,22,3,216,33,522
61,294,800,130,670,16,654,3,184,202,48,8,4,2,72,16,115
61,295,132,25,107,2,105,0,21,40,8,0,0,0,18,6,12
61,296,252,45,207,0,207,5,32,88,18,0,3,1,21,3,36
61,297,549,107,442,4,438,8,112,148,27,4,1,1,43,12,82
61,298,294,41,253,10,243,4,37,64,25,4,0,0,30,3,76
61,299,197,29,168,1,167,0,39,86,8,0,0,2,8,2,22
61,300,392,52,340,2,338,9,71,122,31,4,1,0,31,6,63
61,301,155,31,124,1,123,0,24,44,13,0,0,0,12,2,28
61,302,116,12,104,2,102,2,15,42,6,1,0,0,16,4,16
61,303,387,63,324,7,317,5,56,75,33,5,5,0,32,8,98
61,304,201,20,181,4,177,2,53,61,13,5,0,0,8,4,31
61,305,469,63,406,7,399,5,88,162,34,3,4,1,37,5,60
61,306,109,20,89,3,86,2,23,27,4,2,0,0,11,2,15
61,307,196,18,178,3,175,2,34,60,14,2,4,2,15,10,32
61,308,178,23,155,4,151,5,22,47,21,1,1,1,11,5,37
61,309,554,76,478,12,466,10,84,163,47,4,4,0,54,10,90
61,310,437,83,354,12,342,2,91,125,21,5,2,2,40,6,48
61,311,90,13,77,2,75,0,21,38,3,0,0,0,3,1,9
61,313,51,14,37,2,35,3,8,11,1,0,1,1,4,1,5
61,314,408,31,377,9,368,4,49,122,32,8,6,0,33,12,102
61,315,80,10,70,1,69,1,10,27,13,1,0,0,7,1,9
61,316,101,7,94,0,94,0,18,34,10,1,1,1,6,1,22
61,317,157,22,135,3,132,4,31,47,5,2,0,1,9,8,25
61,318,95,12,83,1,82,8,11,15,9,0,1,0,10,3,25
61,319,229,37,192,4,188,2,45,74,13,0,0,0,17,6,31
61,320,84,17,67,2,65,1,24,23,3,0,1,1,1,4,7
61,321,296,26,270,11,259,5,67,71,20,10,2,0,14,11,59
61,322,92,10,82,2,80,1,18,26,7,1,0,0,6,4,17
61,323,120,17,103,1,102,2,28,29,10,0,1,2,10,4,16
61,324,554,70,484,12,472,4,79,172,29,6,2,1,54,31,94
61,325,256,28,228,3,225,12,35,61,21,2,2,2,26,6,58
61,326,181,22,159,6,153,11,15,51,13,3,0,0,9,7,44
61,327,276,50,226,6,220,3,42,74,19,4,4,0,18,9,47
61,328,260,38,222,11,211,3,44,72,15,0,0,1,26,2,48
61,329,511,93,418,8,410,2,93,157,19,5,2,1,45,7,79
61,330,157,23,134,3,131,3,44,34,5,0,1,0,16,4,24
61,331,106,24,82,0,82,3,18,22,13,1,0,0,11,0,14
61,332,243,23,220,1,219,2,37,78,12,1,4,1,31,4,49
61,333,159,46,113,1,112,0,25,29,9,2,2,1,6,4,34
61,335,136,27,109,2,107,2,36,31,12,0,0,1,5,2,18
61,336,107,13,94,1,93,0,24,30,10,2,1,0,5,8,13
61,337,435,42,393,12,381,8,64,99,45,10,4,3,35,11,102
61,338,107,10,97,3,94,1,22,32,8,2,2,0,11,1,15
61,339,710,102,608,10,598,8,114,193,53,6,4,0,75,8,137
61,340,123,21,102,2,100,1,20,38,15,2,0,0,5,0,19
61,341,776,92,684,21,663,14,98,202,67,7,1,3,95,12,164
61,342,1081,130,951,27,924,9,240,190,103,19,10,0,82,14,257
61,343,498,124,374,7,367,2,97,108,44,9,2,1,16,8,80
61,344,810,134,676,12,664,8,143,206,44,17,3,3,90,23,127
61,345,915,131,784,16,768,17,168,267,57,10,4,2,64,13,166
61,346,176,23,153,1,152,3,47,47,4,1,1,0,17,1,31
61,347,172,21,151,2,149,1,34,55,11,1,1,0,13,4,29
61,348,284,42,242,0,242,3,56,83,20,5,1,2,24,2,46
61,349,116,15,101,1,100,3,22,43,5,2,0,0,7,1,17
61,350,117,12,105,4,101,1,19,28,15,1,2,0,13,0,22
61,351,97,9,88,4,84,3,24,30,5,0,1,0,7,4,10
61,352,132,17,115,3,112,1,23,39,13,2,1,0,6,2,25
61,353,270,36,234,2,232,6,53,58,34,6,1,1,20,10,43
61,354,99,6,93,2,91,3,14,49,7,0,0,0,9,1,8
61,355,155,19,136,2,134,3,20,46,14,1,0,2,26,2,20
61,356,540,82,458,10,448,6,130,139,41,5,5,2,24,18,78
61,357,117,16,101,0,101,4,27,25,5,2,1,0,22,1,14
61,358,202,20,182,2,180,3,37,52,11,0,1,0,26,4,46
61,359,117,10,107,3,104,4,21,32,13,1,2,0,12,5,14
61,360,85,6,79,0,79,1,13,30,6,2,0,0,5,3,19
61,361,152,21,131,1,130,3,36,44,9,1,0,0,10,8,19
61,362,465,54,411,7,404,13,85,105,34,5,4,0,44,8,106
61,363,70,15,55,3,52,1,9,27,1,1,0,0,4,2,7
61,364,103,20,83,4,79,2,13,28,4,1,0,0,14,4,13
61,365,309,45,264,4,260,4,59,84,11,5,2,2,34,9,50
61,366,116,13,103,1,102,3,21,45,4,0,0,0,9,2,18
61,367,134,18,116,2,114,0,26,41,10,1,1,0,10,2,23
61,368,67,6,61,0,61,1,10,20,3,0,1,0,9,0,17
61,369,748,91,657,14,643,8,117,197,57,9,5,4,96,18,132
61,370,144,10,134,2,132,3,28,37,2,5,1,1,23,3,29
61,371,113,17,96,3,93,3,17,30,10,1,3,0,10,3,16
61,372,161,27,134,0,134,4,19,46,20,1,0,0,17,5,22
61,373,219,33,186,2,184,3,36,68,10,5,0,1,23,6,32
61,374,70,16,54,0,54,1,7,11,4,0,0,0,9,3,19
61,375,210,21,189,1,188,1,56,47,14,2,0,0,20,2,46
61,376,705,109,596,10,586,5,139,84,95,11,4,1,64,22,161
61,377,492,55,437,6,431,5,105,127,44,4,5,1,65,3,72
61,378,67,10,57,0,57,2,15,15,5,2,1,0,8,0,9
61,379,199,38,161,4,157,9,35,48,18,1,0,0,8,7,31
61,380,107,13,94,2,92,0,30,30,7,0,0,0,14,3,8
61,381,48,10,38,0,38,2,5,16,1,0,0,0,9,1,4
61,382,750,112,638,16,622,7,138,196,69,7,7,4,63,5,126
61,383,122,17,105,5,100,2,17,24,8,3,1,0,10,1,34
61,384,198,35,163,6,157,2,33,55,13,1,2,0,19,0,32
61,385,257,32,225,4,221,5,71,45,16,6,2,0,33,7,36
61,386,362,65,297,5,292,3,67,100,25,6,3,1,34,10,43
61,387,470,74,396,7,389,11,58,159,22,7,5,0,42,11,74
61,388,139,20,119,0,119,4,35,32,8,2,1,2,11,6,18
61,389,884,161,723,6,717,8,177,223,57,6,2,2,70,24,148
61,390,122,20,102,4,98,1,17,40,5,0,2,0,11,3,19
61,391,2596,296,2300,43,2257,44,335,678,201,27,14,3,268,48,639
61,392,115,24,91,3,88,0,33,25,8,1,0,0,3,0,18
61,393,134,25,109,6,103,2,17,32,3,2,0,2,22,3,20
61,394,685,130,555,10,545,12,133,147,45,14,6,3,49,23,113
61,395,193,31,162,2,160,4,30,68,16,2,1,0,19,1,19
61,396,86,6,80,1,79,1,17,22,2,1,0,0,18,1,17
61,397,3184,604,2580,52,2528,32,432,685,252,28,12,3,313,39,732
61,398,43,3,40,1,39,1,3,12,5,0,0,0,4,0,14
61,399,57,10,47,0,47,1,9,15,7,0,0,0,4,4,7
61,400,226,19,207,4,203,5,68,47,9,3,2,0,20,5,44
61,401,84,10,74,2,72,2,21,21,9,1,0,0,6,1,11
61,402,216,21,195,3,192,7,38,64,11,5,0,1,18,3,45
61,403,100,12,88,3,85,8,18,24,4,0,0,0,8,5,18
61,404,493,60,433,9,424,7,97,145,29,5,2,0,47,16,76
61,405,431,64,367,5,362,7,77,116,32,7,2,0,34,6,81
61,406,253,45,208,3,205,4,53,41,16,5,3,0,8,5,70
61,407,556,73,483,10,473,13,104,117,43,13,7,1,54,6,115
61,408,296,39,257,7,250,12,43,77,29,1,1,0,29,3,55
61,409,143,26,117,2,115,5,27,35,12,1,2,0,6,3,24
61,410,146,18,128,1,127,4,17,32,10,4,1,0,27,5,27
61,411,216,26,190,2,188,5,40,56,14,1,0,0,31,3,38
61,412,560,111,449,12,437,3,88,140,36,4,1,0,69,12,84
61,413,112,21,91,4,87,3,30,18,2,1,0,0,14,5,14
61,414,706,101,605,10,595,2,136,192,44,9,4,0,54,13,141
61,415,244,39,205,3,202,1,51,76,20,4,2,2,16,4,26
61,416,46,5,41,0,41,1,2,21,3,0,0,1,6,2,5
61,417,313,41,272,5,267,7,61,73,27,4,2,1,19,2,71
61,418,359,45,314,7,307,8,52,120,23,0,3,3,29,5,64
61,419,185,29,156,5,151,3,30,44,18,3,2,1,12,3,35
61,420,67,10,57,4,53,0,4,16,7,1,0,0,13,1,11
61,421,554,102,452,8,444,6,100,175,28,9,3,3,50,14,56
61,422,533,76,457,2,455,8,126,161,42,7,2,1,27,14,67
61,423,447,67,380,13,367,5,95,88,40,3,4,2,39,9,82
61,424,176,21,155,3,152,4,35,55,16,2,0,0,13,4,23
61,425,103,19,84,1,83,2,20,34,3,1,0,0,2,1,20
61,426,519,105,414,9,405,6,68,135,39,2,1,0,50,15,89
61,427,159,15,144,1,143,4,35,32,16,4,0,0,11,3,38
61,428,562,49,513,10,503,6,89,160,37,11,7,2,53,14,124
61,429,306,53,253,7,246,0,62,93,11,0,4,1,16,6,53
61,430,49,7,42,0,42,2,12,11,4,0,1,0,4,2,6
61,431,270,35,235,5,230,9,39,71,12,2,2,0,33,14,48
61,432,428,45,383,7,376,2,112,111,23,4,4,1,34,10,75
61,433,204,14,190,6,184,8,41,53,16,4,0,0,16,10,36
61,434,67,9,58,1,57,1,17,18,0,1,1,0,7,3,9
61,435,191,37,154,0,154,3,41,47,13,0,0,0,23,3,24
61,436,178,23,155,4,151,1,17,49,19,3,0,0,31,1,30
61,437,60,7,53,0,53,3,7,11,4,2,0,0,7,2,17
61,438,159,21,138,1,137,3,41,53,5,0,0,0,14,3,18
61,439,110,15,95,4,91,2,26,42,4,0,1,0,10,1,5
61,440,707,107,600,12,588,6,128,174,49,9,11,1,67,14,129
61,441,97,11,86,2,84,0,24,11,10,0,1,0,14,0,24
61,442,174,30,144,1,143,5,32,51,15,0,1,0,13,7,19
61,443,512,49,463,6,457,18,94,111,57,3,2,1,57,11,103
61,444,120,23,97,1,96,5,8,20,15,2,1,0,15,1,29
61,445,546,68,478,10,468,15,94,106,49,3,6,1,51,14,129
61,446,132,18,114,1,113,2,26,28,3,0,2,0,9,5,38
61,447,1068,137,931,7,924,13,208,196,103,13,6,2,87,25,271
61,448,340,30,310,5,305,5,74,71,31,6,2,1,28,12,75
61,449,140,19,121,1,120,1,19,60,9,0,0,0,7,3,21
61,450,61,6,55,1,54,4,9,14,4,1,0,0,7,4,11
61,451,232,32,200,3,197,2,45,53,17,4,0,0,19,5,52
61,452,160,21,139,3,136,1,23,57,6,3,2,0,18,7,19
61,453,225,37,188,4,184,4,54,42,30,3,1,0,15,5,30
61,454,387,79,308,8,300,3,80,97,20,4,5,2,30,6,53
61,455,191,44,147,2,145,8,21,60,6,4,0,0,18,0,28
61,456,1186,178,1008,13,995,13,200,252,119,11,7,3,107,19,264
61,457,423,64,359,6,353,3,93,104,27,8,2,2,30,6,78
61,458,195,37,158,1,157,5,35,47,10,2,1,1,20,3,33
61,459,213,19,194,2,192,7,36,49,21,5,1,0,23,4,46
61,460,638,139,499,10,489,4,117,183,28,6,6,1,43,16,85
61,461,111,20,91,1,90,2,33,31,3,2,1,0,4,3,11
61,462,735,62,673,9,664,5,97,182,89,6,1,1,58,16,209
61,463,677,70,607,12,595,4,146,170,43,11,10,0,53,19,139
61,464,2869,628,2241,34,2207,32,437,733,168,23,11,5,220,43,535
61,465,325,58,267,6,261,16,46,47,39,7,0,0,24,5,77
61,466,1055,122,933,20,913,21,185,206,92,13,11,1,90,15,279
61,467,323,38,285,10,275,6,77,98,12,1,3,0,29,7,42
61,468,117,16,101,1,100,0,20,30,13,0,1,0,13,2,21
61,469,222,30,192,7,185,2,32,71,8,5,0,0,25,6,36
61,470,183,23,160,3,157,5,27,58,13,1,1,0,13,7,32
61,471,332,52,280,4,276,7,55,92,12,3,1,0,29,14,63
61,472,302,35,267,4,263,2,31,100,27,2,0,2,14,10,75
61,473,181,22,159,5,154,7,40,40,17,3,0,2,14,2,29
61,474,324,48,276,2,274,3,53,101,21,4,1,0,23,9,59
61,475,522,95,427,8,419,5,125,130,33,4,6,0,35,11,70
61,476,254,20,234,5,229,5,59,69,24,1,3,0,21,6,41
61,477,138,24,114,2,112,5,25,37,10,0,2,0,8,2,23
61,478,128,14,114,1,113,5,22,30,10,1,0,2,18,1,24
61,479,138,21,117,3,114,2,19,38,9,1,2,0,13,2,28
61,480,190,28,162,3,159,3,44,37,27,0,0,0,19,8,21
61,481,73,7,66,3,63,2,15,19,7,0,0,0,5,0,15
61,482,294,50,244,4,240,2,56,86,15,4,2,1,19,2,53
61,483,1871,316,1555,27,1528,27,207,642,120,9,8,0,176,43,296
61,484,1310,229,1081,22,1059,13,293,237,104,25,18,1,71,35,262
61,485,185,26,159,1,158,3,26,69,15,0,2,0,11,2,30
61,486,2033,307,1726,39,1687,23,276,467,161,21,20,3,182,45,489
61,487,224,37,187,6,181,1,28,74,15,6,2,1,13,4,37
61,488,59,13,46,1,45,0,6,14,8,0,0,0,6,0,11
61,489,64,11,53,2,51,2,10,17,1,2,1,0,6,1,11
61,490,260,41,219,10,209,2,55,40,12,3,4,1,17,14,61
61,491,1182,199,983,14,969,10,241,319,79,10,8,5,72,19,206
61,492,78,15,63,2,61,1,13,26,1,1,0,0,5,1,13
61,493,60,6,54,1,53,3,17,16,0,0,1,0,7,3,6
61,494,807,107,700,9,691,10,165,206,68,11,5,0,67,12,147
61,496,661,78,583,10,573,1,91,184,51,3,2,3,53,9,176
61,497,1137,109,1028,13,1015,18,157,295,94,12,6,5,131,21,276
61,498,87,16,71,3,68,2,18,22,8,1,0,0,7,0,10
61,499,131,18,113,2,111,0,23,43,6,0,3,0,6,2,28
61,500,113,18,95,1,94,0,30,22,7,0,3,2,7,1,22
61,501,328,47,281,7,274,1,59,107,16,3,5,2,23,10,48
61,502,66,7,59,0,59,3,22,16,3,0,1,0,6,1,7
61,503,174,37,137,1,136,1,21,39,10,0,2,0,16,5,42
61,504,104,14,90,4,86,3,14,38,6,1,0,0,13,1,10
61,505,189,22,167,4,163,3,29,43,29,6,0,0,14,3,36
61,506,273,33,240,1,239,4,57,81,26,6,1,0,14,15,35
61,507,282,57,225,1,224,3,60,76,15,6,1,0,23,5,35
61,508,2571,604,1967,35,1932,18,403,667,150,32,8,8,177,41,428
61,509,319,37,282,6,276,3,72,95,12,6,2,1,17,2,66
61,510,182,19,163,4,159,2,34,58,3,2,2,1,30,3,24
61,511,263,34,229,3,226,2,55,69,17,3,0,0,31,6,43
61,512,83,5,78,3,75,3,18,23,3,0,1,0,9,2,16
61,513,119,19,100,0,100,2,18,46,3,2,0,0,12,1,16
62,1,1468,220,1248,26,1222,9,232,348,130,17,7,3,104,29,343
62,2,156,12,144,4,140,0,35,33,10,2,2,0,12,4,42
62,3,499,67,432,6,426,12,106,115,35,3,5,0,39,9,102
62,4,5927,995,4932,88,4844,96,982,923,579,64,41,11,409,75,1664
62,5,673,101,572,9,563,13,151,102,77,18,7,0,26,10,159
62,6,250,25,225,5,220,3,50,64,27,1,1,0,21,2,51
62,7,519,54,465,6,459,5,67,154,31,3,6,1,44,6,142
62,8,537,52,485,11,474,4,120,150,28,7,7,0,35,6,117
62,9,182,21,161,3,158,4,42,46,15,5,0,0,9,5,32
62,10,170,18,152,1,151,1,30,29,18,2,2,0,18,4,47
62,11,549,73,476,6,470,3,95,201,24,3,1,0,47,9,87
62,12,175,33,142,2,140,0,21,49,19,0,0,1,20,1,29
62,13,1700,374,1326,32,1294,22,271,296,145,20,7,4,120,21,388
62,14,7524,1595,5929,121,5808,83,1277,1264,579,70,57,13,434,133,1898
62,15,169,19,150,4,146,3,28,45,23,2,0,0,16,2,27
62,16,170,11,159,2,157,6,26,64,13,2,0,0,9,6,31
62,17,116,20,96,0,96,0,28,18,9,0,3,0,8,4,26
62,18,212,37,175,1,174,1,35,60,9,3,4,2,9,4,47
62,19,2869,510,2359,34,2325,34,583,482,323,23,18,6,158,51,647
62,20,415,61,354,7,347,4,117,104,23,3,7,0,21,9,59
62,21,272,25,247,5,242,3,51,92,29,0,2,2,22,7,34
62,22,282,27,255,4,251,4,45,97,15,4,3,2,23,4,54
62,23,2516,479,2037,37,2000,18,543,337,265,27,26,2,162,38,582
62,24,621,92,529,6,523,5,163,134,21,3,3,0,36,10,148
62,25,1533,274,1259,21,1238,18,323,361,93,7,4,1,64,17,350
62,26,100,15,85,1,84,6,9,23,16,0,0,0,3,1,26
62,27,163,19,144,0,144,4,59,39,9,0,0,0,5,1,27
62,28,478,61,417,14,403,1,105,80,48,1,5,0,29,11,123
62,29,350,58,292,2,290,2,63,87,27,3,2,0,19,9,78
62,30,229,34,195,5,190,2,49,56,16,1,2,0,9,4,51
62,31,1139,217,922,11,911,7,284,156,101,15,7,5,56,18,262
62,32,3274,573,2701,49,2652,26,609,477,431,45,30,9,129,39,857
62,33,3004,519,2485,47,2438,27,755,425,399,38,18,3,86,26,661
62,34,1711,235,1476,32,1444,6,494,231,156,20,16,5,60,16,440
62,35,4581,1004,3577,71,3506,43,925,698,368,44,37,9,235,69,1078
62,36,665,152,513,12,501,4,132,108,41,10,10,2,42,6,146
62,37,2316,321,1995,24,1971,36,312,626,154,15,5,4,259,39,521
62,38,3214,608,2606,50,2556,30,644,600,252,32,27,4,175,55,737
62,39,657,74,583,15,568,5,156,158,58,3,2,2,48,11,125
62,40,7276,1730,5546,107,5439,57,1467,965,509,65,73,13,302,83,1905
62,41,26227,5742,20485,384,20101,422,3346,4933,2301,233,109,51,1954,319,6433
62,42,792,114,678,23,655,10,129,149,77,9,2,1,69,12,197
62,43,1423,240,1183,11,1172,10,286,326,123,13,10,2,69,21,312
62,44,582,96,486,6,480,5,122,106,44,9,5,0,22,6,161
62,45,1065,154,911,21,890,17,213,238,66,13,6,3,73,13,248
62,46,625,140,485,15,470,6,104,95,64,11,9,2,25,7,147
62,47,113,14,99,2,97,1,21,42,6,0,0,0,12,0,15
62,48,7995,2355,5640,82,5558,48,1628,860,894,64,45,13,263,63,1680
62,49,355,41,314,9,305,4,69,79,32,2,4,1,24,6,84
62,50,1216,229,987,25,962,11,242,215,82,13,13,5,54,13,314
62,51,3494,714,2780,58,2722,39,876,420,401,52,34,2,139,49,710
62,52,302,42,260,0,260,4,49,67,25,1,1,2,45,6,60
62,53,521,60,461,5,456,3,120,113,41,3,2,0,23,8,143
62,54,450,76,374,2,372,7,95,128,23,4,5,0,29,7,74
62,55,356,54,302,1,301,4,87,73,28,3,1,1,16,4,84
62,56,641,136,505,12,493,12,131,163,41,3,3,0,38,7,95
62,57,3845,652,3193,54,3139,32,847,905,270,21,27,7,214,60,756
62,58,175,27,148,0,148,0,44,45,19,3,1,0,10,3,23
62,59,224,29,195,5,190,1,32,67,9,1,1,2,31,4,42
62,60,2170,418,1752,29,1723,21,347,394,176,47,15,3,89,36,595
62,61,193,0,193,22,171,1,45,44,10,1,1,1,20,3,45
62,62,37,4,33,1,32,0,13,8,1,0,0,0,3,1,6
62,63,1485,281,1204,25,1179,13,269,260,125,12,17,1,80,18,384
62,64,135,26,109,3,106,1,30,30,5,0,0,1,12,4,23
62,65,12640,3063,9577,192,9385,81,2514,1077,2359,119,68,18,370,114,2665
62,66,42,5,37,1,36,0,8,21,2,0,0,0,4,0,1
62,67,425,42,383,6,377,4,114,86,21,7,7,0,19,8,111
62,68,264,32,232,3,229,0,56,71,19,1,6,2,16,5,53
62,69,236,24,212,2,210,0,44,84,19,1,0,1,24,2,35
62,70,203,30,173,2,171,0,48,60,12,1,1,1,14,0,34
62,71,302,26,276,5,271,1,89,47,31,3,7,2,9,4,78
62,72,209,17,192,5,187,7,47,49,17,3,1,1,18,4,40
62,73,973,139,834,13,821,13,171,240,80,11,6,4,73,21,202
62,74,188,20,168,1,167,2,42,64,14,2,5,0,9,2,27
62,75,1106,181,925,25,900,12,193,296,66,11,3,1,74,14,230
62,76,147,19,128,2,126,1,30,35,13,0,2,0,12,12,21
62,77,272,36,236,6,230,0,42,44,38,3,4,0,16,5,78
62,78,757,92,665,11,654,7,175,122,80,5,3,1,40,17,204
62,79,69,9,60,3,57,1,13,21,3,1,0,0,5,6,7
62,80,2117,472,1645,29,1616,18,375,427,138,21,18,3,97,33,486
62,81,394,61,333,8,325,1,80,77,38,3,3,0,24,10,89
62,82,211,30,181,3,178,4,41,69,8,0,1,4,14,5,32
62,83,5851,1548,4303,112,4191,43,1257,640,443,72,56,14,185,65,1416
62,84,193,29,164,4,160,1,37,60,8,1,0,0,11,3,39
62,85,126,16,110,2,108,1,18,38,10,3,1,0,9,2,26
62,86,257,35,222,1,221,2,52,64,20,5,4,0,29,8,37
62,87,737,102,635,7,628,7,153,129,62,12,9,3,40,14,199
62,88,266,23,243,4,239,1,55,56,19,3,0,0,28,9,68
62,89,319,59,260,5,255,7,41,78,32,2,0,1,33,11,50
62,90,110,13,97,2,95,2,28,30,10,0,0,0,1,6,18
62,91,91,7,84,2,82,0,21,36,6,0,1,0,8,2,8
62,92,330,45,285,2,283,2,72,77,16,9,4,1,24,3,75
62,93,179,24,155,5,150,1,45,34,14,2,0,0,4,1,49
62,94,286,30,256,4,252,5,58,74,14,1,2,0,24,1,73
62,95,178,21,157,3,154,0,55,49,3,0,0,0,8,2,37
62,96,454,94,360,3,357,4,87,97,33,6,7,1,24,8,90
62,97,718,71,647,12,635,9,163,189,42,8,9,4,58,18,135
62,99,4128,659,3469,69,3400,57,631,663,414,56,31,7,295,65,1181
62,100,1573,245,1328,24,1304,13,244,284,195,10,12,1,87,29,429
62,101,100,15,85,0,85,0,27,21,11,0,0,1,9,3,13
62,102,181,23,158,5,153,3,27,52,6,3,3,0,24,2,33
62,103,112,14,98,0,98,0,26,43,14,1,0,0,3,2,9
62,104,235,18,217,2,215,4,40,65,27,1,1,0,27,13,37
62,105,428,41,387,9,378,15,77,127,27,5,0,0,43,11,73
62,106,204,17,187,3,184,1,44,69,25,1,0,1,12,3,28
62,107,285,31,254,5,249,7,74,73,9,3,1,0,21,6,55
62,108,10739,2400,8339,178,8161,122,1805,2226,833,104,74,17,560,145,2275
62,109,165,28,137,3,134,3,47,41,6,2,0,0,8,4,23
62,111,188,24,164,2,162,2,43,55,16,0,0,0,13,2,31
62,112,435,61,374,5,369,4,83,134,17,5,1,0,34,5,86
62,113,385,45,340,8,332,8,66,86,47,2,4,1,26,5,87
62,114,118,14,104,0,104,0,22,45,5,1,1,0,13,2,15
62,115,369,27,342,4,338,4,74,89,39,7,1,0,28,8,88
62,116,170,26,144,3,141,4,21,41,9,3,3,1,22,4,33
62,117,704,152,552,12,540,4,198,140,37,8,4,0,36,7,106
62,118,125,15,110,2,108,1,30,25,11,3,1,0,12,1,24
62,119,18013,4867,13146,226,12920,233,2704,3031,1412,175,104,23,939,206,4093
62,120,387,57,330,3,327,4,78,67,18,3,2,1,36,14,104
62,121,87,14,73,5,68,0,27,8,7,1,0,0,6,2,17
62,122,262,36,226,3,223,0,49,71,16,6,2,1,28,2,48
62,123,375,49,326,8,318,5,87,87,30,4,2,1,26,7,69
62,124,372,53,319,9,310,3,83,68,29,6,1,0,24,5,91
62,125,301,30,271,3,268,2,67,96,24,2,0,0,16,3,58
62,126,6838,1661,5177,92,5085,64,1534,950,532,69,55,7,310,87,1477
62,127,247,32,215,1,214,11,31,103,7,2,0,1,24,2,33
62,128,3247,682,2565,62,2503,26,662,414,397,33,17,7,159,43,745
62,129,79,7,72,1,71,0,19,22,7,0,3,0,4,1,15
62,130,491,75,416,10,406,4,112,114,29,9,4,0,33,4,97
62,131,246,45,201,2,199,1,56,25,26,6,3,3,19,5,55
62,132,3665,647,3018,59,2959,30,831,510,359,30,34,9,185,53,918
62,133,5605,1147,4458,67,4391,44,1440,675,835,56,41,13,159,62,1066
62,134,113,16,97,1,96,1,23,36,7,0,1,0,9,2,17
62,135,219,17,202,2,200,4,40,68,19,6,2,1,16,1,43
62,137,87,13,74,2,72,1,16,24,8,0,0,0,2,0,21
62,138,602,77,525,9,516,7,110,184,35,8,3,0,31,6,132
62,139,4060,870,3190,70,3120,26,863,591,286,47,37,7,159,41,1063
62,140,366,67,299,5,294,4,98,55,18,1,1,0,15,8,94
62,141,607,68,539,7,532,4,149,124,34,7,2,2,29,2,179
62,142,107,12,95,3,92,0,21,33,1,1,0,0,5,3,28
62,143,37,3,34,1,33,0,3,17,4,1,0,0,7,0,1
62,144,342,48,294,8,286,0,60,103,21,1,3,1,27,6,64
62,145,363,49,314,5,309,3,61,68,30,5,6,0,25,3,108
62,146,235,30,205,1,204,2,48,48,23,5,2,3,18,3,52
62,147,309,43,266,7,259,5,65,67,25,4,1,2,20,4,66
62,148,648,116,532,11,521,7,157,118,47,7,7,0,53,8,117
62,149,175,31,144,4,140,0,38,40,8,1,0,1,10,4,38
62,150,398,41,357,4,353,6,104,91,23,0,4,0,30,7,88
62,151,388,48,340,3,337,3,97,66,35,2,5,0,26,13,90
62,152,172,19,153,3,150,3,41,37,10,3,0,1,9,5,41
62,153,482,74,408,8,400,3,95,116,22,8,0,0,28,6,122
62,154,530,72,458,12,446,4,141,141,24,10,3,0,33,9,81
62,155,499,69,430,11,419,4,123,80,37,4,7,0,38,11,115
62,156,468,50,418,6,412,9,76,138,31,5,1,2,39,4,107
62,157,77,19,58,2,56,0,6,19,6,0,1,1,4,0,19
62,158,483,98,385,6,379,1,78,95,41,15,4,0,40,12,93
62,160,26121,6259,19862,298,19564,340,4139,4001,2223,256,142,39,1141,252,7031
62,161,493,87,406,9,397,2,118,85,44,1,1,1,21,9,115
62,162,380,41,339,5,334,7,90,67,38,2,6,0,20,12,92
62,163,224,19,205,5,200,1,47,68,24,3,0,0,12,7,38
62,164,932,137,795,13,782,18,202,242,62,7,7,2,64,19,159
62,165,181,20,161,3,158,0,43,35,14,0,1,0,15,2,48
62,166,456,59,397,5,392,7,93,101,45,5,5,1,35,14,86
62,167,180,12,168,8,160,2,30,54,19,1,1,1,24,6,22
62,168,570,78,492,8,484,8,87,163,25,2,2,4,42,18,133
62,169,167,16,151,1,150,5,33,40,6,1,1,0,13,1,50
62,170,2039,385,1654,30,1624,24,431,369,223,12,14,5,119,32,395
62,171,95,12,83,4,79,2,13,33,10,0,1,0,3,5,12
62,172,257,18,239,4,235,1,75,62,17,3,2,0,16,0,59
62,173,3631,613,3018,54,2964,18,847,507,370,39,12,4,200,37,930
62,174,993,123,870,14,856,3,192,206,138,12,8,2,42,14,239
62,175,118,14,104,0,104,1,9,34,15,2,2,0,3,2,36
62,176,548,102,446,11,435,2,130,146,31,6,4,0,16,6,94
62,177,653,105,548,10,538,4,125,124,58,15,2,1,46,7,156
62,178,16147,4509,11638,229,11409,141,3122,1782,1349,168,117,21,565,142,4002
62,179,260,32,228,5,223,6,48,67,18,2,5,1,19,8,49
62,180,222,28,194,4,190,1,59,66,14,2,2,1,9,4,32
62,181,1010,171,839,13,826,4,222,223,96,10,6,2,54,15,194
62,182,189,20,169,3,166,2,36,72,6,0,0,0,12,1,37
62,183,608,112,496,15,481,1,82,134,38,4,3,0,16,5,198
62,184,185,22,163,3,160,0,37,28,15,1,1,0,13,5,60
62,185,206,45,161,3,158,2,46,44,10,3,2,1,9,6,35
62,186,9548,2557,6991,142,6849,92,1990,1006,878,116,54,15,303,88,2307
62,187,135,19,116,10,106,0,26,34,7,3,3,0,8,2,23
62,188,2280,307,1973,24,1949,14,563,245,511,14,22,3,80,35,462
62,189,87,8,79,0,79,0,24,36,4,0,0,0,2,0,13
62,190,1065,153,912,22,890,15,189,266,84,7,10,1,84,19,215
62,191,442,55,387,2,385,5,108,56,62,10,3,0,14,9,118
62,192,299,35,264,3,261,2,60,62,27,3,3,0,20,0,84
62,193,51647,13921,37726,676,37050,486,9538,6922,5335,524,314,79,2041,502,11309
62,194,4281,958,3323,80,3243,22,903,435,681,63,38,7,133,37,924
62,195,1262,211,1051,21,1030,14,279,267,80,12,3,3,101,25,246
62,196,482,74,408,4,404,17,92,142,26,1,5,0,39,13,69
62,197,1271,228,1043,20,1023,15,275,260,119,11,5,1,58,22,257
62,198,274,38,236,1,235,3,43,74,27,3,3,1,16,5,60
62,199,523,88,435,4,431,4,97,117,43,7,2,1,42,7,111
62,200,719,99,620,12,608,9,165,117,71,7,9,0,37,10,183
62,201,2071,370,1701,31,1670,20,483,369,159,21,16,0,85,34,483
62,202,420,58,362,8,354,1,80,125,26,4,1,1,27,4,85
62,203,354,42,312,5,307,3,53,91,38,7,0,0,33,3,79
62,204,1171,122,1049,16,1033,6,208,249,96,9,8,5,66,16,370
62,205,974,136,838,16,822,3,211,220,72,15,10,1,57,18,215
62,206,247,28,219,6,213,3,39,77,19,2,3,0,19,3,48
62,207,466,55,411,7,404,3,97,99,37,5,3,0,35,9,116
62,208,57,9,48,0,48,0,14,23,4,0,0,1,3,3,0
62,209,125,11,114,4,110,2,37,29,3,1,0,1,9,2,26
62,210,13,2,11,0,11,0,0,10,0,0,0,0,0,1,0
62,211,157,20,137,3,134,4,36,46,11,1,0,0,10,3,23
62,212,335,34,301,3,298,1,48,60,25,4,2,2,22,14,120
62,213,607,81,526,11,515,8,101,154,56,9,3,2,46,16,120
62,214,411,50,361,4,357,7,77,107,28,4,2,0,23,6,103
62,215,12520,3041,9479,183,9296,112,2547,1757,1380,106,77,19,475,118,2705
62,216,158,13,145,3,142,0,48,46,6,6,0,0,8,5,23
62,217,2310,452,1858,31,1827,11,588,235,307,26,12,1,69,28,550
62,218,264,28,236,0,236,3,48,57,10,2,2,1,28,5,80
62,219,169,23,146,3,143,1,24,60,6,0,0,0,14,3,35
62,220,362,52,310,6,304,1,57,95,30,8,1,1,19,3,89
62,221,232,41,191,7,184,1,37,61,22,2,1,0,14,7,39
62,222,129,12,117,5,112,3,19,39,12,0,2,0,14,0,23
62,223,222,26,196,2,194,0,44,50,18,0,4,0,20,5,53
62,224,2522,577,1945,51,1894,17,562,343,203,29,19,2,84,29,606
62,225,534,92,442,11,431,11,90,161,37,4,3,1,30,10,84
62,226,232,36,196,2,194,3,36,54,25,4,0,0,20,1,51
62,227,169,20,149,2,147,3,29,55,15,0,0,0,15,1,29
62,228,228,25,203,7,196,2,52,55,13,1,1,0,18,2,52
62,229,534,56,478,10,468,2,114,118,32,7,3,1,24,12,155
62,230,577,60,517,7,510,9,123,149,42,9,4,0,46,13,115
62,231,120,12,108,0,108,1,32,35,9,2,0,0,3,0,26
62,232,617,82,535,5,530,4,152,139,51,5,2,0,40,12,125
62,233,867,138,729,19,710,5,159,192,67,8,6,1,49,12,211
62,234,169,27,142,1,141,0,26,65,12,5,2,0,9,4,18
62,235,2156,332,1824,25,1799,19,275,663,153,16,11,3,157,29,473
62,236,247,26,221,6,215,0,45,38,22,4,3,0,7,6,90
62,237,362,34,328,6,322,10,66,91,14,7,1,0,39,7,87
62,238,64,6,58,0,58,1,10,20,8,0,1,0,3,1,14
62,239,2000,393,1607,24,1583,36,272,524,145,28,6,6,139,25,402
62,240,1545,252,1293,27,1266,6,335,200,194,23,9,6,71,19,403
62,241,216,20,196,2,194,2,58,59,13,3,2,1,12,4,40
62,242,83,11,72,1,71,0,19,22,10,3,0,0,7,1,9
62,243,86,16,70,0,70,0,19,16,5,0,0,0,3,4,23
62,244,4465,846,3619,48,3571,46,863,833,431,50,21,9,240,59,1019
62,245,491,71,420,11,409,2,89,111,16,6,2,0,43,7,133
62,246,156,27,129,0,129,1,23,33,16,1,1,0,7,1,46
62,247,392,26,366,7,359,3,77,100,46,5,4,1,20,8,95
62,248,374,62,312,10,302,3,83,64,24,4,1,1,26,7,89
62,249,3998,808,3190,61,3129,12,1051,436,462,33,32,10,108,44,941
62,250,7811,1771,6040,137,5903,72,1707,998,743,51,45,18,305,86,1878
62,251,408,51,357,4,353,1,77,156,20,4,2,3,28,9,53
62,252,2174,395,1779,36,1743,22,447,469,178,23,19,6,143,37,399
62,253,73,7,66,6,60,0,23,15,9,1,0,0,4,0,8
62,254,484,50,434,9,425,4,88,117,24,10,1,0,21,6,154
62,255,594,89,505,12,493,11,116,158,41,10,1,1,37,9,109
62,256,143,21,122,3,119,2,21,49,7,1,1,1,9,0,28
62,257,406,51,355,12,343,9,53,141,22,4,4,0,21,5,84
62,258,241,24,217,4,213,0,46,81,10,4,1,0,21,4,46
62,259,1093,118,975,22,953,13,268,199,77,10,5,1,56,16,308
62,260,230,22,208,8,200,1,62,43,32,6,1,0,9,8,38
62,261,4365,910,3455,48,3407,35,689,1261,276,41,19,6,260,72,748
62,262,1296,206,1090,23,1067,16,276,214,105,9,11,2,77,20,337
62,263,4445,692,3753,71,3682,39,626,919,274,41,11,6,321,57,1388
62,264,1043,199,844,12,832,8,233,135,88,14,10,1,29,10,304
62,265,862,89,773,18,755,3,183,176,74,7,4,3,51,14,240
62,266,55,10,45,0,45,1,11,11,6,0,1,0,4,0,11
62,267,269,31,238,3,235,2,49,45,19,1,2,0,17,8,92
62,268,3577,705,2872,62,2810,31,603,463,332,35,26,1,139,48,1132
62,269,575,79,496,8,488,4,126,113,55,4,1,0,31,8,146
62,270,5353,1518,3835,79,3756,36,1027,441,833,51,51,7,169,69,1072
62,271,575,67,508,9,499,3,132,169,43,2,1,0,27,8,114
62,272,250,40,210,3,207,0,47,55,25,6,2,1,32,3,36
62,273,373,30,343,7,336,1,64,131,26,4,1,0,18,15,76
62,274,4036,725,3311,59,3252,37,1031,617,424,44,32,6,161,37,863
62,275,224,33,191,2,189,3,22,47,18,5,5,2,17,4,66
62,276,4104,875,3229,55,3174,41,967,544,390,32,28,4,179,64,925
62,277,2202,414,1788,41,1747,13,626,224,374,19,26,1,51,23,390
62,278,419,63,356,4,352,3,68,80,39,3,2,0,37,11,109
62,279,954,114,840,19,821,12,138,330,39,7,1,2,105,24,163
62,280,256,41,215,4,211,3,38,56,36,3,3,0,10,2,60
62,281,285,39,246,4,242,3,48,78,14,2,0,0,26,10,61
62,282,135,17,118,3,115,1,41,27,9,0,2,0,11,0,24
62,283,83,6,77,2,75,0,22,31,7,0,0,0,4,0,11
62,284,1378,224,1154,22,1132,13,376,190,149,13,18,1,57,18,297
62,285,362,33,329,1,328,5,66,95,20,6,6,0,23,9,98
62,286,372,59,313,5,308,7,54,75,50,5,2,0,26,8,81
62,288,1567,203,1364,37,1327,20,308,279,133,24,6,2,99,36,420
62,289,609,67,542,15,527,7,87,122,46,8,7,0,67,16,167
62,290,295,27,268,5,263,2,52,90,31,6,1,1,23,3,54
62,291,2199,408,1791,27,1764,14,491,281,249,38,11,3,76,24,577
62,292,617,63,554,9,545,4,142,103,39,6,7,1,31,15,197
62,293,180,18,162,2,160,6,34,44,14,1,0,0,10,4,47
62,294,337,42,295,5,290,0,89,96,15,4,2,0,25,5,54
62,295,834,142,692,12,680,2,188,131,55,15,11,1,35,13,229
62,296,152,17,135,1,134,1,24,55,14,1,0,0,6,5,28
62,297,2327,307,2020,27,1993,27,487,407,169,24,14,2,164,47,652
62,298,390,55,335,8,327,1,92,115,27,0,3,0,22,3,64
62,299,178,19,159,1,158,2,42,47,9,0,1,0,7,4,46
62,300,2215,409,1806,26,1780,11,488,364,200,23,18,1,75,29,571
62,301,58,8,50,0,50,0,9,15,2,1,0,0,5,1,17
62,302,157,18,139,2,137,6,14,39,11,1,3,0,20,1,42
62,303,155,31,124,1,123,5,29,27,11,5,0,0,5,6,35
62,304,250,30,220,7,213,1,53,63,5,2,1,1,21,3,63
62,306,313,36,277,2,275,0,70,78,27,1,1,0,31,7,60
62,307,208,26,182,2,180,5,41,68,15,1,1,0,9,1,39
62,308,342,23,319,11,308,1,99,71,26,9,2,1,21,5,73
62,309,1143,185,958,22,936,12,235,147,91,11,11,2,53,16,358
62,310,1323,238,1085,20,1065,10,299,234,110,14,7,1,86,17,287
62,311,1465,253,1212,25,1187,10,380,191,170,16,6,3,61,25,325
62,312,233,36,197,7,190,0,50,52,13,4,2,0,9,4,56
62,313,687,104,583,8,575,2,174,115,32,11,4,0,25,14,198
62,314,292,33,259,4,255,4,58,61,24,8,3,1,21,5,70
62,315,267,18,249,3,246,1,54,75,16,3,5,1,31,2,58
62,316,150,23,127,2,125,1,24,46,12,2,1,0,10,4,25
62,317,316,52,264,1,263,11,64,74,29,0,4,0,27,4,50
62,318,8164,1969,6195,155,6040,42,1624,1581,609,90,43,15,369,99,1568
62,319,199,21,178,3,175,1,51,53,13,1,3,1,10,3,39
62,320,247,33,214,5,209,6,42,66,15,2,1,0,28,3,46
62,321,3361,811,2550,39,2511,20,787,387,397,32,11,12,93,35,737
62,322,97,11,86,3,83,0,22,27,8,3,0,0,8,1,14
62,323,896,97,799,19,780,18,151,232,67,5,5,0,74,11,217
62,324,466,62,404,7,397,9,74,105,36,8,1,3,43,5,113
62,325,705,92,613,16,597,9,138,162,45,6,3,0,45,14,175
62,326,179,39,140,0,140,1,49,33,15,1,0,0,10,2,29
62,327,418,60,358,4,354,9,107,102,20,6,1,0,22,3,84
62,328,682,85,597,11,586,1,165,108,104,6,2,1,32,7,160
62,329,1475,288,1187,27,1160,11,329,173,141,14,5,1,50,20,416
62,330,961,134,827,14,813,13,209,228,69,11,6,1,70,17,189
62,331,863,135,728,11,717,6,156,191,81,6,5,0,36,10,226
62,332,424,43,381,8,373,6,72,115,30,1,4,2,32,6,105
62,333,269,39,230,6,224,8,47,75,9,1,1,0,33,3,47
62,334,629,92,537,11,526,8,137,120,44,6,5,1,36,15,154
62,335,374,46,328,6,322,3,82,110,26,2,2,1,35,11,50
62,336,395,54,341,7,334,1,97,88,20,11,0,2,31,8,76
62,337,163,34,129,3,126,0,29,61,12,0,1,0,6,0,17
62,338,2208,339,1869,23,1846,39,254,790,116,5,8,7,251,31,345
62,339,80,15,65,1,64,0,6,23,7,0,0,0,4,2,22
62,340,626,126,500,9,491,2,138,101,55,7,8,2,33,6,139
62,341,329,41,288,3,285,5,67,81,22,0,2,0,25,4,79
62,342,77,11,66,1,65,1,10,25,6,1,0,0,5,0,17
62,343,213,24,189,4,185,1,28,55,25,0,1,0,21,8,46
62,344,95,15,80,1,79,1,25,18,7,0,0,0,2,2,24
62,345,96,11,85,1,84,1,20,40,4,1,3,0,6,0,9
62,346,146,15,131,2,129,1,55,23,6,0,3,1,11,0,29
62,347,112,11,101,0,101,0,37,23,4,1,1,0,10,6,19
62,348,114,12,102,4,98,2,22,37,7,2,5,0,3,0,20
62,349,960,142,818,14,804,12,179,191,99,7,8,3,49,17,239
62,350,890,118,772,18,754,12,145,216,68,5,3,1,51,12,241
62,351,4548,1058,3490,80,3410,28,1128,442,466,53,40,11,112,34,1096
62,352,77,11,66,0,66,0,7,22,5,1,0,0,16,1,14
62,353,225,36,189,3,186,4,55,64,13,0,2,0,16,4,28
62,354,605,79,526,7,519,8,82,199,54,8,1,0,36,12,119
62,355,399,52,347,4,343,6,92,103,35,8,3,2,27,8,59
62,356,635,88,547,13,534,4,141,106,65,3,6,0,24,14,171
62,357,52,4,48,0,48,0,8,20,1,0,1,0,6,2,10
62,358,195,43,152,2,150,2,32,64,16,1,0,1,11,2,21
62,359,380,50,330,4,326,7,74,104,20,4,3,1,26,3,84
62,360,893,148,745,7,738,10,168,178,87,19,12,3,51,14,196
62,361,2586,579,2007,40,1967,14,481,479,165,33,21,3,124,28,619
62,362,188,17,171,2,169,3,62,41,7,1,2,3,10,4,36
62,363,331,35,296,3,293,5,71,82,18,6,0,0,29,6,76
62,364,1461,201,1260,21,1239,11,217,319,123,12,10,0,77,22,448
62,365,144,31,113,1,112,1,50,27,6,1,0,1,6,1,19
62,366,266,36,230,3,227,2,47,75,16,4,2,0,15,5,61
62,367,515,64,451,14,437,9,109,134,37,7,6,1,29,12,93
62,368,149,23,126,2,124,0,29,46,7,1,1,0,6,4,30
62,369,429,35,394,13,381,2,102,117,42,2,0,1,33,5,77
62,370,102,18,84,2,82,0,20,39,2,1,0,0,8,0,12
62,371,1657,223,1434,22,1412,18,310,329,170,23,9,5,121,26,401
62,372,129,25,104,3,101,2,37,29,5,2,0,0,8,2,16
62,373,734,114,620,15,605,5,160,123,80,6,3,0,46,7,175
62,374,148,30,118,4,114,2,23,32,6,2,2,0,17,1,29
62,375,92,13,79,1,78,0,33,17,6,3,0,0,7,0,12
62,376,1943,293,1650,30,1620,23,382,479,130,14,21,3,107,35,426
62,377,794,131,663,10,653,5,189,96,86,15,6,1,33,7,215
62,378,148,16,132,5,127,2,16,58,7,4,0,0,6,3,31
62,379,309,48,261,3,258,3,66,75,15,5,4,0,32,1,57
62,380,265,25,240,6,234,6,62,71,19,1,2,0,21,7,45
62,381,125,14,111,4,107,2,25,28,11,2,1,0,9,1,28
62,382,501,72,429,9,420,0,88,112,45,1,1,0,35,7,131
62,383,985,147,838,9,829,14,188,182,110,10,6,0,69,14,236
62,384,461,64,397,4,393,4,100,104,26,4,2,1,23,8,121
62,385,339,56,283,8,275,4,71,84,17,5,0,2,27,5,60
62,386,4580,1111,3469,54,3415,18,1185,325,659,40,46,11,98,34,999
62,387,287,30,257,11,246,1,80,49,24,4,3,1,16,2,66
62,388,236,31,205,5,200,4,42,45,23,1,8,1,12,1,63
62,389,34,2,32,0,32,0,3,10,4,0,0,0,3,0,12
62,390,1236,156,1080,14,1066,14,216,377,86,8,8,2,84,30,241
62,391,1153,156,997,22,975,11,228,211,128,10,3,2,59,9,314
62,392,291,27,264,1,263,2,56,70,19,3,1,0,40,10,62
62,393,766,126,640,10,630,8,206,150,77,5,2,2,36,11,133
62,395,150,18,132,3,129,1,34,19,10,2,0,1,16,3,43
62,396,16,1,15,1,14,0,2,5,2,0,0,0,3,0,2
62,397,3772,656,3116,47,3069,32,905,523,289,35,27,6,144,51,1057
62,398,253,41,212,4,208,5,49,41,32,4,3,0,16,11,47
62,399,526,63,463,5,458,5,100,125,42,4,11,0,36,5,130
62,400,3657,1013,2644,35,2609,24,774,393,347,49,25,7,120,46,824
62,401,3408,694,2714,38,2676,28,845,425,329,45,49,5,131,33,786
62,402,239,37,202,1,201,0,45,47,24,3,2,1,26,0,53
62,403,1033,159,874,16,858,7,209,134,84,20,13,1,69,12,309
62,404,177,33,144,2,142,1,55,32,7,2,0,0,13,2,30
62,405,401,63,338,8,330,3,110,93,27,2,2,0,14,7,72
62,406,190,26,164,1,163,0,29,54,23,1,0,0,14,0,42
62,407,830,114,716,13,703,14,170,137,76,10,4,3,43,15,231
62,408,988,170,818,11,807,10,187,240,72,8,8,2,57,16,207
62,409,152,22,130,4,126,2,31,29,10,1,0,1,13,1,38
62,410,160,29,131,1,130,1,28,46,10,2,3,0,14,2,24
62,411,41,6,35,1,34,0,12,16,2,0,0,0,0,0,4
62,412,874,152,722,13,709,4,164,195,80,12,6,2,62,22,162
62,413,8942,2068,6874,150,6724,58,2139,1046,1028,102,75,10,269,90,1907
62,414,184,31,153,3,150,1,26,52,12,3,1,0,26,2,27
62,415,327,25,302,6,296,3,53,116,11,0,1,2,37,7,66
62,416,151,14,137,7,130,3,45,36,9,2,3,0,7,3,22
62,418,232,19,213,4,209,3,44,56,22,2,0,1,15,9,57
62,419,116,20,96,4,92,0,24,32,6,1,0,0,12,4,13
62,421,282,66,216,5,211,2,85,41,11,1,1,1,20,6,43
62,422,389,76,313,6,307,3,94,89,31,7,1,1,10,4,67
62,423,1247,164,1083,25,1058,5,289,246,72,10,10,0,74,23,329
62,424,235,32,203,2,201,6,47,69,17,0,1,1,11,1,48
62,425,103,12,91,3,88,2,20,22,8,0,1,0,16,0,19
62,426,166,20,146,2,144,1,19,36,22,2,1,0,24,6,33
62,427,19211,5114,14097,217,13880,180,4924,2187,1663,171,111,37,722,162,3723
62,428,352,29,323,8,315,2,60,89,33,5,3,1,44,12,66
62,429,227,23,204,11,193,3,43,69,22,1,3,1,16,4,31
62,430,125,21,104,2,102,2,32,29,10,0,0,0,7,0,22
62,431,402,37,365,10,355,9,75,92,34,2,4,2,30,2,105
62,432,303,52,251,6,245,3,60,85,20,4,0,0,14,7,52
62,433,82,6,76,0,76,0,11,34,4,0,1,0,8,2,16
62,434,109,26,83,0,83,2,21,37,2,1,0,0,5,1,14
62,435,93,7,86,1,85,1,20,30,3,0,0,0,3,1,27
62,436,107,15,92,3,89,3,13,44,2,2,2,0,6,1,16
62,437,267,59,208,2,206,1,43,86,10,2,2,0,21,6,35
62,438,419,41,378,7,371,5,96,97,40,2,2,2,29,11,87
62,439,228,31,197,1,196,2,48,48,13,3,0,0,20,7,55
62,440,850,165,685,11,674,5,229,152,50,12,10,1,58,10,147
62,441,183,20,163,5,158,0,33,45,18,1,2,0,8,2,49
62,442,378,58,320,5,315,1,74,100,34,3,0,0,24,2,77
62,443,4655,967,3688,58,3630,44,1104,603,495,53,30,7,161,45,1088
62,444,199,54,145,1,144,1,19,44,19,2,3,0,14,3,39
62,445,661,103,558,9,549,8,149,135,66,7,4,1,31,8,140
62,446,548,96,452,4,448,9,95,102,60,9,3,0,28,7,135
62,447,1806,541,1265,36,1229,14,257,351,125,13,3,9,74,25,358
62,448,1600,242,1358,19,1339,19,316,363,119,15,7,1,100,25,374
62,449,133,14,119,3,116,1,19,46,11,1,2,2,11,2,21
62,450,194,20,174,2,172,1,29,78,22,2,0,0,10,2,28
62,451,408,58,350,4,346,1,87,128,21,3,3,1,21,3,78
62,452,1114,114,1000,14,986,11,204,249,80,7,2,4,101,19,309
62,453,85,6,79,1,78,1,14,31,6,0,0,1,5,0,20
62,454,1780,261,1519,22,1497,19,344,404,131,17,12,4,142,33,391
62,455,87,13,74,1,73,0,13,18,2,3,0,0,4,3,30
62,456,552,60,492,8,484,6,156,120,39,5,4,2,27,4,121
62,457,5588,1169,4419,97,4322,45,1106,800,713,64,42,8,232,77,1235
62,458,771,104,667,20,647,9,150,142,66,9,12,2,51,12,194
62,459,182,26,156,2,154,0,44,50,13,0,0,0,16,2,29
62,460,193,27,166,2,164,1,20,86,9,0,1,0,11,1,35
62,461,644,130,514,11,503,5,108,122,47,8,5,1,23,7,177
62,462,89,10,79,1,78,0,23,35,5,1,0,0,4,2,8
62,463,385,54,331,7,324,1,58,83,29,4,1,0,29,5,114
62,464,2396,482,1914,50,1864,16,567,284,249,21,21,2,103,30,571
62,465,194,29,165,4,161,0,31,50,14,2,1,0,18,3,42
62,466,191,32,159,2,157,0,26,55,14,2,0,0,8,1,51
62,467,128,14,114,2,112,3,35,34,6,2,0,0,9,0,23
62,468,197,22,175,3,172,1,26,81,15,0,5,0,13,3,28
62,469,426,57,369,4,365,2,95,113,32,12,2,2,31,1,75
62,470,64,4,60,3,57,0,5,35,1,0,0,0,4,3,9
62,471,325,38,287,2,285,1,92,44,15,1,3,1,23,7,98
62,472,160,28,132,4,128,6,18,48,9,2,1,1,12,3,28
62,473,7460,1602,5858,129,5729,60,1273,778,811,82,70,14,286,82,2273
62,474,901,137,764,7,757,6,177,170,61,6,6,1,55,12,263
62,475,174,21,153,2,151,2,40,45,8,3,3,0,9,6,35
62,476,737,91,646,4,642,5,201,171,57,12,3,0,41,15,137
62,477,575,72,503,11,492,11,123,130,51,4,7,1,41,9,115
62,478,195,22,173,7,166,0,40,63,12,3,0,0,15,3,30
62,479,1287,186,1101,18,1083,8,321,203,127,14,9,3,78,12,308
62,480,1780,325,1455,31,1424,13,467,202,189,19,9,3,77,25,420
62,481,122,14,108,5,103,0,34,18,8,1,1,0,5,2,34
62,483,174,31,143,0,143,0,28,52,18,1,2,0,8,5,29
62,484,235,29,206,3,203,0,45,76,9,2,1,0,11,5,54
62,485,248,37,211,0,211,0,66,60,13,1,3,0,13,2,53
62,486,774,109,665,18,647,5,135,137,85,8,2,0,35,16,224
62,487,857,96,761,14,747,13,197,167,69,8,7,2,45,4,235
62,488,541,80,461,3,458,3,129,142,35,6,3,1,39,10,90
62,489,2744,572,2172,46,2126,18,604,381,254,30,17,4,132,31,655
62,490,186,20,166,6,160,4,35,59,17,0,0,1,18,2,24
62,491,3863,709,3154,51,3103,44,711,972,254,35,17,7,281,77,705
62,492,176,31,145,3,142,1,21,53,11,4,1,0,12,0,39
62,493,191,26,165,1,164,5,52,43,20,3,4,0,10,4,23
62,494,45,5,40,2,38,0,9,16,5,0,0,0,2,1,5
62,495,199,20,179,3,176,0,39,55,16,3,1,1,5,4,52
62,496,205,17,188,5,183,3,36,62,20,0,2,1,15,3,41
62,497,5189,1236,3953,80,3873,51,1158,557,526,46,29,6,181,60,1259
62,498,23995,6718,17277,354,16923,189,4540,2941,1972,208,134,30,785,220,5904
62,499,247,28,219,6,213,1,40,91,7,5,0,0,20,9,40
62,500,317,23,294,5,289,6,67,49,43,0,2,4,13,4,101
62,501,188,15,173,2,171,4,38,40,19,1,3,0,9,4,53
62,502,3256,542,2714,51,2663,52,607,766,206,23,25,14,259,62,649
62,503,241,30,211,5,206,4,40,63,21,4,2,0,33,1,38
62,504,169,15,154,2,152,1,39,47,13,1,2,0,5,4,40
62,505,311,34,277,2,275,3,67,76,17,4,2,0,21,5,80
62,506,1180,180,1000,15,985,6,292,330,49,10,8,1,85,13,191
62,507,233,34,199,6,193,2,54,51,15,3,0,0,13,5,50
62,508,290,31,259,6,253,3,60,57,37,3,3,0,12,4,74
62,509,201,21,180,1,179,4,43,56,17,2,2,1,11,1,42
62,510,22406,5649,16757,338,16419,182,4768,2047,1892,211,184,33,602,219,6281
62,511,124,22,102,2,100,2,26,32,10,2,0,0,7,0,21
62,512,458,62,396,3,393,4,95,115,47,7,3,1,24,6,91
62,513,167,21,146,5,141,1,44,35,15,0,1,0,12,5,28
62,514,190,27,163,3,160,2,42,46,5,1,2,2,18,7,35
62,515,458,62,396,10,386,3,85,60,33,10,7,0,34,8,146
62,516,6739,1177,5562,104,5458,75,1375,931,982,79,53,14,275,92,1582
62,517,187,24,163,0,163,1,38,34,21,3,1,0,15,2,48
62,518,117,11,106,1,105,5,16,48,15,0,0,0,10,0,11
62,519,498,59,439,4,435,1,133,140,29,5,4,1,29,8,85
62,520,1957,336,1621,26,1595,22,374,473,111,14,6,9,187,20,379
62,521,172,28,144,0,144,0,49,25,16,1,1,1,14,2,35
62,522,226,26,200,6,194,5,42,61,14,2,2,1,16,4,47
62,523,3940,888,3052,77,2975,27,928,456,367,39,26,4,99,53,976
62,524,1070,131,939,16,923,8,218,194,93,15,5,4,68,21,297
62,525,7709,1724,5985,107,5878,71,1401,1350,548,70,58,9,352,83,1936
62,526,96,15,81,6,75,0,27,29,3,0,1,1,3,3,8
62,527,194,25,169,3,166,0,49,74,3,4,3,0,6,4,23
62,528,5324,1101,4223,86,4137,92,1213,720,453,65,41,11,185,66,1291
62,529,1179,204,975,10,965,18,216,316,73,9,7,1,107,21,197
62,530,401,46,355,14,341,2,105,112,23,4,2,0,23,6,64
62,531,675,92,583,13,570,9,148,162,39,6,3,1,56,6,140
62,532,833,142,691,15,676,9,223,119,92,8,5,0,28,11,181
62,533,108,17,91,0,91,2,24,18,9,4,0,0,3,1,30
62,534,2821,454,2367,53,2314,34,499,387,199,36,19,2,128,51,959
62,535,146,20,126,3,123,3,20,43,11,1,0,0,12,3,30
62,536,516,85,431,7,424,4,115,136,40,4,2,1,25,9,88
62,537,87,15,72,3,69,1,25,17,5,0,0,0,5,1,15
62,538,318,56,262,4,258,3,55,65,26,4,5,1,19,3,77
62,539,187,22,165,7,158,1,46,57,13,2,1,0,10,6,22
62,540,1035,127,908,20,888,4,227,157,134,13,10,3,53,24,263
62,541,91,13,78,2,76,1,12,44,2,1,0,0,1,3,12
62,542,153,25,128,4,124,2,37,34,16,0,0,0,8,4,23
62,543,1431,185,1246,27,1219,13,294,261,123,19,10,1,93,34,371
62,544,151,16,135,3,132,0,31,36,12,0,3,0,17,1,32
62,545,107,4,103,2,101,2,23,46,3,0,0,0,2,2,23
62,546,272,30,242,1,241,4,38,89,11,4,0,0,31,9,55
62,547,69,8,61,4,57,1,14,14,4,1,0,1,7,2,13
62,548,7424,1454,5970,129,5841,52,1472,1198,660,81,40,6,374,112,1846
62,549,851,139,712,8,704,9,137,223,57,13,4,2,41,20,198
62,550,955,174,781,16,765,5,176,181,64,11,12,2,54,10,250
62,551,182,20,162,2,160,0,30,46,16,1,0,0,7,6,54
62,552,752,152,600,13,587,4,122,107,52,9,7,2,37,5,242
62,553,236,31,205,7,198,4,45,54,21,1,1,0,25,2,45
62,554,73,9,64,0,64,0,4,30,8,0,0,0,9,1,12
62,555,4138,1012,3126,75,3051,26,943,365,545,35,40,7,103,36,951
62,556,241,35,206,7,199,4,58,38,16,2,5,1,12,3,60
62,557,2143,281,1862,54,1808,40,358,512,143,25,11,3,161,41,514
62,558,148,14,134,1,133,0,36,46,12,3,0,0,7,1,28
62,559,807,136,671,14,657,6,158,176,41,15,2,1,67,22,169
62,560,3645,645,3000,61,2939,20,631,646,327,45,23,4,185,42,1016
62,561,169,25,144,2,142,1,35,64,8,0,3,0,9,1,21
62,562,149,15,134,4,130,0,47,25,11,2,0,0,9,1,35
62,563,5519,1518,4001,70,3931,51,1333,549,420,82,42,4,154,49,1247
62,564,334,37,297,2,295,4,74,48,29,6,4,0,28,3,99
62,565,67,10,57,0,57,0,12,11,2,0,2,0,9,1,20
62,566,534,75,459,11,448,3,116,102,42,5,3,1,41,12,123
62,567,449,73,376,8,368,10,118,92,19,6,2,0,24,10,87
62,568,492,61,431,9,422,4,95,126,35,4,3,0,51,7,97
62,569,437,70,367,17,350,6,90,93,23,3,3,1,19,12,100
62,570,8862,2264,6598,144,6454,67,1984,821,1433,88,48,18,241,88,1666
62,571,2589,414,2175,46,2129,26,433,723,179,22,18,4,188,44,492
62,572,495,85,410,4,406,2,127,88,37,9,4,0,17,10,112
62,573,2743,510,2233,38,2195,17,760,345,259,17,18,3,101,49,626
62,574,159,17,142,1,141,1,27,48,13,1,0,0,10,2,39
62,576,89,12,77,1,76,0,26,24,4,2,2,0,6,2,10
62,577,67,18,49,1,48,0,10,21,3,1,0,0,5,0,8
62,578,86,9,77,5,72,1,9,34,3,0,0,0,13,0,12
62,579,389,48,341,3,338,11,70,102,19,9,6,2,32,11,76
62,580,294,34,260,8,252,2,45,67,34,7,3,1,22,4,67
62,581,236,28,208,2,206,2,34,74,17,1,3,0,18,4,53
62,582,515,87,428,7,421,5,83,124,46,4,2,0,59,6,92
62,583,442,67,375,6,369,3,100,93,31,1,5,0,20,7,109
62,584,1130,197,933,21,912,14,260,217,86,8,10,1,77,24,215
62,585,289,45,244,6,238,2,31,102,12,3,1,0,21,5,61
62,586,366,41,325,8,317,1,69,83,28,5,2,0,44,11,74
62,587,6600,1555,5045,80,4965,46,1577,666,757,52,45,11,169,68,1574
62,588,1549,290,1259,27,1232,18,196,373,125,13,12,7,121,25,342
62,589,875,138,737,14,723,18,135,256,55,9,3,2,71,11,163
62,590,47,3,44,2,42,2,13,11,2,0,1,1,1,0,11
62,591,142,29,113,3,110,1,31,34,11,0,3,0,16,1,13
62,592,374,51,323,3,320,4,73,109,22,6,1,1,17,11,76
62,593,65,10,55,0,55,1,13,17,1,1,0,0,13,0,9
62,594,289,54,235,3,232,3,77,41,19,9,2,1,16,1,63
62,595,823,123,700,16,684,13,156,194,50,9,6,2,59,17,178
62,596,196,28,168,2,166,0,23,59,5,2,1,0,16,6,54
62,597,221,36,185,4,181,0,45,47,13,1,0,0,14,1,60
62,598,499,92,407,9,398,2,153,95,26,2,2,0,30,6,82
62,599,144,15,129,2,127,5,14,45,4,1,1,0,24,1,32
62,600,131,16,115,5,110,1,27,33,12,1,0,0,9,2,25
62,601,138,24,114,1,113,1,40,27,10,1,1,0,8,1,24
62,602,131,20,111,7,104,1,20,46,0,1,1,0,7,3,25
62,603,715,133,582,8,574,4,139,103,55,9,5,1,27,6,225
62,604,3248,546,2702,30,2672,33,463,1208,153,33,18,5,187,37,535
62,605,31,5,26,0,26,1,0,18,2,0,0,0,2,0,3
62,606,1014,149,865,18,847,7,225,238,63,8,5,3,83,23,192
62,607,59,9,50,1,49,1,10,20,2,2,0,0,1,1,12
62,608,137,19,118,1,117,1,32,36,6,1,2,0,9,1,29
62,609,1206,138,1068,11,1057,20,193,348,94,9,5,2,121,20,245
62,610,481,73,408,5,403,3,95,136,44,4,3,1,23,6,88
62,611,418,58,360,13,347,5,80,110,39,4,1,0,34,3,71
62,612,382,43,339,14,325,3,77,83,32,0,3,1,27,9,90
62,613,666,90,576,13,563,6,125,159,35,12,1,4,33,6,182
62,614,385,38,347,11,336,3,55,76,31,3,2,0,29,11,126
62,615,170,12,158,0,158,3,29,54,9,1,2,0,9,5,46
62,616,142,20,122,3,119,0,33,43,5,1,1,0,8,2,26
62,617,8767,2175,6592,142,6450,60,1784,1019,750,104,61,19,336,115,2202
62,618,662,111,551,6,545,2,169,151,48,8,5,0,39,10,113
62,619,107,8,99,2,97,0,27,28,8,1,2,0,5,1,25
62,620,1158,161,997,22,975,18,240,196,93,19,8,1,63,26,311
62,621,1140,127,1013,18,995,14,270,247,90,10,6,1,74,20,263
62,622,137,18,119,2,117,0,25,46,7,1,0,0,9,0,29
62,623,350,47,303,13,290,1,86,76,19,3,4,2,24,3,72
62,624,3907,917,2990,84,2906,24,937,513,389,25,25,7,180,43,763
62,625,42,7,35,1,34,0,8,16,0,0,0,0,6,0,4
62,626,1508,175,1333,27,1306,10,368,207,136,23,11,2,62,23,464
62,627,617,82,535,8,527,6,141,114,60,4,3,1,45,15,138
62,628,4860,1164,3696,69,3627,43,1117,550,473,68,36,5,144,42,1149
62,629,144,17,127,2,125,0,23,40,16,3,0,0,10,1,32
62,630,196,17,179,2,177,0,16,64,30,0,2,0,15,2,48
62,631,310,30,280,7,273,4,80,93,23,5,3,0,19,6,40
62,632,182,20,162,3,159,3,42,44,34,2,2,1,7,1,23
62,633,205,23,182,2,180,2,41,78,17,0,2,0,13,1,26
62,634,836,160,676,13,663,6,194,185,44,13,1,5,35,17,163
62,635,183,34,149,2,147,0,29,44,17,0,2,0,9,3,43
62,636,223,31,192,3,189,6,32,65,16,3,1,0,17,1,48
62,637,6977,1682,5295,86,5209,49,1533,888,595,44,53,11,235,80,1721
62,638,964,165,799,8,791,4,229,156,81,11,7,1,50,14,238
62,639,317,30,287,5,282,7,77,91,19,2,1,0,23,3,59
62,640,290,50,240,0,240,4,39,71,24,1,0,0,22,4,75
62,641,225,41,184,2,182,2,50,69,12,3,0,0,16,3,27
62,642,598,98,500,7,493,0,127,120,66,5,4,2,26,10,133
62,643,10904,2546,8358,145,8213,100,2166,1203,1044,125,71,20,378,124,2982
62,644,429,78,351,12,339,6,96,79,30,3,4,1,17,9,94
62,645,4374,773,3601,77,3524,33,1000,720,354,51,22,9,219,73,1043
62,646,461,57,404,9,395,4,122,91,43,2,4,0,33,3,93
62,647,539,66,473,16,457,5,103,102,49,3,8,1,36,23,127
62,648,352,48,304,8,296,1,58,96,18,4,2,1,21,6,89
62,649,640,84,556,12,544,6,113,96,44,10,1,0,38,4,232
62,650,557,70,487,11,476,7,108,114,64,3,8,0,38,10,124
62,651,308,48,260,9,251,2,64,85,19,5,4,0,21,3,48
62,652,1189,196,993,19,974,14,246,194,127,12,10,3,68,15,285
62,653,351,43,308,7,301,6,55,122,21,3,1,0,30,7,56
62,654,502,56,446,6,440,3,97,153,42,2,0,1,38,5,99
62,655,218,20,198,4,194,1,52,60,15,3,2,2,16,8,35
62,656,782,113,669,25,644,8,160,132,60,14,7,2,59,25,177
62,657,341,36,305,4,301,6,70,88,32,4,0,0,33,6,62
62,658,121,14,107,1,106,0,15,55,8,1,0,1,15,1,10
62,659,82,15,67,1,66,2,6,34,2,2,2,0,7,1,10
62,660,370,47,323,2,321,6,102,66,34,1,2,0,28,4,78
62,661,386,64,322,11,311,0,63,73,51,5,3,0,3,3,110
62,662,635,103,532,6,526,2,146,106,53,6,3,0,37,17,156
62,663,237,54,183,1,182,0,71,36,13,3,5,0,15,4,35
62,664,181,18,163,3,160,4,43,75,6,1,1,0,7,1,22
62,665,173,23,150,3,147,0,36,37,11,4,0,0,10,0,49
62,666,2418,603,1815,44,1771,15,590,247,268,16,21,3,51,26,534
62,667,7161,1876,5285,81,5204,43,1428,1036,582,77,50,11,294,70,1613
62,668,150,21,129,1,128,1,33,26,7,2,1,0,15,5,38
62,669,207,38,169,2,167,0,38,63,9,0,0,0,10,2,45
62,670,402,32,370,5,365,0,82,124,22,2,4,0,32,5,94
62,671,238,32,206,3,203,3,63,56,11,4,3,0,13,7,43
62,672,475,57,418,15,403,3,115,110,36,5,5,0,19,8,102
62,673,461,84,377,7,370,2,109,86,37,0,5,0,33,7,91
62,674,424,61,363,7,356,8,92,93,26,1,3,0,30,7,96
62,675,198,25,173,2,171,3,46,41,18,4,2,0,12,2,43
62,676,369,33,336,4,332,1,74,63,51,9,1,0,21,4,108
62,677,261,33,228,9,219,3,56,61,14,6,5,2,8,5,59
62,678,479,51,428,13,415,5,88,162,27,3,1,1,33,7,88
62,679,270,26,244,6,238,1,59,85,20,2,1,0,8,4,58
62,680,555,53,502,11,491,7,137,145,40,7,1,0,44,6,104
62,681,496,34,462,12,450,4,111,98,49,7,8,2,41,6,124
62,682,52,6,46,1,45,0,10,19,0,1,0,0,7,1,7
62,683,205,32,173,1,172,0,37,57,7,4,2,0,19,4,42
62,684,1842,331,1511,22,1489,16,401,269,149,29,23,1,111,33,457
62,685,158,12,146,5,141,1,47,39,5,1,1,1,11,1,34
62,686,251,32,219,3,216,3,43,59,17,2,4,0,24,4,60
62,688,3272,704,2568,54,2514,31,628,662,252,41,23,5,165,38,669
62,689,304,35,269,5,264,3,62,82,29,4,0,1,22,4,57
62,690,183,16,167,4,163,2,41,39,11,4,3,0,19,1,43
62,691,338,34,304,8,296,2,63,63,18,4,5,3,32,7,99
62,692,191,16,175,2,173,0,68,43,12,3,1,0,9,2,35
62,693,936,135,801,20,781,10,158,239,66,7,1,1,63,23,213
62,694,184,19,165,4,161,1,50,63,11,3,1,0,11,8,13
62,695,222,29,193,3,190,1,54,43,19,9,1,0,15,2,46
62,696,148,15,133,2,131,0,28,37,11,0,0,0,11,5,39
62,697,187,28,159,2,157,2,56,34,11,2,0,1,8,3,40
62,698,222,26,196,2,194,1,43,73,22,2,1,0,14,3,35
62,699,443,61,382,7,375,9,120,74,34,5,7,1,37,8,80
62,700,173,11,162,3,159,1,44,54,11,1,3,0,17,2,26
62,701,348,46,302,7,295,2,70,65,32,1,3,2,16,3,101
62,702,280,40,240,8,232,1,57,36,22,4,2,0,23,10,77
62,703,236,20,216,9,207,7,38,63,23,5,0,2,15,6,48
62,704,468,93,375,8,367,4,110,102,25,2,0,1,35,6,82
62,705,1410,200,1210,22,1188,13,336,229,105,21,10,2,66,29,377
62,706,1966,277,1689,21,1668,22,343,551,159,15,8,4,154,37,375
62,708,20,3,17,0,17,0,6,10,0,0,0,0,0,0,1
62,709,232,37,195,3,192,2,50,63,12,3,2,1,6,4,49
62,710,111,22,89,0,89,2,21,31,8,1,0,0,4,0,22
62,711,2201,337,1864,28,1836,11,465,262,189,17,22,4,92,20,754
62,712,940,116,824,19,805,13,152,263,81,3,4,0,61,13,215
62,713,1063,154,909,20,889,17,235,218,83,5,6,5,87,18,215
62,714,681,96,585,16,569,16,114,170,47,5,5,1,61,14,136
62,715,224,40,184,4,180,2,78,33,6,0,1,1,14,5,40
62,716,365,59,306,5,301,2,91,78,27,3,0,1,16,4,79
62,717,459,54,405,10,395,5,122,139,19,4,1,1,30,7,67
62,718,1107,154,953,17,936,9,275,194,133,20,10,3,60,22,210
62,719,197,20,177,5,172,4,36,51,16,2,2,0,8,3,50
62,720,36,6,30,0,30,0,7,9,3,0,0,0,5,0,6
62,721,1588,199,1389,37,1352,13,299,378,113,29,19,2,113,24,362
62,722,88,15,73,3,70,2,15,37,0,2,1,0,6,1,6
62,723,171,29,142,4,138,2,31,45,14,3,3,0,14,1,25
62,724,6910,1507,5403,133,5270,30,1804,667,1301,64,42,8,182,69,1103
62,725,113,12,101,0,101,1,23,34,5,2,4,0,10,1,21
62,726,130,15,115,2,113,5,13,32,16,0,0,1,10,0,36
62,727,1263,177,1086,17,1069,17,255,195,144,14,3,2,67,17,355
62,728,552,95,457,7,450,2,161,100,28,6,4,0,36,11,102
62,729,204,34,170,3,167,6,31,72,4,1,0,0,9,3,41
62,730,1049,172,877,22,855,6,234,228,86,15,6,2,39,13,226
62,731,235,33,202,3,199,2,63,45,10,3,5,0,13,5,53
62,732,233,26,207,4,203,3,46,55,23,1,1,1,16,5,52
62,733,212,28,184,4,180,2,45,44,18,3,5,1,25,2,35
62,734,527,59,468,11,457,4,118,135,57,4,1,0,35,10,93
62,735,1541,275,1266,22,1244,15,329,193,156,15,8,4,85,18,421
62,736,3223,515,2708,37,2671,33,563,788,233,22,16,8,245,48,715
62,737,4910,1262,3648,87,3561,24,1067,487,490,54,43,2,140,43,1211
62,738,125,9,116,0,116,0,19,36,11,0,0,0,9,6,35
62,739,260,30,230,10,220,2,67,68,12,1,1,0,16,10,43
62,740,198,25,173,9,164,4,36,58,14,1,0,0,12,4,35
62,741,115,11,104,1,103,3,26,44,2,0,0,0,8,1,19
62,742,215,33,182,2,180,1,23,79,9,3,0,1,24,6,34
62,743,328,40,288,8,280,3,35,83,25,8,2,2,29,7,86
62,744,2471,382,2089,28,2061,36,307,655,180,20,13,5,245,42,558
62,745,117,20,97,4,93,0,24,36,3,1,0,0,5,1,23
62,746,3835,776,3059,50,3009,55,643,482,664,37,26,7,158,55,882
62,747,369,31,338,6,332,4,68,81,47,4,0,0,41,9,78
62,748,1764,330,1434,22,1412,11,368,358,125,17,13,2,137,33,348
62,749,249,38,211,0,211,4,53,58,17,5,1,0,15,5,53
62,750,668,122,546,13,533,6,133,138,69,3,3,1,33,12,135
62,751,492,53,439,7,432,2,91,128,28,9,2,0,33,7,132
62,752,946,149,797,14,783,12,158,311,53,5,6,1,74,14,149
62,753,4716,899,3817,84,3733,62,797,781,446,45,45,6,302,55,1194
62,754,325,49,276,3,273,7,65,64,30,4,4,0,18,3,78
62,755,2900,532,2368,45,2323,27,493,490,300,23,12,6,153,43,776
62,756,1092,193,899,16,883,9,276,183,98,10,9,4,53,15,226
62,757,3245,702,2543,52,2491,34,480,631,194,30,21,6,185,55,855
62,758,8854,1799,7055,96,6959,126,1426,1598,742,81,54,16,492,124,2300
62,759,345,38,307,17,290,2,83,79,16,7,2,0,33,2,66
62,760,244,30,214,11,203,2,62,64,10,3,5,0,9,8,40
62,761,185,16,169,4,165,2,39,45,13,0,1,2,17,4,42
62,762,97,11,86,2,84,3,8,44,8,0,0,0,0,1,20
62,763,725,110,615,13,602,7,121,202,46,7,4,3,48,13,151
62,764,3471,773,2698,63,2635,66,549,566,272,36,19,6,211,32,878
62,765,9404,2329,7075,140,6935,133,1364,1968,586,81,62,16,584,103,2038
62,766,800,148,652,16,636,10,198,168,53,8,9,2,43,9,136
62,767,3555,743,2812,61,2751,44,629,745,318,31,22,7,177,34,744
62,768,86,14,72,0,72,1,21,19,4,1,0,1,8,0,17
62,769,557,75,482,7,475,8,110,129,36,5,2,1,44,5,135
62,770,2275,309,1966,40,1926,25,448,451,209,30,28,5,116,23,591
62,771,7326,2189,5137,89,5048,34,1477,524,1080,64,50,12,149,55,1603
62,772,394,46,348,6,342,6,100,107,38,0,1,0,23,4,63
62,773,2718,433,2285,28,2257,17,517,474,206,31,32,3,153,32,792
62,774,3541,662,2879,56,2823,36,611,677,323,34,15,8,194,39,886
62,775,195,17,178,6,172,1,63,61,9,2,1,0,13,7,15
62,776,135,27,108,1,107,0,28,29,15,1,3,0,7,1,23
62,777,136,30,106,1,105,0,40,18,17,0,2,0,11,3,14
62,778,65,6,59,4,55,0,15,16,1,0,0,0,10,1,12
62,779,136,15,121,1,120,1,37,30,3,2,0,0,9,5,33
62,780,286,49,237,4,233,4,77,24,35,1,2,2,13,1,74
62,781,338,70,268,5,263,2,86,70,23,3,1,0,13,3,62
62,782,354,44,310,5,305,0,85,77,20,3,5,0,18,8,89
62,783,238,39,199,3,196,4,42,35,13,2,2,0,12,2,84
62,784,531,73,458,8,450,3,156,117,31,1,3,0,24,5,110
62,785,716,94,622,15,607,14,142,162,66,6,6,1,54,12,144
62,786,246,28,218,8,210,2,53,85,11,5,2,0,14,1,37
62,787,218,31,187,2,185,2,34,68,15,8,3,1,11,3,40
62,788,505,60,445,7,438,3,96,97,33,8,6,0,39,12,144
62,789,193,28,165,3,162,0,40,56,7,2,0,0,13,5,39
62,790,148,8,140,2,138,1,22,52,6,1,0,0,6,1,49
62,791,40,4,36,0,36,0,5,10,6,1,2,0,3,0,9
62,792,883,121,762,17,745,7,180,189,59,12,9,2,61,22,204
62,793,770,73,697,22,675,9,156,162,69,6,7,3,62,12,189
62,794,457,49,408,8,400,3,110,97,23,7,7,0,19,6,128
62,795,95,10,85,0,85,1,23,24,9,0,0,0,8,0,20
62,796,431,40,391,9,382,3,77,139,28,6,1,1,31,10,86
62,797,221,30,191,3,188,2,47,54,23,1,1,0,16,3,41
62,798,181,18,163,7,156,2,49,60,9,3,3,0,8,2,20
62,799,506,71,435,8,427,8,95,131,33,6,4,1,35,10,104
62,800,289,43,246,4,242,0,78,39,20,7,1,0,15,3,79
62,801,2107,318,1789,23,1766,25,408,374,237,16,10,3,146,25,522
62,802,129,20,109,2,107,1,33,46,1,0,1,0,6,0,19
62,803,384,34,350,5,345,0,103,95,21,3,1,1,32,10,79
62,804,268,41,227,1,226,3,45,75,19,4,2,2,13,4,59
62,805,201,29,172,3,169,1,41,59,21,3,2,0,13,1,28
62,806,164,21,143,1,142,1,13,76,1,0,1,0,22,0,28
62,807,1395,181,1214,20,1194,12,245,322,86,14,7,2,117,19,370
62,808,195,18,177,5,172,1,57,41,9,6,0,1,11,1,45
62,809,106,14,92,1,91,0,19,39,8,0,1,1,8,3,12
62,810,990,138,852,16,836,11,177,232,80,6,8,2,80,17,223
62,811,880,122,758,15,743,5,167,221,60,9,4,3,51,15,208
62,812,587,69,518,17,501,2,137,159,37,8,3,1,25,5,124
62,813,359,65,294,2,292,2,70,76,30,2,0,0,25,4,83
62,814,84,7,77,1,76,1,8,20,6,2,2,0,3,3,31
62,815,145,13,132,1,131,2,36,43,4,1,0,0,13,2,30
62,816,169,22,147,4,143,1,28,23,19,2,2,0,19,5,44
62,817,1015,126,889,13,876,6,173,196,89,13,4,3,84,15,293
62,818,139,19,120,2,118,2,20,30,7,1,1,1,8,5,43
62,819,906,118,788,16,772,12,138,274,45,6,4,2,82,24,185
62,820,632,71,561,8,553,7,112,180,39,7,5,0,48,11,144
62,821,214,17,197,3,194,3,51,55,12,4,1,2,6,0,60
62,822,81,8,73,1,72,1,17,21,2,0,0,0,5,2,24
62,823,134,16,118,0,118,5,24,41,17,1,1,0,6,1,22
62,824,183,12,171,1,170,5,24,54,10,5,1,0,14,2,55
62,825,549,80,469,4,465,7,167,80,39,10,2,0,32,2,126
62,826,5293,1067,4226,37,4189,46,498,2533,150,26,13,7,348,50,518
62,827,1106,214,892,15,877,7,267,235,62,17,6,0,65,18,200
62,828,47,3,44,0,44,0,4,19,2,2,0,0,2,0,15
62,829,339,56,283,4,279,1,106,53,24,5,4,2,14,6,64
62,830,151,25,126,2,124,2,33,34,17,0,0,1,19,2,16
62,831,235,30,205,6,199,4,61,68,12,4,1,0,12,1,36
62,832,417,64,353,8,345,3,84,131,18,4,3,0,19,7,76
62,833,63,5,58,0,58,1,17,21,1,0,0,0,6,2,10
62,834,188,22,166,1,165,3,50,42,11,4,1,0,13,4,37
62,835,418,51,367,11,356,2,78,141,28,3,0,0,21,8,75
62,836,746,95,651,14,637,12,91,272,31,1,2,2,83,3,140
62,837,359,35,324,8,316,1,68,89,15,1,1,1,14,10,116
62,838,75,6,69,0,69,0,19,15,9,1,1,0,6,5,13
62,839,785,124,661,11,650,3,202,187,52,6,8,3,27,17,145
62,840,113,14,99,1,98,3,22,12,6,0,1,0,12,4,38
62,841,2097,464,1633,21,1612,25,405,283,226,23,12,5,102,18,513
62,842,5572,1179,4393,101,4292,34,1475,637,537,70,31,11,186,75,1236
62,843,209,25,184,4,180,2,37,88,7,0,1,1,18,3,23
62,844,467,62,405,7,398,3,94,131,25,2,6,0,45,5,87
62,845,310,45,265,7,258,4,65,83,14,2,3,1,22,7,57
62,846,3306,641,2665,54,2611,24,847,452,300,41,26,6,129,39,747
62,847,1301,171,1130,23,1107,10,319,232,131,15,7,3,66,10,314
62,848,2570,495,2075,41,2034,33,527,347,225,35,20,12,103,34,698
62,849,1813,250,1563,32,1531,31,357,470,125,14,11,0,110,34,379
62,850,301,39,262,7,255,5,36,103,17,3,0,1,15,4,71
62,851,601,113,488,12,476,2,96,131,47,5,2,1,53,16,123
62,852,963,130,833,21,812,15,247,178,85,3,11,2,42,15,214
62,853,279,24,255,4,251,4,61,80,23,0,5,0,11,7,60
62,854,375,33,342,13,329,8,61,83,21,3,1,0,33,9,110
62,855,193,35,158,2,156,1,49,43,11,1,4,0,16,5,26
62,856,252,23,229,7,222,2,52,54,14,2,4,1,12,1,80
62,857,102,16,86,0,86,3,13,24,5,0,0,0,21,2,18
62,858,193,19,174,2,172,0,42,63,11,1,0,0,18,4,33
62,859,192,18,174,1,173,0,42,57,3,5,1,3,12,4,46
62,860,99,9,90,3,87,0,15,32,11,0,2,0,7,2,18
62,861,3538,439,3099,147,2952,49,619,805,302,40,19,10,259,66,783
62,862,104,20,84,1,83,0,20,27,5,1,0,0,4,0,26
62,863,2942,572,2370,56,2314,36,640,478,197,45,16,2,163,31,706
62,864,445,54,391,10,381,2,109,120,34,2,5,0,27,10,72
62,865,3565,614,2951,60,2891,38,843,604,324,30,22,6,193,58,773
62,866,319,34,285,9,276,5,80,76,20,8,3,0,20,7,57
62,867,196,13,183,2,181,0,47,50,12,1,1,2,14,7,47
62,868,182,30,152,1,151,1,37,52,10,0,0,1,14,3,33
62,869,842,103,739,14,725,6,128,217,58,4,4,1,82,18,207
62,870,773,100,673,6,667,14,150,189,65,9,6,1,65,11,157
62,871,165,22,143,2,141,0,32,40,14,0,1,0,11,2,41
62,872,186,32,154,5,149,0,23,52,12,5,0,1,12,5,39
62,873,480,55,425,9,416,5,107,99,49,5,9,0,32,10,100
62,874,515,43,472,6,466,8,98,122,32,5,2,0,40,12,147
62,875,879,86,793,27,766,7,239,132,87,11,9,3,64,23,191
62,876,103,15,88,3,85,1,24,17,9,2,2,0,3,7,20
62,877,129,17,112,1,111,3,25,37,5,1,0,0,23,3,14
62,878,341,64,277,12,265,2,37,101,20,2,3,0,36,1,63
62,879,201,36,165,6,159,0,45,34,5,3,1,0,10,4,57
62,880,151,21,130,1,129,3,26,48,13,1,0,0,8,7,23
62,881,298,43,255,7,248,5,46,92,10,1,5,0,31,1,57
62,882,973,107,866,18,848,7,242,159,59,16,6,1,48,15,295
62,883,139,13,126,0,126,2,35,51,9,0,0,0,10,6,13
62,885,181,20,161,6,155,2,36,53,18,1,1,0,14,0,30
62,886,170,19,151,3,148,1,29,48,4,1,2,1,11,0,51
62,887,224,34,190,6,184,1,43,66,10,1,2,0,10,0,51
62,888,197,36,161,1,160,0,32,52,10,1,1,0,16,1,47
62,889,648,94,554,6,548,14,116,186,34,9,5,0,57,18,109
62,890,142,15,127,2,125,0,18,64,5,0,1,0,17,1,19
62,891,111,12,99,2,97,0,21,17,13,2,1,0,6,3,34
62,892,505,68,437,7,430,5,95,122,54,6,3,1,23,10,111
62,893,5902,1278,4624,63,4561,81,954,1263,467,44,26,14,351,76,1285
62,894,3335,620,2715,38,2677,43,618,643,264,29,29,9,187,42,813
62,895,6172,1467,4705,87,4618,38,1488,618,631,74,52,16,167,60,1474
62,896,586,61,525,15,510,8,115,197,26,3,1,0,50,13,97
62,897,429,43,386,5,381,3,100,117,18,3,2,0,26,15,97
62,898,207,22,185,0,185,4,27,86,17,0,3,0,18,6,24
62,899,983,151,832,13,819,20,169,289,49,6,2,2,76,15,191
62,900,456,82,374,9,365,2,71,70,54,9,5,0,27,6,121
62,901,677,101,576,12,564,1,164,121,49,8,5,1,37,16,162
62,902,2451,331,2120,31,2089,17,521,392,195,30,26,15,133,42,718
62,903,410,37,373,17,356,3,101,98,28,6,6,3,24,5,82
62,904,399,62,337,5,332,3,103,87,24,1,3,2,28,11,70
62,905,621,61,560,14,546,15,101,151,49,6,1,1,74,11,137
62,906,1360,251,1109,23,1086,7,287,270,103,14,15,3,83,23,281
62,907,5679,1347,4332,82,4250,47,1101,661,575,73,28,11,187,60,1507
62,908,1242,172,1070,10,1060,22,158,375,90,8,7,5,114,15,266
62,909,314,58,256,1,255,1,98,66,16,3,1,0,9,4,57
63,1,1533,237,1296,54,1242,15,251,292,157,31,11,3,104,23,355
63,2,108,25,83,2,81,1,11,23,7,2,0,0,14,2,21
63,3,5008,913,4095,92,4003,54,711,937,616,42,35,5,504,69,1030
63,4,1326,200,1126,25,1101,15,158,165,250,23,9,3,83,21,374
63,5,305,52,253,5,248,2,48,48,29,3,1,0,27,9,81
63,6,233,61,172,3,169,0,39,41,17,0,0,1,10,3,58
63,7,201,37,164,7,157,2,18,35,24,7,5,0,17,4,45
63,8,525,80,445,12,433,3,107,116,51,6,1,1,47,5,96
63,9,449,100,349,12,337,13,50,71,53,2,2,0,26,14,106
63,10,1379,257,1122,25,1097,15,278,251,115,20,14,3,111,18,272
63,11,187,31,156,5,151,2,15,50,18,7,3,0,13,1,42
63,12,624,53,571,10,561,6,80,179,68,17,3,0,42,9,157
63,13,705,84,621,17,604,14,108,138,69,4,2,0,59,12,198
63,14,6468,1249,5219,109,5110,128,641,1167,646,46,23,15,635,85,1724
63,15,206,32,174,3,171,3,32,39,30,2,1,1,19,0,44
63,16,771,129,642,18,624,11,109,124,107,6,2,2,55,7,201
63,17,126,14,112,3,109,3,11,25,17,5,1,1,8,6,32
63,18,335,40,295,3,292,3,57,64,40,6,1,3,23,9,86
63,19,2826,505,2321,51,2270,25,417,346,344,38,22,7,147,36,888
63,20,231,28,203,8,195,6,36,53,15,2,2,0,31,1,49
63,21,484,39,445,8,437,14,66,88,69,3,2,2,38,7,148
63,22,1787,368,1419,21,1398,22,273,152,290,28,10,3,67,30,523
63,23,325,59,266,5,261,8,53,51,54,5,1,0,27,6,56
63,24,205,26,179,2,177,6,24,49,18,1,1,1,27,3,47
63,25,143,13,130,2,128,3,17,33,14,1,1,0,8,0,51
63,26,1858,238,1620,23,1597,73,239,303,223,19,6,2,187,29,516
63,27,139,32,107,0,107,1,24,23,10,0,2,0,15,2,30
63,28,463,71,392,10,382,5,49,110,23,1,1,0,33,8,152
63,29,199,21,178,6,172,1,35,9,49,4,1,1,9,7,56
63,30,204,22,182,5,177,6,40,32,20,0,0,0,12,2,65
63,31,344,64,280,5,275,2,56,33,48,3,2,2,21,2,106
63,32,8539,1778,6761,133,6628,187,687,1518,870,64,33,23,798,112,2336
63,33,230,36,194,4,190,5,45,28,29,2,2,1,13,12,53
63,34,954,123,831,28,803,16,147,165,100,11,5,5,76,20,258
63,35,745,83,662,10,652,4,114,131,91,8,7,3,82,12,200
63,36,306,47,259,10,249,5,40,51,37,2,1,0,32,6,75
63,37,409,71,338,8,330,10,71,72,59,2,6,2,35,3,70
63,38,1473,287,1186,38,1148,21,198,369,119,19,8,5,100,19,290
63,39,276,38,238,4,234,8,59,38,31,4,4,0,19,4,67
63,40,3037,418,2619,45,2574,48,388,459,469,37,17,7,224,45,880
63,41,254,42,212,4,208,4,20,22,53,4,1,1,26,2,75
63,42,2898,485,2413,42,2371,30,291,513,361,29,12,5,236,47,847
63,43,357,81,276,3,273,9,37,48,59,4,4,2,33,6,71
63,44,300,42,258,3,255,9,39,34,51,4,1,0,23,7,87
63,45,428,38,390,6,384,3,76,66,77,5,1,0,29,5,122
63,46,223,31,192,1,191,4,28,43,37,3,1,2,18,5,50
63,47,1502,283,1219,26,1193,23,162,333,139,17,9,3,129,18,360
63,48,768,120,648,10,638,6,100,119,104,11,6,1,51,6,234
63,49,558,63,495,23,472,12,92,74,72,4,4,2,63,8,141
63,50,2557,493,2064,37,2027,26,342,350,324,40,15,10,131,24,765
63,51,496,59,437,10,427,9,83,66,54,6,3,2,32,9,163
63,52,776,104,672,13,659,12,106,123,117,19,5,2,50,13,212
63,53,300,54,246,10,236,3,53,48,36,2,4,0,30,6,54
63,54,512,66,446,9,437,6,77,92,52,3,5,0,44,12,146
63,55,801,129,672,16,656,7,120,140,92,3,4,1,71,15,203
63,56,302,61,241,10,231,9,46,34,63,3,3,2,11,2,58
63,57,282,60,222,3,219,5,37,50,48,3,0,0,16,2,58
63,58,370,42,328,8,320,2,55,66,43,10,3,0,26,4,111
63,59,174,22,152,4,148,5,11,24,32,2,0,1,17,4,52
63,60,112,19,93,0,93,1,10,17,19,1,0,1,12,4,28
63,61,302,57,245,13,232,4,43,41,36,3,0,0,36,4,65
63,62,172,18,154,5,149,5,20,23,32,2,0,0,11,4,52
63,63,5797,1114,4683,85,4598,72,645,1030,542,62,21,10,422,85,1709
63,64,91,20,71,2,69,2,7,15,8,0,0,0,13,0,24
63,65,151,16,135,3,132,5,13,29,27,2,1,1,9,2,43
63,66,1380,260,1120,20,1100,13,210,234,159,15,13,4,106,15,331
63,67,144,9,135,3,132,3,22,33,12,1,0,0,20,4,37
63,68,721,78,643,13,630,8,125,128,76,10,2,2,62,10,207
63,69,3732,548,3184,78,3106,68,486,659,428,41,12,9,277,57,1069
63,70,4726,755,3971,66,3905,91,423,1020,451,36,11,4,502,67,1300
63,71,513,46,467,11,456,16,94,95,64,2,0,1,56,5,123
63,72,1057,200,857,19,838,1,207,109,139,10,8,2,47,21,294
63,73,326,40,286,7,279,7,33,53,49,6,1,2,15,4,109
63,74,142,17,125,3,122,1,21,11,19,2,3,0,16,4,45
63,75,12278,1954,10324,194,10130,236,950,3849,786,71,14,24,1315,169,2716
63,76,173,40,133,2,131,2,24,30,18,1,1,0,16,2,37
63,77,402,72,330,4,326,5,56,94,47,3,1,2,35,8,75
63,78,156,18,138,2,136,3,18,45,7,3,1,0,16,5,38
63,79,124,13,111,1,110,1,12,36,12,1,1,0,12,0,35
63,80,982,149,833,17,816,38,131,135,135,6,4,1,75,17,274
63,81,214,35,179,4,175,5,37,29,38,2,3,0,18,3,40
63,82,308,38,270,7,263,7,24,58,33,1,2,0,28,2,108
63,83,720,87,633,16,617,14,99,125,67,8,1,6,64,13,220
63,84,1379,138,1241,21,1220,41,121,261,158,16,7,1,162,21,432
63,85,938,141,797,30,767,9,134,113,140,9,6,2,96,13,245
63,86,347,47,300,13,287,4,66,54,56,6,3,3,22,9,64
63,87,76,14,62,1,61,0,15,17,5,1,0,0,11,1,11
63,88,77,22,55,2,53,0,11,13,13,0,0,0,6,3,7
63,89,1167,129,1038,13,1025,9,215,184,129,12,8,3,107,21,337
63,90,360,47,313,9,304,7,46,74,40,1,1,1,32,3,99
63,91,657,90,567,19,548,6,84,85,78,5,5,1,24,4,256
63,92,1265,184,1081,30,1051,33,184,170,177,21,8,10,102,24,322
63,93,799,95,704,19,685,18,134,136,112,10,6,0,65,16,188
63,94,451,73,378,18,360,8,68,82,43,4,6,0,53,9,87
63,95,163,21,142,3,139,1,22,25,31,4,5,0,9,5,37
63,96,293,35,258,10,248,4,38,44,48,4,3,2,33,7,65
63,97,93,9,84,1,83,3,20,21,5,1,1,0,11,2,19
63,98,297,70,227,5,222,9,26,77,19,2,1,0,23,4,61
63,99,2397,313,2084,32,2052,37,301,512,256,22,16,3,202,41,662
63,100,274,34,240,2,238,6,35,53,53,3,0,1,13,2,72
63,101,86,13,73,0,73,3,15,16,13,0,2,0,6,2,16
63,102,668,91,577,21,556,13,91,107,141,4,3,1,37,8,151
63,103,4638,675,3963,92,3871,77,568,1145,416,50,14,7,449,76,1069
63,104,152,23,129,3,126,2,27,37,4,1,1,0,11,5,38
63,105,176,24,152,6,146,0,40,31,18,6,0,1,21,1,28
63,106,1165,133,1032,22,1010,16,153,142,162,14,9,2,121,15,376
63,107,326,36,290,4,286,7,33,60,38,4,2,1,32,8,101
63,108,480,46,434,15,419,7,63,96,54,12,1,0,37,10,139
63,109,323,23,300,7,293,11,52,52,33,7,2,3,37,14,82
63,110,392,61,331,11,320,3,65,59,36,4,1,1,34,5,112
63,111,80,4,76,0,76,1,12,10,21,0,0,2,4,2,24
63,112,338,37,301,7,294,5,54,74,33,2,1,0,30,4,91
63,113,70290,13737,56553,1015,55538,1510,6865,11047,7990,642,319,131,5241,805,20988
63,114,136,10,126,2,124,2,30,26,12,4,0,1,17,2,30
63,115,193,36,157,5,152,1,28,18,25,0,1,0,10,3,66
63,116,1557,288,1269,26,1243,23,226,232,210,13,9,5,121,23,381
63,117,153,53,100,3,97,2,19,31,3,3,1,0,17,1,20
63,118,462,101,361,15,346,1,42,84,46,4,2,1,57,5,104
63,119,206,34,172,4,168,4,35,27,26,5,1,0,11,2,57
63,120,529,78,451,6,445,15,75,89,52,6,1,0,33,17,157
63,121,858,97,761,9,752,8,111,113,122,7,9,2,58,15,307
63,122,80,11,69,0,69,5,9,6,21,2,2,0,7,1,16
63,123,191,27,164,1,163,6,12,75,16,2,1,0,20,3,28
63,124,13387,1698,11689,231,11458,189,1649,2380,1532,121,73,26,1127,180,4181
63,125,3257,503,2754,59,2695,43,470,555,465,29,16,7,219,58,833
63,126,966,109,857,19,838,20,101,170,118,6,7,0,107,18,291
63,127,57,15,42,2,40,2,5,7,3,2,1,0,7,2,11
63,128,726,98,628,17,611,13,140,117,94,6,11,2,57,7,164
63,129,177,32,145,3,142,5,19,45,15,0,2,0,12,1,43
63,130,267,35,232,11,221,1,46,51,29,3,0,2,23,3,63
63,131,723,111,612,17,595,7,136,102,75,8,6,1,47,15,198
63,132,961,152,809,19,790,19,104,149,198,8,3,1,83,14,211
63,133,955,102,853,16,837,13,133,203,85,10,11,2,96,18,266
63,134,77,10,67,2,65,1,19,17,7,0,0,0,4,1,16
63,135,400,43,357,10,347,3,48,78,38,6,6,1,37,8,122
63,136,308,36,272,8,264,15,40,45,49,3,1,2,27,6,76
63,137,187,40,147,3,144,2,22,27,31,1,3,0,14,1,43
63,138,513,65,448,12,436,3,105,75,75,12,2,0,35,9,120
63,139,612,108,504,18,486,6,126,91,74,7,3,2,45,15,117
63,140,194,33,161,5,156,2,38,25,34,1,2,0,9,6,39
63,141,1519,197,1322,25,1297,31,175,334,102,17,4,1,153,27,453
63,142,223,30,193,5,188,6,35,46,39,0,1,0,13,1,47
63,143,765,93,672,13,659,14,144,143,60,5,7,0,72,21,193
63,144,431,94,337,11,326,8,65,103,26,5,2,2,25,3,87
63,145,145,29,116,1,115,3,16,25,25,2,0,1,8,3,32
63,146,682,87,595,19,576,16,94,90,121,7,3,1,52,8,184
63,147,275,39,236,7,229,3,44,84,24,0,0,0,17,5,52
63,148,1620,196,1424,41,1383,25,224,285,184,16,12,7,127,38,465
63,149,540,55,485,7,478,4,63,109,61,5,6,3,44,4,179
63,150,1005,78,927,22,905,19,103,178,151,12,4,4,118,12,304
63,151,1083,145,938,21,917,15,196,167,147,17,3,2,83,18,269
63,152,289,60,229,11,218,8,31,41,28,4,4,0,28,9,65
63,153,131,43,88,3,85,3,17,26,8,2,3,0,6,1,19
63,154,272,46,226,13,213,7,34,39,31,3,2,0,30,4,63
63,155,313,27,286,2,284,9,62,61,55,3,4,0,19,5,66
63,156,72,12,60,0,60,2,4,5,17,0,1,0,5,2,24
63,157,284,33,251,12,239,14,44,56,42,1,0,3,18,4,57
63,158,120,31,89,2,87,4,17,18,14,0,1,2,8,0,23
63,159,135,18,117,6,111,1,23,39,6,2,0,0,9,4,27
63,160,400,41,359,7,352,3,54,63,48,5,2,1,42,4,130
63,161,282,48,234,7,227,1,45,34,29,5,6,1,22,3,81
63,162,328,52,276,2,274,5,38,66,39,7,5,0,31,4,79
63,163,775,126,649,18,631,6,118,164,51,10,4,3,96,12,167
63,164,6821,1233,5588,155,5433,91,1055,953,710,69,45,17,424,77,1992
63,165,739,150,589,19,570,4,78,135,71,4,5,2,72,14,185
63,166,201,27,174,5,169,3,21,32,25,3,0,1,15,3,66
63,167,353,44,309,5,304,7,43,50,48,4,2,1,28,0,121
63,168,449,64,385,7,378,15,69,57,79,6,1,3,39,6,103
63,169,36,5,31,1,30,0,2,12,3,0,1,0,6,5,1
63,170,534,85,449,6,443,2,75,117,55,7,4,2,38,2,141
63,171,324,56,268,9,259,2,50,33,60,6,0,0,24,3,81
63,172,51,14,37,0,37,0,7,6,2,0,0,2,1,2,17
63,173,189,45,144,7,137,1,23,23,30,1,4,1,15,1,38
63,174,129,25,104,2,102,0,17,15,20,6,1,0,6,3,34
63,175,237,25,212,6,206,1,31,55,21,4,5,1,24,6,58
63,176,108,20,88,1,87,2,10,18,8,2,0,0,8,3,36
63,177,316,55,261,6,255,12,38,41,41,3,2,2,19,6,91
63,178,9894,1762,8132,163,7969,150,1276,1862,973,99,55,26,740,148,2640
63,179,789,124,665,23,642,9,173,114,96,5,8,1,69,11,156
63,180,829,100,729,14,715,6,165,203,73,8,5,1,56,14,184
63,181,346,32,314,10,304,9,51,72,32,4,1,1,36,12,86
63,182,485,61,424,11,413,0,96,48,66,2,4,1,24,6,166
63,183,85,19,66,2,64,1,8,22,6,0,0,0,8,1,18
63,184,269,30,239,9,230,3,29,42,56,1,4,0,23,2,70
63,185,471,67,404,5,399,4,93,49,64,8,0,0,24,6,151
63,186,192,17,175,8,167,1,20,53,26,2,1,0,16,1,47
63,187,487,62,425,10,415,4,72,63,100,6,4,3,28,5,130
63,188,436,60,376,7,369,14,56,80,67,3,0,0,28,4,117
63,189,304,48,256,10,246,2,41,73,23,4,1,1,49,9,43
63,190,301,69,232,8,224,5,19,53,41,2,0,0,31,5,68
63,191,120,21,99,2,97,1,24,17,11,1,1,0,11,4,27
63,192,596,91,505,12,493,10,55,106,67,0,3,2,59,9,182
63,193,6334,1038,5296,119,5177,90,891,964,713,69,43,5,549,72,1781
63,194,249,37,212,4,208,4,44,29,38,0,0,0,27,9,57
63,195,3802,642,3160,76,3084,46,635,674,375,34,13,13,279,60,955
63,196,509,77,432,10,422,5,97,52,90,5,4,0,33,9,127
63,197,95,11,84,1,83,1,12,9,14,2,1,1,4,2,37
63,198,896,121,775,17,758,17,141,122,132,13,4,2,97,9,221
63,199,338,41,297,4,293,2,62,46,45,6,0,0,46,2,84
63,200,623,73,550,14,536,3,103,132,69,1,4,1,52,10,161
63,201,712,112,600,9,591,5,160,115,96,11,3,0,60,15,126
63,202,106,9,97,2,95,2,8,19,9,2,1,1,15,3,35
63,203,789,60,729,7,722,15,90,181,102,11,1,0,66,9,247
63,204,732,99,633,17,616,2,138,119,103,5,0,1,58,4,186
63,205,354,51,303,3,300,9,47,61,65,4,0,3,24,8,79
63,206,1039,144,895,19,876,15,136,160,158,12,5,6,92,16,276
63,207,729,124,605,23,582,9,119,96,100,8,3,5,57,19,166
63,208,229,43,186,5,181,5,34,36,25,1,1,1,24,5,49
63,209,164,15,149,4,145,0,21,37,15,5,1,1,13,2,50
63,210,1898,389,1509,44,1465,25,309,316,197,13,15,5,125,20,440
63,211,1131,212,919,28,891,13,189,176,148,9,8,7,118,24,199
63,212,908,104,804,17,787,24,104,278,62,4,9,1,98,9,198
63,213,1394,123,1271,24,1247,17,246,312,139,15,7,0,117,22,372
63,214,3019,483,2536,60,2476,38,370,418,379,38,18,13,252,46,904
63,215,459,49,410,13,397,5,76,89,71,3,2,1,32,8,110
63,216,85,7,78,1,77,3,11,13,12,0,0,0,6,0,32
63,218,158,32,126,2,124,4,31,36,11,1,1,1,12,3,24
63,219,537,64,473,13,460,12,70,80,74,8,4,2,54,7,149
63,220,122,28,94,3,91,0,23,28,8,1,1,0,8,5,17
63,221,131,21,110,1,109,8,13,34,9,1,1,0,17,0,26
63,222,365,56,309,4,305,2,64,66,48,9,0,3,14,8,91
63,223,508,81,427,9,418,7,77,79,73,7,5,1,35,8,126
63,224,1316,164,1152,23,1129,14,244,209,154,17,9,3,104,19,356
63,225,1065,212,853,18,835,8,110,136,113,12,10,2,50,9,385
63,226,1385,143,1242,29,1213,21,173,229,187,11,4,2,159,21,406
63,227,1728,196,1532,26,1506,36,205,347,251,15,10,6,129,22,485
63,228,319,39,280,8,272,6,60,50,36,4,2,1,31,5,77
63,229,836,100,736,23,713,19,120,119,137,8,8,1,66,17,218
63,230,207,36,171,2,169,2,25,34,31,7,2,1,22,2,43
63,231,1190,256,934,27,907,5,173,160,137,17,6,2,79,14,314
63,232,372,48,324,8,316,2,80,64,45,4,4,1,20,6,90
63,233,807,148,659,14,645,3,90,119,86,7,6,1,44,20,269
63,234,636,96,540,14,526,17,96,92,105,8,6,1,51,4,146
63,235,351,45,306,8,298,12,23,48,59,4,3,1,20,7,121
63,236,1222,243,979,22,957,21,178,331,91,16,5,1,91,13,210
63,237,431,69,362,4,358,7,70,118,33,7,4,2,39,2,76
63,238,189,24,165,7,158,4,32,31,20,1,2,0,15,3,50
63,239,533,69,464,11,453,4,52,87,84,3,2,3,44,7,167
63,240,339,44,295,6,289,3,49,73,34,4,2,0,36,8,80
63,241,296,19,277,6,271,10,46,85,23,5,3,0,24,7,68
63,242,315,54,261,0,261,0,52,32,53,1,1,0,21,5,96
63,243,235,30,205,6,199,6,49,53,29,3,1,1,20,3,34
63,244,376,52,324,13,311,6,58,59,38,11,1,0,38,7,93
63,245,2753,327,2426,49,2377,58,308,546,272,18,11,2,288,57,817
63,246,424,56,368,6,362,5,51,61,49,12,2,2,35,7,138
63,247,490,73,417,9,408,4,83,114,47,4,1,2,57,9,87
63,248,588,45,543,9,534,8,69,127,66,10,1,1,72,12,168
63,249,379,48,331,6,325,4,56,67,82,2,1,1,20,6,86
63,250,663,121,542,13,529,10,81,74,121,8,2,1,34,8,190
63,251,269,26,243,2,241,0,24,21,91,4,2,2,6,4,87
63,252,315,40,275,3,272,6,56,52,42,2,2,1,20,5,86
63,253,169,22,147,2,145,0,36,21,27,6,1,0,9,4,41
63,254,1589,193,1396,27,1369,31,190,284,210,18,7,5,129,29,466
63,255,240,40,200,6,194,6,31,28,25,4,1,0,20,3,76
63,256,140,28,112,1,111,3,29,26,5,1,3,0,13,3,28
63,257,566,61,505,10,495,11,89,89,67,8,3,1,36,4,187
63,258,643,100,543,16,527,10,99,136,70,5,3,1,38,11,154
63,259,232,22,210,2,208,7,27,43,27,4,0,0,26,4,70
63,260,160,30,130,3,127,6,19,17,24,1,0,0,6,2,52
63,261,688,76,612,15,597,21,75,115,79,8,2,2,61,10,224
63,262,2118,260,1858,58,1800,44,264,356,244,18,10,2,201,33,628
63,263,2690,297,2393,39,2354,59,267,697,254,31,8,4,289,49,696
63,264,200,25,175,6,169,5,35,46,24,3,0,0,19,5,32
63,265,1659,253,1406,39,1367,18,292,352,150,23,7,3,142,28,352
63,266,187,37,150,4,146,2,29,30,18,3,2,0,10,6,46
63,267,435,50,385,5,380,6,98,78,48,6,3,1,39,9,92
63,268,196,24,172,2,170,0,25,38,29,0,1,1,12,3,61
63,269,623,77,546,4,542,14,61,85,84,6,7,3,75,8,199
63,270,414,48,366,13,353,5,50,78,43,4,3,1,34,13,122
63,271,1169,154,1015,19,996,11,186,137,221,12,6,2,82,12,327
63,272,2146,300,1846,42,1804,36,207,547,202,17,3,2,225,35,530
63,273,1241,146,1095,24,1071,25,173,192,163,14,7,5,96,16,380
63,274,334,56,278,15,263,1,34,62,20,2,2,0,53,5,84
63,275,662,82,580,9,571,9,87,130,84,7,4,3,65,8,174
63,276,1756,264,1492,41,1451,16,288,294,215,17,11,4,103,34,469
63,277,72,8,64,2,62,4,9,13,9,0,0,2,8,0,17
63,278,411,44,367,9,358,8,63,100,36,3,2,0,23,10,113
63,279,360,79,281,7,274,6,49,61,29,6,3,0,24,8,88
63,280,236,19,217,2,215,6,25,31,49,4,3,1,17,5,74
63,281,725,156,569,10,559,8,97,108,73,5,4,0,71,14,179
63,282,1079,161,918,17,901,12,130,157,166,5,12,0,96,21,302
63,283,514,85,429,9,420,2,72,119,68,3,1,0,42,4,109
63,284,7460,1116,6344,146,6198,74,1125,1472,746,78,32,21,554,112,1984
63,285,514,87,427,10,417,6,55,97,64,12,2,1,38,9,133
63,286,222,29,193,7,186,4,37,31,31,4,0,1,27,3,48
63,287,238,32,206,5,201,4,26,39,30,6,1,0,22,1,72
63,288,339,33,306,5,301,5,41,66,44,10,0,0,29,9,97
63,289,278,49,229,11,218,6,34,28,32,5,4,0,28,4,77
63,290,332,49,283,5,278,3,49,46,42,3,3,0,20,6,106
63,291,2020,338,1682,53,1629,17,299,303,267,22,18,3,156,36,508
63,292,141,30,111,4,107,3,21,20,5,2,2,0,18,3,33
63,293,206,44,162,4,158,0,25,25,31,2,4,0,16,5,50
63,294,220,29,191,4,187,3,32,30,39,6,4,1,19,4,49
63,295,1019,162,857,26,831,8,225,157,88,8,3,0,76,12,254
63,296,558,89,469,10,459,8,79,78,101,11,5,4,24,8,141
63,297,278,34,244,3,241,2,40,42,45,3,1,2,23,6,77
63,298,132,27,105,6,99,3,18,7,30,0,0,0,8,3,30
63,299,108,11,97,3,94,0,18,26,8,0,1,0,17,0,24
63,300,11414,1792,9622,206,9416,253,1248,2009,1282,112,60,20,969,170,3293
63,301,587,82,505,21,484,5,113,88,79,9,3,1,29,12,145
63,302,2390,239,2151,33,2118,56,237,457,243,20,15,5,279,32,774
63,303,68,27,41,0,41,0,8,19,2,0,0,0,2,1,9
63,304,86,10,76,0,76,0,15,14,14,0,3,0,9,1,20
63,305,606,72,534,6,528,16,60,126,56,7,4,2,60,11,186
63,306,502,31,471,14,457,7,67,92,54,6,3,2,55,14,157
63,307,6008,838,5170,88,5082,130,587,1095,635,53,16,23,558,97,1888
63,308,3360,536,2824,57,2767,65,291,881,250,23,9,5,347,58,838
63,309,300,48,252,6,246,4,60,62,27,1,2,0,29,3,58
63,310,193,39,154,7,147,6,23,26,24,0,0,1,14,4,49
63,311,248,16,232,4,228,4,52,36,25,4,0,1,33,6,67
63,312,222,56,166,2,164,3,44,30,17,2,3,0,12,2,51
63,313,172,41,131,0,131,1,28,42,13,0,0,0,19,3,25
63,314,438,75,363,7,356,12,55,54,103,3,5,1,41,2,80
63,315,1223,134,1089,29,1060,34,124,218,116,13,9,6,116,17,407
63,317,417,53,364,14,350,3,63,71,52,3,2,2,18,10,126
63,318,358,53,305,13,292,5,36,37,60,8,2,1,18,2,123
63,319,823,173,650,11,639,9,117,193,63,5,0,1,74,22,155
63,320,228,40,188,7,181,4,40,59,10,0,1,0,20,2,45
63,321,716,101,615,12,603,8,118,103,76,17,5,0,54,10,212
63,322,1578,175,1403,31,1372,20,243,289,151,13,5,0,157,25,469
63,323,181,40,141,4,137,0,31,29,18,0,5,0,13,1,40
63,324,245,53,192,13,179,4,36,43,25,5,0,1,30,2,33
63,325,306,30,276,7,269,6,53,35,62,6,2,0,16,7,82
63,326,382,44,338,6,332,12,45,92,32,2,2,0,53,2,92
63,327,1454,157,1297,21,1276,32,189,261,163,13,8,3,150,19,438
63,328,87,20,67,3,64,1,15,13,8,1,0,0,10,0,16
63,329,138,13,125,2,123,7,13,16,21,2,0,0,8,4,52
63,330,274,42,232,11,221,3,49,44,35,1,2,1,21,2,63
63,331,246,45,201,6,195,3,53,48,22,2,1,0,22,1,43
63,332,458,64,394,15,379,5,86,109,52,9,1,0,32,3,82
63,333,194,35,159,1,158,1,33,26,23,3,0,0,38,3,31
63,334,482,59,423,13,410,12,84,69,91,5,4,0,42,2,101
63,335,336,70,266,2,264,10,48,61,39,4,5,1,22,2,72
63,336,256,67,189,12,177,3,23,50,23,2,2,1,16,9,48
63,337,72,10,62,1,61,1,6,5,10,0,1,1,7,0,30
63,338,3090,690,2400,56,2344,22,482,510,335,45,26,5,142,37,740
63,339,132,23,109,6,103,1,20,15,10,2,1,0,16,0,38
63,340,252,29,223,4,219,3,31,46,34,2,0,0,17,5,81
63,341,497,77,420,14,406,7,78,87,48,8,2,3,45,10,118
63,342,247,36,211,2,209,4,44,33,41,6,0,1,17,1,62
63,343,247,39,208,10,198,5,34,37,41,3,0,0,19,4,55
63,344,149,38,111,1,110,2,18,18,27,6,0,1,15,3,20
63,345,2618,333,2285,54,2231,97,273,461,293,24,11,4,243,43,782
63,346,277,49,228,5,223,2,33,73,18,2,4,0,33,7,51
63,347,406,44,362,6,356,7,68,76,42,6,0,1,39,11,106
63,348,172,27,145,4,141,2,19,17,33,2,3,2,10,4,49
63,349,1625,291,1334,36,1298,14,174,238,202,24,9,3,122,21,491
63,350,962,115,847,13,834,13,179,129,115,16,5,6,85,16,270
63,351,89,15,74,2,72,0,7,7,12,1,3,1,9,3,29
63,352,1246,178,1068,16,1052,12,140,157,168,19,5,5,82,23,441
63,353,480,123,357,3,354,8,53,91,64,2,1,0,31,5,99
63,354,1068,198,870,21,849,24,133,151,177,2,8,3,65,12,274
63,355,203,34,169,6,163,4,28,24,40,4,0,1,8,3,51
63,356,202,20,182,12,170,3,13,39,40,0,2,0,19,5,49
63,357,99,18,81,1,80,0,19,21,8,2,0,0,3,3,24
63,358,303,47,256,6,250,6,39,45,53,2,1,3,17,9,75
63,359,106,27,79,3,76,0,20,13,8,1,0,1,7,3,23
63,360,207,42,165,6,159,5,28,32,21,2,2,1,20,2,46
63,362,643,88,555,17,538,17,93,119,59,4,7,1,36,13,189
63,363,280,43,237,8,229,7,40,48,39,2,1,1,29,0,62
63,364,367,61,306,3,303,2,67,45,52,1,0,2,19,2,113
63,365,365,57,308,6,302,7,45,54,83,2,0,1,32,1,77
63,366,273,24,249,8,241,9,37,40,46,2,2,0,18,5,82
63,367,107,19,88,3,85,6,4,10,9,0,0,0,13,2,41
63,368,876,102,774,28,746,19,140,121,113,14,6,3,88,13,229
63,369,121,24,97,2,95,0,21,14,16,0,1,0,12,3,28
63,370,327,48,279,4,275,0,59,58,36,3,2,0,34,8,75
63,371,193,33,160,6,154,5,29,25,31,1,2,0,9,4,48
63,372,384,31,353,9,344,8,73,59,41,3,1,2,36,7,114
63,373,175,23,152,2,150,1,22,22,23,2,0,0,15,2,63
63,374,253,28,225,3,222,3,56,28,47,5,3,0,33,2,45
63,375,106,13,93,3,90,1,25,23,5,1,0,0,12,3,20
63,376,159,37,122,1,121,0,18,21,17,0,2,1,20,1,41
63,377,345,76,269,7,262,2,54,34,41,6,5,0,24,8,88
63,378,684,68,616,19,597,17,63,92,120,12,3,1,74,12,203
63,379,390,47,343,8,335,4,74,76,36,7,3,0,38,13,84
63,380,576,100,476,15,461,17,84,122,62,7,2,1,43,7,116
63,381,1215,155,1060,29,1031,11,167,182,153,13,10,3,114,24,354
63,382,354,59,295,13,282,6,40,50,53,7,3,1,30,7,85
63,383,218,36,182,2,180,3,42,33,13,6,2,1,15,1,64
63,384,157,30,127,3,124,2,28,31,20,2,0,1,13,3,24
63,385,289,37,252,12,240,2,42,69,32,3,3,1,40,6,42
63,386,330,45,285,6,279,11,37,66,39,2,1,2,58,6,57
63,387,686,109,577,10,567,7,131,113,75,7,1,1,43,8,181
63,388,625,118,507,12,495,10,80,96,57,7,3,4,38,7,193
63,389,85,14,71,2,69,0,9,10,17,1,0,0,11,1,20
63,390,301,38,263,4,259,8,53,75,34,2,5,0,22,5,55
63,391,205,43,162,2,160,6,29,24,32,4,2,1,11,2,49
63,392,421,32,389,6,383,7,62,65,74,3,2,4,34,10,122
63,393,1380,231,1149,39,1110,8,244,281,128,11,1,3,89,29,316
63,394,241,32,209,9,200,2,31,53,41,1,1,0,20,7,44
63,395,609,101,508,10,498,12,75,83,82,10,4,2,54,14,162
63,396,902,86,816,20,796,30,93,144,124,12,8,0,98,21,266
63,397,956,129,827,19,808,12,124,201,87,14,4,1,75,15,275
63,398,113,29,84,3,81,0,31,23,3,0,0,0,6,1,17
63,399,98,14,84,4,80,1,18,16,14,0,0,1,8,0,22
63,400,890,104,786,15,771,9,196,143,67,5,8,2,75,17,249
63,401,209,39,170,3,167,3,32,47,17,3,2,0,31,0,32
63,402,261,43,218,3,215,8,36,31,46,9,1,0,19,2,63
63,403,314,49,265,5,260,7,55,58,31,2,1,0,13,9,84
63,404,365,31,334,12,322,6,43,83,42,1,3,3,22,9,110
63,405,424,68,356,8,348,8,56,56,69,11,5,2,29,4,108
63,406,240,16,224,2,222,5,34,55,26,2,3,1,26,2,68
63,407,236,32,204,9,195,3,40,60,21,2,1,0,30,0,38
63,408,159,27,132,3,129,4,12,20,25,2,2,0,11,2,51
63,409,187,23,164,1,163,4,41,33,23,1,2,2,11,2,44
63,410,146,33,113,9,104,1,10,16,11,1,2,0,31,3,29
63,411,345,37,308,3,305,6,56,42,53,7,2,2,25,4,108
63,412,500,45,455,11,444,5,89,154,26,1,2,2,52,10,103
63,413,539,64,475,16,459,10,84,74,75,7,6,1,43,7,152
63,414,424,46,378,12,366,6,80,70,68,6,4,1,30,3,98
63,415,862,102,760,18,742,16,119,135,126,7,5,12,62,15,245
63,416,118,25,93,3,90,2,14,26,7,0,1,0,8,1,31
63,417,1831,197,1634,35,1599,27,256,440,148,13,9,4,179,34,489
63,418,456,62,394,6,388,11,57,82,63,11,3,0,30,5,126
63,419,497,85,412,7,405,6,85,99,68,7,3,1,31,7,98
63,420,464,57,407,16,391,7,80,78,57,3,3,0,35,9,119
63,421,197,28,169,5,164,2,20,52,23,0,0,0,12,3,52
63,422,387,71,316,9,307,3,46,86,29,2,1,0,37,7,96
63,423,511,62,449,14,435,10,80,75,90,6,7,4,41,9,113
63,424,396,36,360,4,356,2,108,74,26,11,5,0,21,6,103
63,425,1107,119,988,10,978,14,141,235,100,13,4,4,109,18,340
63,426,723,113,610,16,594,3,91,128,45,6,6,0,89,6,220
63,427,351,51,300,11,289,9,55,68,31,8,0,1,26,5,86
63,428,252,28,224,4,220,2,37,40,37,2,1,1,16,3,81
63,429,42,3,39,0,39,0,4,4,12,0,0,0,7,0,12
63,430,8202,1628,6574,134,6440,83,1272,1189,920,86,43,18,458,91,2280
63,431,140,21,119,4,115,5,35,19,14,1,4,0,11,1,25
63,432,615,61,554,8,546,8,103,117,82,2,3,1,45,10,175
63,433,80,9,71,1,70,1,14,18,14,0,0,1,10,2,10
63,434,494,75,419,12,407,8,84,57,75,4,3,1,36,12,127
63,435,204,36,168,3,165,7,29,21,25,7,2,0,16,0,58
63,436,71,12,59,1,58,0,12,16,5,2,1,0,2,1,19
63,437,153,26,127,2,125,0,25,46,13,1,0,0,12,2,26
63,438,371,37,334,11,323,10,70,63,63,1,3,0,27,3,83
63,439,200,28,172,4,168,8,12,28,23,1,2,1,20,4,69
63,440,163,47,116,6,110,0,23,44,12,0,1,0,10,2,18
63,441,250,39,211,2,209,9,40,41,32,4,4,0,25,2,52
63,442,53,11,42,0,42,0,12,11,6,0,0,0,1,2,10
63,443,288,27,261,14,247,7,36,79,26,2,2,0,25,4,66
63,444,172,21,151,6,145,4,16,29,19,2,1,0,15,2,57
63,445,194,19,175,4,171,4,42,36,18,1,2,0,14,6,48
63,446,339,31,308,3,305,7,43,74,33,2,1,1,47,6,91
63,447,94,13,81,3,78,2,10,7,16,1,2,0,4,0,36
63,448,623,129,494,11,483,15,99,103,61,9,1,1,47,9,138
63,449,242,54,188,6,182,6,32,74,13,0,1,0,21,4,31
63,450,250,48,202,4,198,2,35,38,23,1,1,0,23,3,72
63,451,300,47,253,10,243,7,43,66,31,2,2,2,33,12,45
63,452,62,6,56,1,55,1,10,13,10,0,0,1,8,0,12
63,453,2097,319,1778,36,1742,31,296,334,309,29,20,3,145,27,548
63,454,515,100,415,9,406,4,83,100,55,9,1,2,52,10,90
63,455,2995,436,2559,43,2516,38,350,627,320,23,17,5,288,37,811
63,456,206,19,187,5,182,4,32,38,25,1,1,0,19,4,58
63,457,3815,531,3284,52,3232,62,420,573,509,50,22,11,286,55,1244
63,458,122,13,109,2,107,1,28,15,22,2,1,0,5,2,31
63,459,350,59,291,5,286,6,73,68,43,0,5,0,26,4,61
63,460,340,69,271,9,262,1,44,65,40,3,1,0,35,3,70
63,461,266,43,223,8,215,1,41,55,36,3,3,0,21,2,53
63,462,223,42,181,3,178,2,39,27,33,5,0,0,18,12,42
63,463,544,90,454,9,445,9,101,115,75,3,7,0,16,7,112
63,464,303,32,271,8,263,4,35,58,37,5,5,0,21,4,94
63,465,386,48,338,6,332,1,80,103,41,3,2,0,35,9,58
63,466,157,19,138,3,135,1,24,17,20,3,2,0,9,3,56
63,467,63,15,48,0,48,2,7,6,6,0,0,0,7,3,17
63,468,350,71,279,6,273,6,66,66,23,6,4,2,41,4,55
63,469,605,70,535,11,524,8,94,141,84,3,4,0,61,13,116
63,470,3259,509,2750,60,2690,89,407,379,461,32,12,6,245,42,1017
63,471,847,131,716,15,701,9,135,88,149,6,8,0,41,13,252
63,472,523,45,478,12,466,10,75,90,79,6,0,4,41,13,148
63,473,285,21,264,10,254,6,35,70,33,6,1,0,24,7,72
64,1,157,21,136,3,133,4,21,32,8,0,0,1,35,2,30
64,2,121,15,106,2,104,2,22,24,8,0,0,0,35,0,13
64,3,180,22,158,1,157,5,21,20,17,4,1,3,26,6,54
64,4,91,8,83,2,81,0,15,7,6,4,1,0,21,4,23
64,5,463,52,411,5,406,8,52,70,44,6,0,0,95,9,122
64,6,416,64,352,4,348,7,19,52,89,9,3,0,55,2,112
64,7,777,95,682,18,664,17,66,80,126,8,2,3,86,7,269
64,8,253,38,215,9,206,13,18,44,17,3,1,0,62,3,45
64,9,1357,221,1136,14,1122,39,120,324,148,26,5,5,144,23,288
64,10,530,73,457,11,446,6,45,105,56,10,3,1,80,1,139
64,11,95,18,77,1,76,3,8,24,3,4,0,0,15,1,18
64,12,121,16,105,2,103,4,15,41,12,4,1,0,6,1,19
64,13,133,15,118,3,115,4,7,20,11,10,1,0,26,5,31
64,14,551,90,461,22,439,17,78,130,26,6,3,0,63,6,110
64,15,214,43,171,5,166,6,15,32,9,6,1,0,40,3,54
64,16,325,97,228,4,224,2,24,65,26,13,1,0,49,2,42
64,17,254,38,216,5,211,14,10,40,40,10,0,1,33,3,60
64,18,355,35,320,7,313,9,33,116,24,7,3,2,55,4,60
64,19,168,29,139,4,135,2,10,40,12,5,1,0,40,2,23
64,20,197,32,165,2,163,4,19,31,31,6,0,1,29,2,40
64,21,509,56,453,7,446,9,57,91,42,1,2,0,111,8,125
64,22,106,8,98,7,91,6,9,30,8,4,1,0,13,3,17
64,23,726,105,621,15,606,15,64,92,82,6,2,0,139,9,197
64,24,28811,5422,23389,1184,22205,707,2318,6541,2344,328,97,57,2839,295,6679
64,25,102,21,81,2,79,0,9,30,9,1,0,1,13,3,13
64,26,268,45,223,11,212,8,18,56,15,18,1,3,25,3,65
64,27,145,13,132,6,126,1,29,15,11,1,0,1,34,2,32
64,28,129,15,114,4,110,2,25,18,10,1,1,0,20,1,32
64,29,532,60,472,6,466,5,64,106,73,8,1,1,83,5,120
64,31,97,17,80,2,78,2,10,18,10,2,1,0,14,0,21
64,32,145,27,118,3,115,4,26,19,6,1,0,0,30,3,26
64,33,85,15,70,1,69,3,10,18,10,1,0,0,9,1,17
64,34,242,28,214,8,206,18,20,43,17,6,3,1,35,4,59
64,35,1463,214,1249,18,1231,44,121,407,146,30,6,1,153,19,304
64,36,234,33,201,1,200,6,15,52,20,1,3,1,48,1,53
64,37,869,138,731,15,716,16,107,156,77,11,2,1,113,9,224
64,38,2585,417,2168,51,2117,64,246,719,204,47,10,5,275,26,521
64,39,180,20,160,2,158,4,23,16,26,2,1,0,24,1,61
64,40,984,138,846,10,836,33,89,151,93,14,4,2,216,6,228
64,41,498,58,440,10,430,7,77,97,44,3,2,1,86,7,106
64,42,513,67,446,5,441,11,80,71,43,6,3,1,64,6,156
64,43,195,30,165,3,162,4,28,29,22,3,0,3,28,2,43
64,44,78,17,61,1,60,3,7,13,4,1,0,0,14,0,18
64,45,73,11,62,0,62,2,5,29,6,2,0,0,8,0,10
64,46,317,41,276,5,271,13,25,100,18,12,1,0,55,5,42
64,47,253,66,187,2,185,8,18,62,8,8,2,1,35,1,42
64,48,67,11,56,1,55,0,9,10,4,2,0,0,16,0,14
64,49,203,48,155,2,153,1,26,29,19,4,0,2,35,7,30
64,50,81,9,72,2,70,3,10,18,5,1,0,0,10,0,23
64,51,307,43,264,4,260,6,27,54,24,8,5,2,58,7,69
64,52,84,18,66,0,66,1,7,13,7,0,2,0,13,4,19
64,53,129,22,107,1,106,0,19,19,10,3,0,0,23,0,32
64,54,631,87,544,17,527,13,85,72,50,5,4,3,122,10,163
64,56,118,18,100,3,97,4,15,15,13,3,0,0,21,0,26
64,57,1497,242,1255,19,1236,19,162,250,155,27,11,2,200,13,397
64,58,483,66,417,10,407,5,89,61,53,6,2,1,90,6,94
64,59,717,79,638,9,629,21,89,119,71,13,1,1,144,2,168
64,60,1180,149,1031,15,1016,25,129,234,115,8,0,6,181,16,302
64,61,2430,344,2086,35,2051,40,288,361,289,33,14,1,248,34,743
64,62,1896,310,1586,25,1561,28,181,263,222,18,10,4,140,11,684
64,63,774,108,666,12,654,7,85,128,82,16,1,1,95,11,228
64,64,404,63,341,2,339,7,58,70,50,3,4,1,34,6,106
64,65,3353,484,2869,65,2804,113,280,895,302,89,17,9,431,57,611
64,66,251,45,206,5,201,8,28,54,15,5,2,0,35,1,53
64,67,1248,153,1095,23,1072,24,124,210,115,11,3,0,244,23,318
64,68,1520,147,1373,25,1348,45,196,262,130,20,6,1,328,22,338
64,69,221,37,184,3,181,3,20,43,26,2,1,0,36,2,48
64,70,231,25,206,3,203,3,56,31,13,2,2,0,45,5,46
64,71,175,18,157,4,153,1,30,34,12,2,0,0,41,1,32
64,72,525,74,451,5,446,21,55,87,56,8,2,0,78,10,129
64,73,194,24,170,1,169,3,21,29,25,1,1,0,38,2,49
64,74,51,6,45,0,45,0,3,11,6,3,0,0,6,0,16
64,75,152,17,135,6,129,2,14,30,13,0,1,0,36,2,31
64,77,123,18,105,0,105,3,6,19,35,1,0,0,17,0,24
64,78,209,30,179,4,175,1,27,37,13,0,1,0,27,2,67
64,79,102,15,87,2,85,0,7,22,4,0,0,0,18,0,34
64,80,527,59,468,11,457,7,78,110,52,4,0,0,79,13,114
64,81,218,40,178,4,174,6,19,27,16,4,2,0,46,5,49
64,82,103,21,82,2,80,1,7,23,1,1,0,0,24,0,23
64,83,137,15,122,3,119,1,26,26,12,2,3,1,8,1,39
64,84,115,17,98,2,96,0,16,22,4,1,1,1,21,7,23
64,85,127,18,109,0,109,1,6,19,20,4,0,0,27,1,31
64,86,745,104,641,21,620,46,53,135,74,32,0,2,145,5,128
64,87,588,70,518,13,505,7,56,96,73,10,0,0,65,8,190
64,88,206,33,173,6,167,3,23,26,23,4,1,0,26,1,60
64,89,111,13,98,2,96,5,16,25,7,0,1,0,26,2,14
64,90,109,7,102,3,99,0,14,25,14,2,0,0,25,0,19
64,91,320,43,277,4,273,7,44,47,29,1,1,0,62,6,76
64,92,307,77,230,8,222,8,24,78,20,13,1,0,38,1,39
64,93,625,124,501,24,477,10,54,98,53,13,1,1,129,11,107
64,94,1182,146,1036,17,1019,29,100,307,86,16,4,2,218,19,238
64,95,406,30,376,9,367,9,43,68,39,7,0,0,51,7,143
64,96,143,19,124,4,120,3,11,21,12,4,3,3,24,1,38
64,97,472,57,415,12,403,4,61,64,37,4,2,0,80,2,149
64,98,64,6,58,2,56,2,12,13,6,1,3,2,3,1,13
64,99,98,17,81,4,77,4,18,15,3,3,0,0,13,0,21
64,100,1937,252,1685,38,1647,47,128,602,153,34,10,6,230,21,416
64,101,404,57,347,8,339,6,46,38,58,3,0,1,89,5,93
64,102,28475,6674,21801,397,21404,799,2485,5255,2950,432,108,45,2398,258,6674
64,103,167,30,137,3,134,0,22,19,21,1,2,0,28,1,40
64,104,465,52,413,10,403,14,27,54,93,5,4,0,79,10,117
64,105,238,33,205,5,200,11,12,65,14,11,2,1,34,8,42
64,106,350,47,303,5,298,11,30,57,23,5,4,0,73,3,92
64,107,63,9,54,0,54,2,7,13,2,0,0,0,20,0,10
64,108,705,93,612,12,600,13,93,101,93,7,1,2,63,12,215
64,109,1509,218,1291,17,1274,27,207,231,108,18,4,5,289,10,375
64,110,201,35,166,2,164,3,5,19,26,2,0,0,29,3,77
64,111,96,15,81,2,79,1,15,2,8,1,0,1,24,1,26
64,112,336,37,299,6,293,8,49,56,23,5,2,3,55,10,82
64,113,91,10,81,1,80,3,9,15,11,2,0,0,17,2,21
64,114,457,51,406,11,395,9,66,71,39,7,1,2,73,10,117
64,115,105,12,93,0,93,3,13,18,11,0,4,0,12,0,32
64,116,243,30,213,5,208,3,31,45,21,4,2,0,22,3,77
64,117,116,19,97,2,95,2,17,11,7,3,0,0,14,5,36
64,118,51,15,36,2,34,0,7,3,4,0,0,0,2,0,18
64,119,442,51,391,8,383,4,67,70,38,2,1,0,87,6,108
64,120,417,63,354,16,338,15,26,82,46,20,2,1,63,6,77
64,121,144,21,123,2,121,1,16,25,20,2,0,0,25,3,29
64,122,22482,5582,16900,225,16675,606,1661,6227,1521,209,66,39,2001,196,4149
64,123,1052,188,864,21,843,19,117,178,107,13,5,1,167,7,229
64,124,554,100,454,18,436,18,42,141,40,19,5,2,77,11,81
64,125,4845,879,3966,61,3905,160,418,1205,457,66,25,5,529,65,975
64,126,967,119,848,19,829,15,65,167,139,11,8,3,101,9,311
64,127,399,65,334,4,330,9,40,60,54,6,1,1,44,0,115
64,128,168,31,137,1,136,5,8,17,25,5,2,1,31,1,41
64,129,8746,1851,6895,117,6778,154,854,1495,855,85,27,14,1057,89,2148
64,130,713,121,592,15,577,20,76,113,94,14,6,2,63,6,183
64,131,468,53,415,14,401,4,40,79,49,11,1,0,65,7,145
64,132,3630,596,3034,57,2977,70,336,728,288,28,7,7,583,37,893
64,133,885,115,770,20,750,10,112,133,75,5,1,0,158,21,235
64,134,255,34,221,0,221,10,29,42,25,19,2,0,36,4,54
64,135,575,70,505,11,494,21,36,53,74,7,6,1,58,10,228
64,136,102,16,86,0,86,1,6,7,19,0,1,0,21,1,30
64,137,569,48,521,5,516,8,55,45,59,7,0,0,189,9,144
64,138,1759,243,1516,30,1486,19,215,266,178,23,4,2,233,26,520
64,139,857,101,756,9,747,26,121,160,96,3,2,1,145,14,179
64,140,5761,1009,4752,73,4679,144,596,837,963,81,19,8,455,70,1506
64,141,310,42,268,7,261,3,49,75,25,0,0,0,47,4,58
64,142,565,64,501,14,487,10,72,114,44,3,0,3,88,4,149
64,143,90,9,81,1,80,1,14,24,0,1,1,0,26,0,13
64,144,120,16,104,1,103,2,16,20,14,5,0,0,14,1,31
64,145,313,32,281,7,274,4,50,42,28,3,2,0,64,2,79
64,146,246,37,209,4,205,4,30,55,22,2,0,0,43,2,47
64,147,1911,272,1639,35,1604,53,203,352,175,42,7,5,254,27,486
64,148,702,73,629,11,618,13,82,108,82,6,3,1,148,4,171
64,149,193,25,168,4,164,1,16,40,10,3,1,0,56,5,32
64,150,116,18,98,4,94,8,6,14,15,10,1,0,18,1,21
64,151,83,16,67,2,65,5,6,16,8,1,1,0,15,0,13
64,152,1482,255,1227,24,1203,40,129,313,118,13,5,7,237,14,327
64,153,64,7,57,2,55,1,3,14,11,3,0,1,10,0,12
64,154,153,27,126,1,125,6,7,29,11,3,0,0,40,0,29
64,155,83,16,67,5,62,1,6,18,3,3,0,0,12,0,19
64,156,342,41,301,3,298,10,42,30,52,6,4,0,36,8,110
64,157,755,98,657,10,647,28,75,90,85,6,4,1,109,7,242
64,158,159,16,143,1,142,3,21,20,10,0,0,0,29,5,54
64,159,92,21,71,0,71,0,11,9,15,4,0,0,11,2,19
64,160,4368,894,3474,77,3397,100,413,915,379,72,10,10,509,64,925
64,161,622,89,533,8,525,13,69,130,37,6,2,1,152,7,108
64,162,97,13,84,5,79,2,7,14,13,5,2,1,21,0,14
64,165,204,25,179,4,175,4,24,45,25,3,1,1,37,3,32
64,166,172,28,144,5,139,6,12,41,11,1,1,1,12,2,52
64,167,170,16,154,2,152,0,24,28,17,4,0,2,26,0,51
64,168,460,62,398,6,392,4,41,87,30,10,0,0,76,9,135
64,170,168,18,150,2,148,4,17,23,22,2,3,0,24,5,48
64,171,163,20,143,1,142,5,26,26,18,2,1,1,22,4,37
64,172,166,21,145,2,143,2,27,22,10,2,2,1,23,2,52
64,173,106,16,90,0,90,1,6,14,10,2,0,0,24,1,32
64,174,54,11,43,0,43,1,15,2,8,0,0,0,8,0,9
64,175,153,31,122,2,120,1,15,23,19,6,1,0,12,1,42
64,176,153,25,128,5,123,4,22,25,19,3,2,0,35,1,12
64,177,538,61,477,14,463,6,56,114,30,15,1,2,91,8,140
64,178,346,52,294,9,285,2,46,67,28,1,1,2,47,5,86
64,179,138,25,113,4,109,4,15,34,9,1,0,0,14,0,32
64,180,147,18,129,4,125,4,14,26,14,4,0,1,30,1,31
64,181,236,30,206,6,200,7,24,42,17,2,0,1,31,2,74
64,182,62,17,45,2,43,0,9,5,6,0,0,0,8,1,14
64,183,401,39,362,8,354,7,40,133,23,2,0,0,51,7,91
64,184,368,41,327,2,325,6,53,80,44,5,0,0,58,6,73
64,185,87,18,69,0,69,2,8,8,16,1,2,0,6,0,26
64,186,207,39,168,3,165,2,18,34,26,4,4,1,54,0,22
64,187,190,41,149,4,145,2,23,30,11,4,2,0,20,0,53
64,188,903,153,750,12,738,16,68,157,92,12,3,1,114,7,268
64,189,5554,901,4653,95,4558,167,501,1321,487,91,20,5,502,44,1420
64,190,175,15,160,4,156,2,21,26,15,0,0,0,26,6,60
64,191,1770,359,1411,42,1369,22,186,223,166,10,3,1,292,12,454
64,192,89,11,78,0,78,6,9,25,8,2,1,0,9,0,18
64,193,90,21,69,1,68,1,17,7,5,1,0,1,11,1,24
64,194,266,37,229,3,226,0,40,47,16,7,0,0,29,2,85
64,195,93,11,82,2,80,0,12,28,14,0,0,0,9,0,17
64,196,112,21,91,2,89,1,7,13,19,4,2,0,13,2,28
64,197,165,16,149,5,144,5,25,40,21,3,0,1,13,5,31
64,198,1322,194,1128,19,1109,11,192,197,132,16,3,3,168,15,372
64,199,101,16,85,3,82,2,5,16,14,3,0,0,15,1,26
64,200,145,12,133,5,128,6,18,35,14,1,0,0,16,5,33
64,201,164,27,137,6,131,1,6,30,13,1,1,0,46,1,32
64,202,411,64,347,9,338,6,37,79,40,11,3,2,66,11,83
64,203,210,20,190,4,186,2,27,38,18,4,1,0,31,4,61
64,204,361,89,272,3,269,8,40,53,48,1,2,0,39,5,73
64,205,184,29,155,1,154,0,25,38,11,1,1,2,20,2,54
64,206,119,19,100,1,99,0,19,12,11,0,0,0,18,0,39
64,207,309,49,260,3,257,7,36,36,46,2,1,1,34,3,91
64,208,227,35,192,7,185,3,47,42,21,3,2,0,21,3,43
64,209,368,48,320,5,315,7,52,29,60,8,4,1,50,4,100
64,210,137,19,118,5,113,1,8,20,6,0,0,0,33,2,43
64,211,177,17,160,2,158,4,22,20,12,4,0,1,42,3,50
64,212,129,14,115,1,114,1,13,24,9,0,0,0,40,1,26
64,213,1647,263,1384,30,1354,64,171,332,144,48,9,3,230,19,334
64,214,440,85,355,14,341,9,37,104,39,12,2,0,39,6,93
64,215,47,9,38,0,38,0,4,9,5,0,0,0,9,1,10
64,216,750,79,671,10,661,15,113,149,61,14,1,1,135,8,164
64,217,454,76,378,17,361,6,44,52,41,6,4,1,68,6,133
64,218,307,75,232,4,228,6,37,72,9,4,5,1,45,3,46
64,219,233,27,206,3,203,10,23,38,46,2,2,0,30,2,50
64,220,426,45,381,6,375,5,41,72,58,5,1,3,72,7,111
64,221,106,18,88,2,86,2,21,19,3,3,0,0,18,0,20
64,222,65,15,50,1,49,3,5,2,6,2,0,0,10,0,21
64,223,98,16,82,2,80,3,9,9,20,2,0,0,10,0,27
64,224,564,83,481,9,472,11,62,58,110,7,2,1,68,9,144
64,225,402,44,358,5,353,10,42,65,43,5,2,2,83,0,101
64,226,134,29,105,4,101,2,19,21,10,2,0,0,20,0,27
64,227,526,73,453,3,450,6,69,87,50,5,2,0,96,10,125
64,228,189,32,157,4,153,8,15,34,17,11,1,0,40,1,26
64,229,89,16,73,3,70,8,3,16,4,10,0,0,22,0,7
64,230,4108,606,3502,62,3440,98,436,758,414,38,11,11,602,43,1029
64,231,443,69,374,6,368,3,15,101,44,6,0,1,85,2,111
64,232,173,31,142,3,139,1,12,38,6,1,1,0,39,1,40
64,233,913,134,779,12,767,14,103,184,80,11,6,0,114,9,246
64,234,168,33,135,2,133,4,16,41,15,1,0,0,23,2,31
64,235,264,44,220,2,218,17,25,69,15,5,3,0,31,1,52
64,236,63,9,54,0,54,2,9,15,3,1,0,0,12,2,10
64,237,2550,377,2173,38,2135,60,273,463,251,25,5,5,366,32,655
64,238,1536,187,1349,27,1322,33,210,241,142,8,3,2,280,16,387
64,239,92,16,76,2,74,2,9,7,3,3,0,1,10,2,37
64,240,192,22,170,4,166,2,24,45,15,0,1,1,31,3,44
64,241,372,54,318,6,312,4,40,48,53,4,1,0,50,9,103
64,242,61,5,56,0,56,1,2,6,6,0,0,0,12,2,27
64,243,152,20,132,2,130,3,21,27,9,3,1,0,35,2,29
64,244,200,22,178,5,173,2,12,44,31,1,0,0,29,0,54
64,245,466,45,421,8,413,6,48,45,82,9,5,0,64,5,149
64,246,173,17,156,2,154,1,18,34,16,0,1,0,41,1,42
64,247,404,70,334,4,330,17,22,62,38,11,0,1,36,2,141
64,249,1170,209,961,12,949,37,90,294,105,20,4,5,119,20,255
64,250,664,69,595,10,585,11,87,143,70,7,1,0,114,27,125
64,251,204,43,161,2,159,2,27,23,12,6,2,0,41,4,42
64,252,581,52,529,5,524,21,44,97,69,2,4,0,81,9,197
64,253,340,62,278,3,275,5,47,50,24,3,3,1,60,5,77
64,254,426,53,373,5,368,3,44,46,63,6,6,4,62,3,131
64,255,432,81,351,12,339,13,55,78,51,8,2,0,33,2,97
64,256,4837,749,4088,84,4004,169,533,931,359,108,29,7,747,91,1030
64,257,248,25,223,5,218,6,35,44,25,1,1,1,47,5,53
64,258,103,23,80,6,74,4,7,9,14,4,1,0,9,3,23
64,259,539,72,467,11,456,41,59,86,50,9,6,1,92,8,104
64,260,8389,2010,6379,97,6282,245,679,1194,1110,140,33,13,557,86,2225
64,261,313,54,259,7,252,3,42,32,33,4,2,0,40,4,92
64,262,213,21,192,7,185,0,32,31,19,2,1,0,51,1,48
64,263,133,16,117,8,109,3,12,26,15,0,1,0,32,2,18
64,264,66,8,58,3,55,1,7,13,6,0,1,0,17,2,8
64,265,76,15,61,2,59,2,3,24,3,3,0,0,16,0,8
64,266,174,22,152,7,145,1,31,20,11,1,0,1,50,0,30
64,267,85,15,70,3,67,2,2,18,5,3,0,0,28,2,7
64,268,224,35,189,5,184,6,27,38,15,2,0,1,34,3,58
64,269,3336,515,2821,52,2769,67,299,803,224,18,8,5,477,41,827
64,270,705,94,611,11,600,11,86,129,55,5,0,1,117,4,192
64,271,419,54,365,6,359,8,45,111,27,4,4,2,96,8,54
64,272,125,11,114,5,109,1,12,36,6,8,1,0,27,2,16
64,273,663,104,559,12,547,19,53,146,31,22,5,0,79,7,185
64,274,272,53,219,6,213,14,26,54,16,8,1,0,42,5,47
64,275,508,95,413,10,403,9,33,73,53,12,3,2,55,6,157
64,276,231,39,192,2,190,4,29,27,34,4,0,0,34,3,55
64,277,289,48,241,8,233,22,14,54,27,13,1,0,28,8,66
64,279,1619,247,1372,47,1325,77,147,330,133,62,6,6,205,23,336
64,280,351,55,296,5,291,4,29,43,44,4,3,0,20,4,140
64,281,132,17,115,5,110,1,20,24,8,0,0,0,25,4,28
64,282,842,118,724,19,705,32,99,154,78,22,2,1,127,14,176
64,283,168,36,132,3,129,4,11,25,11,4,1,1,43,2,27
64,284,5408,936,4472,68,4404,92,565,1056,586,57,16,14,695,82,1241
64,285,161,29,132,7,125,7,10,47,5,4,2,0,37,2,11
64,286,329,27,302,14,288,10,38,66,20,5,1,0,25,1,122
64,287,121,28,93,4,89,1,5,25,8,0,0,0,30,1,19
64,288,369,38,331,4,327,6,52,71,51,4,1,1,53,5,83
64,289,722,127,595,13,582,22,59,170,46,13,3,1,129,13,126
64,290,386,30,356,5,351,6,67,58,53,11,5,1,60,10,80
64,291,264,38,226,3,223,2,32,55,28,2,0,1,34,9,60
64,292,201,26,175,1,174,4,20,39,26,1,3,0,32,2,47
64,293,136,18,118,0,118,3,23,30,18,2,0,0,12,1,29
64,294,141,28,113,6,107,0,11,26,11,1,1,0,27,1,29
64,295,91,9,82,2,80,1,8,18,14,1,1,0,12,0,25
64,296,104,22,82,1,81,2,20,19,9,2,1,0,10,0,18
64,297,124,17,107,1,106,5,12,32,6,7,1,0,12,3,28
64,298,101,26,75,3,72,2,5,13,4,5,1,0,19,0,23
64,299,161,19,142,2,140,3,30,26,10,1,1,0,20,2,47
64,300,561,65,496,10,486,9,81,90,60,6,2,2,84,7,145
64,301,920,169,751,17,734,14,128,109,99,14,1,1,98,11,259
64,302,389,46,343,8,335,5,52,61,35,8,0,0,63,1,110
64,303,153,29,124,1,123,6,13,15,22,5,2,1,16,1,42
64,304,1787,332,1455,25,1430,38,226,262,218,25,5,1,172,22,461
64,305,368,64,304,8,296,7,61,60,30,6,4,1,52,9,66
64,306,597,67,530,14,516,10,71,82,54,7,2,1,101,8,180
64,307,158,23,135,3,132,4,21,24,13,3,0,0,19,4,44
64,308,229,29,200,3,197,2,39,44,8,4,2,0,33,2,63
64,309,167,27,140,0,140,1,13,23,12,4,0,1,46,4,36
64,310,460,64,396,19,377,12,49,92,47,4,1,2,75,4,91
64,311,136,18,118,3,115,0,13,20,12,1,0,0,19,2,48
64,312,253,29,224,5,219,5,19,48,41,1,1,0,26,1,77
64,313,243,31,212,5,207,4,16,74,23,11,2,0,37,5,35
64,314,329,42,287,7,280,5,37,97,21,8,1,0,52,2,57
64,315,791,83,708,12,696,26,84,134,85,15,3,0,124,15,210
64,316,209,36,173,7,166,5,15,17,14,7,3,1,25,0,79
64,317,1301,187,1114,26,1088,42,161,299,128,26,8,2,159,21,242
64,318,149,25,124,2,122,5,17,17,25,0,2,2,20,0,34
64,319,166,29,137,2,135,6,8,36,11,2,2,0,35,5,30
64,320,1252,184,1068,10,1058,22,112,189,123,16,4,2,208,14,368
64,321,197,26,171,5,166,3,27,44,23,3,0,0,29,2,35
64,322,274,61,213,6,207,8,24,58,22,11,0,0,40,3,41
64,323,80,17,63,2,61,2,13,16,6,1,1,0,8,0,14
64,324,1378,161,1217,23,1194,49,161,210,132,21,6,3,257,11,344
64,325,166,15,151,3,148,1,18,24,19,1,2,0,43,3,37
64,326,83,12,71,1,70,1,9,18,8,0,1,0,14,0,19
64,327,172,35,137,4,133,7,7,35,17,4,4,0,18,2,39
64,328,918,120,798,13,785,20,82,130,119,8,5,0,137,9,275
64,329,949,153,796,11,785,20,80,243,64,8,0,1,147,9,213
64,330,261,42,219,8,211,3,32,37,29,3,3,0,19,3,82
64,331,588,74,514,8,506,12,86,105,49,4,3,1,69,13,164
64,332,132,24,108,1,107,0,12,13,15,1,1,0,9,2,54
64,334,174,24,150,2,148,2,13,28,37,1,2,0,22,2,41
64,335,7073,1030,6043,119,5924,148,741,1416,586,71,20,16,985,97,1844
64,336,249,41,208,4,204,10,9,38,22,1,1,0,62,2,59
64,337,127,23,104,1,103,0,24,19,17,3,1,0,15,2,22
64,338,130,16,114,7,107,0,20,21,9,0,1,0,29,0,27
64,339,657,92,565,7,558,12,80,96,57,7,0,1,132,5,168
64,340,72,11,61,2,59,2,4,2,11,3,0,0,16,0,21
64,341,113,19,94,1,93,1,7,33,8,1,0,0,21,0,22
64,342,214,40,174,1,173,6,16,35,16,1,1,0,20,1,77
64,343,357,33,324,2,322,4,50,66,31,4,0,0,50,4,113
64,344,313,42,271,3,268,5,24,50,26,4,0,1,76,3,79
64,345,169,28,141,2,139,7,16,41,12,3,3,0,36,1,20
64,346,169,27,142,6,136,2,19,24,11,3,0,0,45,3,29
64,347,137,26,111,1,110,2,16,42,5,0,0,0,20,0,25
64,348,9047,1523,7524,133,7391,186,853,1813,832,80,19,21,1199,126,2262
64,349,379,71,308,4,304,3,52,58,22,7,1,0,37,4,120
64,350,603,121,482,20,462,21,70,120,47,17,6,1,71,6,103
64,351,140,20,120,2,118,0,10,16,6,0,1,0,62,2,21
64,352,243,21,222,0,222,4,30,27,31,1,1,0,53,1,74
64,353,936,156,780,6,774,17,96,131,123,17,5,1,118,9,257
64,354,123,25,98,2,96,8,19,6,16,2,1,0,14,1,29
64,355,105,24,81,1,80,2,8,19,4,1,0,0,19,0,27
64,356,91,21,70,2,68,4,7,11,13,0,0,0,11,0,22
64,357,53,13,40,0,40,1,8,3,0,2,0,0,13,0,13
64,358,250,29,221,7,214,2,28,32,22,2,0,0,64,0,64
64,359,814,123,691,20,671,26,72,128,76,15,3,3,133,9,206
64,360,188,43,145,0,145,5,16,36,19,5,1,0,36,2,25
64,361,141,32,109,3,106,3,20,22,10,5,0,0,18,3,25
64,362,213,31,182,5,177,1,30,35,16,5,1,1,42,5,41
64,363,294,57,237,2,235,5,37,58,52,2,0,0,39,5,37
64,364,455,58,397,13,384,17,28,117,40,11,1,5,81,10,74
64,365,367,58,309,9,300,1,39,69,17,5,5,0,68,5,91
64,366,115,13,102,2,100,1,17,12,13,0,0,0,17,0,40
64,367,612,68,544,13,531,7,63,99,65,24,4,1,66,13,189
64,368,191,31,160,6,154,6,10,45,14,4,2,0,44,3,26
64,369,215,29,186,1,185,2,26,43,22,3,0,0,37,5,47
64,370,399,69,330,5,325,6,49,69,33,7,0,1,66,8,86
64,371,2370,380,1990,38,1952,54,150,379,391,39,7,8,222,15,687
64,372,85,10,75,4,71,1,10,15,8,0,1,0,16,2,18
64,373,1618,256,1362,24,1338,30,181,226,185,16,4,5,223,13,455
64,374,804,121,683,23,660,10,99,169,78,12,0,2,122,8,160
64,375,213,37,176,9,167,0,29,40,5,2,2,0,51,3,35
64,376,647,84,563,6,557,10,72,137,53,8,2,3,118,7,147
64,377,610,85,525,13,512,38,48,94,65,15,7,2,106,14,123
64,378,189,39,150,3,147,7,19,16,25,7,3,0,19,0,51
64,379,171,36,135,6,129,4,20,32,10,1,1,1,21,0,39
64,380,178,21,157,7,150,0,20,45,27,0,0,0,24,4,30
64,381,250,35,215,3,212,3,29,67,23,7,0,0,34,0,49
64,382,294,20,274,6,268,0,30,61,27,8,0,2,37,7,96
64,383,96,13,83,4,79,0,12,6,8,3,0,0,7,1,42
64,385,177,24,153,2,151,2,20,26,12,3,0,2,39,0,47
64,386,940,156,784,15,769,8,113,130,117,9,3,1,151,9,228
64,387,380,47,333,6,327,9,60,81,22,8,1,1,50,7,88
64,388,116,17,99,2,97,0,22,30,13,0,1,1,12,5,13
64,389,264,28,236,4,232,2,34,58,11,4,0,0,34,2,87
64,390,136,13,123,2,121,1,19,15,15,3,1,1,19,3,44
64,391,306,71,235,5,230,9,26,39,31,7,0,0,59,1,58
64,392,95,15,80,0,80,0,17,21,14,1,0,0,12,0,15
64,393,3504,462,3042,75,2967,59,395,527,414,37,17,9,462,60,987
64,394,84,13,71,1,70,3,12,5,15,0,0,0,10,0,25
64,395,115,18,97,0,97,2,18,15,15,0,0,0,17,1,29
64,396,795,100,695,19,676,11,101,109,115,9,3,2,90,14,222
64,397,102,12,90,3,87,0,10,26,12,1,0,0,22,0,16
64,398,371,39,332,7,325,4,53,60,36,2,1,2,78,4,85
64,399,1673,237,1436,29,1407,42,163,371,143,12,4,2,274,13,383
64,400,861,136,725,19,706,18,111,124,82,7,4,2,141,15,202
64,401,65,9,56,0,56,2,11,14,1,0,0,0,5,6,17
64,403,165,36,129,4,125,0,30,16,13,5,0,0,29,1,31
64,404,296,48,248,5,243,6,36,38,30,8,1,1,43,7,73
64,405,3137,500,2637,58,2579,44,358,609,236,33,8,3,482,28,778
64,406,436,52,384,8,376,14,39,76,54,4,0,0,47,10,132
64,407,3858,634,3224,60,3164,114,460,696,407,69,20,4,364,47,983
64,408,43,12,31,0,31,1,3,4,4,0,0,0,5,3,11
64,409,582,74,508,10,498,3,48,87,65,10,1,1,83,10,190
64,410,4991,1255,3736,86,3650,41,682,510,462,51,20,8,259,43,1574
64,411,223,49,174,8,166,13,6,24,22,6,0,1,43,1,50
64,412,101,13,88,3,85,5,14,27,3,1,0,0,19,2,14
64,413,477,56,421,0,421,5,72,75,45,5,0,0,66,5,148
64,414,109,17,92,1,91,0,16,34,2,0,2,0,14,0,23
64,415,1004,123,881,12,869,15,138,190,51,13,3,1,167,13,278
64,416,745,121,624,14,610,11,61,165,65,10,1,4,106,13,174
64,417,2405,407,1998,49,1949,51,247,367,248,33,6,4,464,32,497
64,418,113,21,92,1,91,3,8,23,10,1,0,0,10,3,33
64,419,1003,143,860,14,846,15,98,164,98,12,2,4,189,18,246
64,420,183,13,170,1,169,2,28,23,17,0,0,0,71,4,24
64,421,1039,155,884,12,872,24,111,147,134,12,6,3,136,7,292
64,422,8083,1412,6671,136,6535,168,683,1190,1202,95,32,17,844,70,2234
64,423,139,27,112,6,106,1,13,13,17,2,1,0,18,2,39
64,424,492,82,410,11,399,23,45,72,35,5,4,0,99,5,111
64,425,432,72,360,5,355,8,37,77,30,11,1,0,79,8,104
64,426,197,39,158,0,158,6,22,26,16,4,0,1,24,4,55
64,427,137,14,123,2,121,4,17,22,13,0,2,0,30,3,30
64,428,116,14,102,0,102,0,10,22,14,1,2,0,18,3,32
64,429,86,8,78,0,78,8,6,18,3,7,1,0,15,1,19
64,430,8158,1443,6715,119,6596,175,684,1289,847,106,30,13,946,88,2418
64,431,347,32,315,8,307,4,41,46,38,5,4,2,46,4,117
64,432,82,6,76,6,70,4,3,6,6,9,1,0,10,1,30
64,433,261,40,221,5,216,6,10,32,57,3,0,0,42,1,65
64,434,48,17,31,2,29,1,5,4,2,0,0,0,14,0,3
64,435,193,41,152,3,149,2,10,18,18,4,2,0,27,4,64
64,436,678,138,540,19,521,29,50,128,54,17,4,2,87,9,141
64,437,194,32,162,3,159,19,2,43,17,15,1,2,29,0,31
64,438,364,48,316,6,310,12,28,47,43,2,1,0,71,4,102
64,439,1140,151,989,17,972,22,136,178,93,13,2,0,181,24,323
64,440,321,47,274,7,267,8,32,41,37,3,2,0,46,5,93
64,441,223,31,192,3,189,5,22,35,19,12,1,0,39,1,55
64,442,208,25,183,5,178,6,20,30,21,2,2,0,43,2,52
64,443,758,89,669,16,653,6,85,151,62,11,2,0,125,12,199
64,444,344,49,295,7,288,5,35,31,35,3,1,2,71,6,99
64,445,50502,11649,38853,625,38228,1126,4285,8908,4708,453,127,65,5596,461,12499
64,446,133,21,112,1,111,1,24,21,5,1,2,2,15,2,38
64,447,111,19,92,1,91,1,16,23,12,0,0,1,17,0,21
64,448,1147,134,1013,18,995,23,140,238,104,7,3,1,129,14,336
64,449,155,17,138,8,130,2,22,33,15,0,1,2,27,2,26
64,450,192,30,162,1,161,5,20,31,17,3,2,2,19,6,56
64,451,80,9,71,1,70,3,18,6,7,0,0,0,13,0,23
64,452,202,23,179,3,176,1,19,29,17,1,0,1,53,2,53
64,453,2049,320,1729,31,1698,29,286,370,176,30,5,5,332,36,429
64,454,124,17,107,2,105,0,15,20,5,1,2,0,43,3,16
64,455,157,28,129,1,128,3,31,29,8,1,1,0,20,3,32
64,456,36,5,31,2,29,2,13,0,2,0,1,0,4,1,6
64,457,176,13,163,4,159,2,20,27,14,0,1,2,45,2,46
64,458,227,32,195,3,192,2,26,28,34,2,1,0,33,3,63
64,459,150,19,131,3,128,4,16,27,6,4,2,0,30,2,37
64,460,299,26,273,5,268,12,34,32,39,1,1,0,43,6,100
64,461,847,179,668,11,657,14,94,98,107,13,0,2,72,14,243
64,462,347,28,319,8,311,2,50,56,50,6,2,0,39,0,106
64,463,587,79,508,6,502,14,56,104,101,6,3,2,64,7,145
64,464,81,9,72,0,72,3,12,13,7,2,0,0,3,2,30
64,465,145,15,130,3,127,0,20,28,11,1,0,0,30,2,35
64,466,202,37,165,5,160,4,33,38,14,1,0,0,25,2,43
64,467,574,87,487,5,482,5,37,121,73,8,1,0,84,4,149
64,468,115,23,92,2,90,3,11,18,10,3,1,0,21,1,22
64,469,254,47,207,3,204,4,32,28,36,4,0,0,55,2,43
64,470,444,68,376,9,367,6,37,100,36,0,0,0,80,7,101
64,471,301,55,246,12,234,2,21,46,21,1,1,0,44,4,94
64,472,638,70,568,13,555,11,65,104,55,10,3,0,102,11,194
64,473,275,36,239,4,235,11,26,27,28,2,5,0,51,6,79
64,474,117,19,98,1,97,0,16,19,8,0,0,0,21,1,32
64,475,236,47,189,5,184,1,25,39,20,1,1,0,28,2,67
64,476,347,32,315,5,310,11,40,88,23,16,3,1,73,6,49
64,477,1347,325,1022,19,1003,60,105,254,85,52,5,3,167,7,265
64,478,618,70,548,10,538,23,67,96,64,7,5,2,102,20,152
64,479,130,26,104,1,103,2,8,32,26,0,0,2,10,2,21
64,480,164,29,135,0,135,1,31,32,16,3,1,2,23,1,25
64,481,188,28,160,0,160,2,27,28,25,2,0,0,33,1,42
64,482,478,80,398,8,390,11,42,82,55,2,1,2,77,2,116
64,483,10611,1976,8635,196,8439,247,892,2846,828,135,42,19,1050,129,2251
64,484,716,99,617,16,601,17,72,192,51,20,3,1,93,7,145
64,485,1071,144,927,16,911,42,66,321,63,25,3,1,127,11,252
64,486,73,15,58,0,58,0,10,10,1,0,1,0,14,6,16
64,487,219,32,187,6,181,27,20,30,10,13,1,0,43,0,37
64,488,358,60,298,5,293,11,35,48,33,2,1,0,75,9,79
64,489,267,49,218,3,215,11,21,44,20,7,3,0,70,0,39
64,490,395,82,313,7,306,12,34,60,36,19,0,1,46,5,93
64,491,159,15,144,1,143,4,15,20,13,0,2,0,23,2,64
64,492,217,38,179,8,171,1,17,35,15,10,1,3,28,2,59
64,493,1246,228,1018,21,997,33,114,297,86,30,6,1,181,18,231
64,494,189,26,163,0,163,3,17,46,29,0,2,1,22,2,41
64,495,4392,827,3565,75,3490,144,464,888,383,88,25,13,590,63,832
64,496,3711,633,3078,70,3008,86,315,679,363,59,9,12,395,40,1050
64,498,301,37,264,6,258,4,35,40,22,3,0,1,75,11,67
64,499,3911,783,3128,56,3072,66,385,697,337,56,18,13,500,54,946
64,500,256,38,218,9,209,6,27,41,29,5,1,0,35,7,58
64,501,505,69,436,10,426,10,48,79,65,4,3,1,66,4,146
64,502,490,61,429,6,423,5,62,108,44,2,3,1,87,6,105
64,503,70,13,57,0,57,1,12,15,8,1,0,0,3,1,16
64,504,1897,373,1524,54,1470,62,146,434,172,61,17,3,231,23,321
64,505,215,27,188,5,183,2,37,26,24,4,0,2,26,6,56
64,506,161,26,135,2,133,5,20,27,13,2,0,0,30,6,30
64,507,105,12,93,0,93,2,7,19,10,0,0,0,22,1,32
64,508,114,9,105,1,104,3,6,23,6,3,0,0,24,1,38
64,509,141,38,103,1,102,6,11,17,8,2,1,0,20,0,37
64,510,709,85,624,23,601,4,85,108,55,14,3,1,123,19,189
64,511,2231,306,1925,37,1888,50,284,424,184,26,5,2,299,40,574
64,512,207,28,179,7,172,6,25,33,18,2,3,1,34,0,50
64,513,982,150,832,19,813,20,114,198,65,16,5,1,180,10,204
64,514,162,27,135,3,132,7,21,33,12,0,1,0,22,2,34
64,515,179,26,153,3,150,4,22,18,9,2,1,1,49,1,43
64,516,307,44,263,3,260,5,35,45,18,3,2,0,78,4,70
64,517,150,22,128,3,125,0,25,15,15,3,2,0,32,0,33
64,518,722,108,614,11,603,11,86,108,58,6,1,1,133,9,190
64,519,2864,401,2463,41,2422,41,325,587,259,28,5,4,448,32,693
64,520,601,92,509,5,504,17,48,139,47,2,0,2,116,7,126
64,521,419,49,370,3,367,2,61,77,48,9,0,1,51,5,113
64,522,403,64,339,3,336,11,46,83,37,9,1,2,74,6,67
64,523,520,94,426,9,417,6,60,65,50,3,2,1,74,10,146
64,524,299,50,249,5,244,10,36,44,35,7,0,1,35,5,71
64,525,509,62,447,8,439,4,54,87,43,4,4,1,65,4,173
64,526,987,127,860,16,844,17,135,182,104,13,4,2,137,10,240
64,527,964,133,831,9,822,35,107,243,77,16,7,2,137,20,178
64,528,154,21,133,8,125,6,11,22,14,7,2,0,32,3,28
64,529,261,36,225,2,223,4,34,41,15,3,0,0,45,4,77
64,530,267,27,240,1,239,8,26,43,24,3,1,2,45,4,83
64,531,44,14,30,0,30,2,8,8,2,0,0,0,8,0,2
64,532,59,7,52,0,52,0,12,16,2,0,0,0,12,0,10
64,533,460,87,373,5,368,6,31,62,56,6,3,2,85,6,111
64,534,180,22,158,2,156,4,11,40,15,1,0,0,32,2,51
64,535,358,62,296,12,284,6,47,61,45,2,3,0,33,6,81
64,536,662,97,565,9,556,14,69,136,59,10,5,1,92,12,158
64,537,131,23,108,2,106,3,10,22,10,2,0,0,23,1,35
64,538,578,100,478,14,464,30,48,126,40,12,4,2,78,5,119
64,539,172,30,142,7,135,3,10,47,3,4,1,0,29,5,33
64,540,1787,307,1480,37,1443,35,227,335,164,22,4,3,182,35,436
64,541,239,22,217,4,213,7,37,31,27,0,0,0,34,6,71
64,542,67,12,55,3,52,0,3,8,14,2,0,1,11,1,12
64,543,313,110,203,7,196,14,30,57,19,8,4,0,26,5,33
64,544,62,11,51,1,50,0,5,11,7,3,0,0,22,0,2
64,545,6846,1164,5682,118,5564,210,652,1423,767,173,46,10,676,95,1512
64,546,1639,224,1415,19,1396,29,188,386,173,38,6,3,171,30,372
64,547,4735,783,3952,96,3856,143,503,936,484,103,17,7,578,46,1039
64,548,134,22,112,2,110,0,11,39,8,1,0,0,18,2,31
64,549,719,87,632,9,623,14,114,171,49,3,4,0,108,6,154
64,550,587,79,508,12,496,13,50,118,54,6,1,0,102,10,142
64,551,230,14,216,1,215,5,32,43,25,1,1,0,40,1,67
64,552,154,17,137,2,135,0,19,25,13,4,0,0,31,0,43
64,554,144,19,125,0,125,2,13,24,19,3,0,0,20,1,43
64,555,128,16,112,6,106,3,10,24,8,0,1,0,28,3,29
64,556,316,53,263,6,257,2,50,33,21,2,0,0,50,4,95
64,557,319,44,275,8,267,5,39,46,33,4,0,0,39,5,96
64,558,1778,295,1483,39,1444,50,244,350,161,34,5,1,180,21,398
64,559,642,117,525,10,515,20,41,85,98,8,2,0,64,3,194
64,560,143,19,124,4,120,5,15,19,13,3,1,1,24,0,39
65,1,214,24,190,6,184,0,20,47,24,5,1,0,17,2,68
65,2,630,69,561,13,548,7,108,119,65,11,2,2,55,13,166
65,3,113,18,95,3,92,5,2,11,11,2,1,2,7,0,51
65,4,321,32,289,6,283,9,35,52,43,2,3,0,37,4,98
65,5,335,38,297,5,292,5,27,43,56,4,2,1,38,7,109
65,6,270,62,208,4,204,5,35,54,18,1,1,0,18,1,71
65,7,1099,126,973,13,960,22,145,193,169,13,9,1,109,14,285
65,9,158,22,136,1,135,8,10,14,27,2,1,0,14,5,54
65,10,196,18,178,4,174,4,24,29,29,1,2,0,18,4,63
65,11,115,16,99,3,96,1,16,19,12,2,0,0,14,1,31
65,12,65,11,54,1,53,3,11,6,10,0,1,0,5,2,15
65,13,58,16,42,5,37,0,13,11,2,0,1,0,3,0,7
65,14,38,5,33,1,32,3,5,2,5,0,0,0,3,0,14
65,15,93,13,80,5,75,3,17,22,6,1,0,0,13,1,12
65,16,110,12,98,4,94,1,9,6,31,1,0,0,12,2,32
65,17,302,54,248,6,242,10,24,44,40,10,0,0,31,3,80
65,18,117,21,96,3,93,2,18,13,6,0,0,1,28,1,24
65,19,415,39,376,11,365,12,58,65,56,9,4,1,44,7,109
65,20,212,26,186,3,183,1,39,40,26,1,1,0,25,0,50
65,21,353,58,295,6,289,12,48,44,42,2,0,0,31,4,106
65,22,98,15,83,2,81,3,6,11,13,1,0,0,17,3,27
65,23,24,9,15,0,15,0,0,2,6,0,0,0,2,0,5
65,24,116,19,97,2,95,0,14,20,13,0,0,0,18,1,29
65,25,2583,498,2085,42,2043,59,240,502,278,41,18,4,209,29,663
65,26,57,9,48,0,48,3,9,3,6,0,0,0,5,3,19
65,27,61,6,55,2,53,0,3,7,9,0,0,0,5,1,28
65,28,157,13,144,2,142,0,27,30,19,2,0,2,10,1,51
65,29,439,50,389,5,384,10,48,62,73,3,3,3,37,4,141
65,31,685,131,554,6,548,24,76,117,99,10,3,0,47,2,170
65,32,620,76,544,10,534,10,48,83,76,12,6,1,67,13,218
65,33,81,17,64,1,63,0,8,14,9,2,0,0,4,1,25
65,34,37,4,33,0,33,0,4,0,9,0,0,0,3,0,17
65,35,396,72,324,3,321,8,77,66,42,7,1,1,20,9,90
65,36,113,8,105,5,100,3,13,9,17,1,0,0,12,2,43
65,37,78,8,70,0,70,1,9,11,11,1,1,0,9,1,26
65,38,21,1,20,1,19,4,0,3,2,0,0,0,5,0,5
65,39,57,10,47,2,45,0,12,8,5,0,0,0,3,0,17
65,40,188,18,170,2,168,5,27,31,25,1,0,0,14,5,60
65,41,96,16,80,3,77,3,9,12,14,0,5,0,5,1,28
65,42,468,73,395,15,380,6,56,61,66,6,5,2,30,8,140
65,43,170,21,149,3,146,5,16,11,32,7,1,0,17,3,54
65,44,227,56,171,5,166,2,33,41,27,6,0,0,11,6,40
65,45,237,25,212,3,209,14,34,45,33,1,0,0,19,2,61
65,46,100,25,75,5,70,3,9,14,9,0,0,1,6,0,28
65,47,5640,825,4815,93,4722,86,735,790,843,67,25,8,378,73,1717
65,48,587,73,514,8,506,4,95,98,101,4,2,1,36,8,157
65,49,226,30,196,8,188,5,29,35,22,1,0,0,28,4,64
65,50,65,13,52,1,51,1,4,24,5,0,0,1,6,0,10
65,51,187,34,153,9,144,9,17,31,21,1,0,1,15,0,49
65,52,62,9,53,1,52,2,3,9,14,1,0,0,6,1,16
65,53,45,4,41,4,37,0,4,11,8,2,0,0,2,0,10
65,54,492,86,406,12,394,10,52,56,79,4,2,1,34,5,151
65,55,254,38,216,7,209,11,38,38,23,4,3,0,16,1,75
65,56,351,50,301,4,297,4,47,70,39,7,4,0,34,6,86
65,57,820,93,727,20,707,9,102,158,78,6,2,2,77,14,259
65,58,150,23,127,5,122,1,15,14,18,1,2,0,6,3,62
65,59,5977,1238,4739,106,4633,134,490,887,775,57,23,8,498,62,1699
65,60,55,9,46,3,43,14,4,2,6,0,0,0,8,0,9
65,61,43,5,38,2,36,1,8,12,2,0,1,0,7,1,4
65,62,2571,330,2241,49,2192,26,312,442,383,29,6,3,202,28,761
65,63,132,13,119,4,115,6,21,18,22,1,0,0,10,1,36
65,64,73,13,60,0,60,1,10,14,8,0,2,0,7,1,17
65,65,224,35,189,3,186,0,26,59,21,2,5,0,30,5,38
65,66,40,16,24,1,23,0,1,0,0,0,0,0,7,0,15
65,67,116,12,104,4,100,1,20,18,23,4,0,0,15,0,19
65,68,21,4,17,3,14,1,1,2,0,0,0,0,0,2,8
65,69,982,154,828,20,808,21,119,123,147,10,4,4,77,15,288
65,70,348,37,311,2,309,3,60,101,29,2,2,0,31,10,71
65,71,35,3,32,1,31,4,0,4,2,0,0,0,11,0,10
65,72,1335,177,1158,24,1134,16,178,143,299,20,3,3,74,12,386
65,73,249,37,212,3,209,4,46,47,34,4,0,0,19,4,51
65,74,115,21,94,0,94,3,16,7,9,1,0,2,14,2,40
65,75,121,14,107,2,105,0,14,29,19,0,0,0,6,5,32
65,76,49,8,41,2,39,0,6,7,4,3,1,0,4,1,13
65,77,314,29,285,8,277,4,25,47,42,4,1,1,41,5,107
65,78,372,55,317,5,312,9,36,42,74,7,2,0,33,4,105
65,79,170,26,144,0,144,3,35,16,20,1,2,0,11,3,53
65,80,420,47,373,8,365,12,54,59,46,5,3,0,47,8,131
65,81,79,5,74,2,72,2,9,3,18,1,3,0,10,0,26
65,82,45,9,36,1,35,2,4,4,2,0,0,0,9,0,14
65,83,545,70,475,2,473,7,68,91,94,7,0,2,55,9,140
65,84,258,30,228,6,222,3,29,36,31,3,1,0,38,1,80
65,85,88,17,71,1,70,1,5,26,11,1,1,0,9,0,16
65,86,123,13,110,2,108,0,13,15,12,2,1,0,13,2,50
65,87,146,21,125,3,122,2,16,17,44,0,2,0,12,4,25
65,88,38,10,28,0,28,0,1,6,9,0,0,0,2,2,8
65,89,107,17,90,1,89,2,8,19,9,2,1,1,11,5,31
65,90,58,9,49,0,49,0,11,20,3,1,0,0,4,0,10
65,91,66,10,56,1,55,1,7,3,7,1,0,1,7,0,28
65,92,167,40,127,6,121,1,9,11,28,2,1,0,6,1,62
65,93,214,35,179,0,179,6,24,23,31,3,0,0,11,2,79
65,94,110,21,89,0,89,3,22,15,11,0,1,0,10,1,26
65,95,233,34,199,7,192,7,30,38,29,4,3,0,21,9,51
65,96,70,10,60,0,60,0,7,8,11,0,2,0,5,1,26
65,97,156,36,120,3,117,1,19,25,14,0,0,1,10,0,47
65,98,247,26,221,2,219,6,27,30,31,3,1,0,28,5,88
65,99,139,22,117,0,117,5,13,36,16,3,1,0,5,0,38
65,100,3261,465,2796,37,2759,36,461,401,519,24,18,3,290,42,965
65,101,566,94,472,8,464,8,74,66,81,5,2,1,58,7,162
65,102,22,2,20,0,20,0,3,3,1,0,0,0,3,2,8
65,103,85,24,61,2,59,0,20,15,5,0,0,0,5,1,13
65,104,230,31,199,5,194,5,21,70,29,1,1,2,25,1,39
65,105,162,25,137,4,133,12,21,21,25,5,0,0,16,2,31
65,106,140,18,122,0,122,7,13,32,17,2,0,0,13,1,37
65,107,73,1,72,0,72,1,15,13,9,0,0,0,13,0,21
65,108,611,73,538,9,529,12,83,107,67,11,2,2,72,10,163
65,109,36,4,32,1,31,0,4,3,3,1,0,0,0,0,20
65,110,69,14,55,2,53,2,10,14,2,0,0,0,7,1,17
65,111,68,8,60,2,58,0,6,5,13,0,0,0,7,1,26
65,112,117,7,110,1,109,6,9,8,14,1,1,0,18,3,49
65,113,231,32,199,7,192,2,30,30,21,2,1,0,23,2,81
65,114,73,7,66,0,66,1,16,10,11,0,0,0,5,3,20
65,115,222,29,193,3,190,2,25,44,33,5,4,0,20,8,49
65,116,187,36,151,2,149,9,17,37,27,2,2,0,12,0,43
65,117,70,13,57,4,53,0,3,7,12,0,0,0,6,1,24
65,118,30,5,25,1,24,0,0,17,0,0,0,0,1,0,6
65,119,307,51,256,3,253,8,42,43,37,4,1,2,24,3,89
65,120,215,26,189,7,182,7,35,30,28,1,2,1,17,5,56
65,121,338,67,271,8,263,1,48,62,53,1,0,0,21,5,72
65,122,30,5,25,0,25,3,0,0,4,0,0,0,3,0,15
65,123,1392,229,1163,33,1130,30,109,196,207,16,7,4,130,14,417
65,124,77,11,66,0,66,3,9,17,13,1,0,0,4,0,19
65,125,279,44,235,2,233,2,32,30,36,3,0,0,28,12,90
65,126,130,19,111,3,108,0,17,23,11,4,0,0,8,2,43
65,127,1023,174,849,11,838,13,111,123,183,7,8,4,87,22,280
65,128,111,21,90,5,85,0,8,18,17,0,0,0,8,1,33
65,129,576,103,473,6,467,13,70,114,59,6,0,3,42,12,148
65,130,428,66,362,2,360,7,50,63,61,5,1,0,36,3,134
65,131,194,35,159,5,154,4,28,27,17,2,1,0,18,3,54
65,132,40,7,33,0,33,0,7,1,5,0,0,0,5,2,13
65,133,154,26,128,9,119,3,20,24,13,0,0,0,16,1,42
65,134,11,3,8,2,6,0,0,2,0,0,0,0,1,0,3
65,135,79,12,67,0,67,0,12,9,12,0,1,0,13,1,19
65,136,41,2,39,1,38,0,7,16,3,1,0,0,4,0,7
65,137,83,12,71,0,71,6,4,20,7,4,0,0,5,2,23
65,138,995,124,871,10,861,18,107,345,106,5,2,4,103,16,155
65,139,50,9,41,0,41,2,3,0,10,0,1,1,3,0,21
65,140,29,7,22,1,21,2,3,1,1,0,0,0,3,1,10
65,141,67,10,57,1,56,3,5,7,9,3,0,1,5,1,22
65,142,171,36,135,2,133,7,32,14,17,4,0,0,10,2,47
65,143,104,16,88,2,86,3,10,10,17,0,0,2,18,0,26
65,144,77,8,69,1,68,2,9,15,9,2,0,0,13,2,16
65,145,55,15,40,1,39,0,5,1,9,0,1,0,7,2,14
65,146,236,23,213,2,211,0,48,42,30,7,1,0,14,9,60
65,147,494,63,431,12,419,5,55,55,60,7,1,0,48,11,177
65,148,118,16,102,1,101,3,14,41,9,1,0,0,3,3,27
65,149,151,15,136,6,130,3,17,18,13,1,0,0,15,3,60
65,150,393,51,342,6,336,7,65,55,51,3,1,0,25,3,126
65,151,120,20,100,1,99,2,14,23,15,1,2,0,19,1,22
65,153,112,20,92,0,92,1,14,25,12,2,1,0,9,1,27
65,154,36,2,34,0,34,0,15,4,4,2,1,0,2,2,4
65,155,56,2,54,1,53,2,2,13,16,0,0,0,4,0,16
65,156,195,37,158,4,154,1,29,17,29,1,0,1,11,4,61
65,157,24,12,12,2,10,0,2,2,0,0,0,0,0,0,6
65,158,94,12,82,1,81,0,9,22,10,0,0,0,3,1,36
65,159,310,50,260,6,254,3,49,35,40,5,5,1,22,2,92
65,160,93,8,85,1,84,0,9,11,6,1,1,1,18,0,37
65,161,202,23,179,6,173,4,39,30,22,5,0,0,14,8,51
65,162,40,10,30,0,30,2,3,6,6,1,0,0,5,0,7
65,163,33,8,25,0,25,4,1,5,0,0,0,1,4,1,9
65,164,80,15,65,2,63,0,13,8,21,1,1,0,8,1,10
65,165,161,26,135,4,131,2,22,18,29,4,0,0,11,4,41
65,166,44,2,42,0,42,4,8,4,10,1,0,0,4,0,11
65,167,36,6,30,1,29,0,4,4,3,0,0,0,6,0,12
65,168,335,53,282,8,274,11,23,46,61,8,2,0,26,4,93
65,169,93,14,79,4,75,5,9,15,8,0,2,0,10,0,26
65,170,71,12,59,0,59,1,11,14,7,3,0,2,8,0,13
65,171,36,4,32,2,30,0,4,10,5,1,0,0,1,1,8
65,172,38,5,33,0,33,0,3,0,7,0,0,0,2,0,21
65,173,168,19,149,3,146,8,8,25,41,1,1,0,10,1,51
65,174,77,8,69,3,66,3,9,11,6,3,2,0,6,3,23
65,175,83,16,67,0,67,0,18,15,11,1,0,0,4,0,18
65,176,103,15,88,3,85,1,17,10,14,3,0,0,11,6,23
65,177,130,18,112,0,112,1,18,28,4,2,0,0,11,2,46
65,178,38,1,37,1,36,2,10,7,3,0,0,0,2,0,12
65,179,32,3,29,0,29,3,0,3,9,0,0,0,1,0,13
65,180,18,3,15,0,15,0,0,0,3,0,0,0,5,0,7
65,181,114,20,94,2,92,2,11,22,12,2,0,1,11,1,30
65,182,103,13,90,1,89,1,5,21,10,4,0,0,11,0,37
65,183,509,92,417,17,400,1,80,114,34,9,3,1,42,10,106
65,184,137,20,117,3,114,0,16,24,34,2,1,0,16,2,19
65,185,372,45,327,7,320,3,55,70,24,2,1,0,73,9,83
65,186,43,2,41,0,41,0,7,13,5,0,0,0,0,0,16
65,187,104,10,94,5,89,4,17,19,7,2,1,0,6,2,31
65,188,171,32,139,2,137,0,23,61,15,1,1,0,14,3,19
65,189,210,27,183,1,182,4,34,19,38,3,1,0,20,6,57
65,190,72,12,60,1,59,2,9,8,13,2,1,0,5,0,19
65,191,120,13,107,3,104,3,28,11,10,1,0,1,14,0,36
65,192,260,40,220,7,213,4,14,35,62,2,1,0,31,5,59
65,193,57,8,49,0,49,1,5,14,8,0,0,0,7,1,13
65,194,99,19,80,1,79,1,14,3,14,3,1,0,3,3,37
65,195,138,20,118,1,117,4,13,18,13,4,2,0,9,0,54
65,196,86,5,81,0,81,0,25,12,10,1,0,0,4,1,28
65,197,154,19,135,5,130,0,18,26,13,5,1,0,22,2,43
65,198,936,90,846,24,822,24,64,153,135,8,3,1,77,15,342
65,199,55,16,39,0,39,0,4,14,5,3,0,0,3,0,10
65,200,122,21,101,2,99,6,10,7,12,0,0,0,6,3,55
65,201,146,24,122,3,119,2,17,17,20,0,0,0,9,2,52
65,202,253,25,228,6,222,5,31,29,44,2,2,1,18,3,87
65,203,22,3,19,1,18,0,0,1,7,0,1,0,4,1,4
65,204,35,14,21,0,21,1,5,1,1,0,0,0,8,0,5
65,205,77,3,74,3,71,3,4,19,11,2,1,0,5,1,25
65,206,212,32,180,1,179,5,22,29,15,3,1,0,13,6,85
65,207,58,7,51,2,49,0,11,12,13,0,0,0,4,1,8
65,208,37,6,31,1,30,1,4,5,7,0,0,0,0,0,13
65,209,94,15,79,2,77,2,9,22,8,0,1,0,6,0,29
65,210,44,8,36,1,35,0,4,2,13,0,0,0,3,0,13
65,211,152,22,130,4,126,7,7,31,34,2,2,1,14,1,27
65,212,253,53,200,5,195,7,28,43,32,4,1,0,29,7,44
65,213,107,14,93,4,89,0,18,25,9,1,0,0,10,6,20
65,214,35,4,31,2,29,0,5,9,0,0,0,0,1,5,9
65,215,42,6,36,0,36,1,1,10,3,0,0,0,4,1,16
65,216,89,15,74,1,73,2,5,7,22,2,1,0,8,2,24
65,217,45,5,40,1,39,1,1,3,5,0,0,0,13,2,14
65,218,524,102,422,8,414,25,44,50,78,6,3,0,40,10,158
65,219,104,24,80,1,79,1,24,14,7,0,0,1,11,0,21
65,220,179,14,165,3,162,7,29,23,31,5,2,0,21,1,43
65,221,166,16,150,3,147,1,28,21,18,1,1,0,10,1,66
65,222,136,12,124,5,119,2,13,17,17,4,5,0,18,4,39
65,223,988,111,877,22,855,18,123,198,90,9,3,2,105,16,291
65,224,196,23,173,3,170,0,28,24,25,6,1,1,23,1,61
65,225,109,16,93,3,90,3,20,11,2,1,0,0,16,1,36
65,226,1978,250,1728,22,1706,36,260,371,230,17,7,6,197,30,552
65,228,142,37,105,3,102,0,9,4,22,2,1,0,9,2,53
65,229,32,7,25,1,24,0,13,4,3,0,0,0,0,0,4
65,230,223,33,190,5,185,4,21,39,27,0,2,0,22,4,66
65,231,163,27,136,5,131,0,11,14,20,1,1,0,21,1,62
65,232,56,8,48,0,48,0,5,11,6,3,0,0,4,0,19
65,233,239,33,206,5,201,2,25,53,27,5,1,1,24,7,56
65,234,100,17,83,6,77,2,10,15,15,2,0,0,4,2,27
65,235,3078,370,2708,59,2649,51,478,540,329,40,16,11,288,40,856
65,236,248,38,210,5,205,2,41,61,23,2,1,1,13,3,58
65,237,129,21,108,5,103,2,19,16,11,3,1,1,15,4,31
65,238,223,42,181,1,180,1,13,24,35,6,2,1,20,2,76
65,239,145,23,122,1,121,3,8,26,28,3,4,0,20,1,28
65,240,300,50,250,6,244,10,53,54,31,3,0,1,19,5,68
65,241,82,11,71,2,69,0,3,11,7,3,1,0,9,1,34
65,242,190,26,164,6,158,2,23,44,18,0,1,0,16,4,50
65,243,355,56,299,2,297,4,48,44,42,5,3,0,31,13,107
65,244,410,33,377,4,373,4,78,56,89,2,2,1,24,13,104
65,245,206,29,177,4,173,3,34,27,34,1,0,0,11,4,59
65,247,90,16,74,1,73,2,17,9,5,3,0,1,8,0,28
65,248,197,28,169,6,163,5,26,24,19,5,0,2,19,4,59
65,249,53,4,49,1,48,0,12,9,4,0,1,0,7,1,14
65,250,103,19,84,2,82,2,12,20,8,4,0,0,8,1,27
65,251,1354,164,1190,16,1174,23,165,319,142,9,3,1,129,23,360
65,252,592,66,526,11,515,15,78,128,54,6,1,0,81,6,146
65,253,50,4,46,0,46,0,9,8,1,1,0,0,3,0,24
65,254,118,25,93,2,91,1,32,13,13,0,1,0,5,1,25
65,255,40,6,34,3,31,0,2,6,5,0,0,0,7,0,11
65,256,117,9,108,0,108,1,12,20,13,1,0,1,9,1,50
65,257,427,53,374,15,359,8,57,70,42,3,1,0,53,6,119
65,258,3829,762,3067,78,2989,44,481,603,405,40,14,12,263,47,1080
65,259,148,18,130,2,128,0,24,23,14,1,0,0,20,2,44
65,260,63,2,61,2,59,0,11,17,8,0,1,0,5,2,15
65,261,46,6,40,3,37,0,3,7,7,1,0,0,2,0,17
65,262,320,72,248,6,242,3,32,33,45,9,3,2,20,4,91
65,263,79,4,75,0,75,3,12,10,9,0,2,0,6,1,32
65,264,248,34,214,4,210,5,33,38,33,5,1,0,18,4,73
65,265,249,35,214,4,210,1,33,46,31,2,1,0,29,4,63
65,266,30,4,26,0,26,1,6,3,2,0,1,0,3,0,10
65,267,473,63,410,5,405,7,62,93,37,4,2,0,61,9,130
65,268,151,25,126,3,123,2,6,20,14,0,0,0,32,1,48
65,269,144,29,115,0,115,2,34,20,11,1,0,1,14,0,32
65,270,172,15,157,2,155,0,29,26,17,4,0,0,24,5,50
65,271,303,37,266,7,259,5,48,55,22,5,2,1,41,3,77
65,272,73,11,62,2,60,1,12,12,5,2,0,0,9,1,18
65,273,171,25,146,5,141,0,31,19,23,1,2,0,10,1,54
65,274,117,16,101,6,95,2,27,21,6,2,0,2,14,1,20
65,275,59,9,50,3,47,2,9,5,9,1,0,0,4,0,17
65,276,82,6,76,0,76,3,13,24,11,2,0,0,7,1,15
65,277,67,5,62,2,60,1,14,2,12,1,0,0,1,0,29
65,278,44,9,35,0,35,3,2,2,7,4,0,0,7,0,10
65,279,180,24,156,7,149,7,21,17,40,2,1,2,11,4,44
65,280,343,52,291,6,285,1,44,72,30,2,1,1,51,4,79
65,281,159,20,139,4,135,1,24,16,20,3,1,2,20,2,46
65,282,248,39,209,1,208,2,20,64,33,2,0,0,23,2,62
65,283,68,10,58,4,54,4,3,10,17,1,1,0,4,1,13
65,284,777,74,703,13,690,13,93,152,100,7,4,1,82,12,226
65,285,130,17,113,1,112,1,18,24,20,1,1,1,11,0,35
65,286,11201,2291,8910,172,8738,126,1403,2575,801,110,39,24,1006,206,2448
65,287,491,114,377,6,371,9,66,83,48,3,3,2,28,5,124
65,288,81,23,58,2,56,1,6,11,8,0,0,1,9,0,20
65,289,97,17,80,3,77,0,11,6,17,0,2,1,11,0,29
65,290,184,30,154,3,151,1,18,18,20,6,2,1,16,1,68
65,291,131,22,109,2,107,2,14,29,20,1,1,0,14,1,25
65,292,293,37,256,7,249,5,39,48,17,2,0,0,52,11,75
65,293,107,23,84,3,81,0,21,14,6,1,0,0,7,2,30
65,294,179,37,142,3,139,6,26,25,21,2,0,0,15,3,41
65,295,909,149,760,18,742,21,61,155,161,15,3,1,82,4,239
65,296,386,78,308,5,303,6,40,92,29,4,2,0,41,10,79
65,297,41,4,37,0,37,0,12,4,4,1,0,1,3,2,10
65,298,78,10,68,2,66,0,6,14,11,1,0,2,14,1,17
65,299,210,28,182,4,178,1,37,29,18,2,3,0,13,3,72
65,300,72,14,58,0,58,5,3,7,21,1,1,0,5,0,15
65,301,197,30,167,1,166,5,35,23,31,2,1,1,18,1,49
65,303,300,44,256,6,250,1,45,52,42,0,2,1,31,6,70
65,304,1793,296,1497,39,1458,14,241,288,213,21,9,4,154,29,485
65,305,127,27,100,1,99,1,17,35,14,0,0,0,7,1,24
65,306,199,26,173,2,171,4,29,39,28,2,0,0,24,0,45
65,307,307,45,262,5,257,3,46,34,42,3,3,0,18,1,107
65,308,107,21,86,2,84,1,8,11,13,2,0,0,18,8,23
65,309,20,5,15,0,15,1,4,0,3,3,0,0,2,0,2
65,310,220,39,181,1,180,4,29,24,26,3,2,0,16,2,74
65,311,64,4,60,3,57,0,8,14,4,1,1,0,9,0,20
65,312,30,3,27,0,27,3,1,4,12,0,0,0,2,0,5
65,313,567,75,492,11,481,5,75,120,58,2,2,2,54,8,155
65,314,162,37,125,6,119,3,15,25,18,3,1,1,33,2,18
65,315,315,61,254,6,248,8,37,59,52,4,3,0,16,0,69
65,316,90,15,75,4,71,2,6,11,16,0,1,0,7,0,28
65,317,49,10,39,0,39,5,3,8,16,0,0,0,1,0,6
65,318,200,39,161,3,158,2,31,24,24,1,0,3,23,1,49
65,319,123,14,109,1,108,0,28,12,17,2,0,0,15,0,34
65,320,681,90,591,12,579,16,66,95,95,5,6,2,64,5,225
65,321,95,10,85,2,83,1,10,5,9,2,0,0,10,1,45
65,322,200,29,171,2,169,0,33,20,35,6,1,0,17,2,55
65,323,55,9,46,2,44,3,4,5,2,0,0,0,7,1,22
65,324,162,23,139,3,136,5,22,14,22,2,0,0,7,1,63
65,325,50,11,39,1,38,0,5,14,3,0,0,0,2,0,14
65,326,88,20,68,1,67,0,11,15,6,0,1,0,9,0,25
65,327,153,31,122,4,118,0,13,17,26,4,1,0,13,1,43
65,328,64,10,54,0,54,3,8,5,19,2,0,0,8,1,8
65,329,230,38,192,6,186,2,21,28,32,2,1,1,21,5,73
65,330,170,23,147,6,141,1,26,27,18,1,0,2,28,1,37
65,331,2713,356,2357,36,2321,70,304,544,313,28,6,6,277,38,735
65,332,120,9,111,0,111,1,17,27,18,5,0,0,8,5,30
65,333,107,18,89,0,89,0,12,17,9,1,1,0,16,3,30
65,334,193,24,169,2,167,3,34,27,16,2,3,0,24,0,58
65,335,362,40,322,2,320,6,26,40,91,7,1,1,31,3,114
65,336,40,5,35,1,34,1,4,9,2,0,0,0,6,1,11
65,337,103,18,85,1,84,1,16,17,12,1,0,0,2,0,35
65,338,209,24,185,4,181,3,17,14,41,3,1,0,14,1,87
65,339,243,19,224,8,216,9,41,40,27,2,4,0,29,3,61
65,340,1469,201,1268,14,1254,21,209,244,182,11,3,0,122,21,441
65,341,97,5,92,2,90,0,13,37,8,1,0,1,18,1,11
65,342,65,12,53,2,51,0,12,8,10,4,0,0,6,0,11
65,343,162,18,144,2,142,7,18,20,15,3,0,0,31,1,47
65,344,1772,281,1491,31,1460,37,265,338,159,15,5,1,166,26,448
65,345,30,3,27,1,26,1,3,3,6,0,0,0,2,0,11
65,346,134,16,118,1,117,3,16,22,17,3,0,0,9,1,46
65,347,47,10,37,1,36,2,6,1,7,0,0,0,5,0,15
65,348,47,3,44,2,42,0,4,6,1,2,0,0,9,3,17
65,349,14,2,12,1,11,0,3,1,2,1,0,0,3,0,1
65,350,1094,190,904,24,880,14,87,175,182,10,8,2,78,6,318
65,351,42,10,32,0,32,1,1,4,8,0,0,0,4,0,14
65,352,166,21,145,0,145,4,16,21,18,2,1,0,31,4,48
65,353,217,26,191,7,184,2,20,22,28,3,1,0,20,1,87
65,354,53,7,46,0,46,2,10,11,10,1,0,0,3,1,8
65,355,61,8,53,1,52,0,5,16,7,0,0,0,9,0,15
65,356,43,6,37,1,36,0,9,4,2,1,0,0,10,0,10
65,357,129,22,107,4,103,2,14,10,21,1,0,0,3,1,51
65,358,55,5,50,3,47,0,7,5,7,0,1,0,3,0,24
65,359,19,4,15,3,12,0,1,3,1,0,0,0,1,0,6
65,360,216,25,191,0,191,4,41,35,10,6,1,1,41,1,51
65,361,79,10,69,1,68,1,11,11,6,0,1,0,2,1,35
65,362,994,144,850,25,825,18,116,132,139,15,7,0,82,13,303
65,363,457,86,371,8,363,2,45,66,65,6,2,1,28,6,142
65,364,23,3,20,1,19,0,0,5,0,0,0,0,7,0,7
65,366,686,77,609,10,599,8,114,123,80,7,4,0,77,14,172
65,367,117,16,101,2,99,1,10,10,16,1,0,0,15,1,45
65,368,25,2,23,0,23,0,3,8,1,1,0,0,1,0,9
65,369,520,50,470,2,468,7,69,81,66,6,2,0,58,4,175
65,370,988,109,879,19,860,22,78,113,158,18,5,1,109,21,335
65,371,183,25,158,4,154,2,14,36,24,1,2,2,18,6,49
65,372,484,60,424,8,416,5,84,71,65,4,1,0,37,14,135
65,373,169,32,137,6,131,1,20,24,12,5,2,1,19,0,47
65,374,201,35,166,2,164,3,31,30,19,3,2,1,13,5,57
65,375,972,163,809,11,798,11,184,172,83,10,0,1,81,7,249
65,376,159,29,130,2,128,1,21,16,14,1,1,1,23,5,45
65,377,159,22,137,4,133,0,30,27,21,2,0,1,8,6,38
65,378,64,8,56,2,54,0,7,17,4,0,0,0,3,0,23
65,379,12,1,11,1,10,0,0,1,5,1,0,0,0,0,3
65,380,106,16,90,2,88,1,15,15,11,6,0,0,7,0,33
65,381,35,7,28,0,28,0,3,12,2,0,0,0,10,0,1
65,382,54,10,44,1,43,0,15,7,12,2,0,0,0,1,6
65,383,162,12,150,2,148,2,16,41,42,0,2,0,11,3,31
65,384,108,22,86,1,85,1,7,16,13,2,0,0,10,4,32
65,385,104,11,93,1,92,6,11,22,10,0,1,0,10,0,32
65,386,81,18,63,6,57,0,12,9,4,0,0,0,7,2,23
65,387,102,14,88,1,87,4,10,29,6,0,0,0,7,3,28
65,388,608,118,490,6,484,4,50,175,58,3,2,2,49,6,135
65,389,764,146,618,15,603,15,86,94,127,12,4,3,54,11,197
65,390,346,40,306,3,303,5,47,65,57,5,3,0,25,6,90
65,391,32,2,30,0,30,0,3,2,5,0,0,0,0,4,16
65,392,296,44,252,4,248,1,39,47,33,2,0,0,24,5,97
65,393,106,17,89,5,84,0,17,12,15,2,1,0,6,3,28
65,394,229,34,195,1,194,2,36,48,50,3,1,0,13,3,38
65,395,955,139,816,15,801,13,138,178,81,12,4,0,130,11,234
65,396,336,37,299,11,288,8,26,54,55,4,2,1,33,7,98
65,397,122,14,108,1,107,2,25,8,17,3,0,0,7,1,44
65,398,177,25,152,2,150,9,17,27,24,2,2,0,11,1,57
65,399,74,12,62,1,61,0,4,6,8,3,0,1,7,2,30
65,400,164,30,134,1,133,7,11,24,11,5,2,0,22,6,45
65,401,386,39,347,7,340,5,57,53,82,2,1,1,37,5,97
65,402,18,2,16,2,14,1,4,1,1,1,0,0,2,0,4
65,403,78,16,62,5,57,0,7,6,6,0,0,0,4,2,32
65,404,124,10,114,3,111,4,28,35,7,1,0,1,8,4,23
65,405,71,8,63,1,62,0,9,10,10,0,0,0,6,4,23
65,406,196,23,173,4,169,2,27,23,49,2,0,0,17,2,47
65,407,97,29,68,0,68,0,12,6,12,1,0,0,6,0,31
65,408,526,89,437,10,427,13,55,66,88,9,0,0,37,5,154
65,409,244,30,214,2,212,2,36,54,27,7,0,0,27,2,57
65,410,476,93,383,9,374,7,77,70,42,3,2,1,49,6,117
65,411,68,10,58,2,56,0,3,4,11,0,0,0,5,1,32
65,412,133,27,106,2,104,1,19,27,10,2,0,0,10,4,31
65,413,109,17,92,5,87,0,11,13,26,2,2,0,7,0,26
65,414,86,13,73,2,71,3,7,22,3,2,0,0,13,1,20
65,415,209,26,183,3,180,3,20,38,23,3,0,0,28,6,59
65,416,68,14,54,2,52,3,5,8,7,0,2,0,4,2,21
65,417,3818,653,3165,65,3100,63,427,583,519,35,16,6,294,39,1118
65,418,223,26,197,5,192,6,41,48,22,4,3,0,12,3,53
65,419,87,10,77,4,73,0,12,20,10,1,2,0,11,1,16
65,420,70,16,54,0,54,0,10,8,4,0,0,0,5,0,27
65,421,51,8,43,2,41,0,10,14,4,1,0,0,3,0,9
65,422,232,24,208,5,203,4,30,40,17,0,2,0,57,6,47
65,423,116,12,104,0,104,1,14,15,15,1,2,0,9,0,47
65,424,114,21,93,2,91,0,14,29,14,1,2,0,12,2,17
65,425,357,43,314,5,309,3,54,59,39,7,1,0,37,9,100
65,426,114,25,89,2,87,1,14,17,12,1,0,0,13,0,29
65,427,164,27,137,5,132,1,32,24,19,0,1,0,12,1,42
65,428,60,13,47,0,47,0,5,6,6,0,0,0,4,0,26
65,429,185,28,157,2,155,3,30,38,19,1,2,0,19,4,39
65,430,41,1,40,0,40,0,5,9,4,2,0,1,4,1,14
65,431,100,25,75,1,74,0,17,15,5,0,0,0,8,1,28
65,432,138,21,117,0,117,7,16,32,26,0,1,1,10,0,24
65,433,2224,289,1935,37,1898,39,270,242,468,18,8,2,144,25,682
65,435,217,37,180,5,175,2,18,25,51,3,0,0,10,5,61
65,436,236,34,202,3,199,12,38,31,20,2,1,1,21,2,71
65,437,138,18,120,0,120,5,24,34,13,0,1,0,19,1,23
65,438,60,7,53,0,53,5,8,7,8,1,1,0,2,0,21
65,439,215,30,185,5,180,1,30,36,25,1,1,0,26,5,55
65,440,27900,6520,21380,353,21027,497,3049,4768,3206,256,101,34,1925,274,6917
65,441,79,6,73,1,72,2,24,14,19,0,0,0,2,2,9
65,442,150,27,123,3,120,3,21,21,11,4,1,0,13,0,46
65,443,13,0,13,0,13,2,5,0,2,0,0,0,1,0,3
65,444,175,29,146,4,142,1,46,19,19,1,2,0,11,2,41
65,445,199,32,167,4,163,8,13,32,19,5,1,0,22,2,61
65,446,386,61,325,5,320,5,58,39,75,6,3,1,20,6,107
65,447,990,150,840,15,825,9,157,172,115,13,5,0,94,15,245
65,448,71,13,58,1,57,0,9,18,6,1,1,0,13,1,8
65,449,99,15,84,4,80,0,8,21,12,1,0,0,3,1,34
65,450,40,7,33,3,30,0,9,2,3,0,0,0,5,0,11
65,451,655,106,549,8,541,8,71,80,120,7,2,2,44,3,204
65,452,741,120,621,16,605,6,86,181,57,6,3,1,78,20,167
65,453,53,7,46,0,46,3,8,7,8,2,0,0,5,2,11
65,454,76,21,55,2,53,0,7,12,10,0,1,0,10,2,11
65,455,420,70,350,9,341,8,38,61,67,3,1,0,43,5,115
65,456,239,31,208,7,201,4,42,34,19,4,0,0,16,3,79
65,457,63,8,55,2,53,3,12,11,4,0,0,0,9,0,14
65,458,32,10,22,0,22,0,0,4,6,0,0,0,2,1,9
65,459,91,6,85,1,84,2,13,7,10,0,1,0,21,0,30
65,460,3734,734,3000,59,2941,58,549,658,396,43,15,5,286,40,891
65,461,54,9,45,0,45,0,8,19,0,0,0,0,8,0,10
65,462,212,33,179,9,170,1,27,30,28,1,1,1,28,3,50
65,463,82,17,65,0,65,2,4,7,10,0,0,0,10,0,32
65,464,401,60,341,7,334,5,44,75,52,5,1,0,31,3,118
65,465,322,40,282,7,275,4,30,66,40,5,4,0,44,3,79
65,466,74,12,62,3,59,4,0,7,20,2,1,0,6,0,19
65,467,91,8,83,3,80,11,6,5,24,0,1,0,14,0,19
65,468,39,5,34,2,32,0,9,5,3,0,0,0,6,0,9
65,469,29,7,22,1,21,1,6,4,2,0,1,0,5,1,1
65,470,114,10,104,1,103,4,23,17,10,4,2,0,12,0,31
65,471,160,22,138,5,133,3,13,38,19,2,2,0,21,5,30
65,472,80,12,68,0,68,3,14,8,8,1,1,1,4,2,26
65,473,337,37,300,3,297,2,44,54,47,5,2,1,33,5,104
65,474,113,25,88,1,87,0,20,22,13,1,0,0,8,1,22
65,475,44,8,36,0,36,0,5,5,7,2,0,0,3,1,13
65,476,54,9,45,2,43,2,8,7,0,1,0,0,11,0,14
65,477,54,7,47,4,43,0,3,5,9,1,0,0,3,0,22
65,478,48,8,40,1,39,5,2,8,8,1,0,0,5,1,9
65,479,298,36,262,6,256,4,17,43,36,5,1,0,32,2,116
65,480,34,6,28,0,28,0,3,1,11,0,1,0,3,0,9
65,481,197,29,168,3,165,7,16,49,28,1,1,0,24,4,35
65,482,382,67,315,6,309,2,46,82,31,5,1,1,28,3,110
66,1,81,13,68,0,68,4,9,26,11,3,0,1,6,0,8
66,2,2271,317,1954,32,1922,29,448,487,355,15,8,4,108,23,445
66,3,3249,772,2477,40,2437,49,594,632,261,35,17,12,155,44,638
66,4,652,160,492,14,478,15,82,186,47,7,1,0,54,1,85
66,5,461,83,378,6,372,12,59,71,76,2,2,1,22,6,121
66,6,156,31,125,4,121,2,21,18,11,2,1,0,5,2,59
66,7,102,15,87,1,86,6,14,20,16,1,0,0,8,2,19
66,8,9035,1546,7489,136,7353,162,1780,2118,714,69,30,16,432,108,1924
66,9,2048,418,1630,17,1613,39,282,293,287,34,10,4,106,30,528
66,10,82,8,74,3,71,1,19,14,10,0,0,0,8,2,17
66,11,3143,600,2543,44,2499,44,640,560,337,38,12,4,165,44,655
66,12,2303,264,2039,32,2007,36,604,521,249,25,9,2,148,25,388
66,13,83,12,71,2,69,10,10,4,12,1,1,0,6,0,25
66,14,1992,319,1673,32,1641,27,425,374,226,28,7,6,118,32,398
66,15,948,147,801,12,789,25,169,189,92,13,7,2,45,23,224
66,16,3698,624,3074,71,3003,69,568,780,402,42,21,7,223,51,840
66,17,4765,946,3819,60,3759,53,1217,1130,298,34,16,9,176,48,778
66,18,70,17,53,1,52,2,10,9,7,1,1,0,4,0,18
66,19,183,18,165,3,162,4,32,34,38,3,0,1,11,4,35
66,20,697,154,543,10,533,19,75,146,82,9,7,3,34,16,142
66,21,5778,938,4840,89,4751,88,1355,1222,483,67,27,6,274,73,1156
66,22,55,11,44,0,44,1,3,10,12,2,0,0,5,1,10
66,23,637,88,549,12,537,8,138,69,106,3,4,0,32,12,165
66,24,4195,856,3339,54,3285,51,831,876,359,42,13,6,195,65,847
66,25,799,203,596,14,582,10,104,191,69,13,4,2,32,6,151
66,26,876,117,759,26,733,17,219,175,79,11,5,1,41,13,172
66,27,457,67,390,2,388,7,100,105,49,4,1,1,30,9,82
66,28,7435,1189,6246,101,6145,111,1371,1629,991,56,11,14,416,76,1470
66,29,108,16,92,1,91,2,19,16,24,3,0,0,6,2,19
66,30,182,28,154,2,152,12,32,12,22,3,1,1,8,2,59
66,32,44,11,33,0,33,2,4,2,20,1,0,0,0,0,4
66,33,336,50,286,3,283,9,60,69,39,3,0,0,32,4,67
66,34,106,17,89,1,88,5,13,21,27,0,1,0,5,0,16
66,35,67,4,63,1,62,2,12,5,11,0,0,0,2,0,30
66,36,56,13,43,0,43,7,6,9,5,3,0,0,1,0,12
66,37,10464,1743,8721,136,8585,153,2101,2999,718,95,21,17,536,120,1825
66,38,4175,672,3503,58,3445,75,809,895,421,41,14,11,227,67,885
66,39,139,21,118,4,114,1,24,23,23,3,0,4,6,2,28
66,40,38,4,34,0,34,1,1,2,11,0,0,0,1,1,17
66,41,504,65,439,3,436,8,108,88,73,4,4,0,21,10,120
66,42,181,30,151,3,148,6,22,44,25,1,0,0,12,3,35
66,43,111,14,97,1,96,4,22,21,23,0,0,0,2,0,24
66,44,334,50,284,7,277,13,73,44,46,2,1,1,31,7,59
66,45,585,89,496,14,482,13,109,104,68,7,1,0,19,9,152
66,46,547,96,451,5,446,7,81,75,82,3,3,2,29,12,152
66,47,30,6,24,0,24,1,3,6,1,0,0,0,4,0,9
66,48,1058,215,843,14,829,10,195,149,141,17,2,2,38,9,266
66,49,6159,1189,4970,117,4853,135,792,1152,813,76,23,11,357,66,1428
66,50,2788,355,2433,40,2393,39,686,591,289,31,10,3,183,25,536
66,51,193,28,165,4,161,3,35,22,39,6,0,0,10,3,43
66,52,293,50,243,12,231,7,40,55,34,4,0,1,12,7,71
66,53,2405,326,2079,50,2029,59,326,717,217,32,11,6,131,30,500
66,54,54,10,44,2,42,4,14,8,7,0,0,0,2,0,7
66,55,433,49,384,6,378,7,113,78,58,2,2,0,24,8,86
66,56,756,74,682,14,668,12,167,120,128,11,3,1,51,3,172
66,57,317,44,273,3,270,8,40,57,59,4,2,0,15,4,81
66,58,1395,208,1187,27,1160,39,343,254,149,17,4,2,76,14,262
66,59,1502,209,1293,31,1262,16,353,295,159,10,15,3,82,16,313
66,60,162,27,135,1,134,8,25,28,29,5,0,0,6,1,32
66,61,107,18,89,4,85,6,15,14,18,0,0,0,8,1,23
66,62,147,38,109,1,108,7,11,22,23,4,4,0,6,3,28
66,63,214,32,182,3,179,2,46,48,24,2,2,1,11,4,39
66,64,361,74,287,3,284,15,60,68,32,6,1,0,26,2,74
66,65,5875,1070,4805,116,4689,98,1283,981,856,67,25,10,243,45,1081
66,66,419,94,325,7,318,17,51,57,62,7,6,0,29,2,87
66,67,406,61,345,10,335,11,62,83,66,8,0,1,30,5,69
66,68,115,18,97,4,93,8,8,10,36,5,0,0,3,1,22
66,69,2236,317,1919,35,1884,30,563,373,262,23,15,4,101,22,491
66,70,123,15,108,4,104,2,35,23,9,2,0,0,8,1,24
66,71,1505,263,1242,22,1220,19,289,239,273,17,8,3,65,13,294
66,72,299,50,249,7,242,3,40,72,27,3,1,0,31,2,63
66,73,138,19,119,1,118,7,32,29,13,1,1,0,5,1,29
66,74,310,61,249,6,243,15,30,54,36,2,1,1,30,3,71
66,75,117,18,99,4,95,4,12,13,10,2,0,1,10,1,42
66,76,52,9,43,0,43,3,8,3,7,1,1,0,3,0,17
66,77,76,20,56,1,55,2,8,3,15,0,1,1,7,0,18
66,78,168,17,151,3,148,18,4,9,38,3,0,1,5,1,69
66,79,169,29,140,2,138,4,36,37,17,1,0,1,9,2,31
66,80,133,25,108,2,106,4,16,8,45,5,1,0,6,1,20
66,81,144,12,132,6,126,9,25,38,17,3,0,0,2,2,30
66,82,339,61,278,7,271,8,60,82,40,5,3,1,23,4,45
66,83,50,14,36,0,36,0,2,3,7,1,3,0,1,0,19
66,84,828,126,702,15,687,20,169,141,106,9,6,2,61,9,164
66,85,304,58,246,2,244,10,44,55,37,1,1,2,13,8,73
66,86,19,6,13,0,13,0,1,3,4,0,0,0,1,0,4
66,88,3860,658,3202,80,3122,54,692,647,468,53,14,12,158,42,982
66,89,185,28,157,1,156,4,35,31,32,5,2,0,9,0,38
66,90,55,11,44,1,43,3,5,12,7,5,0,0,0,0,11
66,91,62,9,53,0,53,1,8,10,21,1,0,0,5,0,7
66,92,74,11,63,2,61,1,11,9,21,2,0,0,1,1,15
66,93,1765,284,1481,27,1454,36,292,473,174,17,3,4,100,25,330
66,94,1564,210,1354,30,1324,16,386,387,117,14,10,3,94,18,279
66,95,356,75,281,10,271,11,36,63,40,6,5,1,20,6,83
66,96,759,122,637,13,624,21,156,99,103,22,5,3,24,10,181
66,97,127,21,106,3,103,3,19,8,13,4,0,0,6,2,48
66,98,242,52,190,2,188,5,31,42,27,4,4,0,26,3,46
66,99,230,46,184,5,179,5,34,46,35,0,0,0,11,1,47
66,100,138,26,112,1,111,4,18,22,25,2,2,0,3,0,35
66,101,1544,155,1389,34,1355,14,326,322,170,16,4,3,96,14,390
66,102,37,8,29,0,29,3,2,1,7,2,0,0,0,0,14
66,103,324,60,264,4,260,15,58,60,51,5,1,1,13,4,52
66,104,641,103,538,19,519,23,125,80,135,10,4,1,27,8,106
66,105,256,33,223,6,217,7,22,30,69,10,2,1,7,1,68
66,106,2172,410,1762,59,1703,57,360,380,248,23,6,6,104,30,489
66,107,702,139,563,5,558,9,127,135,84,9,2,1,28,8,155
66,108,2818,432,2386,51,2335,39,647,435,300,33,18,1,134,14,714
66,109,169,23,146,1,145,7,23,31,29,2,1,0,15,0,37
66,111,119,28,91,2,89,2,27,12,17,1,0,0,2,2,26
66,112,189,22,167,1,166,3,35,60,16,3,1,1,14,3,30
66,113,113,14,99,2,97,5,13,25,17,3,0,0,2,3,29
66,114,1270,184,1086,29,1057,14,275,225,154,13,8,3,70,12,283
66,115,895,112,783,10,773,27,153,242,117,8,2,2,54,11,157
66,116,165,30,135,6,129,11,12,23,28,4,2,0,15,2,32
66,117,172,27,145,1,144,6,41,58,12,1,0,0,10,0,16
66,118,218,40,178,3,175,5,50,29,30,3,0,0,9,4,45
66,119,279,56,223,4,219,15,21,40,59,8,3,2,17,2,52
66,120,67,6,61,1,60,7,7,15,17,0,0,0,3,0,11
66,121,877,125,752,11,741,10,223,165,88,7,5,0,41,9,193
66,122,77,18,59,1,58,8,10,6,18,2,0,0,1,0,13
66,123,110,22,88,1,87,13,12,4,25,0,1,0,5,2,25
66,124,1479,271,1208,30,1178,39,183,373,159,19,7,7,97,12,282
66,125,355,74,281,5,276,13,54,55,72,4,1,4,10,2,61
66,126,220,34,186,3,183,7,22,33,42,5,0,0,14,4,56
66,127,744,112,632,11,621,12,195,91,100,3,6,0,49,12,153
66,128,28,2,26,1,25,0,8,4,2,0,0,0,0,0,11
66,129,979,158,821,10,811,21,225,182,104,3,7,0,40,15,214
66,130,837,138,699,12,687,19,126,169,94,5,4,4,51,14,201
66,132,240,42,198,1,197,4,41,42,35,3,1,2,15,4,50
66,133,2152,331,1821,28,1793,35,462,408,246,18,11,1,89,22,501
66,134,471,66,405,6,399,15,132,45,49,8,1,0,20,5,124
66,136,66980,16177,50803,850,49953,1092,11220,13244,5755,527,224,115,3225,550,14001
66,137,476,121,355,7,348,13,71,115,28,4,0,1,17,2,97
66,138,1034,151,883,16,867,15,235,204,116,5,4,2,42,12,232
66,139,66,15,51,1,50,0,5,6,7,0,0,0,1,0,31
66,140,2460,464,1996,55,1941,36,495,474,222,15,9,10,131,28,521
66,141,5335,1036,4299,68,4231,68,1325,938,504,56,13,9,216,50,1052
66,142,48,14,34,0,34,1,8,6,6,2,0,0,3,0,8
66,143,96,9,87,2,85,3,6,24,25,0,1,0,1,1,24
66,144,3426,417,3009,57,2952,53,763,826,321,45,13,8,213,33,677
66,145,1926,261,1665,28,1637,17,477,361,215,17,8,0,109,18,415
66,146,124,29,95,3,92,8,21,16,12,2,1,0,5,1,26
66,147,145,38,107,1,106,0,7,25,18,4,1,1,13,3,34
66,148,3356,640,2716,57,2659,49,691,757,287,27,24,5,118,39,662
66,149,4168,741,3427,65,3362,107,583,881,454,41,26,11,237,47,975
66,150,847,138,709,15,694,16,104,157,147,8,2,3,42,11,204
66,151,67,7,60,1,59,1,2,15,14,0,0,0,10,0,17
66,152,82,14,68,2,66,4,11,6,15,1,0,0,3,0,26
66,153,36,8,28,1,27,1,3,8,5,0,0,0,4,1,5
66,154,119,31,88,1,87,2,25,15,9,2,0,0,11,0,23
66,155,100,27,73,2,71,5,9,13,22,0,0,0,5,1,16
66,156,113,21,92,2,90,5,16,14,22,2,0,1,3,1,26
66,157,45,12,33,0,33,0,1,7,4,0,0,0,3,0,18
66,158,146,14,132,0,132,10,22,13,29,5,1,0,5,2,45
66,159,72,14,58,2,56,3,15,8,11,0,0,0,6,0,13
66,160,1077,220,857,20,837,27,178,191,135,13,4,0,61,25,203
66,161,998,139,859,15,844,24,160,203,137,7,2,0,35,12,264
66,162,371,48,323,5,318,5,97,82,46,7,1,0,19,6,55
66,164,6373,1164,5209,116,5093,90,1190,1192,756,69,31,5,291,87,1382
66,165,470,66,404,6,398,17,93,70,82,4,1,2,16,5,108
66,166,302,62,240,5,235,13,38,48,35,9,3,0,20,7,62
66,167,735,143,592,6,586,15,102,176,72,22,5,0,50,6,138
66,168,2556,438,2118,41,2077,32,548,533,219,19,13,6,112,27,568
66,169,94,12,82,1,81,3,23,24,7,1,0,0,7,1,15
66,170,98,9,89,2,87,5,19,19,12,2,0,0,10,1,19
66,171,8721,1436,7285,122,7163,116,1941,2408,640,85,26,13,413,113,1408
66,172,8716,1362,7354,157,7197,123,1838,1837,822,79,25,11,499,130,1833
66,173,607,98,509,19,490,15,156,73,48,10,6,0,33,5,144
66,174,1742,244,1498,34,1464,24,437,346,172,19,10,2,104,17,333
66,175,2195,389,1806,50,1756,28,478,502,207,21,10,5,103,24,378
66,176,1949,286,1663,29,1634,23,567,360,214,23,7,4,97,19,320
66,177,760,78,682,27,655,9,194,124,62,10,3,4,59,12,178
66,178,1616,297,1319,32,1287,19,311,256,195,8,12,1,82,24,379
66,179,794,141,653,13,640,22,66,128,159,5,6,1,24,14,215
66,180,7468,1267,6201,119,6082,64,1931,1521,656,65,29,21,326,88,1381
66,181,110,21,89,3,86,2,20,30,1,0,1,0,8,0,24
66,182,3839,604,3235,58,3177,60,996,828,324,35,7,3,197,41,686
66,183,83,17,66,0,66,4,19,13,15,1,0,0,3,0,11
66,184,63,15,48,0,48,1,5,16,7,0,1,0,7,0,11
66,185,243,29,214,3,211,6,44,45,34,5,1,2,12,1,61
66,186,2006,318,1688,21,1667,24,524,381,189,20,3,3,87,23,413
66,187,1409,255,1154,23,1131,24,309,234,148,8,8,2,44,20,334
66,188,212,30,182,1,181,2,48,36,15,1,2,1,14,1,61
66,189,3649,473,3176,43,3133,49,759,1034,271,28,7,4,219,45,717
66,190,2194,321,1873,56,1817,22,473,397,244,27,21,0,71,35,527
66,191,47,17,30,0,30,1,6,4,13,0,0,0,1,0,5
66,192,86,21,65,2,63,2,19,8,13,1,0,0,2,2,16
66,193,230,26,204,4,200,3,34,25,61,5,4,1,5,3,59
66,194,228,43,185,1,184,11,38,44,41,1,0,0,18,2,29
66,195,5375,883,4492,93,4399,75,1221,1110,482,49,24,18,295,48,1077
66,196,2508,478,2030,23,2007,34,433,625,234,21,6,5,127,28,494
66,197,35,3,32,0,32,0,4,8,11,0,0,0,0,0,9
66,198,352,72,280,4,276,6,72,81,35,3,1,0,7,7,64
66,199,93,22,71,0,71,8,6,12,23,1,0,0,5,1,15
66,201,50,5,45,0,45,3,4,12,6,0,0,0,4,0,16
66,202,142,23,119,3,116,4,15,36,18,2,0,1,4,2,34
66,203,50,11,39,1,38,1,10,3,4,0,0,1,1,2,16
66,204,256,43,213,6,207,11,35,26,41,4,3,0,9,6,72
66,205,729,126,603,8,595,12,153,136,105,6,4,1,34,6,138
66,206,70,10,60,1,59,3,6,12,17,1,0,0,0,2,18
66,207,504,74,430,16,414,15,85,89,63,7,0,0,26,10,119
66,208,1022,134,888,13,875,30,209,215,95,8,3,2,51,12,250
66,209,47,13,34,0,34,2,4,12,8,1,0,0,1,0,6
66,210,5896,1113,4783,119,4664,96,1083,908,710,54,35,9,262,51,1456
66,211,142,16,126,3,123,6,25,9,24,6,0,1,6,3,43
66,212,2540,382,2158,45,2113,34,607,520,227,23,15,4,143,30,510
66,213,4972,729,4243,71,4172,58,967,968,478,53,19,9,305,73,1242
66,214,651,90,561,19,542,11,149,115,77,12,0,1,28,7,142
66,215,112,10,102,3,99,2,19,36,8,1,1,0,3,1,28
66,216,67,8,59,3,56,1,5,4,11,1,0,0,6,1,27
66,217,1289,195,1094,19,1075,14,302,231,145,13,8,1,73,11,277
66,218,234,45,189,3,186,0,29,64,24,6,3,1,18,3,38
66,219,65,16,49,0,49,4,10,16,4,1,1,0,1,0,12
66,220,68,12,56,2,54,3,1,9,16,0,3,0,2,2,18
66,221,48,11,37,1,36,0,2,3,12,1,0,2,1,1,14
66,222,1197,181,1016,13,1003,36,158,220,197,17,4,1,58,20,292
66,223,179,20,159,3,156,7,23,37,29,3,1,1,5,0,50
66,224,2206,348,1858,36,1822,34,497,470,228,29,10,2,135,32,385
66,225,1179,186,993,23,970,25,207,199,140,10,3,5,56,15,310
66,226,812,99,713,17,696,7,219,137,108,8,4,0,47,10,156
66,227,3284,534,2750,58,2692,46,618,707,295,32,11,5,195,41,742
66,228,934,139,795,24,771,12,209,174,102,7,5,1,58,9,194
66,230,1524,274,1250,22,1228,28,272,302,173,14,5,2,81,10,341
66,231,469,106,363,6,357,18,75,39,66,6,3,1,30,8,111
66,232,38,3,35,0,35,1,6,15,1,2,0,1,4,0,5
66,233,134,19,115,4,111,1,28,29,11,0,0,0,8,3,31
66,234,99,17,82,4,78,2,6,13,14,2,1,0,13,0,27
67,1,1714,258,1456,37,1419,29,281,531,69,6,10,1,193,26,273
67,2,366,80,286,8,278,4,50,114,19,4,2,2,36,10,37
67,3,403,51,352,5,347,17,102,89,28,6,5,1,38,6,55
67,4,425,53,372,10,362,3,101,119,20,6,5,0,44,6,58
67,5,624,110,514,9,505,8,110,218,31,4,1,2,55,12,64
67,6,179,16,163,4,159,2,47,70,7,1,2,2,14,1,13
67,8,965,132,833,6,827,20,187,299,51,10,5,3,94,10,148
67,9,338,63,275,4,271,4,73,107,8,7,5,0,33,5,29
67,10,1264,249,1015,15,1000,36,254,334,62,14,5,6,149,14,126
67,11,756,118,638,19,619,13,174,195,30,8,6,2,86,9,96
67,12,513,85,428,22,406,5,108,180,16,3,2,1,41,7,43
67,13,222,35,187,1,186,3,69,40,9,2,5,0,30,5,23
67,14,635,128,507,10,497,12,151,200,16,9,7,1,43,11,47
67,16,586,120,466,17,449,15,107,153,32,4,6,1,64,7,60
67,17,228,36,192,6,186,0,51,72,6,1,3,1,28,3,21
67,18,541,110,431,7,424,14,94,183,30,5,6,2,45,10,35
67,19,884,155,729,8,721,15,169,267,41,6,5,2,115,13,88
67,20,685,138,547,9,538,7,121,130,52,4,6,0,53,6,159
67,21,4510,916,3594,76,3518,123,660,1152,255,32,22,13,516,61,684
67,22,205,42,163,5,158,9,45,30,10,3,3,0,29,5,24
67,23,734,87,647,12,635,7,152,279,28,9,5,0,61,14,80
67,25,1132,183,949,29,920,16,207,405,41,13,7,4,92,16,119
67,26,134,21,113,2,111,3,20,41,8,0,1,0,12,3,23
67,27,157,17,140,3,137,7,47,31,6,0,0,0,20,7,19
67,28,3440,680,2760,55,2705,66,648,874,197,32,21,9,319,46,493
67,29,345,77,268,6,262,8,89,74,17,3,4,1,32,3,31
67,30,535,73,462,8,454,6,104,180,23,3,4,1,59,7,67
67,31,1122,160,962,20,942,18,205,385,55,10,3,2,107,22,135
67,32,171,21,150,2,148,2,32,68,2,2,2,0,20,2,18
67,33,463,68,395,13,382,8,77,164,15,0,3,0,47,5,63
67,34,1833,282,1551,21,1530,54,280,557,81,13,13,1,246,30,255
67,35,352,61,291,9,282,6,72,120,11,2,0,2,38,4,27
67,36,271,46,225,3,222,6,63,53,9,7,4,1,40,6,33
67,37,306,57,249,6,243,7,67,73,16,0,3,1,33,4,39
67,38,217,23,194,3,191,6,61,73,8,0,1,1,16,4,21
67,39,334,36,298,6,292,5,65,116,9,4,1,0,43,4,45
67,40,731,99,632,16,616,7,165,240,41,3,8,3,64,9,76
67,41,241,20,221,2,219,9,56,80,22,1,1,1,20,6,23
67,43,9367,2207,7160,136,7024,189,1392,1750,728,71,45,19,701,91,2038
67,44,220,35,185,3,182,3,46,53,14,2,2,2,30,2,28
67,45,2606,433,2173,60,2113,51,394,894,103,22,11,8,301,55,274
67,46,6747,1636,5111,85,5026,91,1270,1405,487,44,35,12,496,91,1095
67,47,129,25,104,1,103,0,46,33,5,4,1,0,8,1,5
67,48,339,48,291,4,287,6,84,127,7,5,0,0,36,3,19
67,49,1044,156,888,14,874,22,182,383,51,4,4,0,97,10,121
67,50,52,5,47,1,46,3,12,13,4,0,0,0,3,4,7
67,51,296,47,249,3,246,6,49,112,16,1,2,2,44,6,8
67,52,1828,267,1561,28,1533,64,298,592,84,15,9,9,193,37,232
67,53,259,36,223,4,219,3,39,75,8,1,1,1,65,5,21
67,54,355,60,295,6,289,5,67,117,16,1,5,1,36,6,35
67,55,967,199,768,13,755,20,204,288,36,8,11,4,82,18,84
67,56,408,55,353,8,345,9,113,83,20,4,4,2,43,10,57
67,57,135,18,117,9,108,1,23,46,9,0,0,0,15,1,13
67,58,273,29,244,4,240,6,50,98,9,4,1,2,45,3,22
67,59,353,60,293,2,291,10,88,67,23,5,1,0,35,3,59
67,60,377,52,325,4,321,11,75,74,19,6,2,1,60,7,66
67,61,2756,557,2199,48,2151,53,638,650,137,21,16,3,291,41,301
67,62,239,28,211,4,207,11,36,78,17,0,2,0,28,3,32
67,63,604,106,498,6,492,29,132,154,40,2,2,1,54,10,68
67,65,991,165,826,17,809,15,157,323,50,7,8,2,105,20,122
67,66,2164,443,1721,30,1691,38,479,466,141,27,18,7,125,32,358
67,67,7070,1415,5655,114,5541,141,1189,2056,343,45,33,9,684,90,951
67,68,169,20,149,1,148,4,26,57,11,4,3,0,24,4,15
67,69,352,64,288,13,275,3,85,102,12,1,1,1,24,13,33
67,70,270,66,204,0,204,5,76,65,4,1,2,0,15,3,33
67,71,351,57,294,10,284,3,104,93,10,3,2,0,40,5,24
67,72,556,99,457,10,447,5,157,151,33,13,3,1,28,17,39
67,73,3187,784,2403,63,2340,52,476,830,158,34,18,9,301,47,415
67,74,550,96,454,11,443,12,104,173,14,8,1,1,82,17,31
67,75,339,64,275,6,269,8,68,97,17,6,1,2,26,4,40
67,76,389,75,314,0,314,3,86,90,25,5,7,1,33,7,57
67,77,474,60,414,3,411,32,87,132,32,2,6,1,63,6,50
67,78,167,33,134,7,127,0,45,37,8,3,2,0,15,0,17
67,79,107,20,87,0,87,1,27,41,1,0,1,0,7,2,7
67,80,1316,246,1070,19,1051,25,237,316,77,10,6,1,157,26,196
67,81,542,81,461,3,458,10,104,195,22,4,4,1,51,16,51
67,82,763,153,610,17,593,14,185,229,24,4,6,2,65,15,49
67,83,631,111,520,14,506,11,165,145,43,6,4,2,55,10,65
67,84,1563,251,1312,27,1285,34,235,502,72,6,11,7,180,30,208
67,85,547,82,465,9,456,17,89,169,28,6,2,0,67,8,70
67,86,311,47,264,5,259,7,54,123,11,2,2,1,26,6,27
67,87,1084,141,943,21,922,8,273,387,29,10,9,3,101,21,81
67,88,316,62,254,4,250,4,98,101,10,1,3,0,18,5,10
67,89,2020,383,1637,28,1609,43,452,554,89,26,16,2,202,20,205
67,90,503,89,414,12,402,8,100,148,30,2,5,0,51,5,53
67,91,281,60,221,4,217,2,48,80,5,3,3,0,28,4,44
67,92,517,69,448,11,437,23,64,144,34,9,3,0,76,8,76
67,93,285,64,221,11,210,2,60,85,7,5,1,0,21,3,26
67,94,246,62,184,5,179,5,40,67,21,4,3,1,14,3,21
67,95,1218,238,980,25,955,17,254,359,54,12,10,1,89,26,133
67,96,261,41,220,4,216,6,55,69,19,5,0,1,38,5,18
67,97,997,125,872,10,862,27,113,368,35,8,2,1,139,14,155
67,98,1085,184,901,24,877,17,230,283,60,6,5,3,123,15,135
67,99,228,52,176,1,175,6,49,66,9,6,0,2,12,7,18
67,100,208,20,188,3,185,5,29,71,13,0,0,3,29,4,31
67,101,1901,311,1590,31,1559,28,349,618,79,14,7,5,184,31,244
67,102,193,26,167,1,166,4,26,78,10,1,2,3,19,4,19
67,103,956,227,729,16,713,22,213,204,45,7,3,1,84,21,113
67,104,617,151,466,13,453,17,109,155,19,6,2,0,72,19,54
67,105,1001,194,807,22,785,14,186,279,56,8,8,1,112,14,107
67,106,4000,804,3196,72,3124,37,870,1136,180,44,21,17,330,62,427
67,107,473,84,389,7,382,9,91,131,18,1,6,0,50,8,68
67,108,1260,204,1056,22,1034,16,266,378,64,10,6,3,121,14,156
67,109,527,80,447,3,444,17,85,178,26,3,6,1,65,8,55
67,110,840,156,684,15,669,8,191,264,31,7,6,4,79,11,68
67,111,340,47,293,8,285,13,68,87,16,3,4,1,39,9,45
67,112,2247,349,1898,31,1867,37,423,699,141,19,11,5,216,37,279
67,113,296,33,263,9,254,5,76,87,11,4,8,1,38,8,16
67,115,1758,322,1436,35,1401,45,365,454,73,14,9,7,170,22,242
67,116,407,57,350,12,338,13,70,122,24,5,0,1,41,1,61
67,117,366,74,292,5,287,5,70,78,14,7,3,2,47,10,51
67,118,4537,850,3687,69,3618,81,605,1299,249,33,27,10,445,62,807
67,119,1181,198,983,21,962,19,199,361,73,5,9,2,117,19,158
67,120,398,62,336,1,335,16,76,134,18,2,3,1,34,10,41
67,121,611,88,523,6,517,17,130,186,29,4,3,1,73,12,62
67,122,1076,185,891,9,882,20,268,322,43,13,10,1,93,14,98
67,123,398,59,339,6,333,1,111,115,7,2,4,2,52,7,32
67,124,1508,258,1250,20,1230,26,260,431,108,12,13,5,128,20,227
67,125,1662,249,1413,37,1376,53,280,531,67,16,13,4,211,22,179
67,126,229,41,188,3,185,5,49,60,10,3,2,0,30,3,23
67,127,938,158,780,15,765,15,158,288,52,3,4,3,121,21,100
67,128,1380,173,1207,15,1192,25,234,451,77,8,11,3,152,28,203
67,129,500,94,406,7,399,9,116,128,15,6,3,0,68,8,46
67,130,7604,1784,5820,117,5703,151,1398,1765,360,53,38,18,661,141,1118
67,131,3571,547,3024,72,2952,80,636,1056,156,28,8,11,392,60,525
67,132,851,154,697,20,677,8,168,270,39,8,6,1,85,13,79
67,133,384,79,305,8,297,7,89,82,26,4,1,1,28,8,51
67,134,148,23,125,2,123,4,39,38,5,1,3,1,20,3,9
67,135,653,78,575,11,564,19,144,198,26,5,3,0,104,9,56
67,136,201,29,172,9,163,6,51,57,6,2,3,3,24,3,8
67,137,4185,840,3345,37,3308,63,651,1293,198,29,7,11,420,46,590
67,138,394,57,337,7,330,8,63,140,23,1,2,1,39,2,51
67,139,397,70,327,11,316,5,86,96,30,3,4,0,46,7,39
67,140,481,100,381,15,366,6,117,152,16,5,2,3,28,6,31
67,141,515,118,397,10,387,7,120,153,12,2,3,1,46,11,32
67,142,174,31,143,3,140,0,56,48,6,1,1,1,9,2,16
67,143,559,92,467,9,458,20,85,145,34,11,5,2,43,5,108
67,144,271,40,231,5,226,11,64,68,7,6,3,0,30,2,35
67,145,197,23,174,4,170,2,48,62,7,4,0,2,23,5,17
67,146,524,94,430,7,423,10,128,140,26,4,3,1,48,17,46
67,147,439,99,340,10,330,8,117,96,20,9,2,2,41,6,29
67,148,170,42,128,1,127,3,46,32,11,2,0,0,13,3,17
67,149,372,73,299,6,293,9,67,104,10,4,3,2,40,11,43
67,150,855,146,709,15,694,22,115,284,34,6,3,3,99,18,110
67,151,3563,746,2817,55,2762,57,610,1060,155,43,20,6,306,46,459
67,152,5356,997,4359,84,4275,94,805,1610,289,29,24,11,520,85,808
67,153,182,22,160,5,155,5,46,66,1,3,0,1,19,7,7
67,154,2380,370,2010,44,1966,37,467,725,115,20,17,7,232,39,307
67,155,842,153,689,14,675,15,153,231,39,10,7,3,90,18,109
67,156,1910,311,1599,33,1566,17,466,583,65,15,7,3,153,18,239
67,158,243,28,215,3,212,3,47,96,11,3,1,0,28,2,21
67,159,175,24,151,4,147,5,55,54,7,2,1,0,5,0,18
67,160,882,157,725,21,704,18,240,208,30,17,9,3,79,17,83
67,161,330,55,275,4,271,11,62,85,20,5,8,0,33,4,43
67,162,268,43,225,2,223,5,58,83,23,1,0,0,25,4,24
67,163,438,45,393,7,386,13,85,159,25,0,0,1,46,7,50
67,164,667,121,546,8,538,14,144,179,26,8,5,3,73,8,78
67,165,341,68,273,7,266,4,84,63,33,7,3,1,20,6,45
67,166,178,17,161,4,157,2,45,61,7,2,0,0,24,2,14
67,167,1000,178,822,18,804,25,206,298,50,10,7,1,97,23,87
67,168,1263,226,1037,21,1016,28,242,315,67,14,10,6,123,24,187
67,169,2256,429,1827,44,1783,32,495,667,84,27,12,6,203,33,224
67,172,1579,189,1390,29,1361,42,312,488,99,14,7,5,169,30,195
67,173,965,113,852,23,829,17,102,331,38,9,1,4,137,12,178
67,174,989,193,796,18,778,12,276,213,48,6,7,1,93,11,111
67,176,2688,551,2137,54,2083,32,610,584,106,43,21,10,278,41,358
67,177,543,85,458,9,449,8,126,175,16,3,4,2,67,5,43
67,178,218,38,180,12,168,3,46,54,9,3,1,1,29,7,15
67,179,545,97,448,9,439,19,115,148,33,1,0,0,57,11,55
67,180,22225,4795,17430,310,17120,350,3702,5995,1107,178,123,51,2187,323,3104
67,181,256,46,210,5,205,12,37,73,9,0,0,3,53,1,17
67,182,1102,148,954,14,940,20,195,388,70,10,4,5,85,17,146
67,183,687,136,551,15,536,7,173,175,34,5,3,0,75,8,56
67,184,1353,250,1103,44,1059,32,325,368,54,11,14,7,132,15,101
67,185,552,105,447,13,434,8,131,139,11,7,6,3,61,9,59
67,186,287,37,250,7,243,6,76,67,10,1,0,1,25,3,54
67,187,343,50,293,5,288,4,79,85,16,4,2,1,48,13,36
67,188,522,92,430,8,422,11,118,146,23,2,0,0,51,13,58
67,189,683,97,586,16,570,27,137,185,27,10,2,3,119,10,50
67,190,150,15,135,7,128,3,43,44,2,0,1,0,20,2,13
67,191,1600,323,1277,28,1249,16,414,371,71,14,15,11,125,44,168
67,192,715,96,619,22,597,11,160,199,31,7,16,5,67,14,87
67,194,3970,754,3216,85,3131,46,840,1150,141,36,33,7,379,51,448
67,195,396,55,341,4,337,2,77,135,17,6,3,1,53,6,37
67,196,1985,439,1546,34,1512,43,396,482,92,17,17,1,177,36,251
67,197,1133,183,950,16,934,24,197,380,44,4,11,6,111,20,137
67,198,109,19,90,2,88,3,15,36,9,0,2,0,18,3,2
67,199,74,19,55,0,55,0,15,25,2,0,1,0,5,0,7
67,200,705,107,598,15,583,22,123,217,31,6,4,3,71,15,91
67,201,248,54,194,4,190,6,54,51,8,2,3,2,35,5,24
67,202,2469,409,2060,38,2022,32,463,821,102,17,13,4,281,39,250
67,203,259,32,227,5,222,8,40,79,17,2,0,2,37,4,33
67,204,7593,1533,6060,89,5971,131,1089,1991,531,63,35,13,703,102,1313
67,205,3305,567,2738,53,2685,72,609,1106,127,24,16,7,323,48,353
67,206,883,185,698,27,671,17,210,230,34,9,7,0,76,14,74
67,207,160,14,146,5,141,7,29,72,7,0,1,0,15,2,8
67,208,416,60,356,9,347,6,98,137,22,2,3,0,33,1,45
67,209,219,48,171,4,167,1,53,54,8,1,1,0,22,0,27
67,210,413,98,315,6,309,15,81,95,23,5,2,1,28,9,50
67,212,2519,472,2047,32,2015,27,441,825,135,14,9,5,199,32,328
67,213,555,125,430,19,411,14,98,148,22,4,2,1,71,12,39
67,214,401,51,350,8,342,8,70,144,17,5,1,3,45,12,37
67,215,394,59,335,7,328,7,102,142,9,1,2,0,36,5,24
67,216,2028,469,1559,33,1526,35,406,528,93,20,17,4,165,29,229
67,217,210,20,190,3,187,3,27,85,9,3,2,0,32,3,23
67,218,17839,4179,13660,218,13442,381,2268,4562,953,120,65,40,1677,193,3183
67,220,246,44,202,3,199,2,49,77,11,4,5,0,27,5,19
67,221,203,38,165,5,160,0,55,38,5,2,0,0,29,9,22
67,222,2996,753,2243,48,2195,44,586,717,144,30,17,4,250,34,369
67,223,893,136,757,10,747,12,207,275,25,12,7,3,86,15,105
67,225,83,12,71,0,71,2,21,16,4,1,0,0,16,3,8
67,226,1575,252,1323,20,1303,20,246,519,74,6,6,4,199,26,203
67,227,201,22,179,1,178,3,30,95,6,0,2,1,29,4,8
67,228,579,77,502,7,495,20,65,222,22,0,2,7,66,10,81
67,229,164,23,141,4,137,0,37,54,6,2,1,1,19,3,14
67,230,1694,385,1309,18,1291,23,351,476,77,13,4,5,142,19,181
67,231,140,28,112,3,109,3,28,45,5,0,1,2,13,2,10
67,232,175,23,152,3,149,3,66,40,10,0,1,0,18,2,9
67,233,1054,206,848,25,823,14,226,309,43,10,10,1,80,19,111
67,234,1248,233,1015,22,993,17,316,308,71,16,4,3,99,18,141
67,235,277,37,240,8,232,4,56,109,8,4,0,0,31,3,17
67,236,496,71,425,8,417,15,55,189,23,4,0,3,53,6,69
67,237,1896,322,1574,25,1549,40,343,597,92,6,15,3,172,26,255
67,238,484,80,404,10,394,4,142,142,14,4,4,2,47,8,27
67,239,1319,201,1118,29,1089,27,191,430,64,16,7,3,154,28,169
67,240,532,68,464,4,460,8,109,176,23,2,4,1,71,15,51
67,241,163,32,131,3,128,3,42,47,4,2,3,1,10,1,15
67,242,413,75,338,3,335,4,89,108,20,2,1,2,48,7,54
67,244,106,5,101,1,100,1,19,45,4,0,1,0,10,0,20
67,245,162,21,141,3,138,1,36,53,2,2,1,0,19,3,21
67,246,870,178,692,13,679,12,210,216,35,9,5,1,84,7,100
67,247,626,100,526,6,520,19,119,168,27,4,2,0,89,13,79
67,248,1380,217,1163,21,1142,33,252,460,75,7,10,2,129,22,152
67,249,151,19,132,2,130,4,31,55,8,1,0,0,13,2,16
67,250,551,56,495,15,480,13,99,181,21,1,3,0,75,9,78
67,252,808,157,651,9,642,9,188,212,37,7,3,1,72,10,103
67,253,525,51,474,10,464,8,94,200,22,1,0,1,55,6,77
67,254,694,135,559,18,541,11,162,162,30,5,11,2,59,15,84
67,255,367,74,293,5,288,15,89,80,25,3,2,1,17,4,52
67,256,2487,429,2058,27,2031,65,276,910,92,8,8,6,291,45,330
67,257,574,86,488,14,474,15,142,151,14,3,4,2,49,10,84
67,258,149,17,132,2,130,0,38,40,7,2,1,0,16,3,23
67,259,737,145,592,26,566,19,181,160,40,3,4,2,54,20,83
67,260,251,26,225,8,217,7,49,89,7,0,3,2,32,3,25
67,261,1395,349,1046,19,1027,28,166,380,56,18,15,2,98,28,236
67,263,1220,239,981,34,947,26,225,361,44,7,8,5,112,18,141
67,264,551,78,473,18,455,9,120,176,20,4,3,1,43,12,67
67,265,459,100,359,3,356,13,111,150,12,4,0,2,32,3,29
67,266,542,84,458,12,446,9,110,158,20,1,4,1,56,12,75
67,267,12024,3378,8646,116,8530,219,1570,2779,630,74,39,14,1008,117,2080
67,268,2073,390,1683,20,1663,53,342,609,90,13,11,3,219,31,292
67,269,195,29,166,2,164,3,33,70,3,2,0,1,32,4,16
67,270,265,24,241,3,238,6,69,80,9,1,2,4,26,8,33
67,271,430,63,367,10,357,8,115,96,9,11,5,1,45,10,57
67,272,362,51,311,0,311,11,81,105,17,3,2,2,42,6,42
67,273,433,88,345,11,334,7,121,96,26,5,4,5,30,9,31
67,274,195,41,154,5,149,4,42,36,2,8,4,0,20,9,24
67,275,650,104,546,12,534,16,126,186,36,5,4,1,63,13,84
67,276,1341,279,1062,14,1048,24,270,311,95,14,3,2,143,28,158
67,277,545,82,463,21,442,4,150,148,23,3,5,0,45,11,53
67,278,512,108,404,9,395,6,157,129,15,2,3,1,38,9,35
67,279,169,18,151,4,147,0,42,70,7,0,0,0,15,8,5
67,280,655,108,547,24,523,15,152,180,33,7,4,2,60,12,58
67,281,2811,589,2222,53,2169,41,588,687,153,23,8,9,241,40,379
67,282,3061,586,2475,37,2438,53,484,956,129,25,12,6,381,48,344
67,283,2061,389,1672,24,1648,41,435,525,103,12,11,4,237,28,252
67,285,1172,223,949,11,938,21,263,289,53,10,7,2,129,20,144
67,286,1223,236,987,13,974,16,320,374,27,5,5,3,98,24,102
67,287,437,83,354,4,350,5,99,127,28,4,2,2,32,9,42
67,288,261,39,222,6,216,6,52,81,9,1,1,0,32,8,26
67,289,473,71,402,10,392,9,102,145,19,7,3,2,50,8,47
67,290,699,128,571,19,552,9,158,189,40,9,3,0,59,12,73
67,291,2629,587,2042,47,1995,27,643,674,110,23,18,3,207,29,261
67,292,491,85,406,9,397,16,135,135,16,3,7,0,53,7,25
67,293,504,73,431,6,425,3,98,184,21,6,1,0,57,5,50
67,295,583,121,462,4,458,23,74,156,15,4,2,0,101,12,71
67,296,1471,255,1216,8,1208,25,155,560,60,2,5,3,167,12,219
67,297,430,58,372,7,365,19,52,151,22,5,3,0,45,8,60
67,298,376,60,316,3,313,5,73,143,9,3,0,0,41,3,36
67,299,685,124,561,8,553,31,138,182,34,8,3,1,69,14,73
67,300,6331,1267,5064,93,4971,132,969,1543,414,48,21,14,694,103,1033
67,301,1397,222,1175,21,1154,18,239,487,54,6,5,2,160,27,156
67,302,1504,296,1208,29,1179,32,306,310,101,22,8,5,139,20,236
67,303,454,77,377,3,374,4,88,146,30,6,2,1,43,10,44
67,304,444,62,382,11,371,8,78,146,16,4,2,0,54,5,58
67,305,1377,251,1126,44,1082,18,339,349,41,11,10,5,162,31,116
67,306,527,110,417,14,403,13,99,142,22,9,7,0,53,9,49
67,307,342,42,300,9,291,6,102,93,17,4,2,1,25,4,37
67,308,487,53,434,3,431,4,110,188,14,1,2,2,53,13,44
67,309,4033,677,3356,67,3289,88,561,1161,219,24,14,7,440,62,713
67,310,958,142,816,29,787,22,198,263,39,6,6,2,126,20,105
67,311,1563,300,1263,27,1236,55,275,363,136,13,8,5,130,35,216
67,312,335,39,296,6,290,7,80,108,18,1,0,1,36,1,38
67,313,3732,954,2778,74,2704,68,674,754,224,31,11,16,310,57,559
67,314,492,74,418,15,403,9,95,66,19,8,3,0,66,9,128
67,315,422,90,332,9,323,6,73,148,9,6,4,1,36,9,31
67,317,528,78,450,5,445,19,91,122,26,6,7,1,63,9,101
67,319,254,55,199,9,190,6,52,84,7,1,1,0,23,3,13
67,320,557,76,481,10,471,22,95,155,32,3,3,2,72,13,74
67,321,307,61,246,3,243,13,40,75,21,10,4,1,24,3,52
67,322,893,173,720,13,707,36,166,206,51,9,9,3,101,12,114
67,324,3254,803,2451,50,2401,30,607,781,158,34,20,13,298,48,412
67,325,1018,154,864,26,838,15,241,284,44,10,4,3,101,19,117
67,326,1125,185,940,14,926,29,143,344,68,8,5,2,152,17,158
67,327,615,100,515,19,496,10,114,220,18,4,5,2,64,4,55
67,328,649,122,527,8,519,12,149,192,37,7,4,0,45,11,62
67,329,934,142,792,27,765,15,191,314,34,7,4,7,84,16,93
67,330,647,107,540,12,528,7,166,226,18,4,4,2,43,12,46
67,331,1041,145,896,18,878,16,220,372,49,12,8,3,103,14,81
67,333,192,24,168,5,163,4,43,49,14,2,1,0,22,3,25
67,334,131,25,106,1,105,4,27,43,4,2,0,0,10,0,15
67,335,679,112,567,8,559,14,115,247,24,4,1,1,77,6,70
67,336,1347,252,1095,26,1069,23,275,415,52,9,7,2,122,22,142
67,337,394,56,338,3,335,5,80,132,12,4,0,2,57,6,37
67,338,1069,178,891,15,876,11,238,310,54,7,3,0,113,24,116
67,339,2844,571,2273,67,2206,56,679,663,128,30,23,13,230,60,324
67,340,1166,245,921,20,901,14,322,288,44,8,9,2,65,14,135
67,341,324,54,270,11,259,6,84,68,18,6,3,0,28,11,35
67,342,1352,216,1136,20,1116,29,286,442,63,9,3,4,122,20,138
67,343,3201,503,2698,40,2658,84,377,1061,199,18,14,6,330,44,525
67,344,233,32,201,7,194,8,34,73,13,4,0,1,30,2,29
67,345,2549,502,2047,45,2002,33,630,695,101,18,13,9,204,50,249
67,346,367,48,319,16,303,15,71,99,14,7,9,1,45,5,37
67,347,1346,268,1078,26,1052,32,242,340,69,18,8,2,167,30,144
67,348,7948,1799,6149,123,6026,152,1220,2181,435,45,23,16,700,101,1153
67,349,358,50,308,16,292,8,78,126,11,9,3,1,24,13,19
67,350,1797,279,1518,23,1495,36,276,557,78,4,8,5,207,27,297
67,351,1354,245,1109,31,1078,38,259,432,48,17,4,4,155,28,93
67,352,336,46,290,4,286,6,102,101,11,6,1,0,30,9,20
67,353,181,25,156,2,154,15,35,37,11,1,1,3,23,0,28
67,354,339,35,304,5,299,11,64,113,14,3,1,2,44,8,39
67,355,854,117,737,21,716,14,223,256,37,11,5,2,88,17,63
67,356,1779,342,1437,36,1401,25,393,507,39,19,7,7,194,23,187
67,358,714,140,574,13,561,8,205,186,24,5,5,2,61,6,59
67,359,1107,165,942,15,927,15,210,418,31,10,8,4,120,25,86
67,360,747,128,619,18,601,9,175,200,46,7,6,1,73,13,71
67,361,376,58,318,7,311,7,56,128,20,2,2,0,46,3,47
67,362,509,85,424,18,406,13,66,159,29,5,2,3,58,7,64
67,363,631,68,563,14,549,13,108,222,25,6,3,1,77,6,88
67,364,802,175,627,21,606,15,122,274,26,2,5,2,72,15,73
67,365,7757,1496,6261,80,6181,161,1446,1912,507,48,23,13,618,81,1372
67,366,600,85,515,10,505,16,81,188,29,9,5,5,71,14,87
67,367,1084,165,919,12,907,24,206,306,51,6,9,0,137,18,150
67,368,1350,219,1131,23,1108,34,217,460,43,13,7,1,163,12,158
67,369,198,36,162,8,154,2,38,54,13,0,1,0,17,3,26
67,370,545,122,423,8,415,16,124,134,31,5,8,1,42,11,43
67,371,488,111,377,13,364,12,88,121,23,4,5,0,46,7,58
67,372,1913,436,1477,27,1450,31,385,495,118,10,10,3,174,26,198
67,373,251,48,203,3,200,9,45,67,15,6,1,0,21,4,32
67,374,614,54,560,7,553,27,78,245,30,4,9,1,70,14,75
67,375,993,145,848,21,827,31,124,301,47,6,5,2,127,9,175
67,377,817,139,678,15,663,24,200,152,45,10,4,0,80,12,136
67,378,3136,518,2618,42,2576,54,547,936,171,32,9,2,286,42,497
67,379,729,142,587,23,564,10,181,183,23,11,9,3,59,13,72
67,380,184,32,152,5,147,2,47,44,5,3,2,1,23,2,18
67,381,279,68,211,2,209,3,91,67,7,2,2,0,16,5,16
67,382,622,103,519,6,513,21,89,216,28,4,1,1,70,4,79
67,383,154,25,129,1,128,2,24,64,4,1,1,0,17,3,12
67,384,332,65,267,5,262,1,52,88,28,7,1,1,35,5,44
67,385,228,40,188,6,182,4,56,64,15,4,4,1,12,2,20
67,386,167,26,141,5,136,5,42,54,7,2,1,0,17,2,6
67,387,224,37,187,8,179,9,34,57,7,2,0,0,34,1,35
67,388,3913,874,3039,65,2974,55,862,915,181,54,23,4,306,60,514
67,389,3444,554,2890,48,2842,60,573,1030,171,19,15,12,376,46,540
67,391,378,55,323,7,316,11,103,93,11,6,0,0,45,4,43
67,392,826,165,661,16,645,13,234,193,34,10,3,2,54,10,92
67,394,233,36,197,2,195,6,39,65,10,2,1,1,32,8,31
67,395,303,43,260,4,256,1,59,116,13,3,1,2,32,1,28
67,396,170,27,143,2,141,2,36,45,9,2,0,0,19,2,26
67,397,2058,364,1694,31,1663,27,474,589,84,15,14,6,221,27,206
67,398,265,57,208,1,207,5,79,55,17,4,1,0,23,2,21
67,400,828,167,661,20,641,2,154,265,36,13,2,0,93,17,59
67,401,262,43,219,3,216,9,87,46,7,2,1,1,36,6,21
67,402,79,8,71,0,71,0,14,33,3,0,0,0,14,1,6
67,403,337,62,275,12,263,14,63,85,13,4,2,1,39,7,35
67,404,721,153,568,16,552,12,140,204,30,9,5,1,67,13,71
67,405,1574,240,1334,27,1307,26,323,511,62,16,9,6,196,24,134
67,406,214,23,191,0,191,10,16,80,20,0,1,0,20,3,41
67,407,1382,291,1091,15,1076,9,320,425,59,7,7,2,93,22,132
67,408,1089,199,890,21,869,12,203,289,59,10,16,4,102,25,149
67,409,626,139,487,8,479,10,159,141,19,5,4,2,49,12,78
67,410,571,58,513,11,502,13,115,185,25,3,2,5,72,10,72
67,411,3798,706,3092,65,3027,85,601,1145,193,18,18,6,455,59,447
67,412,700,115,585,13,572,16,147,192,28,6,6,0,79,9,89
67,413,481,92,389,14,375,6,121,106,26,4,5,1,31,3,72
67,414,1181,314,867,21,846,11,267,195,66,18,10,4,76,10,189
67,415,403,80,323,3,320,10,102,87,25,4,6,0,35,7,44
67,416,388,73,315,7,308,8,79,124,10,4,4,0,31,2,46
67,417,290,41,249,4,245,5,43,114,14,3,0,2,25,4,35
67,418,744,134,610,15,595,17,187,235,12,5,5,2,56,15,61
67,420,1093,196,897,24,873,11,230,248,64,5,10,2,89,17,197
67,421,571,89,482,10,472,22,115,96,34,10,3,0,46,13,133
67,422,464,74,390,6,384,10,108,125,19,6,2,0,52,9,53
67,423,443,74,369,5,364,13,97,135,22,4,1,3,42,6,41
67,424,192,44,148,4,144,1,47,41,8,1,1,0,19,8,18
67,425,499,73,426,6,420,7,79,136,26,5,4,0,61,8,94
67,426,277,55,222,5,217,7,55,50,11,5,1,1,42,4,41
67,427,325,40,285,4,281,18,53,69,19,6,4,1,58,6,47
67,428,427,76,351,8,343,11,80,134,19,4,2,1,46,6,40
67,429,451,73,378,7,371,12,78,169,20,7,2,3,43,2,35
67,430,610,82,528,14,514,26,129,140,30,7,4,1,68,13,96
67,431,174,21,153,6,147,5,41,45,10,3,2,1,13,1,26
67,432,483,81,402,4,398,4,106,175,11,8,5,5,29,12,43
67,433,916,149,767,15,752,32,191,258,54,10,5,4,82,6,110
67,434,2139,575,1564,30,1534,29,444,503,100,25,24,3,161,40,205
67,435,757,144,613,18,595,12,183,207,29,17,3,2,75,6,61
67,436,386,61,325,6,319,6,114,73,36,4,5,1,29,7,44
67,437,7680,1682,5998,103,5895,191,1030,2012,507,56,26,13,790,106,1164
67,438,673,92,581,7,574,19,111,231,30,4,3,1,100,9,66
67,439,323,49,274,7,267,7,48,110,14,4,1,1,31,5,46
67,440,454,104,350,11,339,6,85,130,13,6,5,1,50,8,35
67,441,243,48,195,4,191,17,53,47,11,4,3,1,18,6,31
67,442,899,131,768,13,755,25,158,290,28,12,1,1,109,22,109
67,443,465,101,364,12,352,6,63,167,11,5,0,2,42,4,52
67,444,105,11,94,1,93,1,19,41,5,2,0,0,13,2,10
67,445,2447,363,2084,38,2046,64,494,748,108,12,19,6,232,53,310
67,446,380,75,305,3,302,7,71,81,17,3,5,0,61,10,47
67,447,17486,4805,12681,192,12489,477,2035,3160,1418,119,62,27,1199,156,3836
67,448,1575,374,1201,27,1174,21,302,325,100,25,8,3,89,18,283
67,449,1779,332,1447,26,1421,15,408,533,65,22,17,2,154,39,166
67,450,542,91,451,4,447,9,110,163,24,3,4,2,53,14,65
67,451,1194,211,983,26,957,12,192,496,20,23,12,3,102,21,76
67,452,1049,138,911,15,896,19,149,428,36,4,4,3,116,12,125
67,453,455,82,373,3,370,3,109,128,16,9,3,0,37,5,60
67,454,344,45,299,12,287,6,92,97,12,6,4,0,33,2,35
67,455,542,102,440,8,432,7,139,132,18,3,4,3,56,2,68
67,456,315,65,250,10,240,4,80,103,4,4,1,1,20,3,20
67,458,3514,589,2925,69,2856,59,734,1074,153,27,23,8,340,38,400
67,459,595,78,517,13,504,10,136,197,15,8,5,1,75,6,51
67,460,1253,207,1046,22,1024,14,257,372,56,7,4,2,157,15,140
67,461,213,21,192,4,188,0,56,72,8,3,2,0,25,4,18
67,462,12701,2602,10099,222,9877,305,2013,2853,831,103,70,31,1145,167,2359
67,463,2036,374,1662,32,1630,39,457,611,82,21,15,5,167,35,198
67,464,673,97,576,12,564,11,193,216,15,6,2,2,59,2,58
67,465,1619,306,1313,31,1282,15,365,492,64,14,21,5,128,24,154
67,466,328,61,267,6,261,9,57,105,14,1,2,2,37,6,28
67,467,345,57,288,3,285,3,88,122,10,1,1,0,31,5,24
67,468,503,95,408,8,400,5,114,137,26,2,2,0,42,8,64
67,469,311,55,256,3,253,5,61,94,14,6,2,0,35,3,33
67,470,105,27,78,2,76,5,16,10,11,1,0,0,8,5,20
67,471,5277,853,4424,66,4358,98,700,1594,355,40,18,12,574,72,895
67,472,3517,806,2711,67,2644,59,715,989,165,39,21,2,251,36,367
67,473,742,129,613,10,603,20,149,189,46,12,2,1,88,12,84
67,474,2234,398,1836,48,1788,36,446,664,74,21,12,6,244,34,251
67,475,195,38,157,2,155,9,44,34,10,4,1,0,20,4,29
67,476,505,105,400,7,393,7,124,117,22,6,4,1,57,10,45
67,477,497,74,423,13,410,10,104,139,30,3,8,0,65,9,42
67,478,1634,303,1331,16,1315,21,421,428,43,17,9,5,157,21,193
67,479,509,109,400,6,394,13,83,160,18,4,2,0,53,19,42
67,480,1346,229,1117,20,1097,25,316,342,74,17,9,5,129,28,152
67,481,846,136,710,20,690,23,132,313,33,9,3,2,85,19,71
67,482,142277,34325,107952,1429,106523,4464,12635,29272,12115,918,447,258,11096,1086,34232
67,483,206,31,175,6,169,7,45,41,14,3,6,0,23,5,25
67,484,358,61,297,10,287,4,85,121,10,2,3,0,28,8,26
67,485,1161,145,1016,19,997,22,169,398,53,4,3,3,150,15,180
67,486,1198,244,954,23,931,10,274,349,54,9,8,2,89,20,116
67,487,1283,275,1008,28,980,16,265,369,43,19,4,3,112,23,126
67,488,153,36,117,2,115,2,41,44,3,4,1,0,11,3,6
67,489,635,82,553,16,537,14,124,214,21,9,7,2,54,6,86
67,490,497,61,436,6,430,10,97,132,31,7,2,0,45,12,94
67,491,273,74,199,6,193,6,49,72,15,6,2,0,15,2,26
67,492,556,93,463,13,450,16,83,170,25,3,1,3,73,5,71
67,493,373,44,329,9,320,10,80,92,18,6,5,0,51,8,50
67,494,348,63,285,8,277,7,82,122,8,4,2,1,29,4,18
67,495,2441,411,2030,42,1988,52,352,837,93,18,10,12,247,51,316
67,496,957,122,835,22,813,4,244,325,35,15,4,1,91,18,76
67,497,572,91,481,13,468,10,100,194,24,13,5,2,47,11,62
67,498,591,110,481,9,472,11,156,142,26,5,3,2,59,15,53
67,499,270,38,232,4,228,19,53,68,14,0,3,0,34,7,30
67,500,1179,202,977,22,955,21,225,349,65,9,11,1,113,20,141
67,501,442,64,378,0,378,6,94,145,14,4,2,0,50,5,58
67,502,166,28,138,1,137,1,59,19,7,2,1,0,17,6,25
67,503,143,17,126,5,121,5,34,25,15,2,0,0,18,5,17
67,504,992,165,827,19,808,7,234,316,29,13,3,5,94,16,91
67,505,355,65,290,7,283,16,49,103,25,2,0,1,35,4,48
67,506,4527,995,3532,70,3462,76,624,1242,230,35,14,8,492,46,695
67,507,1418,328,1090,30,1060,31,253,363,52,13,9,2,154,15,168
67,508,347,71,276,6,270,3,101,83,11,5,1,2,37,7,20
67,509,280,62,218,4,214,10,68,55,13,1,1,2,24,8,32
67,510,344,39,305,8,297,9,49,107,15,3,2,0,45,8,59
67,511,685,100,585,23,562,17,144,200,24,7,0,1,78,7,84
67,512,827,177,650,12,638,17,179,231,37,6,3,1,72,8,84
67,513,115,20,95,3,92,3,28,30,5,1,3,1,5,4,12
67,514,517,74,443,8,435,13,178,125,14,6,4,1,42,10,42
67,515,441,52,389,10,379,12,91,146,15,4,2,1,59,4,45
67,516,553,83,470,9,461,19,115,148,29,4,3,0,66,11,66
67,517,527,73,454,6,448,20,99,163,28,10,3,2,59,8,56
67,519,4485,742,3743,50,3693,97,625,1643,211,25,11,12,474,49,546
67,520,4030,849,3181,64,3117,67,887,1024,178,44,33,8,349,59,468
67,521,380,72,308,12,296,6,87,98,13,6,3,1,39,11,32
67,522,466,110,356,13,343,5,110,109,17,2,5,1,43,15,36
67,523,2345,415,1930,37,1893,24,563,690,77,17,19,7,227,41,228
67,524,495,110,385,10,375,13,120,96,26,4,3,0,44,7,62
67,525,1303,218,1085,27,1058,21,249,426,51,5,9,0,150,22,125
67,526,1276,205,1071,14,1057,28,290,352,58,6,11,2,139,23,148
67,527,207,30,177,6,171,7,37,74,10,1,1,0,23,1,17
67,528,425,56,369,8,361,12,121,98,18,4,6,4,52,5,41
67,529,2643,484,2159,39,2120,36,501,842,122,20,16,5,248,35,295
67,530,357,53,304,7,297,9,65,132,10,5,1,0,36,11,28
67,531,270,45,225,1,224,9,57,48,23,8,1,2,25,3,48
67,532,728,93,635,8,627,12,146,243,32,4,3,5,88,12,82
67,534,575,85,490,12,478,7,115,185,20,5,2,1,68,14,61
67,535,895,115,780,18,762,15,242,228,38,10,7,2,98,14,108
67,536,157,27,130,4,126,4,38,29,8,3,1,0,25,6,12
67,537,387,79,308,7,301,10,61,105,8,8,3,1,48,16,41
67,538,1212,227,985,19,966,28,266,282,68,8,8,0,130,21,155
67,539,880,90,790,11,779,12,141,366,25,2,3,1,107,9,113
67,540,608,96,512,10,502,12,132,209,18,6,3,2,72,5,43
67,541,344,63,281,5,276,3,103,97,7,2,2,1,30,8,23
67,542,265,27,238,4,234,5,54,80,15,4,1,1,37,7,30
67,543,1559,314,1245,21,1224,19,358,343,102,18,15,5,111,24,229
67,544,5634,1503,4131,97,4034,133,784,1397,255,41,23,10,550,71,770
67,545,398,57,341,9,332,14,83,123,14,5,4,0,47,9,33
67,546,486,57,429,8,421,8,109,181,15,1,2,0,60,7,38
67,547,1603,271,1332,28,1304,30,370,403,77,8,12,1,155,24,224
67,548,655,72,583,5,578,7,107,275,24,4,2,0,79,11,69
67,550,1395,315,1080,28,1052,24,291,342,65,12,7,4,111,31,165
67,551,2893,516,2377,34,2343,84,403,874,171,8,9,5,312,26,451
67,552,278,52,226,7,219,16,58,54,8,6,5,2,37,9,24
67,553,260,43,217,5,212,2,63,91,12,1,1,0,20,5,17
67,554,746,97,649,9,640,19,120,275,28,6,2,2,98,6,84
67,555,199,43,156,5,151,1,34,69,6,1,1,0,23,2,14
67,556,150,21,129,2,127,2,24,48,11,0,0,0,21,3,18
67,557,542,60,482,6,476,10,138,178,29,6,4,3,51,12,45
67,558,636,130,506,5,501,4,178,152,40,4,2,4,46,8,63
67,559,213,42,171,5,166,3,37,58,20,0,4,1,16,1,26
67,560,147,26,121,5,116,3,21,42,12,0,1,1,22,1,13
68,1,599,94,505,15,490,17,138,148,29,9,3,2,55,17,72
68,2,294,47,247,5,242,3,52,91,19,6,5,2,34,8,22
68,4,3833,749,3084,69,3015,91,541,915,306,38,18,6,427,76,597
68,5,1388,224,1164,18,1146,58,230,450,50,10,2,4,149,24,169
68,6,317,32,285,7,278,7,72,103,24,3,0,2,33,4,30
68,7,1791,255,1536,40,1496,37,338,509,80,8,10,1,242,34,237
68,8,430,55,375,4,371,11,101,117,17,2,1,0,48,9,65
68,9,580,86,494,11,483,5,127,154,33,6,7,3,67,16,65
68,10,832,142,690,8,682,19,152,235,46,10,3,2,113,9,93
68,11,1025,166,859,16,843,15,242,244,59,9,6,5,113,24,126
68,12,1121,169,952,24,928,17,232,294,67,11,4,4,129,17,153
68,13,648,94,554,6,548,8,120,292,13,2,0,1,55,7,50
68,14,262,39,223,11,212,18,58,37,24,8,2,0,33,1,31
68,15,2117,372,1745,19,1726,42,386,580,115,15,8,4,203,42,331
68,16,655,92,563,12,551,8,160,189,31,5,9,0,76,10,63
68,17,658,107,551,20,531,11,149,169,45,6,2,3,77,13,56
68,18,643,82,561,2,559,16,131,192,24,7,3,1,101,15,69
68,19,399,63,336,9,327,6,103,99,23,3,2,1,33,4,53
68,20,1186,204,982,22,960,14,246,291,73,16,6,2,122,27,163
68,21,2471,471,2000,41,1959,45,452,905,76,22,13,4,211,36,195
68,22,1143,168,975,19,956,21,279,332,46,8,1,1,90,21,157
68,23,762,147,615,9,606,20,125,231,33,8,4,3,85,5,92
68,24,96,19,77,4,73,3,14,23,8,0,0,1,11,2,11
68,25,167,31,136,2,134,5,33,49,5,4,0,2,16,4,16
68,26,988,145,843,25,818,23,144,345,32,5,6,1,130,11,121
68,27,261,50,211,10,201,9,49,86,4,2,1,1,26,5,18
68,28,1508,241,1267,27,1240,42,334,424,76,16,14,8,135,29,162
68,29,833,114,719,16,703,24,177,192,38,10,6,1,112,15,128
68,30,339,45,294,6,288,14,64,106,10,5,2,0,30,5,52
68,31,534,84,450,3,447,14,102,157,22,6,2,1,87,14,42
68,32,953,101,852,8,844,23,219,292,49,8,3,2,107,22,119
68,33,402,69,333,9,324,8,96,119,9,4,0,0,35,15,38
68,34,254,41,213,2,211,4,51,108,10,1,0,0,22,4,11
68,35,211,53,158,7,151,15,22,63,9,1,0,2,23,4,12
68,36,1724,357,1367,34,1333,25,372,406,74,19,13,3,143,27,251
68,37,290,46,244,9,235,1,91,47,20,1,0,0,31,4,40
68,38,778,124,654,15,639,20,153,206,48,8,4,0,72,17,111
68,39,477,103,374,6,368,6,119,127,24,2,2,1,42,14,31
68,40,1433,268,1165,17,1148,18,356,279,91,20,13,2,112,16,241
68,41,1374,233,1141,22,1119,34,314,399,77,13,9,3,100,32,138
68,42,2895,614,2281,38,2243,57,534,979,85,14,16,7,259,42,250
68,43,2887,598,2289,40,2249,41,620,562,187,46,12,4,242,50,485
68,44,625,113,512,10,502,22,130,129,51,2,2,0,59,21,86
68,45,469,57,412,4,408,10,127,122,22,6,3,2,45,10,61
68,46,350,53,297,12,285,18,64,54,24,4,2,3,32,3,81
68,49,337,73,264,6,258,13,58,104,12,8,2,2,34,7,18
68,50,364,64,300,7,293,7,52,115,11,2,2,0,44,9,51
68,51,704,147,557,7,550,17,149,164,34,3,5,3,82,17,76
68,52,140,17,123,1,122,1,23,46,9,2,3,2,13,2,21
68,54,278,33,245,3,242,8,61,103,5,1,2,3,32,6,21
68,55,834,110,724,10,714,14,156,283,33,2,1,5,90,11,119
68,56,4605,912,3693,58,3635,110,640,1423,219,39,16,12,476,71,629
68,57,192,19,173,2,171,1,43,57,17,1,1,1,22,3,25
68,58,2527,640,1887,37,1850,41,522,506,124,31,10,6,221,40,349
68,59,1360,220,1140,17,1123,17,324,373,68,16,3,4,118,24,176
68,60,1302,175,1127,24,1103,26,262,345,68,11,5,7,157,35,187
68,61,683,139,544,17,527,10,99,237,18,6,2,2,76,16,61
68,62,1499,235,1264,28,1236,32,266,447,108,6,11,2,158,27,179
68,63,7665,1701,5964,111,5853,136,1551,1541,543,72,25,17,569,131,1268
68,64,695,112,583,10,573,11,160,176,33,10,5,5,53,17,103
68,65,467,90,377,5,372,6,113,83,32,2,5,1,46,11,73
68,66,41850,11062,30788,520,30268,1017,5987,9090,2414,352,207,93,3360,490,7258
68,67,298,60,238,8,230,8,66,102,7,4,2,0,19,3,19
68,68,1382,220,1162,22,1140,31,288,369,82,15,9,5,135,29,177
68,69,902,94,808,16,792,10,246,261,42,8,4,5,87,23,106
68,70,1277,225,1052,14,1038,37,245,353,83,6,13,6,109,14,172
68,71,212,39,173,0,173,3,54,44,14,4,1,0,23,10,20
68,72,1087,166,921,15,906,23,189,363,56,10,5,5,119,25,111
68,73,349,22,327,4,323,8,82,92,41,2,5,3,34,6,50
68,74,381,55,326,4,322,7,114,120,9,5,3,1,33,9,21
68,75,645,111,534,9,525,15,128,207,27,5,2,2,46,7,86
68,76,644,90,554,11,543,12,173,194,21,10,6,1,48,25,53
68,77,285,42,243,12,231,11,63,65,9,2,6,2,42,6,25
68,78,1311,169,1142,14,1128,47,143,490,48,12,5,1,174,18,190
68,79,229,36,193,4,189,2,54,58,15,0,5,3,20,3,29
68,80,238,34,204,5,199,8,46,63,10,1,2,0,31,4,34
68,81,416,54,362,8,354,9,83,149,15,7,1,0,50,3,37
68,82,5552,1234,4318,96,4222,83,1174,1171,322,58,50,15,442,89,818
68,83,316,54,262,12,250,15,59,74,16,9,3,1,29,3,41
68,84,1161,167,994,22,972,30,171,363,67,16,3,5,160,29,128
68,85,294,45,249,6,243,9,84,57,18,1,4,1,36,5,28
68,86,154,33,121,2,119,1,29,52,6,4,1,0,16,3,7
68,87,382,69,313,6,307,12,62,131,19,2,2,0,38,4,37
68,88,749,106,643,18,625,15,132,175,64,8,5,0,70,29,127
68,89,1305,201,1104,28,1076,32,325,347,63,17,9,7,95,41,140
68,90,518,114,404,10,394,21,89,116,20,7,2,1,67,9,62
68,91,1630,232,1398,30,1368,28,340,459,142,13,10,8,164,34,170
68,92,343,56,287,2,285,11,50,135,16,3,0,0,33,5,32
68,93,1250,216,1034,23,1011,30,202,412,76,7,2,3,108,19,152
68,94,595,106,489,7,482,14,80,208,18,11,3,0,84,23,41
68,95,928,154,774,12,762,10,134,294,58,13,4,3,87,15,144
68,96,268,31,237,2,235,5,57,119,8,3,1,1,24,5,12
68,97,1104,171,933,18,915,33,217,246,70,13,6,6,160,27,137
68,98,491,74,417,10,407,12,115,137,24,6,2,3,46,9,53
68,99,575,95,480,9,471,14,136,156,20,3,4,4,35,6,93
68,100,290,48,242,5,237,12,74,87,8,1,2,0,26,6,21
68,101,575,93,482,10,472,13,111,188,22,3,3,0,63,8,61
68,102,406,58,348,12,336,7,84,88,34,10,7,2,54,14,36
68,103,364,51,313,3,310,5,78,144,10,2,2,0,42,5,22
68,104,223,32,191,4,187,3,51,63,6,2,0,0,24,8,30
68,105,251,43,208,1,207,4,43,76,13,3,1,1,38,4,24
68,106,251,40,211,8,203,8,81,47,18,3,1,0,22,4,19
68,107,309,54,255,4,251,10,51,91,16,2,0,0,43,14,24
68,108,406,69,337,8,329,6,78,133,10,1,2,1,56,9,33
68,109,590,73,517,7,510,15,131,153,28,13,4,2,62,17,85
68,110,691,96,595,7,588,8,180,217,26,8,0,0,71,21,57
68,111,701,97,604,11,593,21,107,267,22,5,3,5,58,17,88
68,112,7846,2035,5811,107,5704,165,1327,1475,580,77,38,16,552,139,1335
68,113,1103,193,910,17,893,21,244,324,40,15,9,3,108,20,109
68,114,127,18,109,4,105,4,31,35,5,1,2,0,7,3,17
68,115,1123,175,948,19,929,25,234,306,72,16,4,2,116,31,123
68,116,595,95,500,7,493,25,130,114,23,11,7,1,63,9,110
68,117,715,102,613,14,599,44,128,182,40,17,7,0,78,14,89
68,118,3739,750,2989,58,2931,76,712,1040,153,30,13,12,330,80,485
68,119,537,76,461,8,453,8,101,145,39,2,1,0,64,11,82
68,120,782,170,612,10,602,20,91,322,18,8,0,0,68,14,61
68,121,453,74,379,2,377,13,70,197,13,2,4,1,39,14,24
68,122,488,81,407,11,396,15,88,120,30,5,6,6,57,5,64
68,123,652,109,543,3,540,13,138,158,40,7,6,2,78,15,83
68,124,348,56,292,8,284,4,59,115,23,7,2,5,32,13,24
68,125,383,79,304,9,295,9,88,72,20,7,3,3,37,4,52
68,126,2001,425,1576,21,1555,41,258,738,61,9,9,4,203,36,196
68,127,547,92,455,10,445,11,102,151,26,6,1,1,64,11,72
68,128,481,78,403,20,383,10,106,110,13,8,2,0,50,14,70
68,129,1119,172,947,26,921,14,239,332,56,10,6,0,107,14,143
68,130,706,132,574,19,555,16,184,146,27,11,7,2,75,16,71
68,131,152,24,128,4,124,3,40,44,9,1,2,0,11,0,14
68,132,554,74,480,12,468,20,92,220,24,3,2,2,55,6,44
68,133,163,21,142,2,140,6,33,62,2,3,1,0,17,2,14
68,134,1477,238,1239,30,1209,30,238,436,80,9,7,2,179,22,206
68,135,1579,275,1304,18,1286,33,260,609,54,10,4,1,124,31,160
68,136,277,43,234,4,230,2,60,98,11,0,1,1,28,7,22
68,137,458,70,388,8,380,10,121,115,20,8,5,0,38,14,49
68,138,1531,320,1211,22,1189,27,239,450,73,8,9,5,164,20,194
68,139,1060,204,856,29,827,15,243,269,50,13,7,0,86,23,121
68,140,906,140,766,17,749,14,224,262,27,5,17,3,79,22,96
68,141,1633,241,1392,20,1372,25,280,478,95,16,8,2,198,36,234
68,142,273,43,230,6,224,9,53,57,17,6,0,1,38,10,33
68,143,1091,158,933,17,916,35,214,336,48,7,4,4,119,17,132
68,144,816,140,676,12,664,23,166,190,63,11,2,2,65,17,125
68,145,4102,678,3424,44,3380,76,738,1138,200,43,18,14,496,60,597
68,146,1404,177,1227,35,1192,22,324,421,67,13,6,1,143,40,155
68,147,461,68,393,6,387,15,62,165,22,3,0,0,73,1,46
68,148,244,50,194,4,190,4,54,71,7,2,0,0,29,6,17
68,149,4039,1009,3030,63,2967,95,589,890,233,46,17,12,342,56,687
68,150,388,51,337,4,333,12,72,134,18,1,0,0,45,12,39
68,151,780,122,658,16,642,24,153,150,45,12,9,3,90,16,140
68,152,1899,306,1593,33,1560,32,312,627,96,6,13,5,213,34,222
68,153,546,53,493,16,477,8,106,216,22,3,4,0,63,13,42
68,154,9606,2265,7341,151,7190,117,1690,1900,679,71,45,26,657,133,1872
68,155,3355,650,2705,46,2659,88,607,846,152,41,18,3,333,62,509
68,156,2342,413,1929,42,1887,35,485,570,109,30,16,5,213,38,386
68,157,923,121,802,20,782,20,197,279,45,9,5,1,104,28,94
68,158,381,72,309,4,305,15,50,152,16,3,0,1,34,15,19
68,159,695,97,598,21,577,23,154,140,46,7,4,1,69,14,119
68,160,422,66,356,8,348,10,72,155,12,4,3,0,63,7,22
68,161,441,50,391,12,379,19,70,157,19,1,5,2,50,5,51
68,162,2131,389,1742,41,1701,87,352,590,118,23,17,6,206,31,271
68,163,3378,723,2655,57,2598,70,702,901,156,39,12,9,291,44,374
68,164,628,127,501,9,492,23,94,186,22,4,6,3,69,13,72
68,165,165,31,134,0,134,5,30,70,4,0,3,0,12,3,7
68,166,10210,2406,7804,135,7669,145,2056,2037,603,102,44,25,633,139,1885
68,167,656,114,542,17,525,7,164,187,34,2,3,2,58,11,57
68,168,251,37,214,3,211,7,53,91,17,1,0,2,15,7,18
68,169,360,54,306,9,297,14,60,136,24,6,1,1,22,9,24
68,170,456,44,412,9,403,20,90,146,27,4,1,4,43,2,66
68,171,805,139,666,11,655,10,216,210,51,8,5,1,58,12,84
68,172,1145,188,957,26,931,25,220,277,53,23,11,4,146,30,142
68,173,1712,293,1419,35,1384,86,296,464,105,13,10,0,171,36,203
68,174,1287,206,1081,26,1055,26,289,317,80,19,7,6,102,28,181
68,175,1528,253,1275,27,1248,59,237,337,133,31,18,4,164,31,234
68,176,227,29,198,4,194,7,52,56,8,1,2,0,35,5,28
68,177,1288,270,1018,27,991,36,229,269,83,19,7,4,111,22,211
68,178,810,142,668,21,647,28,159,185,61,12,2,2,81,14,103
68,179,722,107,615,15,600,12,141,205,36,6,7,1,73,18,101
68,180,706,98,608,18,590,22,130,193,45,5,3,1,86,19,86
68,181,222,44,178,0,178,9,31,81,12,2,0,0,22,6,15
68,182,594,140,454,4,450,17,84,226,12,4,1,0,62,9,35
68,183,121,20,101,3,98,4,15,51,4,0,0,0,19,1,4
68,184,234,37,197,5,192,11,56,78,8,2,0,1,17,3,16
68,185,1344,236,1108,32,1076,17,359,214,97,23,11,4,92,26,233
68,186,254,42,212,4,208,9,48,101,7,1,2,0,24,1,15
68,187,247,38,209,2,207,7,48,111,9,0,1,2,17,2,10
68,188,489,74,415,13,402,21,98,95,56,4,5,2,46,15,60
68,189,616,69,547,11,536,12,138,192,29,2,2,2,74,11,74
68,190,37,5,32,3,29,0,0,22,1,1,0,0,1,2,2
68,191,629,99,530,15,515,18,119,194,39,5,5,0,56,11,68
68,192,285,60,225,6,219,8,70,50,17,4,0,3,38,4,25
68,193,639,109,530,18,512,28,160,140,37,7,6,0,51,7,76
68,194,189,31,158,6,152,3,39,63,8,1,3,2,21,0,12
68,195,4650,1061,3589,60,3529,96,811,1018,275,34,21,13,403,78,780
68,196,201,40,161,5,156,2,72,36,11,3,1,2,12,5,12
68,197,335,40,295,5,290,10,42,137,10,2,1,0,52,8,28
68,198,206,42,164,2,162,5,54,67,2,1,0,0,14,7,12
68,199,402,69,333,7,326,3,98,78,30,11,2,2,31,10,61
68,200,429,85,344,9,335,11,83,93,27,8,10,5,46,5,47
68,201,2463,494,1969,23,1946,39,458,580,180,31,15,10,240,38,355
68,202,182,24,158,2,156,5,39,65,11,1,0,0,22,2,11
68,203,1045,128,917,18,899,13,297,211,66,9,9,3,115,8,168
68,204,875,139,736,16,720,29,185,261,43,9,7,1,71,20,94
68,205,778,119,659,13,646,12,180,189,38,7,10,3,94,19,94
68,206,277,43,234,4,230,12,55,87,9,0,0,1,25,4,37
68,207,588,88,500,6,494,10,118,212,28,5,5,1,54,8,53
68,208,426,75,351,6,345,12,89,156,12,0,1,1,31,12,31
68,209,670,118,552,8,544,18,128,205,26,6,4,1,80,7,69
68,210,288,50,238,8,230,12,61,72,10,2,4,0,30,8,31
68,211,320,49,271,10,261,4,78,98,19,4,4,0,21,10,23
68,212,439,53,386,3,383,6,80,196,21,3,5,1,43,9,19
68,213,342,68,274,5,269,12,62,70,38,4,2,2,25,6,48
68,214,244,27,217,5,212,3,76,60,14,1,2,2,19,4,31
68,215,687,123,564,8,556,9,165,154,48,6,3,1,52,16,102
68,216,296,40,256,6,250,10,50,113,15,6,4,0,24,6,22
68,217,1345,282,1063,30,1033,17,332,305,77,24,6,3,105,33,131
68,218,2646,497,2149,49,2100,50,456,680,152,19,18,10,258,47,410
68,219,268,29,239,13,226,7,38,72,28,5,3,1,33,6,33
68,221,645,104,541,16,525,13,105,252,24,5,3,1,65,21,36
68,222,726,118,608,13,595,18,127,277,26,7,5,1,80,16,38
68,223,623,105,518,11,507,16,130,186,27,4,4,4,60,9,67
68,224,54630,16453,38177,972,37205,980,6510,9743,4005,360,203,122,3308,511,11463
68,225,1232,172,1060,30,1030,28,295,313,66,18,8,3,99,9,191
68,226,3381,779,2602,54,2548,79,630,828,187,36,21,5,304,60,398
68,227,892,132,760,10,750,13,164,228,47,13,7,4,132,19,123
68,228,366,42,324,5,319,5,96,98,12,8,4,1,44,11,40
68,229,117,14,103,3,100,10,24,28,9,0,0,0,2,2,25
68,230,401,60,341,4,337,5,119,65,28,5,1,0,59,5,50
68,231,1158,245,913,18,895,15,266,260,68,16,3,4,72,19,172
68,232,348,57,291,4,287,9,38,165,8,4,1,2,31,4,25
68,233,356,62,294,9,285,8,85,77,35,2,0,3,21,1,53
68,234,381,50,331,12,319,4,84,105,17,6,0,3,47,12,41
68,235,789,91,698,20,678,15,164,214,38,2,2,0,110,16,117
68,237,492,67,425,7,418,13,73,187,14,6,8,0,62,13,42
68,238,627,89,538,15,523,10,137,202,27,2,4,3,76,8,54
68,239,347,56,291,10,281,17,71,86,17,2,7,0,38,5,38
68,240,415,60,355,5,350,6,73,160,18,9,2,0,37,10,35
68,241,456,71,385,10,375,5,86,125,33,4,1,2,40,9,70
68,242,959,127,832,22,810,25,261,199,68,14,8,6,78,23,128
68,243,111,18,93,4,89,4,16,45,6,1,1,1,9,1,5
68,244,300,58,242,4,238,3,52,95,16,1,3,2,24,4,38
68,245,342,47,295,6,289,8,64,103,22,4,2,0,46,4,36
68,246,684,98,586,18,568,15,159,182,25,6,4,1,67,23,86
68,247,961,169,792,19,773,15,233,249,54,6,5,1,88,14,108
68,248,525,102,423,4,419,19,68,223,20,5,1,1,44,2,36
68,249,2742,485,2257,48,2209,106,538,655,188,29,22,9,275,70,317
68,250,824,119,705,12,693,26,141,284,40,9,7,2,84,17,83
68,251,749,119,630,14,616,25,162,219,36,6,0,3,79,7,79
68,252,1246,234,1012,12,1000,33,292,336,45,8,5,3,139,19,120
68,253,1438,295,1143,24,1119,17,316,282,150,15,7,6,103,27,196
68,254,575,72,503,15,488,11,129,156,32,7,2,2,77,5,67
68,255,1040,187,853,17,836,28,211,278,59,8,6,5,114,21,106
68,256,6981,1756,5225,119,5106,103,1174,1612,394,58,27,10,536,86,1106
68,257,739,109,630,17,613,14,131,226,46,11,4,4,78,9,90
68,258,2394,475,1919,45,1874,36,530,498,160,24,15,2,209,42,358
68,259,355,59,296,3,293,4,59,165,16,2,0,1,27,7,12
68,260,950,166,784,12,772,15,218,249,50,6,3,4,86,34,107
68,261,200,36,164,3,161,8,40,51,6,2,2,0,22,8,22
68,262,676,109,567,3,564,13,178,156,50,3,4,1,57,17,85
68,263,516,75,441,8,433,8,82,245,11,4,1,0,49,5,28
68,264,394,51,343,6,337,9,71,178,7,1,0,1,43,3,24
68,265,617,101,516,7,509,12,101,227,21,3,2,1,76,11,55
68,266,1378,241,1137,22,1115,13,337,302,67,12,6,6,146,15,211
68,267,1482,247,1235,38,1197,31,306,417,79,13,6,4,148,15,178
68,268,472,95,377,8,369,6,89,102,36,3,0,0,60,6,67
68,269,3565,678,2887,67,2820,118,616,1025,163,38,18,10,363,57,412
68,270,2790,514,2276,36,2240,43,592,710,133,33,10,13,200,63,443
68,271,9359,2213,7146,170,6976,238,1195,2596,470,57,26,20,916,118,1340
68,272,321,27,294,5,289,7,79,102,13,1,1,0,46,8,32
68,273,509,59,450,6,444,7,80,195,31,9,1,2,67,9,43
68,274,121,31,90,3,87,2,33,22,4,0,0,0,10,1,15
68,275,410,82,328,8,320,5,113,88,19,1,2,0,42,3,47
68,276,160,22,138,1,137,5,42,32,13,0,4,0,17,3,21
68,277,885,163,722,12,710,18,157,293,39,4,3,3,80,15,98
68,278,10042,2135,7907,143,7764,187,1754,2481,578,65,36,22,940,152,1549
68,279,739,99,640,7,633,29,122,181,38,9,4,1,103,24,122
68,280,256,38,218,4,214,8,53,84,12,0,2,0,31,5,19
68,281,350,42,308,8,300,14,70,85,30,3,2,3,35,9,49
68,282,169,17,152,5,147,1,58,28,21,0,0,2,13,5,19
68,283,687,144,543,7,536,6,155,132,54,11,6,0,63,22,87
68,284,505,89,416,5,411,11,103,176,22,1,1,0,46,8,43
68,285,333,48,285,4,281,16,64,103,24,3,2,0,29,4,36
68,286,1508,302,1206,6,1200,23,273,501,68,17,7,7,142,18,144
68,287,2995,511,2484,44,2440,87,617,736,176,23,16,12,253,56,464
68,288,280,48,232,7,225,6,37,90,13,1,1,0,41,5,31
68,289,1939,296,1643,35,1608,46,454,451,115,20,9,2,162,50,299
68,290,608,96,512,20,492,18,140,141,38,8,2,1,52,13,79
68,291,807,144,663,17,646,10,189,253,30,5,7,0,74,10,68
68,292,1834,389,1445,42,1403,22,433,426,107,27,19,4,135,25,205
68,293,76,8,68,4,64,0,24,23,1,1,0,0,6,0,9
68,294,1469,334,1135,25,1110,35,313,301,106,23,7,3,100,20,202
68,295,2086,277,1809,27,1782,34,478,640,82,10,9,8,223,44,254
68,296,840,129,711,12,699,13,154,288,26,5,4,2,97,8,102
68,297,10972,2943,8029,155,7874,218,1389,2646,751,86,32,23,808,137,1784
68,298,3338,749,2589,59,2530,60,605,654,277,38,12,11,234,39,600
68,299,238,33,205,3,202,7,45,79,20,2,0,0,15,10,24
68,300,4098,648,3450,74,3376,76,815,1091,236,30,14,15,406,83,610
68,301,923,129,794,17,777,22,154,284,46,4,8,1,109,40,109
68,302,625,84,541,8,533,24,123,157,48,6,2,5,82,12,74
68,303,205,32,173,2,171,8,54,53,10,3,1,1,20,4,17
68,304,1085,150,935,22,913,23,275,219,76,11,12,0,107,22,168
68,305,799,161,638,11,627,10,154,211,48,11,3,3,58,17,112
68,306,329,51,278,3,275,7,55,78,23,5,2,0,39,9,57
68,307,484,73,411,7,404,12,135,115,24,8,8,0,49,7,46
68,308,285,37,248,2,246,5,56,87,11,2,1,0,42,8,34
68,309,2041,331,1710,31,1679,40,396,663,78,20,9,7,212,28,226
68,310,964,140,824,19,805,20,188,290,47,7,10,1,122,16,104
68,311,556,105,451,3,448,10,140,145,29,7,1,2,38,11,65
68,312,286,55,231,5,226,6,62,106,4,3,0,0,16,5,24
68,313,591,67,524,7,517,7,176,135,32,8,2,0,49,43,65
68,314,485,78,407,6,401,15,103,110,30,5,3,0,48,13,74
68,315,4754,900,3854,83,3771,119,924,1045,297,53,19,12,392,76,834
68,316,551,91,460,7,453,13,102,150,25,7,1,1,78,12,64
68,317,978,186,792,17,775,28,243,223,45,10,5,1,116,25,79
68,318,1682,266,1416,26,1390,33,401,419,74,21,9,9,161,41,222
68,319,563,84,479,3,476,18,114,180,30,3,1,1,67,9,53
68,320,492,61,431,8,423,16,101,167,26,2,4,3,48,5,51
68,321,2932,607,2325,38,2287,32,731,489,250,28,13,12,180,38,514
68,322,1144,197,947,13,934,36,199,305,62,15,3,0,137,21,156
68,323,574,104,470,6,464,8,105,200,20,5,2,1,55,11,57
68,324,477,65,412,12,400,12,97,144,15,3,2,2,57,3,65
68,325,555,80,475,13,462,9,123,194,26,10,6,0,45,15,34
68,326,121,12,109,2,107,1,22,31,18,3,2,3,14,4,9
68,327,262,34,228,3,225,12,41,96,5,2,4,0,36,2,27
68,328,212,36,176,1,175,5,48,64,8,2,0,0,25,1,22
68,329,1083,188,895,18,877,21,296,254,35,18,4,5,115,19,110
68,330,255,37,218,6,212,1,64,79,20,6,1,0,18,2,21
68,331,1565,199,1366,23,1343,39,292,454,78,14,9,9,174,29,245
68,332,585,92,493,15,478,7,138,142,25,6,3,0,70,12,75
68,333,244,45,199,4,195,4,45,86,7,2,1,0,18,2,30
68,334,5360,1081,4279,80,4199,121,912,1166,406,54,35,18,455,99,933
68,335,384,59,325,10,315,20,81,99,21,7,1,0,44,9,33
68,336,380,68,312,9,303,6,106,109,13,2,1,2,34,7,23
68,337,412,58,354,7,347,4,96,113,15,2,2,3,48,9,55
68,338,2963,541,2422,47,2375,69,452,888,130,32,19,8,301,43,433
68,340,269,55,214,7,207,3,54,67,8,4,2,1,27,9,32
68,341,726,107,619,5,614,24,126,264,44,6,5,0,66,6,73
68,342,1228,221,1007,29,978,45,227,320,60,13,8,3,132,28,142
68,343,1702,376,1326,23,1303,20,447,339,107,32,10,4,131,35,178
68,344,361,48,313,6,307,5,100,98,24,3,4,0,33,10,30
68,345,516,42,474,9,465,6,141,144,29,5,5,0,63,10,62
68,347,473,84,389,7,382,11,96,113,24,8,0,2,61,5,62
68,348,2147,473,1674,26,1648,37,404,414,154,19,12,9,181,45,373
68,349,2597,497,2100,49,2051,61,356,852,112,17,9,6,295,42,301
68,350,464,70,394,6,388,15,84,149,16,2,4,1,49,8,60
68,351,406,69,337,4,333,18,90,114,20,6,1,2,32,7,43
68,352,1500,359,1141,12,1129,24,312,307,73,11,11,3,122,27,239
68,353,335,54,281,4,277,5,68,112,11,5,1,0,37,10,28
68,354,802,112,690,12,678,26,124,205,60,5,6,2,95,28,127
68,355,1088,266,822,14,808,22,184,363,45,12,3,1,73,18,87
68,356,720,105,615,7,608,14,176,223,20,5,1,5,59,23,82
68,357,415,58,357,1,356,15,82,116,14,3,1,3,70,5,47
68,358,394,56,338,4,334,14,95,80,15,2,0,1,50,10,67
68,359,1385,212,1173,17,1156,50,280,373,70,9,11,3,141,22,197
68,360,379,60,319,3,316,7,93,95,17,5,2,4,34,10,49
68,361,297,53,244,2,242,1,66,79,23,5,1,1,32,6,28
68,362,476,93,383,9,374,9,83,161,16,4,2,2,46,8,43
68,363,427,62,365,9,356,5,99,141,23,5,3,0,39,7,34
68,364,784,126,658,21,637,17,147,255,27,9,11,5,90,16,60
68,365,1438,208,1230,27,1203,40,262,503,53,12,3,5,154,18,153
68,366,617,93,524,6,518,5,134,171,22,10,1,1,73,7,94
68,367,892,141,751,19,732,20,209,208,46,6,7,2,69,23,142
68,368,1071,153,918,13,905,33,228,302,79,8,5,2,102,13,133
68,370,143,20,123,2,121,7,39,32,13,0,2,0,7,9,12
68,371,271,38,233,8,225,12,52,104,8,2,0,1,24,2,20
68,372,1496,300,1196,32,1164,23,376,331,93,18,15,4,108,28,168
68,373,259,54,205,3,202,9,52,88,7,2,1,1,26,2,14
68,374,5716,1143,4573,82,4491,148,944,1479,320,64,30,14,545,96,851
68,375,8171,1699,6472,132,6340,85,2063,1475,579,91,40,17,522,124,1344
68,376,10226,2303,7923,166,7757,111,2231,1778,767,105,48,25,582,125,1985
68,377,629,96,533,12,521,8,134,164,37,8,6,1,74,11,78
68,378,242,35,207,7,200,6,61,79,10,5,2,0,14,2,21
68,379,762,95,667,17,650,8,178,248,42,14,1,1,77,11,70
68,380,336,64,272,5,267,4,44,128,5,1,5,0,44,13,23
68,381,670,97,573,13,560,18,152,188,34,10,2,0,66,10,80
68,382,255,46,209,3,206,4,50,87,4,5,0,1,31,4,20
68,383,327,50,277,4,273,15,38,128,11,2,0,0,42,4,33
68,384,2209,368,1841,35,1806,54,401,646,90,16,7,5,270,27,290
68,385,751,113,638,12,626,24,120,251,27,4,6,2,96,10,86
68,386,953,140,813,13,800,32,141,350,39,8,1,2,110,19,98
69,1,250,25,225,7,218,3,61,68,12,4,2,0,29,14,25
69,2,224,42,182,6,176,4,61,59,9,1,2,2,28,0,10
69,3,1583,272,1311,24,1287,31,216,461,98,13,8,9,136,19,296
69,4,417,49,368,9,359,11,80,114,29,3,5,2,35,9,71
69,5,389,49,340,5,335,4,107,118,13,2,1,1,23,11,55
69,6,3664,724,2940,53,2887,51,695,859,257,33,25,7,328,66,566
69,7,1917,269,1648,34,1614,40,384,508,119,14,8,5,167,39,330
69,8,444,43,401,8,393,13,75,140,45,1,1,0,46,8,64
69,9,4004,565,3439,59,3380,87,572,1067,321,28,14,9,368,66,848
69,10,3858,674,3184,65,3119,94,477,778,385,21,18,13,395,75,863
69,12,471,56,415,13,402,20,77,138,38,4,0,5,39,10,71
69,13,2379,358,2021,42,1979,31,446,654,157,13,8,2,216,31,421
69,14,781,90,691,18,673,24,119,197,59,10,5,0,92,28,139
69,15,97,11,86,2,84,5,10,31,13,2,1,0,9,2,11
69,16,122,15,107,4,103,0,21,43,6,0,1,0,21,2,9
69,17,567,82,485,13,472,18,102,130,59,4,5,0,38,9,107
69,18,1220,246,974,25,949,15,221,337,77,12,5,1,93,28,160
69,19,4515,954,3561,69,3492,46,803,1022,353,39,31,6,325,62,805
69,20,461,43,418,14,404,11,76,106,34,3,2,1,49,10,112
69,21,1544,188,1356,25,1331,36,220,403,161,23,2,6,155,30,295
69,22,348,49,299,3,296,8,55,112,28,3,3,1,37,6,43
69,23,1002,131,871,15,856,25,228,328,27,7,3,1,108,15,114
69,24,1656,215,1441,30,1411,34,226,452,144,10,10,3,168,30,334
69,25,1762,382,1380,26,1354,14,320,370,154,19,5,5,140,30,297
69,26,306,31,275,3,272,4,53,98,20,2,3,0,44,7,41
69,27,8291,1539,6752,114,6638,181,933,2098,654,65,34,14,800,148,1711
69,28,3967,458,3509,47,3462,117,560,1263,244,35,11,12,445,70,705
69,29,22309,4496,17813,282,17531,455,2745,4627,2058,138,89,51,1652,285,5431
69,30,605,70,535,11,524,11,96,201,39,6,2,1,54,15,99
69,31,759,68,691,23,668,22,148,195,70,11,3,2,83,19,115
69,32,1475,218,1257,19,1238,26,245,442,100,6,5,3,139,19,253
69,33,1811,183,1628,26,1602,39,215,681,121,7,3,6,187,25,318
69,34,28452,4839,23613,306,23307,726,2627,8560,2204,185,67,59,2629,376,5874
69,35,302,50,252,6,246,7,42,68,31,2,2,0,42,5,47
69,36,743,95,648,15,633,7,178,184,64,12,2,0,64,12,110
69,37,552,85,467,8,459,5,106,134,43,9,2,0,50,13,97
69,38,636,117,519,12,507,11,111,165,50,4,7,1,50,18,90
69,39,510,84,426,15,411,16,74,128,40,3,2,1,54,7,86
69,40,3728,531,3197,49,3148,63,460,1299,230,25,10,14,332,60,655
69,41,181,13,168,3,165,4,51,53,15,0,0,1,14,4,23
69,42,395,26,369,7,362,10,75,127,28,3,2,0,44,14,59
69,43,5986,767,5219,54,5165,160,596,1962,375,25,19,11,679,104,1234
69,44,3864,472,3392,39,3353,80,310,1890,137,13,2,10,352,61,498
69,45,824,104,720,13,707,15,181,232,68,3,1,2,65,17,123
69,46,3435,380,3055,37,3018,80,382,1207,218,14,4,6,394,66,647
69,47,729,117,612,18,594,25,94,206,61,2,1,1,79,11,114
69,48,878,77,801,23,778,20,170,221,89,7,2,5,74,15,175
69,49,2089,329,1760,36,1724,51,223,739,110,9,4,1,211,33,343
69,50,1514,202,1312,25,1287,42,216,419,117,17,7,6,136,38,289
69,51,778,78,700,9,691,45,111,201,67,8,7,3,91,14,144
69,52,3101,441,2660,63,2597,71,358,973,197,22,9,6,308,57,596
69,53,385,52,333,5,328,8,64,99,31,2,1,0,46,8,69
69,54,276,36,240,2,238,5,56,92,13,2,1,0,29,5,35
69,55,954,132,822,23,799,15,167,304,54,7,1,1,95,21,134
69,56,1184,142,1042,21,1021,28,183,322,102,11,4,2,109,30,230
69,57,401,39,362,8,354,13,56,120,46,3,2,0,37,6,71
69,58,326,61,265,9,256,4,40,86,28,4,3,1,29,7,54
69,59,1032,148,884,12,872,17,146,337,68,3,8,1,111,23,158
69,60,478,61,417,7,410,5,101,145,41,6,4,0,46,6,56
69,61,834,118,716,8,708,23,146,273,59,5,0,3,57,18,124
69,62,578,65,513,10,503,10,81,173,40,5,5,1,94,17,77
69,63,2949,408,2541,25,2516,60,229,1278,139,14,3,2,319,47,425
69,64,2612,464,2148,35,2113,59,339,582,232,24,15,5,189,38,630
69,65,621,90,531,11,520,11,173,158,40,9,1,3,44,10,71
69,66,2824,477,2347,58,2289,23,537,683,217,24,24,7,219,67,488
69,67,833,95,738,5,733,25,154,248,65,9,5,4,88,13,122
69,68,1719,282,1437,47,1390,52,197,439,178,11,8,2,136,19,348
69,69,6983,1005,5978,121,5857,171,861,2033,475,38,32,24,730,140,1353
69,70,889,119,770,15,755,17,217,218,50,5,6,2,74,22,144
69,71,748,97,651,13,638,33,91,244,49,2,2,3,71,15,128
69,72,6283,965,5318,66,5252,135,598,2329,356,26,13,9,633,79,1074
69,73,368,32,336,7,329,5,71,129,32,2,1,0,43,3,43
69,74,1049,108,941,21,920,25,159,352,71,7,4,3,93,12,194
69,75,118,10,108,0,108,0,31,33,5,0,0,0,19,4,16
69,76,2078,238,1840,23,1817,46,249,875,89,9,5,1,214,26,303
69,77,667,113,554,12,542,6,188,182,40,4,4,2,38,14,64
69,78,540,63,477,9,468,11,100,169,41,4,1,2,53,21,66
69,80,1111,121,990,16,974,24,244,274,93,7,5,2,97,25,203
69,81,12056,2289,9767,112,9655,200,1015,4676,579,39,18,23,1089,147,1869
69,82,182,16,166,3,163,2,31,79,7,0,1,1,16,5,21
69,83,810,76,734,17,717,31,89,229,68,8,4,2,93,23,170
69,84,984,126,858,16,842,9,210,309,66,14,6,2,85,16,125
69,85,975,113,862,12,850,21,116,358,70,8,2,2,102,13,158
69,86,1763,237,1526,22,1504,62,231,501,118,13,2,3,194,32,348
69,87,2110,262,1848,29,1819,50,199,730,124,11,6,7,226,27,439
69,88,4297,729,3568,53,3515,82,516,1232,327,22,16,9,377,78,856
69,89,8830,1145,7685,85,7600,267,928,2545,703,45,28,19,962,104,1999
69,90,591,79,512,9,503,15,105,154,57,3,2,1,68,4,94
69,91,10856,2868,7988,126,7862,169,1501,1137,1697,83,59,21,441,96,2658
69,92,5343,1048,4295,78,4217,86,798,1326,429,35,25,14,451,93,960
69,93,818,156,662,8,654,16,137,212,62,10,10,3,61,12,131
69,94,3626,466,3160,55,3105,88,521,1068,233,21,7,10,429,72,656
69,95,595,70,525,9,516,11,94,170,49,8,4,3,76,21,80
69,96,5803,1339,4464,76,4388,97,883,782,778,57,39,5,335,73,1339
69,97,590,77,513,13,500,20,145,110,52,6,1,1,35,5,125
69,98,321,51,270,7,263,4,79,74,27,4,0,0,21,10,44
69,99,954,117,837,25,812,17,195,218,74,10,11,2,95,26,164
69,100,5948,873,5075,81,4994,115,905,1310,539,57,27,20,594,92,1335
69,101,475,57,418,5,413,13,64,134,49,2,6,4,41,9,91
69,102,498,80,418,10,408,7,97,107,48,6,1,0,51,8,83
69,103,706,77,629,17,612,10,127,196,56,3,2,1,86,16,115
69,104,322,55,267,8,259,4,69,74,26,4,4,0,23,7,48
69,105,712,83,629,11,618,14,108,237,43,6,5,2,63,11,129
69,106,690,44,646,10,636,20,134,250,24,7,1,3,62,12,123
69,107,740,124,616,5,611,7,134,178,60,8,6,0,69,12,137
69,108,576,70,506,4,502,14,111,153,50,12,5,2,51,10,94
69,109,602,80,522,18,504,9,133,170,35,7,4,1,61,14,70
69,110,1396,188,1208,17,1191,23,241,444,92,11,7,5,141,69,158
69,111,430,58,372,2,370,13,56,115,29,7,2,2,47,6,93
69,112,4099,616,3483,43,3440,105,529,1295,265,20,6,10,437,65,708
69,113,556,63,493,9,484,15,86,129,57,6,4,1,81,12,93
69,114,1335,149,1186,24,1162,20,279,437,81,8,12,3,110,26,186
69,115,3111,456,2655,35,2620,49,499,900,228,21,11,3,285,51,573
69,116,2303,232,2071,21,2050,52,251,1047,92,12,3,3,250,35,305
69,117,2437,310,2127,31,2096,39,314,907,112,13,7,3,299,39,363
69,118,1741,238,1503,24,1479,28,372,443,161,17,10,3,127,32,286
69,119,727,116,611,19,592,16,175,137,53,11,7,1,54,16,122
69,120,454,70,384,10,374,9,87,118,35,2,7,0,43,17,56
69,121,1711,247,1464,18,1446,47,263,510,107,6,11,6,189,33,274
69,122,1269,165,1104,18,1086,14,205,477,57,9,2,0,103,23,196
69,123,292869,59541,233328,3114,230214,9416,22718,70311,27240,1746,915,605,24531,3103,69629
69,124,369,56,313,7,306,9,72,77,44,2,4,0,28,12,58
69,125,689,57,632,5,627,17,104,257,37,6,1,0,78,14,113
69,126,534,52,482,8,474,11,76,223,21,2,1,0,44,14,82
69,127,2220,263,1957,40,1917,55,272,679,158,10,7,8,235,32,461
69,128,416,57,359,4,355,8,76,121,45,5,5,1,26,6,62
69,129,467,63,404,8,396,6,97,142,26,5,1,0,45,11,63
69,130,186,30,156,5,151,3,29,44,20,2,4,0,20,6,23
69,131,2362,245,2117,35,2082,50,393,724,145,23,10,7,262,52,416
69,132,588,76,512,18,494,15,125,167,36,9,5,1,65,12,59
69,133,2816,325,2491,41,2450,63,353,893,205,17,10,11,302,48,548
69,134,161,11,150,6,144,5,20,47,11,0,1,3,26,3,28
69,135,601,115,486,8,478,15,126,102,57,7,3,1,61,11,95
69,136,1749,200,1549,13,1536,22,330,526,135,12,12,5,140,29,325
69,137,253,39,214,1,213,12,37,59,20,2,0,0,33,7,43
69,138,318,44,274,5,269,18,36,86,41,2,0,0,28,11,47
69,139,1086,203,883,38,845,28,213,199,82,9,8,1,118,18,169
69,140,1508,202,1306,21,1285,45,239,471,79,5,2,5,174,35,230
69,141,3958,412,3546,61,3485,142,530,1057,333,30,15,11,403,60,904
69,142,4102,872,3230,41,3189,65,471,960,361,30,19,9,284,53,937
69,143,4543,942,3601,60,3541,80,545,1044,384,34,31,8,328,79,1008
69,144,505,46,459,9,450,10,88,132,44,3,3,2,64,11,93
69,145,578,93,485,7,478,10,104,158,39,4,2,1,70,8,82
69,146,526,69,457,8,449,13,85,164,27,9,1,3,55,9,83
69,147,663,111,552,7,545,18,108,172,41,7,2,2,75,14,106
69,148,1589,179,1410,25,1385,63,212,468,116,15,7,2,169,35,298
69,149,16817,3350,13467,207,13260,442,2026,3333,1727,120,79,31,1269,212,4021
69,150,267,41,226,5,221,8,39,72,20,2,0,0,44,10,26
69,151,976,133,843,21,822,11,239,248,72,9,5,2,87,23,126
69,152,6192,1611,4581,76,4505,68,759,823,867,53,31,16,342,72,1474
69,153,722,87,635,5,630,30,73,246,36,6,1,0,87,13,138
69,154,1267,141,1126,21,1105,44,161,441,76,10,4,1,146,29,193
69,155,799,90,709,14,695,13,106,221,49,11,2,4,115,40,134
69,156,1729,201,1528,19,1509,41,202,637,84,12,5,4,218,23,283
69,157,1903,351,1552,28,1524,21,339,479,103,10,9,6,177,56,324
69,158,325,37,288,7,281,6,87,77,20,5,3,3,22,8,50
69,159,637,71,566,7,559,12,114,196,49,7,0,0,65,9,107
69,160,809,143,666,12,654,11,135,241,53,2,5,3,77,20,107
69,161,396,78,318,7,311,7,97,109,17,3,1,1,26,10,40
69,162,965,117,848,17,831,16,168,292,58,15,5,2,131,37,107
69,163,2213,338,1875,33,1842,41,382,591,175,21,13,5,213,37,364
69,164,283,56,227,3,224,5,54,76,13,4,0,0,24,2,46
69,165,837,107,730,17,713,15,152,259,61,10,5,3,66,14,128
69,166,195,20,175,1,174,15,27,41,22,3,0,1,21,2,42
69,167,411,50,361,7,354,14,82,118,33,1,2,2,36,7,59
69,168,871,97,774,9,765,13,118,299,75,7,3,0,101,9,140
69,169,504,55,449,8,441,13,130,143,31,3,5,0,55,9,52
69,170,832,94,738,22,716,47,169,221,39,1,2,3,92,13,129
69,171,1601,290,1311,20,1291,33,233,320,156,15,6,7,136,34,351
69,172,559,44,515,9,506,13,128,151,37,4,1,0,75,14,83
69,173,677,71,606,19,587,23,111,219,41,6,2,4,74,23,84
69,174,436,74,362,9,353,8,87,100,35,4,0,1,59,10,49
69,175,1459,173,1286,24,1262,46,219,415,104,14,6,9,176,45,228
69,176,2838,381,2457,35,2422,64,386,827,226,22,11,11,301,40,534
69,177,1524,223,1301,16,1285,42,234,360,136,9,10,3,157,29,305
69,178,508,48,460,10,450,13,125,123,29,7,3,0,48,12,90
69,179,1110,115,995,15,980,31,163,270,91,14,8,4,105,20,274
69,180,207,35,172,2,170,6,32,64,14,4,0,1,12,5,32
69,181,133,22,111,2,109,2,28,23,22,0,2,0,14,0,18
69,182,333,72,261,4,257,3,90,89,12,3,0,0,30,2,28
69,183,257,49,208,2,206,2,44,78,11,1,0,0,33,5,32
69,184,661,73,588,13,575,14,119,180,67,9,6,0,80,14,86
69,185,193,31,162,4,158,5,49,52,16,0,1,1,13,1,20
69,186,200,38,162,8,154,1,38,58,6,8,0,2,17,4,20
69,187,434,48,386,9,377,13,57,125,50,6,5,1,32,10,78
69,188,455,50,405,7,398,11,96,129,34,3,2,0,39,8,76
69,189,1334,218,1116,21,1095,18,192,364,92,15,6,2,106,24,276
69,190,1512,215,1297,17,1280,38,193,465,84,8,0,2,179,34,277
69,191,4249,595,3654,40,3614,98,374,1932,160,17,14,8,390,53,568
69,192,97,6,91,1,90,3,15,23,19,0,0,2,13,3,12
69,193,947,101,846,6,840,17,144,308,65,8,1,1,83,23,190
69,194,5057,594,4463,36,4427,100,350,2542,206,17,7,6,519,48,632
69,195,899,104,795,14,781,32,158,266,60,7,2,5,73,35,143
69,196,421,61,360,5,355,5,96,99,29,7,1,2,58,7,51
69,197,1415,229,1186,22,1164,34,309,397,82,13,4,2,116,33,174
69,198,538,70,468,11,457,7,132,138,36,6,3,1,55,14,65
69,199,7858,2162,5696,104,5592,87,954,887,989,58,57,9,271,68,2212
69,200,1168,164,1004,19,985,13,254,360,65,7,4,1,130,21,130
69,201,876,155,721,15,706,11,169,217,60,6,7,1,73,14,148
69,202,15283,2215,13068,143,12925,394,1381,5197,910,80,41,43,1622,213,3044
69,203,750,110,640,21,619,17,141,153,69,15,9,4,69,15,127
69,204,15219,3316,11903,193,11710,334,1630,3781,1094,95,40,27,1399,194,3116
69,205,3717,583,3134,51,3083,128,391,1036,268,20,5,12,383,54,786
69,206,3151,699,2452,45,2407,40,578,917,167,21,10,5,237,50,382
69,207,1937,301,1636,36,1600,50,239,468,204,14,5,4,178,23,415
69,208,1046,99,947,20,927,34,143,299,104,16,5,1,113,21,191
69,209,498,102,396,14,382,4,116,125,18,0,3,3,39,15,59
69,210,95,17,78,3,75,1,13,28,3,0,0,1,17,5,7
69,211,2226,408,1818,38,1780,36,463,495,170,11,10,2,156,54,383
69,212,326,48,278,7,271,9,50,81,32,3,0,1,43,5,47
69,213,567,55,512,12,500,30,72,149,27,2,2,0,66,13,139
69,214,782,94,688,17,671,11,199,198,45,4,5,3,73,18,115
69,215,645,84,561,11,550,10,142,182,30,2,3,1,68,9,103
69,216,425,58,367,6,361,6,64,144,34,8,1,1,39,16,48
69,217,641,94,547,5,542,6,106,199,31,5,1,1,85,16,92
69,218,714,106,608,12,596,13,160,210,38,3,2,0,81,14,75
69,219,1643,199,1444,27,1417,45,204,463,131,18,9,2,181,24,340
69,220,1306,162,1144,36,1108,24,218,396,84,12,8,4,135,32,195
69,221,174,17,157,1,156,8,28,47,17,0,1,1,16,2,36
69,222,671,90,581,11,570,21,95,161,60,12,1,2,93,11,114
69,223,808,83,725,7,718,21,161,260,53,2,3,1,84,23,110
69,224,56,7,49,1,48,1,7,17,4,0,0,0,9,0,10
69,225,422,41,381,6,375,14,81,120,31,9,1,0,46,8,65
69,227,2953,460,2493,44,2449,59,390,1066,164,17,12,5,285,61,390
69,228,1636,190,1446,27,1419,62,258,387,150,20,15,4,192,31,300
69,229,562,80,482,7,475,10,108,187,37,6,4,1,49,9,64
69,230,242,28,214,6,208,5,36,80,23,1,0,2,24,13,24
69,231,1813,292,1521,35,1486,39,271,361,181,23,5,1,169,41,395
69,233,848,124,724,9,715,30,76,276,74,3,1,3,86,15,151
69,234,1100,133,967,17,950,18,198,329,72,17,3,3,111,22,177
69,235,1181,156,1025,23,1002,20,186,308,97,13,5,1,104,17,251
69,236,371,48,323,3,320,4,81,87,33,8,0,1,20,4,82
69,237,481,32,449,8,441,18,57,140,37,7,2,4,68,12,96
69,238,2552,454,2098,52,2046,50,392,687,143,23,14,1,238,56,442
69,239,864,105,759,12,747,26,153,279,59,10,6,1,80,29,104
69,240,539,97,442,11,431,5,123,147,28,3,3,3,39,9,71
69,241,1603,191,1412,25,1387,48,246,489,118,16,3,4,163,25,275
69,242,574,62,512,16,496,6,130,175,37,6,6,1,37,18,80
69,243,6641,1518,5123,84,5039,75,1119,1259,507,60,26,15,411,112,1455
69,244,12523,1760,10763,138,10625,247,1291,4537,694,65,33,30,1330,190,2208
69,245,568,71,497,9,488,13,112,171,46,2,3,0,54,7,80
69,246,925,134,791,12,779,31,111,295,85,6,4,0,91,15,141
69,247,242,31,211,5,206,0,58,99,11,1,1,0,17,6,13
69,248,1527,290,1237,24,1213,10,249,353,121,11,8,0,182,19,260
69,249,2028,215,1813,22,1791,45,343,662,138,10,8,5,211,42,327
69,250,2820,302,2518,24,2494,62,299,1140,173,11,3,4,299,40,463
69,251,101,18,83,4,79,3,25,20,6,2,1,0,11,2,9
69,252,546,100,446,10,436,9,89,94,47,8,1,1,69,10,108
69,253,492,55,437,13,424,17,74,152,44,3,6,1,45,10,72
69,254,579,108,471,9,462,15,122,128,49,7,3,4,37,5,92
69,255,3482,396,3086,66,3020,87,437,1098,249,23,9,8,398,89,622
69,256,20877,6318,14559,253,14306,195,1979,2063,2692,123,113,36,655,166,6284
69,257,748,87,661,17,644,14,182,189,49,4,1,3,57,23,122
69,258,273,37,236,10,226,5,36,80,19,3,1,0,38,9,35
69,259,29463,7348,22115,451,21664,349,3520,3319,4118,249,190,43,1220,272,8384
69,260,2978,472,2506,35,2471,61,382,813,228,22,9,3,308,41,604
69,261,54,5,49,1,48,2,3,23,3,0,0,0,10,0,7
69,263,614,82,532,7,525,7,123,195,56,6,2,2,45,13,76
69,264,18424,4061,14363,213,14150,273,2647,4126,1671,113,64,40,1323,228,3665
69,265,605,94,511,9,502,25,104,179,40,1,1,1,54,11,86
69,266,78307,16121,62186,978,61208,2039,8207,14738,7939,554,331,161,5653,888,20698
69,267,1628,342,1286,33,1253,27,261,456,133,11,8,5,125,32,195
69,268,2426,324,2102,32,2070,49,313,839,152,13,5,6,254,43,396
69,269,724,99,625,10,615,19,115,207,62,3,0,1,75,12,121
69,270,2872,353,2519,44,2475,55,493,925,162,13,7,2,276,38,504
69,271,7436,1247,6189,111,6078,146,1039,2147,459,43,22,9,677,111,1425
69,272,3125,409,2716,54,2662,56,441,809,258,22,18,6,304,45,703
69,273,6881,1005,5876,103,5773,106,1249,1562,609,62,26,11,531,112,1505
69,275,16854,4136,12718,263,12455,275,2512,3249,1378,94,87,38,993,203,3626
69,276,5692,1035,4657,76,4581,72,963,987,626,49,33,8,320,52,1471
69,277,9242,1290,7952,104,7848,150,1426,2798,522,66,39,19,911,145,1772
69,278,3615,544,3071,68,3003,60,590,995,246,22,8,12,322,54,694
69,279,4265,599,3666,57,3609,53,849,1160,322,31,14,2,292,56,830
69,280,873,126,747,8,739,8,207,231,69,5,7,0,53,24,135
69,281,1180,166,1014,18,996,28,219,346,84,5,3,0,107,11,193
69,282,19892,3635,16257,248,16009,301,2967,4476,1664,137,82,34,1380,268,4700
69,283,8264,1327,6937,157,6780,117,1578,1843,651,59,33,15,575,137,1772
69,284,2218,253,1965,33,1932,56,234,680,148,12,9,3,310,45,435
69,285,2582,553,2029,36,1993,24,566,655,146,20,7,3,143,35,394
69,286,16839,3534,13305,231,13074,295,2070,3512,1429,110,81,35,1101,216,4225
69,287,4980,734,4246,76,4170,70,915,1423,311,27,11,9,424,78,902
69,288,3962,629,3333,56,3277,43,807,1165,222,28,8,12,288,71,633
69,289,3338,440,2898,59,2839,50,723,906,226,19,17,5,257,46,590
69,290,25689,5174,20515,370,20145,402,4116,4710,2640,183,134,37,1431,347,6145
69,291,3588,564,3024,54,2970,69,656,856,299,28,20,7,279,63,693
69,292,2906,625,2281,44,2237,61,415,609,229,31,8,4,230,49,601
69,293,1679,166,1513,25,1488,36,240,581,89,13,4,8,163,37,317
69,294,1861,337,1524,20,1504,27,289,442,129,21,6,6,155,22,407
69,295,1184,153,1031,15,1016,21,224,325,99,8,3,2,97,20,217
69,296,1989,254,1735,34,1701,35,322,583,163,14,2,3,156,37,386
69,297,3515,486,3029,47,2982,71,550,922,294,19,13,13,323,49,728
69,298,1751,162,1589,35,1554,46,403,477,104,13,7,0,158,35,311
69,299,1705,244,1461,24,1437,18,452,439,107,16,4,3,119,33,246
70,1,269,64,205,6,199,1,62,46,12,3,1,0,20,5,49
70,2,189,24,165,1,164,8,35,44,15,3,1,0,28,1,29
70,3,61,8,53,0,53,2,23,12,4,0,2,0,2,1,7
70,4,230,18,212,6,206,4,69,40,29,4,2,0,10,8,40
70,5,100,21,79,2,77,2,22,21,8,3,1,0,6,1,13
70,6,1304,269,1035,23,1012,13,305,187,96,11,7,4,74,34,281
70,7,244,47,197,9,188,4,48,63,6,2,1,0,14,5,45
70,8,158,19,139,5,134,0,42,37,11,0,0,0,7,1,36
70,9,87,10,77,0,77,2,15,29,3,1,0,0,3,5,19
70,10,82,12,70,3,67,0,19,28,3,0,1,0,3,2,11
70,11,290,15,275,8,267,1,65,48,22,1,3,0,22,6,99
70,12,535,101,434,16,418,5,102,83,38,10,0,0,40,9,131
70,13,84,15,69,3,66,0,22,16,6,1,0,1,2,1,17
70,14,276,28,248,6,242,5,65,54,14,5,1,0,17,1,80
70,15,262,45,217,5,212,0,62,55,18,5,0,0,18,6,48
70,16,177,35,142,2,140,0,27,41,12,0,3,0,20,3,34
70,17,202,32,170,1,169,3,64,43,7,1,1,0,7,7,36
70,18,368,60,308,6,302,6,92,89,21,1,1,0,19,7,66
70,19,117,14,103,2,101,0,20,29,15,0,0,0,6,1,30
70,20,163,16,147,3,144,4,33,35,15,3,1,0,15,0,38
70,21,138,18,120,3,117,2,29,24,10,4,2,2,8,1,35
70,22,119,21,98,2,96,2,23,19,13,1,0,0,9,6,23
70,23,147,27,120,3,117,2,35,34,10,3,1,0,5,1,26
70,24,353,50,303,8,295,2,81,71,23,8,2,0,19,7,82
70,25,191,24,167,4,163,2,42,45,12,4,1,0,8,2,47
70,26,1936,374,1562,34,1528,14,348,328,169,11,16,5,119,32,486
70,27,73,13,60,0,60,1,16,25,1,0,0,2,5,1,9
70,28,147,15,132,3,129,2,17,42,12,1,1,0,18,2,34
70,29,180,26,154,1,153,0,55,39,19,1,0,0,8,1,30
70,30,42,8,34,0,34,0,9,10,1,0,0,0,3,2,9
70,31,514,81,433,17,416,4,107,116,36,12,3,0,23,13,102
70,32,32,2,30,1,29,2,2,18,0,0,0,0,2,0,5
70,35,121,23,98,2,96,1,13,41,10,5,0,0,5,1,20
70,36,130,27,103,1,102,2,32,25,3,0,0,0,12,6,22
70,37,251,38,213,4,209,5,48,72,11,0,2,5,12,4,50
70,38,232,28,204,5,199,3,44,55,14,1,2,1,26,1,52
70,39,248,37,211,3,208,0,73,39,16,3,3,0,11,3,60
70,40,178,14,164,5,159,5,41,42,12,4,2,1,14,4,34
70,41,361,84,277,6,271,4,84,83,25,3,1,2,11,1,57
70,42,69,4,65,1,64,1,21,6,4,1,0,0,8,1,22
70,43,223,37,186,1,185,3,56,27,24,3,1,0,16,5,50
70,44,359,42,317,7,310,9,73,91,22,8,1,0,43,6,57
70,45,330,44,286,4,282,5,70,81,37,1,0,0,17,3,68
70,46,270,32,238,5,233,3,68,49,22,3,3,0,18,4,63
70,47,74,10,64,0,64,0,17,16,6,1,0,0,2,3,19
70,48,120,13,107,1,106,2,32,29,10,0,1,0,8,1,23
70,49,78,9,69,1,68,0,21,29,4,0,0,0,5,0,9
70,50,73,5,68,0,68,2,16,27,6,0,0,0,3,2,12
70,51,47,7,40,0,40,5,17,12,1,1,0,0,0,0,4
70,52,128,24,104,0,104,4,24,13,10,0,2,0,10,2,39
70,53,74,13,61,7,54,2,14,9,9,1,0,0,4,1,14
70,54,192,18,174,5,169,4,37,48,16,5,1,0,14,3,41
70,55,427,63,364,9,355,2,120,83,19,6,6,0,21,5,93
70,56,271,63,208,2,206,0,70,34,25,5,0,0,13,1,58
70,57,82,6,76,3,73,3,21,27,6,0,0,0,2,1,13
70,58,661,108,553,15,538,7,165,150,31,4,2,1,31,10,137
70,59,373,60,313,11,302,12,76,82,28,5,0,0,26,8,65
70,60,230,30,200,4,196,7,36,56,18,2,2,0,11,11,53
70,61,91,10,81,5,76,0,15,21,12,0,0,1,5,1,21
70,62,111,22,89,2,87,4,18,15,10,4,1,0,5,3,27
70,63,184,32,152,3,149,0,30,39,25,2,1,1,9,4,38
70,64,122,22,100,3,97,2,33,14,9,3,1,0,3,4,28
70,65,63,10,53,1,52,1,14,7,8,0,0,0,3,2,17
70,66,111,19,92,2,90,1,16,32,4,2,0,0,5,4,26
70,67,70,4,66,3,63,1,12,8,12,2,0,0,4,3,21
70,69,51,9,42,2,40,3,9,17,3,0,0,0,2,1,5
70,70,43,9,34,2,32,0,10,7,1,2,0,0,2,0,10
70,71,64,13,51,4,47,1,17,15,0,0,0,0,4,3,7
70,72,70,10,60,0,60,1,14,18,3,1,1,0,7,1,14
70,74,213,41,172,3,169,1,39,35,21,2,4,0,10,5,52
70,75,135,22,113,3,110,2,35,28,8,0,0,0,8,4,25
70,76,230,26,204,4,200,10,31,56,23,3,1,1,26,2,47
70,77,202,34,168,4,164,0,33,45,17,5,2,2,16,1,43
70,78,71,5,66,1,65,0,8,26,3,3,0,0,7,0,18
70,79,360,55,305,9,296,5,64,95,29,1,1,0,24,5,72
70,80,210,22,188,5,183,0,59,46,6,0,1,0,8,9,54
70,81,220,25,195,9,186,0,53,54,19,7,1,0,12,1,39
70,82,102,12,90,0,90,1,17,17,10,4,2,1,8,0,30
70,83,368,73,295,15,280,5,67,88,16,7,5,1,22,4,65
70,84,431,44,387,7,380,4,103,128,29,4,2,1,26,11,72
70,85,364,39,325,8,317,7,72,93,45,4,0,5,35,2,54
70,86,73,13,60,1,59,0,24,8,9,2,0,0,5,0,11
70,87,98,12,86,2,84,1,21,17,2,1,0,0,17,3,22
70,88,98,8,90,3,87,3,19,21,6,1,0,0,10,3,24
70,89,52,14,38,0,38,1,7,15,1,0,2,0,2,0,10
70,90,60,12,48,0,48,1,7,10,12,1,0,0,2,3,12
70,91,46,7,39,1,38,0,15,18,2,0,0,0,2,0,1
70,92,130,19,111,1,110,0,36,39,5,0,2,0,11,1,16
70,93,599,122,477,8,469,5,119,127,40,10,2,0,37,7,122
70,94,257,55,202,16,186,1,39,37,19,4,5,0,18,4,59
70,95,453,77,376,12,364,3,123,79,30,10,4,3,18,8,86
70,96,476,54,422,10,412,3,125,78,53,4,4,1,33,12,99
70,97,220,36,184,1,183,0,53,57,11,1,2,0,11,2,46
70,98,184,38,146,3,143,1,63,29,9,1,1,0,12,2,25
70,99,62,5,57,1,56,1,7,23,4,1,2,0,2,0,16
70,100,89,21,68,3,65,1,19,22,6,0,0,0,3,0,14
70,101,385,43,342,12,330,5,80,103,38,5,5,2,34,10,48
70,102,212,26,186,4,182,3,41,64,16,2,2,2,9,4,39
70,103,168,23,145,5,140,2,20,36,11,1,1,0,8,1,60
70,104,504,87,417,7,410,15,110,126,26,4,2,2,22,9,94
70,105,102,9,93,2,91,3,23,21,10,0,1,1,13,1,18
70,106,91,15,76,0,76,2,25,11,8,0,2,0,8,2,18
70,107,278,50,228,3,225,4,42,65,28,4,1,1,16,3,61
70,109,243,42,201,4,197,5,32,59,26,5,0,0,17,0,53
70,111,187,13,174,4,170,1,45,52,21,3,1,0,10,1,36
70,112,174,26,148,3,145,1,49,43,11,0,0,0,9,0,32
70,113,104,11,93,4,89,1,15,43,6,1,1,0,7,0,15
70,114,193,26,167,5,162,5,37,32,33,1,2,1,7,4,40
70,115,165,24,141,9,132,1,27,57,8,0,0,0,8,1,30
70,116,581,104,477,5,472,7,152,75,69,2,3,0,34,17,113
70,117,979,135,844,17,827,17,197,260,78,13,2,3,76,12,169
70,118,136,13,123,4,119,4,27,37,9,0,0,1,10,1,30
70,119,274,33,241,5,236,3,76,46,27,5,2,1,18,5,53
70,120,2876,572,2304,58,2246,13,769,389,250,28,27,12,159,37,562
70,121,638,79,559,7,552,9,134,102,68,13,6,1,45,20,154
70,122,1449,219,1230,33,1197,12,275,360,113,13,18,3,105,26,272
70,124,65,8,57,0,57,0,21,4,6,1,0,0,5,3,17
70,125,171,18,153,1,152,2,46,55,4,1,1,0,9,1,33
70,126,133,12,121,3,118,5,27,34,15,0,0,2,9,2,24
70,127,94,20,74,5,69,1,21,19,12,3,0,0,3,1,9
70,128,355,79,276,14,262,0,113,52,13,1,3,2,13,7,58
70,129,115,22,93,4,89,3,20,28,6,0,0,0,6,0,26
70,130,241,33,208,7,201,6,35,74,10,4,1,0,24,7,40
70,132,474,56,418,10,408,11,101,113,24,1,1,0,40,12,105
70,133,201,23,178,6,172,7,48,49,14,4,1,1,12,6,30
70,134,173,29,144,2,142,2,28,33,18,2,1,1,12,6,39
70,135,42,13,29,3,26,2,4,12,2,0,0,0,3,0,3
70,136,353,48,305,5,300,1,78,69,28,4,2,3,26,6,83
70,137,172,23,149,3,146,5,48,27,7,2,1,1,9,2,44
70,138,102,19,83,0,83,1,30,16,3,0,0,0,7,5,21
70,140,39,1,38,2,36,1,12,7,5,0,1,0,5,0,5
70,141,111,13,98,2,96,1,15,19,17,2,1,0,12,3,26
70,142,131,20,111,4,107,1,23,33,7,6,0,0,11,4,22
70,143,102,27,75,0,75,0,17,28,7,1,3,0,8,2,9
70,144,45,9,36,0,36,2,15,6,2,2,0,0,2,0,7
70,145,307,30,277,6,271,9,57,54,33,7,3,1,17,3,87
70,146,121,15,106,3,103,1,44,16,7,0,1,1,13,3,17
70,147,170,23,147,6,141,3,43,31,22,1,1,1,10,1,28
70,148,78,9,69,0,69,1,14,29,3,0,3,0,10,1,8
70,149,618,102,516,8,508,12,152,65,68,13,1,0,51,12,134
70,150,188,22,166,6,160,6,30,48,13,0,0,0,28,2,33
70,151,45,2,43,1,42,3,4,15,5,0,0,0,4,1,10
70,152,301,42,259,4,255,7,75,48,24,3,3,1,27,5,62
70,153,107,17,90,3,87,1,20,37,5,1,0,0,8,2,13
70,154,221,26,195,4,191,10,46,50,16,1,0,0,10,4,54
70,155,657,102,555,13,542,7,187,107,63,5,0,0,40,19,114
70,156,81,8,73,3,70,0,27,19,3,2,1,0,4,0,14
70,157,359,64,295,10,285,4,89,39,36,7,1,0,13,4,92
70,158,108,17,91,4,87,2,18,30,8,1,1,0,11,2,14
70,159,90,7,83,4,79,2,24,15,6,1,0,0,9,1,21
70,160,241,25,216,9,207,9,58,35,9,7,4,0,9,5,71
70,162,385,22,363,19,344,2,72,80,31,5,2,0,50,7,95
70,163,325,28,297,9,288,5,84,92,15,3,4,0,24,9,52
70,164,55,11,44,1,43,0,10,16,2,6,0,0,2,0,7
70,165,423,57,366,6,360,3,81,102,37,8,5,0,19,7,98
70,166,148,18,130,5,125,2,23,24,16,3,1,1,14,3,38
70,167,337,62,275,5,270,6,64,41,37,3,0,0,14,1,104
70,168,515,75,440,11,429,3,119,130,31,13,3,3,25,11,91
70,169,185,26,159,3,156,8,48,32,19,1,2,1,16,3,26
70,170,81,8,73,4,69,1,7,16,15,2,0,0,7,3,18
70,171,1008,185,823,22,801,9,210,263,60,11,9,2,56,17,164
70,172,80,14,66,1,65,0,16,13,5,0,1,0,6,0,24
70,174,110,25,85,2,83,1,21,22,4,0,0,0,11,1,23
70,175,119,19,100,3,97,4,17,26,5,2,2,0,8,0,33
70,176,201,33,168,4,164,6,38,46,10,1,1,0,18,3,41
70,177,512,96,416,14,402,1,121,113,40,5,2,2,28,11,79
70,178,451,87,364,9,355,2,113,69,48,7,4,2,22,12,76
70,179,184,34,150,6,144,2,26,34,31,1,0,0,10,3,37
70,180,365,46,319,7,312,5,96,73,28,8,1,3,22,9,67
70,181,94,13,81,2,79,4,22,13,4,0,0,1,11,3,21
70,182,82,15,67,1,66,2,21,10,7,1,0,1,4,3,17
70,183,73,9,64,1,63,1,24,13,12,5,2,0,4,2,0
70,184,574,88,486,11,475,10,115,94,69,11,8,1,22,6,139
70,185,158,32,126,1,125,2,37,37,3,2,1,1,13,2,27
70,186,57,0,57,2,55,1,15,19,4,0,0,0,0,1,15
70,187,202,27,175,6,169,1,55,32,15,5,1,0,12,4,44
70,188,52,15,37,1,36,0,7,15,3,0,2,0,1,1,7
70,189,174,18,156,6,150,1,21,46,17,0,1,1,17,2,44
70,190,113,11,102,2,100,1,26,29,22,0,0,0,8,4,10
70,192,148,20,128,5,123,2,29,61,4,0,1,0,7,2,17
70,193,168,16,152,1,151,4,30,31,28,0,0,0,12,5,41
70,194,130,21,109,2,107,1,51,14,4,0,0,0,5,6,26
70,195,223,42,181,12,169,4,49,31,22,5,2,0,16,3,37
70,196,219,40,179,7,172,2,50,40,13,5,1,1,26,1,33
70,197,618,110,508,13,495,13,117,142,37,5,0,1,44,14,122
70,198,840,116,724,14,710,3,165,245,43,9,5,2,58,27,153
70,199,93,16,77,2,75,0,22,19,3,0,0,0,6,3,22
70,200,43,13,30,1,29,0,7,7,3,1,0,0,2,1,8
70,201,144,17,127,8,119,3,45,43,6,0,0,1,5,3,13
70,202,302,56,246,3,243,6,71,39,15,1,4,0,21,6,80
70,203,98,11,87,1,86,4,18,25,7,0,1,1,10,3,17
70,204,130,9,121,2,119,3,30,48,10,2,0,1,7,2,16
70,205,192,37,155,1,154,2,58,22,18,1,0,3,17,1,32
70,206,391,64,327,7,320,4,70,51,53,1,0,1,33,11,96
70,207,2316,359,1957,40,1917,38,359,510,188,20,6,7,166,46,577
70,208,246,33,213,5,208,12,56,39,29,5,4,0,13,4,46
70,210,145,27,118,5,113,5,27,28,16,0,0,0,11,1,25
70,211,75,21,54,3,51,0,25,13,7,0,0,0,2,4,0
70,213,209,25,184,5,179,2,59,68,10,0,0,0,10,4,26
70,214,114,15,99,0,99,6,13,23,10,0,1,0,5,2,39
70,215,230,47,183,3,180,13,39,61,13,2,0,0,11,2,39
70,216,398,58,340,9,331,4,93,67,24,8,1,0,24,2,108
70,217,117,24,93,4,89,0,21,26,4,0,0,0,3,5,30
70,218,90,6,84,5,79,4,25,20,7,0,1,0,7,1,14
70,219,531,67,464,11,453,15,121,100,34,8,0,0,43,9,123
70,220,308,48,260,5,255,4,69,46,31,4,2,1,13,5,80
70,221,241,41,200,3,197,4,63,34,29,3,4,1,12,3,44
70,222,65,11,54,2,52,0,16,3,1,1,1,0,3,0,27
70,224,466,57,409,2,407,7,92,116,50,2,2,0,31,4,103
70,225,104,13,91,1,90,0,19,28,5,0,0,0,9,3,26
70,226,269,40,229,6,223,0,58,42,23,4,2,1,15,3,75
70,227,474,59,415,15,400,6,70,91,20,16,1,2,24,16,154
70,228,697,85,612,9,603,13,112,171,46,10,3,2,40,18,188
70,229,221,20,201,2,199,0,60,32,12,1,0,0,18,3,73
70,230,99,12,87,0,87,4,6,44,5,0,2,0,10,2,14
70,231,44,5,39,0,39,0,11,17,2,1,0,0,3,2,3
70,232,126,16,110,2,108,2,18,43,13,0,0,0,15,2,15
70,233,104,19,85,2,83,2,16,23,9,1,1,0,8,0,23
70,234,193,21,172,9,163,3,44,43,22,1,0,0,12,6,32
70,235,141,15,126,9,117,3,19,34,11,2,1,0,11,6,30
70,236,348,51,297,5,292,5,65,89,19,4,5,1,12,8,84
70,237,104,13,91,5,86,0,26,28,10,0,1,0,10,2,9
70,238,124,32,92,1,91,1,25,42,5,2,0,0,3,1,12
70,239,135,14,121,4,117,3,15,42,9,1,0,1,13,1,32
70,240,1127,195,932,22,910,6,265,211,79,13,17,0,59,18,242
70,242,125,26,99,0,99,1,28,31,10,0,1,0,4,6,18
70,243,226,27,199,4,195,2,38,45,20,2,2,0,11,5,70
70,244,103,14,89,4,85,5,17,20,7,1,0,0,10,5,20
70,245,2864,474,2390,92,2298,24,610,577,232,49,22,8,182,54,540
70,247,245,44,201,6,195,7,44,61,20,8,1,0,16,2,36
70,248,1073,183,890,26,864,15,283,161,70,12,8,1,103,11,200
70,249,115,21,94,4,90,0,28,32,4,0,1,0,3,2,20
70,250,339,49,290,4,286,4,82,62,33,7,2,4,23,15,54
70,251,85,13,72,0,72,0,20,29,1,2,0,0,6,1,13
70,252,152,22,130,2,128,5,46,44,11,0,0,1,9,0,12
70,253,200,36,164,12,152,0,36,38,15,3,0,3,21,4,32
70,254,190,23,167,2,165,2,45,26,13,6,0,2,12,4,55
70,255,437,64,373,7,366,5,99,108,33,1,1,0,19,5,95
70,256,614,120,494,8,486,9,152,80,70,7,7,0,34,6,121
70,257,481,87,394,7,387,4,114,99,35,2,5,1,36,7,84
70,258,1783,369,1414,47,1367,14,356,365,119,18,8,2,106,27,352
70,259,310,44,266,9,257,3,85,56,26,2,0,0,21,6,58
70,260,548,65,483,12,471,9,136,88,36,6,1,0,27,15,153
70,261,1080,165,915,6,909,17,156,269,85,14,11,2,84,16,255
70,262,135,8,127,2,125,1,35,29,12,0,2,2,4,3,37
70,263,221,26,195,6,189,2,58,43,14,4,3,2,17,5,41
70,264,60,7,53,0,53,2,12,14,4,1,0,0,3,2,15
70,265,137,19,118,2,116,3,31,43,2,2,1,0,9,11,14
70,267,372,49,323,7,316,4,45,109,34,4,3,0,25,7,85
70,268,154,24,130,3,127,0,25,37,13,0,0,0,15,4,33
70,269,38,9,29,1,28,0,13,7,2,1,0,0,1,1,3
70,271,315,42,273,8,265,12,95,59,31,6,1,0,14,3,44
70,272,184,33,151,3,148,4,33,42,16,0,1,0,15,4,33
70,273,53,3,50,4,46,0,9,23,4,0,0,0,1,3,6
70,274,29,5,24,0,24,0,2,10,4,0,0,0,2,0,6
70,275,262,38,224,2,222,1,67,58,23,2,2,0,15,6,48
70,276,164,37,127,2,125,0,39,33,9,5,2,0,4,1,32
70,277,297,27,270,7,263,5,75,50,41,5,7,0,14,5,61
70,278,172,22,150,2,148,0,36,32,12,6,0,0,6,4,52
70,279,3472,937,2535,50,2485,30,502,659,218,29,15,10,168,53,801
70,280,750,128,622,6,616,11,138,147,38,7,3,2,53,13,204
70,281,58,10,48,2,46,1,23,10,1,0,0,0,4,0,7
70,282,714,102,612,15,597,14,153,158,54,8,2,2,61,17,128
70,283,440,95,345,19,326,6,101,67,28,12,1,4,24,4,79
70,284,215,39,176,4,172,2,47,41,10,5,0,1,12,3,51
70,285,7149,1385,5764,150,5614,82,1472,988,724,73,48,14,386,72,1755
70,286,90,7,83,2,81,2,11,25,10,3,1,0,9,2,18
70,287,52,9,43,1,42,1,7,13,4,0,0,0,2,0,15
70,288,71,3,68,1,67,0,9,20,5,0,2,1,7,0,23
70,289,148,18,130,2,128,2,30,42,9,0,1,0,10,4,30
70,290,183,20,163,6,157,2,41,27,17,2,1,0,16,5,46
70,291,128,27,101,3,98,0,31,31,5,2,0,1,8,2,18
70,292,1224,217,1007,26,981,11,188,300,107,6,7,3,75,15,269
70,293,62,7,55,2,53,1,11,22,1,0,0,0,6,1,11
70,294,288,47,241,5,236,1,72,70,14,4,3,0,10,4,58
70,295,158,26,132,2,130,4,23,33,14,0,0,0,6,5,45
70,296,193,51,142,3,139,3,37,38,8,4,2,0,13,1,33
70,297,47,11,36,2,34,0,12,12,0,0,4,0,2,0,4
70,298,107,10,97,3,94,6,20,26,11,1,0,0,4,4,22
70,299,233,29,204,13,191,4,25,56,14,4,3,0,13,3,69
70,301,44,7,37,1,36,1,12,9,5,3,1,0,3,0,2
70,302,53,7,46,0,46,3,9,17,2,0,1,0,4,1,9
70,303,103,8,95,3,92,0,25,20,11,2,0,0,10,7,17
70,304,125,19,106,2,104,1,13,21,9,2,0,0,8,3,47
70,305,83,10,73,1,72,0,21,21,6,2,0,0,6,1,15
70,306,311,48,263,5,258,3,72,47,24,1,5,1,14,7,84
70,307,107,7,100,5,95,0,28,22,11,2,0,0,10,1,21
70,308,228,53,175,5,170,2,34,47,9,1,3,0,10,7,57
70,309,327,47,280,5,275,12,55,72,33,5,2,4,18,4,70
70,310,5169,1171,3998,85,3913,51,882,858,433,46,28,9,271,64,1271
70,311,4858,1247,3611,101,3510,57,687,1032,259,33,29,7,262,85,1059
70,312,628,78,550,7,543,6,152,115,59,14,5,1,43,13,135
70,313,276,31,245,8,237,4,59,58,25,0,3,0,13,8,67
70,314,153,35,118,4,114,1,38,27,6,0,1,0,6,2,33
70,315,389,69,320,14,306,1,78,65,25,4,7,2,20,15,89
70,316,80,7,73,2,71,3,18,14,9,0,0,0,1,4,22
70,317,123,26,97,1,96,2,34,25,5,0,2,2,5,2,19
70,318,366,59,307,8,299,10,71,41,62,6,2,1,18,9,79
70,319,85,20,65,2,63,3,19,16,10,1,2,0,5,1,6
70,320,109,12,97,5,92,3,31,11,7,1,1,0,15,3,20
70,321,981,80,901,23,878,8,222,193,103,13,13,0,74,16,236
70,322,238,25,213,7,206,3,59,56,17,1,2,1,11,1,55
70,323,174,43,131,1,130,0,58,36,6,4,1,0,5,2,18
70,324,496,37,459,7,452,11,80,117,46,8,1,1,57,9,122
70,325,236,24,212,7,205,5,38,81,19,3,3,1,19,0,36
70,326,208,28,180,6,174,4,49,40,10,0,1,0,12,3,55
70,327,127,20,107,2,105,2,14,37,8,0,0,1,14,8,21
70,328,291,43,248,3,245,2,78,47,32,2,0,0,10,7,67
70,329,77,16,61,0,61,0,21,16,1,1,0,0,4,0,18
70,330,183,15,168,9,159,3,31,53,20,1,0,0,15,2,34
70,331,444,58,386,5,381,3,84,122,36,3,2,1,35,5,90
70,332,37,2,35,1,34,3,10,8,1,0,0,0,0,0,12
70,334,1047,172,875,13,862,12,201,271,80,9,7,5,53,11,213
70,335,70,9,61,3,58,0,11,10,7,3,0,0,4,2,21
70,336,124,17,107,2,105,0,33,29,7,2,0,1,11,0,22
70,337,57,12,45,1,44,1,4,20,3,0,0,0,2,1,13
70,338,201,29,172,5,167,0,42,70,13,1,0,1,10,7,23
70,339,1442,285,1157,31,1126,10,264,243,134,18,9,6,65,17,360
70,340,185,25,160,1,159,3,27,54,19,1,0,0,12,1,42
70,341,213,33,180,8,172,1,55,30,13,3,1,1,12,0,56
70,342,114,19,95,3,92,0,37,34,6,1,1,0,1,2,10
70,343,237,31,206,5,201,4,61,38,18,4,1,0,12,8,55
70,344,266,52,214,8,206,1,56,51,16,6,1,0,12,6,57
70,345,79,8,71,0,71,2,16,34,2,1,0,0,6,1,9
70,347,306,52,254,6,248,1,103,34,19,10,8,1,16,4,52
70,348,505,72,433,8,425,5,127,74,38,8,5,3,28,6,131
70,349,159,26,133,3,130,0,27,24,14,2,0,0,15,1,47
70,350,58,12,46,0,46,0,10,16,6,1,0,0,3,1,9
70,351,215,40,175,1,174,2,49,41,22,2,0,1,5,11,41
70,352,33,4,29,0,29,1,7,10,4,0,1,0,4,0,2
70,353,321,43,278,8,270,9,71,66,21,7,0,0,24,4,68
70,355,176,20,156,0,156,5,44,34,19,1,0,1,13,6,33
70,356,195,25,170,4,166,3,46,57,9,0,0,0,14,2,35
70,357,383,50,333,5,328,7,94,79,28,4,3,2,25,7,79
70,358,182,12,170,6,164,0,46,39,15,1,1,1,17,5,39
70,359,59,9,50,1,49,2,12,16,4,0,0,0,5,1,9
70,360,66,10,56,2,54,0,8,23,3,1,1,0,2,1,15
70,361,141,11,130,2,128,2,42,21,12,2,2,0,4,7,36
70,362,157,22,135,1,134,3,27,30,18,4,3,1,7,5,36
70,363,506,68,438,14,424,5,109,110,44,4,2,1,45,9,95
70,364,110,12,98,3,95,6,15,39,5,1,1,0,8,1,19
70,366,97,16,81,2,79,1,18,29,12,0,0,0,9,2,8
70,367,130,12,118,1,117,1,48,29,7,1,0,0,9,1,21
70,368,94,13,81,1,80,1,29,15,12,2,0,0,4,0,17
70,369,53,10,43,4,39,1,5,16,0,0,1,0,3,0,13
70,371,168,25,143,0,143,3,50,41,9,4,1,1,14,6,14
70,372,121,15,106,2,104,1,16,34,11,0,0,0,9,1,32
70,373,246,45,201,4,197,4,51,47,23,1,1,0,22,5,43
70,374,96,11,85,2,83,4,21,19,3,1,0,0,14,0,21
70,375,25,7,18,0,18,0,1,3,4,0,0,0,0,0,10
70,376,392,52,340,4,336,5,91,94,29,3,1,0,18,2,93
70,378,1386,228,1158,23,1135,16,186,289,92,15,4,5,141,26,361
70,380,146,10,136,5,131,1,43,22,19,3,0,0,12,0,31
70,381,134,13,121,5,116,3,29,26,12,0,0,0,11,3,32
70,383,238,33,205,2,203,1,58,45,17,0,6,2,17,5,52
70,384,221,49,172,4,168,2,40,63,11,1,2,1,10,1,37
70,385,278,50,228,13,215,1,65,47,27,4,3,0,10,0,58
70,386,144,11,133,5,128,1,47,31,12,1,0,0,11,2,23
70,387,511,85,426,11,415,1,122,116,31,6,3,0,28,6,102
70,388,1496,232,1264,33,1231,22,230,302,122,19,11,3,103,25,394
70,389,50,10,40,1,39,1,17,9,2,0,0,0,0,1,9
70,390,427,56,371,5,366,11,95,78,26,8,2,0,36,5,105
70,392,46,6,40,0,40,1,5,18,2,0,0,0,1,0,13
70,393,337,40,297,6,291,7,63,73,38,7,4,0,15,8,76
70,394,65,4,61,2,59,0,18,21,5,0,0,0,2,2,11
70,395,59,5,54,0,54,5,19,8,6,2,0,0,6,0,8
70,396,32,2,30,2,28,0,2,7,2,0,0,0,4,0,13
70,397,54,4,50,0,50,0,13,18,2,2,0,1,4,2,8
70,398,67,6,61,0,61,0,16,15,11,0,0,0,3,2,14
70,399,168,26,142,3,139,1,33,45,9,5,0,1,9,3,33
70,400,117,33,84,3,81,2,17,27,5,1,0,0,6,3,20
70,401,111,17,94,4,90,0,19,34,11,0,0,1,8,2,15
70,402,295,50,245,11,234,2,73,67,25,1,4,0,10,3,49
70,403,171,24,147,4,143,0,47,19,8,4,2,0,24,4,35
70,404,570,113,457,13,444,4,136,98,26,6,4,1,15,3,151
70,405,150,27,123,3,120,2,25,28,13,0,1,1,8,6,36
70,406,90,16,74,3,71,1,22,22,2,0,1,0,4,3,16
70,407,173,15,158,2,156,0,28,55,19,0,2,0,10,4,38
70,408,813,110,703,10,693,13,124,246,37,17,4,4,66,19,163
70,409,105,25,80,6,74,0,10,24,11,2,1,1,9,2,14
70,410,471,80,391,8,383,13,110,97,40,3,1,0,36,9,74
70,411,35,2,33,0,33,0,17,8,2,0,1,0,2,0,3
70,412,50,6,44,4,40,1,12,5,3,0,0,0,6,0,13
70,413,1591,324,1267,26,1241,18,417,189,194,16,8,2,82,18,297
70,414,789,174,615,15,600,9,219,90,78,11,4,2,33,7,147
70,415,458,57,401,13,388,4,97,83,43,3,3,3,30,9,113
70,416,147,16,131,3,128,1,45,25,13,4,1,0,7,3,29
70,417,258,42,216,5,211,2,49,66,14,1,4,0,21,0,54
70,418,147,11,136,3,133,9,33,30,10,0,1,0,7,2,41
70,419,89,17,72,2,70,0,20,27,2,1,0,0,5,0,15
70,420,44,4,40,0,40,0,7,13,2,0,0,0,4,3,11
70,421,2192,420,1772,37,1735,24,471,422,147,23,7,5,106,29,501
70,422,124,22,102,0,102,4,24,34,9,3,0,1,6,2,19
70,423,102,18,84,0,84,0,17,26,7,0,2,0,6,5,21
70,425,133,13,120,5,115,0,29,33,12,0,0,0,13,0,28
70,426,222,31,191,5,186,1,66,45,13,1,1,0,12,3,44
70,427,322,49,273,7,266,7,56,44,28,3,4,0,16,5,103
70,428,1017,108,909,35,874,13,192,263,66,9,8,3,82,18,220
70,429,409,44,365,8,357,10,62,98,41,0,3,1,30,11,101
70,430,59,8,51,0,51,4,8,19,5,0,0,0,9,3,3
70,431,175,17,158,4,154,2,53,36,17,0,2,0,11,2,31
70,432,289,41,248,13,235,4,69,54,33,2,5,0,7,5,56
70,433,1083,118,965,27,938,22,198,257,80,9,9,0,85,22,256
70,435,756,82,674,21,653,10,165,206,38,4,7,2,48,13,160
70,436,107,28,79,1,78,1,23,16,13,1,0,0,8,1,15
70,437,15,3,12,2,10,0,2,4,0,1,0,0,0,0,3
70,438,166,16,150,0,150,0,25,61,11,2,1,0,15,3,32
70,439,290,33,257,3,254,7,55,75,19,2,2,0,25,2,67
70,440,31,5,26,0,26,0,6,2,0,1,0,2,5,1,9
70,441,180,22,158,2,156,10,30,36,12,2,2,1,18,1,44
70,442,97,11,86,5,81,0,29,26,4,1,0,1,9,3,8
70,443,81,9,72,1,71,0,16,30,2,0,0,0,5,1,17
70,444,117,13,104,2,102,1,28,20,14,0,1,0,10,1,27
70,445,97,18,79,4,75,0,25,27,8,0,2,0,4,1,8
70,446,522,68,454,10,444,4,98,120,38,8,2,1,35,7,131
70,447,1218,153,1065,26,1039,29,175,289,115,11,5,1,106,21,287
70,448,127,16,111,2,109,2,24,40,8,1,1,0,12,3,18
70,449,65,15,50,0,50,1,5,26,4,0,0,0,2,2,10
70,450,45,3,42,0,42,0,7,23,1,0,0,0,7,0,4
70,451,2211,511,1700,39,1661,12,537,254,216,23,14,3,66,23,513
70,452,226,33,193,6,187,0,60,46,17,0,1,0,15,4,44
70,453,96,15,81,0,81,2,18,26,7,1,0,0,10,2,15
70,454,69,11,58,2,56,1,11,16,6,0,0,0,7,1,14
70,455,944,147,797,27,770,3,242,154,95,15,6,2,37,17,199
70,456,119,14,105,3,102,1,25,17,19,0,1,0,6,4,29
70,457,122,27,95,0,95,1,24,27,9,1,0,0,7,6,20
70,459,947,166,781,32,749,4,243,114,94,8,11,4,46,10,215
70,460,394,58,336,5,331,9,71,128,20,6,2,0,34,6,55
70,461,109,12,97,4,93,0,15,28,16,2,0,0,10,5,17
70,462,68,9,59,0,59,0,16,22,3,0,0,1,4,0,13
70,463,89,8,81,1,80,1,23,27,8,0,0,0,4,0,17
70,464,1024,150,874,21,853,11,249,137,88,16,4,2,59,13,274
70,466,105,20,85,1,84,1,25,24,5,0,0,0,8,2,19
70,467,2349,690,1659,57,1602,12,394,412,142,16,19,3,90,22,492
70,468,100,20,80,2,78,1,13,23,9,1,0,0,15,0,16
70,469,200,35,165,6,159,5,33,54,4,4,1,0,10,3,45
70,470,137,21,116,3,113,0,30,36,9,0,0,0,9,2,27
70,471,29,2,27,2,25,1,6,4,1,2,0,0,5,2,4
70,472,232,34,198,6,192,7,53,43,15,3,4,1,14,6,46
70,473,1361,236,1125,29,1096,16,314,271,101,13,4,3,88,23,263
70,474,114,19,95,2,93,3,18,23,7,2,1,1,9,2,27
70,475,196,27,169,6,163,5,32,22,21,1,1,2,18,4,57
70,476,64,8,56,0,56,1,13,19,1,0,0,0,5,4,13
70,477,573,83,490,6,484,9,127,129,60,8,7,1,22,13,108
70,478,544,75,469,12,457,11,101,133,52,5,1,1,39,6,108
70,479,95,8,87,1,86,2,19,27,8,0,3,0,5,1,21
70,480,142,24,118,2,116,4,25,34,4,4,3,0,12,0,30
70,481,161,25,136,3,133,4,21,51,11,3,2,1,8,2,30
70,482,1129,191,938,17,921,13,229,271,73,20,4,2,40,23,246
70,483,111,10,101,0,101,1,31,34,8,1,0,0,6,2,18
70,484,120,10,110,1,109,1,30,14,9,4,1,0,8,4,38
70,485,223,44,179,2,177,1,46,37,11,7,1,0,13,3,58
70,486,104,15,89,0,89,0,30,22,5,1,0,0,4,1,26
70,487,260,34,226,2,224,9,63,45,22,2,2,1,13,4,63
70,488,185,20,165,7,158,0,40,38,19,5,0,2,14,4,36
70,489,754,132,622,20,602,8,158,204,34,15,8,3,49,9,114
70,490,101,14,87,0,87,0,18,25,8,1,0,0,3,0,32
70,491,366,56,310,6,304,4,78,107,20,3,6,3,22,3,58
70,492,402,53,349,10,339,5,73,133,12,2,0,0,30,7,77
70,493,307,30,277,3,274,7,48,92,29,1,1,0,25,10,61
70,494,234,29,205,0,205,4,40,57,38,1,1,2,13,3,46
70,496,39,6,33,0,33,0,13,10,1,0,0,0,3,1,5
70,497,344,58,286,3,283,2,86,75,17,6,3,0,27,5,62
70,498,425,71,354,9,345,1,64,125,30,8,1,4,31,9,72
70,499,84,10,74,2,72,0,15,26,8,0,0,0,5,2,16
70,500,166,36,130,2,128,2,27,30,9,5,3,0,13,1,38
70,501,76,13,63,3,60,0,10,28,3,0,1,1,2,5,10
70,502,82,8,74,3,71,1,20,25,3,2,0,0,7,3,10
70,503,138,29,109,1,108,1,19,41,12,0,0,0,6,1,28
70,504,315,43,272,4,268,3,50,74,30,1,0,0,25,11,74
70,505,124,9,115,6,109,1,33,33,8,0,0,1,11,1,21
70,506,299,37,262,6,256,9,86,59,28,4,1,0,16,1,52
70,507,155,29,126,6,120,3,34,23,14,3,3,0,8,4,28
70,509,88,8,80,1,79,1,23,36,3,0,0,4,4,2,6
70,510,112,19,93,2,91,0,31,23,12,1,0,2,6,4,12
70,511,167,22,145,1,144,2,43,51,6,1,0,1,7,3,30
70,512,211,37,174,5,169,0,53,16,9,9,1,0,8,4,69
70,513,1968,268,1700,33,1667,44,330,392,174,17,5,2,135,39,529
70,514,443,93,350,5,345,3,127,85,26,5,1,0,27,6,65
70,515,59,4,55,0,55,1,13,14,13,0,0,0,3,0,11
70,516,222,15,207,3,204,0,43,58,16,3,3,0,16,8,57
70,517,257,30,227,5,222,3,47,53,29,4,1,1,26,3,55
70,518,89,11,78,0,78,1,24,11,7,0,1,0,8,0,26
70,519,82,11,71,0,71,1,24,12,8,1,2,0,7,1,15
70,520,86,16,70,1,69,3,15,16,3,3,2,0,7,0,20
70,521,146,28,118,2,116,5,26,32,12,1,0,0,11,0,29
70,522,112,11,101,1,100,3,26,28,11,1,0,0,8,4,19
70,523,166,22,144,3,141,2,32,61,17,1,1,0,5,1,21
70,524,100,14,86,1,85,1,11,30,11,0,0,0,7,1,24
70,525,177,19,158,6,152,1,34,48,9,2,1,2,12,2,41
70,526,536,83,453,15,438,3,110,128,40,9,5,1,38,10,94
70,527,60,17,43,1,42,3,9,10,7,0,0,0,4,1,8
70,528,401,49,352,9,343,5,83,101,21,3,2,1,40,12,75
70,529,376,72,304,8,296,1,89,78,19,5,3,1,28,4,68
70,530,136,20,116,1,115,1,38,29,7,2,1,0,11,0,26
70,531,74,5,69,1,68,2,15,20,5,0,2,0,6,6,12
70,532,375,30,345,10,335,13,73,100,30,1,4,0,39,7,68
70,533,86,7,79,0,79,2,16,17,3,0,2,0,12,3,24
70,534,97,6,91,4,87,0,19,14,15,3,1,0,9,3,23
70,535,138,19,119,1,118,2,36,20,21,1,0,1,7,1,29
70,536,125,23,102,4,98,2,24,22,10,0,2,0,13,6,19
70,537,235,55,180,2,178,5,58,36,24,5,3,0,13,1,33
70,538,75,6,69,1,68,2,15,11,5,1,0,0,12,4,18
70,539,360,39,321,11,310,4,103,87,19,7,4,0,20,5,61
70,540,60,9,51,1,50,0,10,17,2,1,0,2,5,0,13
70,541,164,24,140,6,134,1,61,29,4,2,1,0,8,2,26
70,542,142,35,107,1,106,2,37,30,5,3,0,0,7,5,17
70,544,84,4,80,4,76,1,35,16,8,4,0,0,3,0,9
70,545,122,21,101,3,98,0,25,26,14,0,1,1,11,0,20
70,546,191,24,167,7,160,0,53,42,18,0,1,0,6,0,40
70,547,132,9,123,0,123,2,38,27,6,5,1,0,7,3,34
70,548,171,38,133,3,130,1,31,29,21,3,1,0,7,5,32
70,549,79,20,59,0,59,0,19,3,9,5,0,0,6,0,17
70,550,9602,2200,7402,183,7219,139,1190,1999,792,95,47,26,498,111,2322
70,551,124,23,101,1,100,0,27,51,10,0,2,0,1,2,7
70,552,161,21,140,5,135,3,42,25,11,2,6,0,3,4,39
70,553,94,12,82,1,81,2,24,12,7,0,2,0,11,1,22
70,554,154,24,130,1,129,3,43,25,16,2,1,0,3,0,36
70,555,146,24,122,4,118,1,46,25,14,1,4,0,7,2,18
70,557,101,9,92,8,84,1,33,29,4,0,0,0,4,1,12
70,558,125,20,105,2,103,4,26,21,11,1,0,0,14,2,24
70,559,170,22,148,3,145,2,34,32,24,1,1,0,5,3,43
70,560,125,18,107,0,107,3,45,9,9,1,1,1,12,4,22
70,561,885,135,750,18,732,15,182,213,79,4,5,3,50,14,167
70,562,111,9,102,3,99,0,29,32,0,0,0,0,12,4,22
70,563,489,58,431,9,422,5,61,127,34,3,1,0,42,11,138
70,564,242,42,200,7,193,6,54,52,7,7,2,2,13,5,45
70,565,32,8,24,0,24,2,2,7,2,1,0,0,8,0,2
70,566,172,36,136,4,132,0,35,45,2,1,0,1,16,1,31
70,567,116,8,108,1,107,2,34,33,10,1,0,1,9,2,15
70,568,58,6,52,2,50,1,12,14,7,2,2,0,1,1,10
70,569,80,11,69,4,65,1,23,9,3,0,3,0,5,0,21
70,571,35,1,34,2,32,1,12,10,3,1,0,0,1,0,4
70,572,243,49,194,7,187,2,46,59,12,2,1,1,21,2,41
70,573,113,21,92,4,88,0,23,31,6,2,0,0,8,4,14
70,574,74,8,66,4,62,0,20,11,3,0,3,0,6,0,19
70,575,589,90,499,12,487,9,92,156,45,4,2,2,58,5,114
70,576,160,30,130,2,128,1,33,24,4,7,4,0,7,7,41
70,577,307,34,273,6,267,6,52,43,56,4,5,0,18,5,78
70,578,155,25,130,2,128,3,34,31,7,5,1,0,15,6,26
70,579,376,43,333,3,330,8,93,59,39,4,2,4,25,8,88
70,580,142,31,111,3,108,2,45,20,10,0,0,1,8,1,21
70,581,517,87,430,7,423,6,138,65,47,3,3,1,27,13,120
70,582,79,21,58,0,58,1,24,16,3,1,0,0,4,0,9
70,583,77,9,68,1,67,2,25,14,2,0,3,0,5,0,16
71,1,585,99,486,10,476,3,128,88,62,12,6,1,29,7,140
71,2,866,119,747,22,725,3,209,132,70,11,3,0,53,20,224
71,3,580,95,485,5,480,9,116,157,35,2,7,2,23,10,119
71,4,761,95,666,9,657,5,132,189,56,9,1,5,47,11,202
71,5,186,23,163,3,160,5,29,53,15,2,0,0,18,3,35
71,6,175,27,148,2,146,1,13,48,13,1,1,2,30,1,36
71,7,120,14,106,0,106,3,18,22,12,1,1,0,26,1,22
71,8,135,24,111,0,111,2,29,19,10,0,2,0,23,2,24
71,9,636,123,513,5,508,13,79,128,70,1,2,0,24,5,186
71,10,644,109,535,19,516,6,144,115,39,8,5,1,32,15,151
71,11,392,58,334,10,324,6,46,115,29,8,1,3,61,2,53
71,12,280,35,245,8,237,4,66,64,30,0,2,1,27,2,41
71,13,187,41,146,1,145,4,38,33,10,1,0,0,8,6,45
71,14,9856,1951,7905,195,7710,114,1459,2359,624,84,38,19,558,121,2334
71,15,814,107,707,7,700,8,193,142,71,10,8,3,49,14,202
71,16,760,115,645,21,624,17,119,179,94,9,2,0,44,19,141
71,17,80,17,63,2,61,0,2,26,2,1,2,0,12,0,16
71,18,402,74,328,9,319,4,100,72,26,3,3,0,21,6,84
71,19,122,17,105,3,102,3,33,18,10,3,0,3,11,1,20
71,20,101,19,82,4,78,2,12,18,7,0,0,0,8,3,28
71,21,197,30,167,3,164,8,30,47,13,3,3,0,16,7,37
71,22,539,80,459,12,447,3,99,150,27,3,2,1,47,17,98
71,23,678,106,572,15,557,7,156,130,44,11,4,0,48,13,144
71,24,404,52,352,9,343,5,53,96,42,2,0,0,45,15,85
71,25,306,56,250,3,247,3,54,56,19,4,3,0,36,5,67
71,26,253,23,230,6,224,3,52,50,23,5,1,1,27,8,54
71,27,455,68,387,14,373,5,93,69,31,4,1,1,46,7,116
71,28,72,6,66,1,65,2,22,14,4,1,0,0,7,1,14
71,29,243,30,213,3,210,5,40,47,18,4,4,1,29,8,54
71,30,158,20,138,0,138,4,27,34,19,1,0,0,16,2,35
71,31,63,5,58,0,58,2,11,22,5,1,1,0,6,1,9
71,32,458,67,391,8,383,5,69,94,47,4,2,0,29,14,119
71,33,555,82,473,7,466,4,96,111,40,8,3,0,35,5,164
71,34,295,30,265,4,261,9,53,54,37,2,1,0,26,6,73
71,35,172,29,143,6,137,5,14,36,18,1,0,0,21,0,42
71,36,63,7,56,2,54,2,7,11,5,0,4,0,3,1,21
71,37,78,10,68,1,67,2,8,18,12,1,0,0,8,0,18
71,38,371,41,330,7,323,7,67,70,41,9,5,2,40,2,80
71,39,144,20,124,2,122,7,20,18,32,3,0,0,13,2,27
71,40,5094,999,4095,106,3989,33,971,834,464,54,28,8,239,56,1302
71,41,80,6,74,3,71,0,15,17,9,1,1,0,11,2,15
71,42,221,43,178,2,176,2,26,37,29,1,1,1,19,4,56
71,43,87,19,68,2,66,1,14,16,8,2,1,1,7,0,16
71,44,238,40,198,5,193,5,47,62,9,1,0,0,20,2,47
71,45,138,20,118,4,114,2,33,35,9,2,0,0,12,1,20
71,46,78,17,61,2,59,1,14,14,4,0,1,0,12,1,12
71,47,4013,791,3222,118,3104,24,541,776,322,49,18,7,222,78,1067
71,48,167,31,136,0,136,0,21,35,21,2,0,0,15,4,38
71,50,259,48,211,4,207,6,30,59,20,3,3,0,29,4,53
71,51,122,21,101,4,97,0,22,26,9,1,0,0,8,3,28
71,52,536,102,434,9,425,7,93,130,30,8,4,0,44,10,99
71,54,495,55,440,9,431,7,126,139,26,9,3,0,38,10,73
71,55,238,40,198,4,194,8,52,57,13,2,1,1,21,4,35
71,56,1659,219,1440,47,1393,11,309,419,120,13,11,1,134,21,354
71,57,129,12,117,1,116,9,18,30,21,0,0,1,11,2,24
71,58,161,21,140,3,137,2,22,46,15,2,2,0,20,3,25
71,59,2967,491,2476,48,2428,35,422,557,218,29,10,5,177,34,941
71,60,200,29,171,6,165,4,28,50,23,1,2,1,19,6,31
71,61,330,47,283,1,282,1,81,52,24,10,0,2,24,8,80
71,62,315,50,265,3,262,2,54,114,14,1,0,1,26,6,44
71,63,602,90,512,15,497,10,105,98,68,2,1,2,37,11,163
71,64,746,114,632,7,625,11,164,142,58,6,10,0,63,7,164
71,65,210,44,166,6,160,5,22,51,24,3,2,1,19,3,30
71,66,91,8,83,1,82,2,9,25,8,0,0,0,5,2,31
71,67,117,14,103,2,101,2,13,24,13,2,0,0,12,4,31
71,68,76,8,68,1,67,3,14,21,6,0,0,1,13,0,9
71,69,501,66,435,18,417,15,63,129,45,4,1,0,43,15,102
71,70,1503,202,1301,28,1273,30,198,369,145,9,6,4,106,30,376
71,71,238,43,195,0,195,3,42,44,17,0,1,0,24,3,61
71,72,105,22,83,5,78,4,18,21,6,2,1,0,9,2,15
71,73,3951,903,3048,64,2984,34,677,683,409,36,23,7,217,52,846
71,74,475,83,392,15,377,5,62,149,33,2,2,0,46,5,73
71,75,565,100,465,26,439,5,108,110,42,7,5,1,29,21,111
71,76,27220,6637,20583,375,20208,412,3338,5265,2360,222,112,45,1571,329,6554
71,77,376,64,312,9,303,5,63,79,23,4,4,1,37,9,78
71,78,114,13,101,4,97,3,20,19,8,0,0,0,13,4,30
71,79,385,61,324,9,315,5,100,71,29,3,0,0,30,10,67
71,80,76,7,69,2,67,3,14,19,4,0,0,0,7,2,18
71,81,1699,297,1402,35,1367,13,308,266,167,12,7,3,107,28,456
71,82,193,21,172,2,170,7,29,58,10,2,3,0,31,3,27
71,84,450,53,397,6,391,10,63,141,34,1,3,0,44,7,88
71,85,172,15,157,0,157,6,29,46,20,3,2,1,17,7,26
71,86,375,46,329,14,315,10,66,113,30,5,0,1,38,6,46
71,87,138,14,124,2,122,2,7,44,11,2,0,0,19,1,36
71,88,214,29,185,5,180,1,21,58,24,0,1,0,17,4,54
71,89,191,23,168,3,165,4,35,42,15,4,1,0,31,2,31
71,90,2585,488,2097,51,2046,40,484,603,189,21,8,7,204,40,450
71,91,160,32,128,7,121,6,17,44,12,1,3,0,9,2,27
71,92,368,66,302,7,295,0,56,101,28,5,1,3,20,7,74
71,93,529,120,409,6,403,12,100,110,49,2,3,1,42,5,79
71,94,117,20,97,3,94,4,11,18,8,4,0,0,15,2,32
71,95,350,50,300,10,290,5,59,82,30,6,2,1,26,4,75
71,96,164,27,137,4,133,4,30,17,24,4,1,1,10,1,41
71,97,434,122,312,5,307,5,71,65,34,5,1,1,40,2,83
71,98,203,31,172,4,168,4,36,63,8,3,1,0,18,1,34
71,99,299,36,263,6,257,8,45,77,22,1,0,2,31,5,66
71,100,162,11,151,2,149,1,26,40,26,1,1,0,16,7,31
71,101,301,52,249,6,243,1,60,71,10,2,2,0,27,3,67
71,102,534,61,473,10,463,10,71,121,39,2,1,1,35,9,174
71,103,240,52,188,3,185,2,44,66,6,0,1,0,19,9,38
71,104,143,24,119,1,118,2,33,42,8,0,0,0,12,2,19
71,105,5203,918,4285,105,4180,81,658,1415,362,33,16,10,432,87,1086
71,106,1987,399,1588,41,1547,19,233,525,132,15,6,3,200,41,373
71,107,235,25,210,3,207,7,43,51,18,1,1,0,21,9,56
71,108,121,7,114,2,112,8,15,37,12,2,0,0,6,3,29
71,109,272,39,233,4,229,8,61,51,28,5,3,0,19,6,48
71,110,474,70,404,23,381,10,80,116,29,2,0,0,70,17,57
71,111,260,24,236,6,230,4,47,43,32,1,4,1,20,15,63
71,112,209,35,174,7,167,18,20,35,24,1,0,0,22,0,47
71,113,80,10,70,1,69,3,16,22,4,1,0,0,9,1,13
71,115,83,19,64,0,64,0,11,20,5,2,2,0,7,2,15
71,116,149,35,114,2,112,1,22,35,12,2,1,2,20,4,13
71,117,763,104,659,24,635,5,114,180,76,7,2,1,58,24,168
71,118,4737,1003,3734,86,3648,50,731,925,366,42,17,8,341,63,1105
71,119,754,92,662,13,649,18,174,127,66,8,1,1,60,18,176
71,120,3037,652,2385,71,2314,30,485,707,186,21,15,14,282,55,519
71,121,228,51,177,7,170,3,67,36,12,2,0,1,9,3,37
71,122,395,53,342,7,335,13,79,82,36,7,4,0,20,8,86
71,123,318,53,265,6,259,4,68,72,32,3,0,0,23,5,52
71,124,179,18,161,3,158,1,12,41,25,2,3,0,17,3,54
71,125,26,5,21,1,20,0,2,15,0,0,0,0,1,2,0
71,126,485,69,416,11,405,9,46,164,36,2,1,3,49,5,90
71,127,82,18,64,2,62,4,0,14,7,0,0,0,8,0,29
71,128,71,9,62,2,60,0,7,18,7,1,1,0,6,4,16
71,129,255,44,211,5,206,3,64,56,14,2,0,1,12,8,46
71,130,220,36,184,2,182,9,24,39,43,1,0,1,9,7,49
71,131,562,96,466,12,454,4,132,132,48,6,1,0,34,10,87
71,132,1784,344,1440,23,1417,13,330,282,174,19,16,3,95,27,458
71,133,1359,311,1048,32,1016,8,199,353,66,6,8,3,109,26,238
71,134,176,25,151,3,148,0,32,56,14,2,1,0,17,1,25
71,135,699,109,590,19,571,26,125,133,58,4,3,3,51,13,155
71,136,240,22,218,8,210,3,43,47,25,2,1,0,17,3,69
71,137,2976,495,2481,39,2442,68,322,681,337,36,14,6,246,59,673
71,138,90,10,80,0,80,1,34,15,1,1,0,0,6,1,21
71,139,124,23,101,2,99,3,22,20,16,1,2,0,4,4,27
71,140,43,10,33,0,33,0,8,15,2,0,0,0,3,0,5
71,141,240,23,217,6,211,1,47,59,27,3,1,0,26,2,45
71,142,160,34,126,4,122,0,23,46,14,2,0,0,12,1,24
71,143,320,52,268,5,263,2,63,64,42,0,2,0,22,5,63
71,144,147,26,121,5,116,0,37,33,13,1,3,0,5,1,23
71,145,384,61,323,8,315,22,49,77,37,5,1,1,18,8,97
71,146,189,30,159,2,157,10,22,39,19,1,0,0,21,2,43
71,147,222,38,184,4,180,3,27,48,24,6,1,0,18,2,51
71,148,681,105,576,28,548,9,124,144,46,11,3,3,85,15,108
71,149,1015,180,835,33,802,15,146,202,94,10,5,3,92,19,216
71,150,2187,436,1751,32,1719,22,347,556,140,10,8,2,175,47,412
71,151,57,11,46,1,45,2,8,11,7,0,1,0,1,1,14
71,152,162,16,146,5,141,1,31,45,9,1,1,0,17,2,34
71,153,15018,3744,11274,229,11045,111,1869,2379,1209,140,56,32,756,164,4329
71,154,1780,235,1545,44,1501,24,312,367,140,22,5,6,143,29,453
71,155,454,81,373,10,363,0,55,86,26,8,6,4,34,9,135
71,156,217,46,171,3,168,5,32,45,24,0,0,1,13,4,44
71,157,1355,244,1111,26,1085,10,235,273,126,15,7,3,116,19,281
71,158,1147,243,904,22,882,19,190,214,108,23,5,6,72,21,224
71,159,172,21,151,1,150,10,26,33,18,3,1,1,12,2,44
71,160,297,34,263,10,253,2,46,100,20,2,0,0,27,8,48
71,161,269,45,224,9,215,1,37,38,31,4,4,4,17,9,70
71,162,913,96,817,22,795,9,164,220,66,10,2,2,84,17,221
71,163,65,19,46,0,46,2,7,16,3,0,0,0,3,1,14
71,164,129,22,107,3,104,3,21,26,15,1,1,0,10,1,26
71,165,335,52,283,4,279,11,43,82,31,5,3,2,24,3,75
71,166,108,22,86,2,84,0,19,37,5,1,1,1,6,3,11
71,167,397,48,349,14,335,1,84,64,45,5,4,0,14,5,113
71,168,124,21,103,7,96,0,14,23,14,0,1,0,11,2,31
71,169,595,88,507,8,499,10,82,175,44,4,4,2,63,13,102
71,170,1269,197,1072,20,1052,22,237,268,100,10,7,1,106,17,284
71,171,244,45,199,3,196,2,57,23,20,3,1,0,13,3,74
71,172,97,11,86,1,85,5,13,26,7,2,2,0,18,3,9
71,173,197,29,168,3,165,2,38,49,20,4,1,0,13,2,36
71,174,163,19,144,2,142,5,28,46,16,0,0,0,18,2,27
71,175,221,48,173,4,169,2,58,42,7,2,0,0,15,6,37
71,176,5599,1182,4417,100,4317,46,867,919,471,48,40,13,228,89,1596
71,177,547,102,445,5,440,3,114,101,59,5,4,0,22,8,124
71,178,733,113,620,15,605,12,138,163,40,5,5,4,79,33,126
71,179,63,5,58,2,56,0,9,29,1,0,0,0,10,3,4
71,180,170,23,147,1,146,13,14,23,33,2,1,3,16,1,40
71,181,126,18,108,2,106,1,13,27,22,1,0,1,11,3,27
71,182,1109,148,961,14,947,17,155,397,54,16,0,4,108,20,176
71,183,139,20,119,3,116,6,25,30,15,1,0,0,10,2,27
71,184,506,86,420,11,409,4,131,78,20,7,2,2,49,11,105
71,185,258,48,210,11,199,2,55,63,12,4,2,0,26,9,26
71,186,175,27,148,2,146,3,31,41,24,3,2,0,10,4,28
71,187,1333,275,1058,21,1037,8,208,203,137,24,10,1,98,14,334
71,188,54,8,46,1,45,4,14,7,4,2,0,2,2,0,10
71,189,1277,232,1045,27,1018,21,246,252,86,14,8,2,92,13,284
71,190,1804,333,1471,19,1452,13,334,323,137,27,14,5,71,33,495
71,191,363,35,328,7,321,11,58,74,29,8,3,1,20,4,113
71,192,1467,241,1226,37,1189,16,263,293,82,15,4,2,92,22,400
71,193,372,42,330,7,323,9,58,75,38,1,3,0,34,8,97
71,194,553,48,505,19,486,7,115,115,42,4,4,3,39,13,144
71,195,185,37,148,8,140,6,21,71,14,0,0,0,6,4,18
71,196,497,79,418,10,408,4,136,76,40,3,2,1,42,5,99
71,198,279,61,218,6,212,0,43,51,15,2,2,0,24,6,69
71,199,159,17,142,0,142,3,22,37,10,1,1,0,18,3,47
71,200,471,57,414,12,402,13,66,119,40,5,1,1,51,12,94
71,201,235,83,152,2,150,3,15,64,19,0,1,0,22,2,24
71,202,1542,235,1307,33,1274,32,245,352,127,13,11,3,131,30,330
71,203,36,5,31,1,30,0,3,16,3,0,0,0,5,0,3
71,204,758,76,682,13,669,6,153,185,56,5,1,1,54,11,197
71,205,462,77,385,4,381,5,88,69,66,5,2,1,26,8,111
71,206,191,41,150,1,149,4,41,32,19,5,1,0,9,3,35
71,207,219,33,186,4,182,1,36,75,12,1,2,0,12,7,36
71,208,181,29,152,5,147,3,25,49,18,2,1,0,16,2,31
71,209,477,92,385,10,375,5,87,79,48,8,7,1,31,10,99
71,210,301,39,262,6,256,2,53,116,13,3,0,2,25,7,35
71,212,1219,224,995,22,973,5,178,223,154,10,7,1,77,12,306
71,213,447,102,345,6,339,8,103,86,19,5,5,1,24,6,82
71,214,328,50,278,6,272,6,71,76,24,4,1,0,18,4,68
71,215,1908,238,1670,58,1612,28,414,343,185,18,12,1,130,48,433
71,216,155,18,137,4,133,3,22,38,8,4,1,0,14,5,38
71,217,104,20,84,3,81,1,20,30,10,3,0,0,6,0,11
71,218,521,109,412,9,403,9,79,120,33,10,4,2,72,13,61
71,219,428,60,368,13,355,8,70,74,42,11,3,2,28,6,111
71,220,408,76,332,12,320,5,70,53,33,9,1,1,31,6,111
71,221,3073,444,2629,46,2583,44,416,875,214,21,3,8,307,59,636
71,222,762,123,639,16,623,14,135,208,49,10,2,3,63,8,131
71,223,497,43,454,9,445,12,101,106,30,9,3,1,50,12,121
71,224,86,19,67,1,66,1,7,28,1,0,0,0,9,1,19
71,225,371,40,331,7,324,6,92,72,32,4,1,0,29,10,78
71,226,42,3,39,2,37,0,9,10,5,0,0,0,7,0,6
71,227,468,62,406,21,385,1,60,106,46,7,1,1,25,6,132
71,228,138,21,117,0,117,2,28,20,12,1,1,0,8,7,38
71,229,226,42,184,3,181,5,45,33,31,2,1,1,14,3,46
71,230,5885,1101,4784,100,4684,45,776,841,736,42,39,16,263,85,1841
71,231,434,112,322,13,309,4,94,70,28,0,2,0,34,3,74
71,232,171,27,144,5,139,1,36,41,8,3,1,0,13,2,34
71,233,267,48,219,2,217,1,59,56,14,3,0,1,26,2,55
71,234,263,66,197,5,192,1,70,26,25,1,3,1,14,9,42
71,235,1280,128,1152,18,1134,35,178,338,92,9,4,3,150,21,304
71,236,654,107,547,11,536,14,114,132,64,7,6,2,48,9,140
71,237,447,84,363,11,352,1,102,62,36,7,3,1,11,18,111
71,238,802,142,660,12,648,10,128,174,83,8,6,1,61,18,159
71,239,598,93,505,17,488,3,92,145,38,2,0,0,57,15,136
71,240,267,29,238,3,235,8,34,50,33,8,5,1,24,5,67
71,241,407,60,347,9,338,9,61,98,24,5,2,1,45,8,85
71,242,362,46,316,8,308,9,64,83,33,7,1,1,34,9,67
71,243,321,64,257,4,253,6,68,36,43,5,3,2,16,6,68
71,244,331,69,262,8,254,3,50,70,38,4,3,0,12,5,69
71,245,234,41,193,3,190,7,37,55,15,4,0,0,14,5,53
71,246,194,40,154,1,153,3,45,33,14,2,2,1,9,8,36
71,247,261,35,226,3,223,7,35,41,31,5,1,0,13,7,83
71,248,540,89,451,9,442,6,87,114,44,6,2,0,57,6,120
71,249,843,127,716,29,687,7,145,185,66,11,3,1,59,20,190
71,250,784,100,684,25,659,15,135,164,70,7,3,2,71,23,169
71,251,551,80,471,11,460,13,119,131,31,3,7,3,35,3,115
71,252,287,29,258,7,251,5,35,58,39,3,1,1,17,8,84
71,253,793,150,643,25,618,9,134,128,97,9,2,0,49,7,183
71,254,127,12,115,2,113,0,19,51,6,1,1,0,4,1,30
71,255,162,25,137,5,132,1,24,23,12,3,1,2,13,6,47
71,256,368,42,326,8,318,5,90,69,29,7,4,1,23,8,82
71,257,509,81,428,8,420,6,99,89,49,4,4,3,36,9,121
71,258,398,54,344,4,340,11,78,87,27,1,1,3,31,6,95
71,259,304,49,255,11,244,5,41,70,25,2,2,1,29,3,66
71,261,496,92,404,8,396,8,105,83,42,10,4,1,39,10,94
71,262,146,23,123,2,121,1,27,40,13,0,1,1,8,1,29
71,263,4789,1049,3740,90,3650,43,695,1160,343,36,23,6,309,77,958
71,264,284,38,246,7,239,14,38,57,44,3,1,0,16,4,62
71,265,349,53,296,12,284,7,70,84,29,4,5,1,14,6,64
71,266,316,67,249,5,244,5,52,81,15,5,2,0,25,5,54
71,267,710,119,591,17,574,8,114,168,80,6,1,1,43,14,139
71,268,277,45,232,8,224,2,37,80,29,5,0,0,33,3,35
71,269,1265,209,1056,17,1039,18,212,259,116,13,10,2,92,21,296
71,270,21148,5647,15501,297,15204,368,2097,3792,1939,147,72,39,1339,257,5154
71,271,161,27,134,2,132,4,19,43,6,1,0,0,12,2,45
71,272,215,42,173,1,172,10,33,27,34,2,1,1,12,3,49
71,273,253,44,209,6,203,1,38,32,21,3,2,0,20,5,81
71,274,319,54,265,4,261,8,43,66,35,2,1,1,22,5,78
71,275,1416,308,1108,20,1088,15,188,321,99,14,9,1,105,23,313
71,276,116,11,105,1,104,3,22,35,10,1,0,0,8,1,24
71,277,518,93,425,11,414,10,91,92,52,5,0,0,43,7,114
71,278,139,19,120,2,118,3,17,45,12,0,1,0,10,1,29
71,279,357,59,298,7,291,6,54,89,28,2,0,0,45,8,59
71,280,77,8,69,0,69,0,16,30,5,1,2,0,2,1,12
71,281,324,55,269,7,262,1,40,96,20,1,2,1,33,7,61
71,282,970,153,817,23,794,15,197,176,91,11,5,0,86,13,200
71,283,397,48,349,8,341,2,82,118,27,7,1,0,27,8,69
71,284,125,21,104,6,98,2,13,36,8,0,0,0,12,6,21
71,285,337,47,290,5,285,3,59,83,18,3,3,0,43,14,59
71,286,209,41,168,3,165,5,41,33,21,2,0,0,18,5,40
71,287,285,40,245,4,241,5,57,33,23,9,0,0,27,5,82
71,288,47,12,35,1,34,0,9,11,4,0,0,0,5,0,5
71,289,915,199,716,23,693,20,145,173,70,10,7,1,84,18,165
71,290,284,40,244,3,241,4,57,78,14,0,0,0,36,2,50
71,291,719,112,607,12,595,5,158,162,51,7,6,1,63,14,128
71,292,1017,166,851,17,834,17,129,252,78,10,9,1,95,20,223
71,293,277,55,222,2,220,7,49,57,19,1,3,0,23,5,56
71,294,928,130,798,19,779,8,153,277,73,3,7,2,76,7,173
71,295,1033,155,878,21,857,9,195,229,55,11,6,0,57,13,282
71,296,542,68,474,4,470,10,130,98,46,5,6,1,37,5,132
71,297,652,121,531,10,521,10,117,123,59,5,8,2,41,12,144
71,299,290,37,253,10,243,5,38,63,40,1,2,2,29,4,59
71,300,444,82,362,6,356,4,89,69,59,9,2,0,20,14,90
71,301,170,18,152,7,145,5,35,25,22,3,1,0,10,5,39
71,302,200,33,167,3,164,6,25,39,6,0,1,0,25,14,48
71,303,334,42,292,11,281,5,62,65,28,3,1,0,22,4,91
71,304,82,8,74,2,72,4,9,20,14,4,0,0,5,0,16
71,305,606,92,514,15,499,8,86,157,51,7,4,5,59,13,109
71,306,13867,4108,9759,199,9560,112,2037,2122,1211,110,60,17,537,150,3204
71,307,224,24,200,4,196,6,31,69,22,4,2,0,17,5,40
71,308,45,4,41,0,41,9,0,3,6,0,0,0,5,0,18
71,309,1748,300,1448,35,1413,20,274,414,124,21,7,4,121,32,396
71,310,3837,803,3034,64,2970,26,552,614,367,38,29,2,197,55,1090
71,311,205,31,174,6,168,4,50,47,12,2,0,0,11,4,38
71,312,191,24,167,5,162,2,52,25,14,2,2,1,4,6,54
71,313,271,38,233,11,222,0,48,71,27,2,1,1,20,2,50
71,314,152,29,123,2,121,5,32,23,4,4,0,2,11,1,39
71,315,114,9,105,1,104,0,28,24,5,1,0,0,5,2,39
71,316,277,42,235,3,232,6,49,80,14,3,2,0,33,7,38
71,317,147,19,128,2,126,1,40,42,7,1,1,0,4,1,29
71,318,833,162,671,14,657,4,140,187,72,7,6,0,72,10,159
71,319,527,80,447,12,435,9,107,73,30,4,1,0,29,13,169
71,320,239,26,213,4,209,8,32,66,24,3,0,0,21,1,54
71,321,168,29,139,3,136,3,35,28,24,6,1,0,6,0,33
71,322,71,12,59,2,57,0,10,17,5,1,0,0,8,1,15
71,323,130,21,109,4,105,2,10,24,11,0,0,0,12,2,44
71,324,502,83,419,5,414,11,73,116,49,7,3,0,49,12,94
71,325,857,120,737,11,726,6,172,133,123,14,7,4,41,23,203
71,326,328,69,259,6,253,6,64,64,34,3,1,1,23,7,50
71,327,270,34,236,7,229,3,52,66,20,1,0,1,39,5,42
71,328,448,61,387,12,375,8,96,74,69,3,4,2,35,4,80
71,329,321,69,252,6,246,2,97,56,13,7,0,0,16,9,46
71,330,612,81,531,17,514,1,103,156,50,6,4,2,37,16,139
71,331,87,19,68,0,68,0,13,18,3,1,0,0,14,3,16
71,332,366,47,319,3,316,2,91,71,33,2,1,0,28,9,79
71,333,977,137,840,19,821,3,171,189,91,11,4,5,66,16,265
71,334,320,50,270,3,267,7,39,59,31,6,0,0,26,4,95
71,335,53,9,44,1,43,0,8,15,5,1,0,0,2,3,9
71,336,2152,308,1844,51,1793,22,471,439,146,26,13,3,148,43,482
71,337,238,34,204,5,199,11,27,76,15,3,0,2,25,3,37
71,338,194,29,165,5,160,6,36,28,18,5,0,0,15,2,50
71,339,385,66,319,7,312,7,70,104,22,1,2,0,29,10,67
71,340,1109,158,951,25,926,15,185,215,104,16,9,2,103,15,262
71,341,126,31,95,2,93,2,26,27,6,0,0,0,7,2,23
71,342,7238,1752,5486,126,5360,77,743,1743,521,58,24,14,557,115,1508
71,343,197,20,177,9,168,8,30,54,20,2,2,0,17,2,33
71,344,52,8,44,0,44,1,11,12,2,0,0,0,6,0,12
71,345,433,66,367,10,357,9,74,99,35,2,1,1,28,8,100
71,346,1269,188,1081,24,1057,7,220,209,133,13,8,1,68,15,383
71,347,384,52,332,4,328,8,75,56,46,8,1,4,21,7,102
71,348,117,21,96,5,91,2,25,24,7,1,0,0,10,3,19
71,349,53,7,46,2,44,0,9,22,6,0,0,0,1,2,4
71,350,646,99,547,13,534,16,100,181,51,5,3,2,46,12,118
71,351,1449,238,1211,20,1191,14,278,397,100,12,12,3,92,17,266
71,352,72,7,65,0,65,2,23,11,6,1,1,0,4,0,17
71,353,408,93,315,6,309,8,57,78,40,5,2,0,25,6,88
71,354,461,62,399,11,388,3,72,104,56,10,3,0,46,15,79
71,355,191,22,169,2,167,3,40,42,11,0,1,1,10,0,59
71,356,723,98,625,21,604,8,141,124,96,9,5,2,55,9,155
71,357,162,24,138,3,135,1,44,36,8,0,5,0,2,2,37
71,358,81,11,70,1,69,0,5,19,7,2,1,0,8,0,27
71,359,480,40,440,12,428,6,78,101,51,4,2,1,40,11,134
71,360,1269,164,1105,26,1079,21,202,336,95,6,5,3,109,19,283
71,361,60,8,52,0,52,1,9,12,7,2,0,0,15,0,6
71,362,227,41,186,7,179,4,46,34,31,1,2,2,22,8,29
71,363,89,12,77,7,70,0,8,18,17,2,0,0,9,4,12
71,364,102,13,89,2,87,0,38,21,5,2,0,0,5,1,15
71,365,408,98,310,10,300,0,59,92,34,3,0,3,18,8,83
71,366,314,51,263,6,257,5,50,69,30,6,3,0,23,9,62
71,367,322,34,288,6,282,3,80,47,25,3,4,1,28,11,80
71,368,272,41,231,4,227,4,64,56,13,5,0,1,35,3,46
71,369,340,52,288,7,281,5,72,79,36,7,3,1,15,1,62
71,370,541,75,466,5,461,4,73,137,63,4,3,1,32,8,136
71,371,1218,206,1012,12,1000,23,154,315,107,8,5,1,104,19,264
71,372,1290,229,1061,24,1037,26,238,362,95,15,4,1,90,18,188
71,373,1276,292,984,26,958,13,244,265,87,7,5,3,102,18,214
71,374,167,29,138,2,136,4,17,36,32,2,0,1,8,1,35
71,375,216,40,176,0,176,4,25,43,23,0,1,1,21,9,49
71,376,258,56,202,1,201,4,43,35,36,2,2,0,12,8,59
71,377,120,19,101,2,99,5,13,24,14,1,1,0,6,2,33
71,378,1350,259,1091,28,1063,34,188,299,95,11,11,6,110,15,294
71,379,993,175,818,23,795,18,188,196,104,8,8,3,74,19,177
71,380,566,67,499,6,493,15,108,125,55,3,5,0,52,15,115
71,381,67,15,52,1,51,0,11,19,2,1,2,0,7,4,5
71,382,561,88,473,10,463,6,121,94,68,3,7,2,29,10,123
71,383,344,50,294,7,287,4,76,74,24,4,3,0,27,6,69
71,384,349,44,305,8,297,4,64,83,28,1,3,1,17,4,92
71,385,440,62,378,9,369,3,67,149,27,6,3,1,41,7,65
71,386,78,24,54,0,54,0,17,16,5,0,0,0,0,0,16
71,387,208,36,172,5,167,4,41,49,15,1,0,0,20,5,32
71,388,334,44,290,11,279,5,64,88,24,3,2,1,28,9,55
71,389,243,37,206,11,195,1,34,56,15,0,1,1,15,6,66
71,390,795,116,679,22,657,13,147,172,73,2,3,1,64,13,169
71,391,377,60,317,6,311,5,75,57,58,6,1,1,19,7,82
71,392,392,55,337,9,328,13,64,71,32,9,5,2,28,4,100
71,393,372,46,326,6,320,8,62,92,25,3,3,1,44,10,72
71,394,738,147,591,20,571,6,121,198,27,5,10,0,67,18,119
71,395,159,25,134,4,130,3,16,40,20,0,0,0,22,0,29
71,396,351,91,260,2,258,3,64,69,36,2,2,0,11,3,68
71,397,193,18,175,7,168,2,43,47,14,1,0,1,19,2,39
71,398,783,151,632,13,619,7,192,131,63,10,4,0,48,10,154
71,399,449,81,368,10,358,3,49,133,19,0,2,1,64,5,82
71,400,140,19,121,1,120,9,15,32,13,0,1,0,10,5,35
71,401,476,97,379,10,369,7,105,111,25,4,6,1,47,8,55
71,402,536,58,478,11,467,9,107,116,42,8,3,0,40,9,133
71,403,235,34,201,7,194,1,54,55,19,2,0,1,22,5,35
71,404,704,104,600,14,586,6,127,166,68,7,1,0,66,17,128
71,405,146,27,119,2,117,1,40,32,3,0,1,0,15,0,25
71,406,125,10,115,3,112,2,12,41,9,0,0,0,14,4,30
71,407,204,28,176,5,171,7,31,52,18,1,0,0,22,4,36
71,408,307,38,269,9,260,5,57,58,19,1,4,0,37,7,72
71,409,258,57,201,3,198,6,64,46,19,5,0,0,22,2,34
71,410,592,99,493,6,487,8,131,99,62,5,2,2,31,7,140
71,411,150,27,123,4,119,9,13,44,15,1,4,0,13,3,17
71,412,895,111,784,13,771,7,148,194,81,8,4,2,79,20,228
71,413,676,112,564,13,551,9,107,137,85,5,2,1,47,12,146
71,414,375,49,326,12,314,6,61,67,27,7,4,1,28,3,110
71,415,114,24,90,5,85,2,15,23,7,1,0,1,9,5,22
71,416,493,78,415,6,409,14,73,103,49,6,0,2,42,7,113
71,417,802,134,668,15,653,12,136,167,72,11,6,1,50,10,188
71,419,1434,230,1204,27,1177,18,251,329,88,14,10,2,99,27,339
71,420,1626,215,1411,37,1374,8,328,373,106,20,5,3,132,29,370
71,421,156,38,118,3,115,3,23,40,2,0,1,0,22,4,20
71,422,209,24,185,5,180,3,31,46,21,5,1,1,20,4,48
71,423,314,57,257,6,251,5,55,86,12,5,4,1,28,3,52
71,424,188,27,161,2,159,5,43,56,17,3,1,0,12,1,21
71,425,253,52,201,5,196,4,60,39,15,2,1,1,20,6,48
71,426,328,45,283,11,272,4,68,50,29,1,2,0,26,5,87
71,427,54,8,46,3,43,1,7,11,5,2,0,0,9,1,7
71,428,498,72,426,9,417,7,79,98,41,9,0,3,46,14,120
71,430,284,40,244,7,237,4,50,57,24,1,1,1,23,3,73
71,431,236,36,200,4,196,1,48,47,18,2,1,1,19,1,58
71,433,458,69,389,5,384,14,77,126,24,8,4,0,48,14,69
71,434,277,41,236,5,231,8,20,65,34,2,1,1,25,11,64
71,435,194,37,157,1,156,0,41,36,17,1,1,0,14,3,43
71,436,809,102,707,18,689,7,137,124,88,10,4,5,47,15,252
71,437,335,51,284,4,280,3,66,84,16,2,1,0,44,10,54
71,438,463,90,373,8,365,2,113,96,28,2,0,0,29,6,89
71,439,514,59,455,15,440,8,84,126,47,5,4,0,49,5,112
71,440,338,59,279,7,272,6,66,55,41,5,2,0,13,3,81
71,441,227,48,179,4,175,11,38,66,14,2,1,0,16,1,26
71,442,1152,189,963,23,940,10,230,249,104,13,4,2,86,15,227
71,443,1106,139,967,22,945,22,161,279,74,13,3,3,118,23,249
71,444,831,99,732,15,717,8,194,166,70,8,5,4,53,16,193
71,445,4248,730,3518,65,3453,52,770,784,376,33,22,6,277,59,1074
71,446,157,26,131,3,128,1,16,30,19,3,0,0,14,2,43
71,447,226,42,184,3,181,8,40,51,18,0,0,0,28,7,29
71,448,937,136,801,23,778,16,145,229,77,9,3,2,89,15,193
71,449,75,8,67,0,67,3,7,13,6,0,0,0,12,3,23
71,450,97,17,80,1,79,0,15,23,9,0,1,0,18,1,12
71,451,89,14,75,1,74,0,16,20,4,3,0,0,2,5,24
71,452,97,16,81,1,80,2,17,14,6,3,0,0,8,2,28
71,453,224,39,185,4,181,3,28,61,23,0,1,1,29,2,33
71,454,137,21,116,4,112,3,19,25,11,2,1,0,14,4,33
71,455,160,33,127,1,126,0,18,37,22,0,0,2,20,2,25
71,456,1459,254,1205,27,1178,17,282,243,122,17,11,5,109,29,343
71,457,106,27,79,0,79,0,20,28,4,2,0,0,5,1,19
71,458,61,12,49,0,49,3,16,6,4,0,1,0,5,2,12
71,459,302,44,258,7,251,1,42,79,22,6,1,0,28,6,66
71,460,310,60,250,6,244,5,44,67,25,3,0,1,24,7,68
71,461,70,15,55,1,54,4,8,11,6,0,0,0,7,1,17
71,462,397,72,325,10,315,6,86,79,35,6,5,1,12,1,84
71,463,423,60,363,13,350,5,65,101,27,3,4,1,41,10,93
71,464,153,26,127,4,123,2,39,34,11,3,2,0,10,1,21
71,465,207,24,183,4,179,3,42,55,17,2,1,0,24,4,31
71,466,87,13,74,3,71,3,21,18,3,2,0,0,3,3,18
71,468,692,79,613,12,601,8,136,132,55,7,7,2,46,19,189
71,469,320,48,272,3,269,10,52,81,23,3,2,2,36,6,54
71,470,286,46,240,4,236,6,34,60,32,3,1,1,39,1,59
71,471,74,19,55,5,50,1,13,8,10,0,1,0,6,1,10
71,472,194,26,168,5,163,9,26,37,7,4,1,0,24,1,54
71,473,162,35,127,6,121,4,26,34,12,0,0,0,24,3,18
71,474,156,29,127,7,120,2,37,24,15,1,0,0,14,3,24
71,475,4771,883,3888,95,3793,67,702,928,423,52,19,11,328,72,1191
71,477,417,58,359,14,345,3,51,101,46,9,2,0,35,8,90
71,478,79,16,63,1,62,0,15,23,8,2,0,0,7,1,6
71,479,1487,242,1245,26,1219,18,232,189,171,17,7,5,91,28,461
71,480,500,84,416,13,403,16,81,112,29,6,4,1,30,9,115
71,481,778,135,643,11,632,4,169,189,59,7,0,1,41,12,150
71,482,647,88,559,12,547,3,146,127,55,8,4,0,44,7,153
71,483,356,51,305,9,296,4,75,81,17,7,5,2,41,8,56
71,484,928,150,778,20,758,17,189,190,72,11,5,1,50,12,211
71,485,224,29,195,12,183,5,21,51,25,4,2,0,25,5,45
71,486,7009,1500,5509,117,5392,81,1121,1117,779,81,41,12,323,94,1743
71,487,172,40,132,0,132,0,37,41,12,1,0,0,8,3,30
71,488,86,6,80,4,76,4,2,20,7,0,0,1,10,2,30
71,489,395,55,340,10,330,2,87,89,36,6,1,1,32,8,68
71,490,756,94,662,12,650,16,108,203,53,2,2,1,90,13,162
71,491,974,173,801,24,777,14,160,238,68,8,7,3,70,27,182
71,492,120,19,101,2,99,1,23,14,23,3,2,1,9,0,23
71,493,270,68,202,3,199,6,49,41,21,4,1,0,15,7,55
71,494,390,54,336,8,328,5,75,77,43,6,7,3,27,4,81
71,495,581,82,499,12,487,8,77,132,61,8,1,0,42,9,149
71,496,126,15,111,0,111,2,22,25,15,3,0,1,15,4,24
71,497,1504,181,1323,31,1292,28,217,384,104,18,5,6,153,23,354
71,498,119,12,107,0,107,1,20,38,8,1,0,0,15,1,23
71,499,3387,801,2586,67,2519,22,585,519,291,50,22,5,142,46,837
71,500,121,12,109,1,108,4,28,47,5,1,0,1,9,0,13
71,501,127,13,114,1,113,7,17,23,18,1,2,0,8,3,34
71,502,1215,161,1054,23,1031,3,238,253,79,15,6,0,79,29,329
71,503,111,21,90,4,86,2,11,28,16,1,0,0,9,0,19
71,504,82,17,65,1,64,3,11,29,1,0,0,0,4,1,15
71,505,88,11,77,0,77,0,9,36,4,1,1,1,7,3,15
71,506,854,142,712,19,693,14,157,194,75,22,5,2,68,18,138
71,507,158,24,134,0,134,4,21,40,22,2,1,0,12,2,30
71,508,299,48,251,3,248,1,56,36,51,3,2,1,14,7,77
71,509,399,69,330,9,321,3,93,68,36,3,3,0,17,10,88
71,510,478,72,406,7,399,5,45,126,46,5,3,1,44,8,116
71,512,2060,345,1715,25,1690,22,408,479,184,22,8,4,129,32,402
71,513,849,144,705,16,689,7,192,159,70,6,3,1,59,16,176
71,514,263,27,236,1,235,0,65,55,30,1,0,1,15,6,62
71,515,96,11,85,3,82,4,18,22,7,2,1,0,6,3,19
71,516,402,67,335,5,330,6,108,82,20,1,3,0,15,7,88
71,517,188,35,153,4,149,0,38,51,13,0,0,1,7,5,34
71,518,251,44,207,4,203,7,28,68,21,1,1,1,17,6,53
71,519,129,34,95,0,95,1,37,28,4,1,0,0,5,2,17
71,520,746,89,657,13,644,9,123,129,58,16,13,2,60,10,224
71,521,84,11,73,0,73,0,18,21,4,1,2,0,4,0,23
71,522,1170,220,950,21,929,11,218,229,104,16,9,0,104,17,221
71,523,767,117,650,14,636,4,163,160,69,7,7,0,48,15,163
71,524,148,35,113,4,109,2,12,27,19,0,0,0,15,4,30
71,525,425,60,365,9,356,15,44,92,53,3,2,2,42,8,95
71,526,333,38,295,8,287,6,41,123,19,3,0,0,40,9,46
71,527,174,24,150,4,146,8,42,23,15,2,1,0,15,3,37
71,528,1623,310,1313,33,1280,18,242,399,108,16,12,1,90,23,371
71,529,278,55,223,4,219,8,34,49,21,2,1,3,39,7,55
71,530,485,98,387,3,384,7,100,105,24,6,6,3,45,10,78
71,531,220,36,184,4,180,4,45,47,18,2,2,0,19,3,40
71,532,85,14,71,0,71,2,7,12,6,0,0,0,20,0,24
71,533,458,71,387,24,363,1,79,100,28,8,2,3,51,8,83
71,534,85,15,70,1,69,2,9,19,8,2,2,0,8,1,18
71,535,431,51,380,9,371,2,82,110,26,7,3,0,41,8,92
71,537,130,20,110,1,109,3,31,26,12,0,1,0,10,0,26
71,538,318,54,264,7,257,3,67,76,14,3,2,1,22,2,67
71,539,79,17,62,0,62,2,20,17,3,1,0,1,6,0,12
71,540,2378,657,1721,38,1683,21,328,261,234,20,7,5,87,28,692
71,541,262,50,212,4,208,5,61,44,18,1,2,0,21,8,48
71,542,1286,250,1036,34,1002,11,181,252,105,15,8,2,91,15,322
71,543,4323,1169,3154,47,3107,53,545,890,361,31,17,5,297,61,847
71,544,148,21,127,1,126,6,41,30,18,2,0,1,7,2,19
71,545,727,128,599,18,581,21,112,167,45,5,6,1,84,14,126
71,546,328,58,270,6,264,11,57,84,26,1,2,0,20,3,60
71,547,223,46,177,4,173,8,31,81,16,0,0,1,16,4,16
71,548,198,40,158,7,151,1,37,38,10,4,1,0,10,3,47
71,549,161,20,141,2,139,1,35,29,8,5,1,0,13,4,43
71,550,599,67,532,6,526,16,118,122,59,7,4,0,55,11,134
71,551,91,15,76,5,71,2,9,20,10,2,1,1,10,2,14
71,552,438,60,378,10,368,4,70,51,60,6,3,1,31,5,137
71,553,194,26,168,3,165,1,25,49,12,2,1,0,30,4,41
71,554,117,32,85,2,83,3,30,24,5,1,0,0,8,3,9
71,555,1345,188,1157,30,1127,10,276,293,115,14,11,3,113,22,270
71,556,372,67,305,8,297,5,63,96,19,5,0,1,20,2,86
71,557,491,65,426,15,411,5,110,107,33,4,1,1,44,11,95
71,558,839,125,714,21,693,5,167,266,49,6,5,3,72,20,100
71,559,528,63,465,14,451,9,94,172,14,7,3,3,64,17,68
71,561,208,27,181,1,180,6,42,45,11,2,0,0,36,7,31
71,562,196,34,162,3,159,0,31,67,14,4,1,0,15,4,23
71,563,92,8,84,3,81,4,15,17,15,1,0,0,7,0,22
71,564,627,83,544,14,530,7,128,170,36,7,2,1,64,10,105
71,565,505,69,436,9,427,1,65,94,78,4,2,0,43,16,124
71,566,705,134,571,15,556,7,153,184,29,6,6,1,40,5,125
71,567,208,27,181,5,176,3,24,82,13,2,0,0,17,1,34
71,568,45,3,42,1,41,0,13,20,1,2,0,0,4,0,1
71,570,411,53,358,7,351,4,77,99,46,9,1,2,12,8,93
71,571,349,50,299,9,290,10,70,70,20,7,0,1,52,4,56
71,572,173,29,144,4,140,1,43,22,9,1,0,0,14,7,43
71,573,179,22,157,5,152,1,31,46,15,2,1,1,12,9,34
71,574,555,76,479,10,469,13,86,123,50,6,2,2,49,12,126
71,576,214,32,182,3,179,1,36,63,16,4,3,1,19,3,33
71,577,139,7,132,4,128,2,39,35,17,0,0,0,7,1,27
71,578,175,24,151,4,147,2,38,45,15,1,1,0,12,3,30
71,579,135,21,114,2,112,6,17,36,9,2,0,0,13,5,24
71,580,317,41,276,10,266,3,61,60,28,1,0,1,25,11,76
71,581,187,13,174,5,169,1,36,61,11,3,0,1,14,6,36
71,582,244,46,198,1,197,3,28,53,40,1,1,1,17,0,53
71,583,612,86,526,8,518,8,86,164,42,7,4,0,46,12,149
71,584,859,172,687,12,675,12,153,190,68,15,7,0,62,20,148
71,585,1024,154,870,23,847,11,225,192,86,8,4,1,71,30,219
71,586,198,24,174,6,168,2,23,58,14,0,4,1,30,7,29
71,587,58,6,52,0,52,1,7,22,4,0,0,0,2,1,15
71,588,882,99,783,8,775,6,164,187,66,9,7,2,81,18,235
71,589,339,68,271,8,263,3,47,64,33,5,4,2,18,3,84
71,590,504,59,445,14,431,12,79,128,37,7,4,0,66,13,85
71,591,363,64,299,6,293,0,70,78,39,4,1,1,23,1,76
72,1,1209,143,1066,24,1042,14,159,229,100,15,8,0,111,23,383
72,2,219,21,198,7,191,2,33,63,19,1,1,0,17,3,52
72,3,7418,1786,5632,149,5483,69,1181,922,1065,68,40,14,314,71,1739
72,4,371,41,330,6,324,7,71,85,37,3,0,1,38,6,76
72,5,685,106,579,8,571,10,125,161,53,9,4,0,63,18,128
72,6,1363,175,1188,33,1155,21,182,384,105,17,12,2,126,19,287
72,7,333,35,298,8,290,2,72,65,35,8,2,1,22,5,78
72,8,4350,740,3610,72,3538,64,626,764,503,43,19,10,266,63,1180
72,9,255,44,211,7,204,2,51,53,21,0,2,1,20,14,40
72,10,304,39,265,2,263,8,44,72,34,2,1,0,31,5,66
72,11,694,98,596,19,577,11,142,164,68,12,0,2,54,12,112
72,12,366,49,317,7,310,6,62,81,32,5,3,2,26,12,81
72,13,1742,355,1387,38,1349,14,360,320,131,25,14,6,115,34,330
72,15,109,18,91,0,91,0,26,13,15,0,2,0,7,5,23
72,16,1157,230,927,26,901,14,182,285,61,16,4,2,120,33,184
72,17,179,21,158,4,154,2,25,61,12,2,0,0,14,3,35
72,18,98,21,77,1,76,1,26,22,1,0,0,1,10,1,14
72,19,286,57,229,8,221,1,62,69,16,3,0,0,24,10,36
72,20,560,75,485,15,470,7,127,145,30,3,3,0,52,9,94
72,21,412,51,361,13,348,10,66,99,29,4,2,2,41,11,84
72,22,807,116,691,25,666,10,157,193,64,8,4,3,58,11,158
72,23,955,167,788,25,763,4,153,204,73,11,11,0,69,21,217
72,24,2707,357,2350,46,2304,37,450,601,233,22,9,5,238,63,646
72,25,906,156,750,24,726,10,130,268,66,10,4,0,67,27,144
72,26,1115,192,923,30,893,9,203,257,95,19,1,2,76,21,210
72,27,283,34,249,3,246,8,52,66,30,5,2,0,22,5,56
72,28,417,56,361,6,355,10,91,79,33,8,2,1,35,9,87
72,29,1358,225,1133,22,1111,11,205,408,78,13,6,3,79,30,278
72,31,341,49,292,5,287,3,74,61,36,5,3,0,13,10,82
72,32,286,49,237,10,227,5,60,52,13,3,3,0,19,4,68
72,33,290,42,248,6,242,5,37,69,32,2,5,0,34,6,52
72,34,371,39,332,5,327,2,49,103,28,4,1,0,38,10,92
72,35,1777,357,1420,31,1389,13,288,317,166,30,18,4,148,31,374
72,36,219,34,185,5,180,2,34,42,13,3,2,0,25,5,54
72,37,74,16,58,3,55,0,7,28,6,1,0,0,2,0,11
72,38,408,74,334,12,322,6,82,83,27,6,2,3,16,13,84
72,39,2958,621,2337,73,2264,24,509,699,149,27,17,4,153,39,643
72,40,95,17,78,1,77,3,23,11,10,1,0,0,5,0,24
72,41,208,19,189,5,184,3,54,43,19,5,4,1,18,5,32
72,42,1651,346,1305,31,1274,14,208,384,115,23,15,2,95,20,398
72,43,225,23,202,6,196,8,33,66,16,2,2,2,16,4,47
72,44,320,43,277,7,270,3,50,75,30,7,4,0,18,3,80
72,45,468,51,417,11,406,7,81,93,55,6,4,1,33,7,119
72,46,994,147,847,19,828,17,191,198,81,8,8,3,68,16,238
72,47,1417,199,1218,38,1180,15,268,269,127,16,9,2,100,34,340
72,48,448,93,355,11,344,1,99,85,41,7,3,1,26,10,71
72,49,205,44,161,6,155,1,40,44,16,1,2,0,5,1,45
72,50,1122,161,961,20,941,15,211,323,64,11,9,2,91,25,190
72,51,2326,372,1954,57,1897,22,434,473,228,28,17,4,156,43,492
72,52,626,77,549,17,532,12,92,146,66,7,6,4,33,13,153
72,53,895,126,769,25,744,19,190,203,84,13,6,2,43,14,170
72,54,2377,305,2072,39,2033,26,448,467,276,34,8,8,155,49,562
72,56,942,97,845,17,828,7,182,203,73,13,4,3,85,18,240
72,57,75,8,67,1,66,0,7,25,5,0,0,0,13,2,14
72,58,4847,613,4234,74,4160,93,714,1146,417,40,25,13,355,87,1270
72,59,620,94,526,18,508,8,130,172,42,9,4,3,37,11,92
72,60,239,45,194,1,193,1,50,52,19,3,2,0,15,7,44
72,61,1143,166,977,27,950,10,262,264,71,22,14,0,77,34,196
72,62,626,99,527,14,513,8,134,142,47,8,8,0,47,8,111
72,63,246,49,197,5,192,2,61,40,15,0,3,0,17,6,48
72,64,442,69,373,8,365,3,107,67,29,10,5,0,39,10,95
72,65,1783,177,1606,42,1564,44,187,447,132,11,4,4,205,33,497
72,66,323,39,284,10,274,4,58,76,30,4,3,1,28,7,63
72,67,703,131,572,13,559,6,156,139,38,9,6,1,44,20,140
72,68,1081,151,930,25,905,17,157,317,101,11,6,2,70,19,205
72,69,133,11,122,1,121,0,39,29,6,4,0,1,12,1,29
72,70,191,28,163,7,156,2,24,58,20,2,0,1,9,1,39
72,71,3404,849,2555,63,2492,41,444,744,247,29,27,4,248,49,659
72,72,173,24,149,3,146,3,28,25,16,4,2,0,13,3,52
72,73,780,87,693,6,687,9,120,171,69,16,4,1,77,17,203
72,74,179,23,156,2,154,8,39,32,17,4,2,0,15,1,36
72,75,719,91,628,11,617,17,113,152,76,10,6,2,83,18,140
72,76,155,15,140,6,134,5,21,42,14,1,1,0,13,2,35
72,77,361,62,299,4,295,2,65,120,18,4,2,0,18,3,63
72,78,277,50,227,4,223,5,63,57,20,5,1,1,17,4,50
72,79,263,43,220,3,217,4,52,62,8,4,1,0,20,8,58
72,80,1291,164,1127,23,1104,19,223,359,87,9,8,4,120,35,240
72,81,717,80,637,11,626,12,119,176,59,14,8,5,83,20,130
72,82,496,90,406,9,397,8,90,88,48,3,5,1,43,12,99
72,83,286,28,258,13,245,5,43,68,33,5,3,0,23,12,53
72,84,867,125,742,16,726,17,145,181,66,5,5,2,64,27,214
72,85,172,28,144,3,141,3,35,50,15,1,0,1,10,10,16
72,86,125,16,109,2,107,0,17,44,10,1,1,0,13,5,16
72,87,434,68,366,10,356,2,90,86,40,6,7,2,26,9,88
72,88,253,30,223,9,214,6,65,63,19,1,0,0,18,5,37
72,89,1393,199,1194,24,1170,16,202,415,75,13,12,5,146,18,268
72,90,2051,304,1747,40,1707,12,335,476,190,22,11,4,123,50,484
72,91,130,8,122,2,120,3,17,40,14,0,0,0,14,5,27
72,93,762,137,625,15,610,11,160,155,50,3,9,2,67,14,139
72,94,462,76,386,8,378,9,82,112,54,1,3,1,30,7,79
72,95,4894,920,3974,84,3890,75,596,822,510,63,27,9,379,76,1333
72,96,1036,99,937,21,916,17,138,250,103,18,5,3,94,25,263
72,97,340,50,290,7,283,11,72,84,31,12,1,0,22,5,45
72,98,435,66,369,3,366,2,93,66,52,4,2,1,26,7,113
72,99,433,59,374,10,364,8,112,80,31,11,4,0,36,10,72
72,100,282,36,246,4,242,1,49,70,27,2,3,1,19,3,67
72,101,466,55,411,8,403,8,90,95,63,10,1,0,31,16,89
72,102,75,11,64,1,63,0,19,24,4,2,0,0,2,1,11
72,103,492,77,415,12,403,9,72,111,65,3,1,1,30,9,102
72,104,430,70,360,7,353,1,116,91,34,3,9,0,19,8,72
72,105,386,57,329,4,325,8,98,95,15,6,1,0,20,19,63
72,106,624,88,536,16,520,7,139,129,34,8,5,3,48,7,140
72,107,253,29,224,4,220,10,32,66,22,10,1,1,26,7,45
72,108,561,86,475,19,456,8,114,145,30,12,5,1,45,9,87
72,109,411,55,356,7,349,5,102,108,25,6,1,0,38,6,58
72,110,664,97,567,15,552,5,129,135,43,8,5,1,60,17,149
72,111,403,49,354,7,347,9,94,87,43,0,3,0,35,5,71
72,112,411,81,330,5,325,3,77,106,29,4,2,1,17,8,78
72,113,576,54,522,12,510,7,79,118,49,9,6,4,66,14,158
72,114,211,32,179,4,175,2,55,51,19,2,3,1,14,3,25
72,115,723,111,612,18,594,10,130,216,51,7,2,1,48,11,118
72,116,103,21,82,0,82,1,19,23,10,0,0,0,4,3,22
72,117,472,75,397,9,388,2,103,123,40,4,2,0,34,11,69
72,118,1040,184,856,20,836,11,204,209,96,29,9,0,75,13,190
72,119,768,78,690,16,674,17,108,209,82,8,4,1,58,14,173
72,120,155,24,131,2,129,3,34,29,7,1,1,1,11,2,40
72,121,251,36,215,3,212,2,70,61,14,3,0,1,23,9,29
72,122,759,119,640,14,626,7,180,169,45,9,8,5,43,10,150
72,123,56,6,50,3,47,0,9,20,2,0,0,0,6,2,8
72,124,3347,679,2668,57,2611,41,594,699,233,33,6,5,226,88,686
72,125,256,38,218,8,210,3,45,61,30,6,0,0,16,8,41
72,126,243,32,211,7,204,4,37,64,24,4,4,0,18,5,44
72,127,1637,167,1470,33,1437,12,267,309,184,21,10,0,135,24,475
72,128,295,64,231,9,222,2,46,68,29,3,2,1,19,9,43
72,129,588,97,491,12,479,4,112,141,43,6,5,3,47,16,102
72,130,471,63,408,9,399,16,49,119,39,4,2,2,48,8,112
72,131,400,43,357,4,353,5,93,46,49,4,2,0,32,5,117
72,132,6116,1336,4780,109,4671,68,893,1427,379,71,43,14,382,118,1276
72,133,1091,131,960,22,938,31,163,220,142,19,5,3,97,21,237
72,134,442,50,392,6,386,13,98,106,42,5,2,0,29,20,71
72,135,424,56,368,7,361,3,102,73,44,13,2,1,31,6,86
72,136,266,51,215,8,207,0,71,71,14,2,1,0,15,0,33
72,137,692,105,587,4,583,4,134,190,60,8,2,3,60,12,110
72,138,1687,384,1303,32,1271,20,228,425,104,21,13,3,106,30,321
72,139,731,100,631,16,615,7,172,165,48,10,2,2,58,13,138
72,141,685,100,585,16,569,9,138,142,61,13,4,2,69,8,123
72,142,138,25,113,4,109,1,31,34,3,4,1,2,10,0,23
72,143,1400,255,1145,31,1114,15,227,316,133,17,14,3,106,25,258
72,144,321,55,266,7,259,4,46,101,24,3,0,0,20,5,56
72,145,324,69,255,7,248,4,58,61,23,2,5,0,28,6,61
72,146,2126,312,1814,30,1784,26,392,397,212,20,13,4,130,53,537
72,147,843,145,698,20,678,5,129,171,84,16,5,5,63,13,187
72,148,88,15,73,0,73,6,13,14,15,2,0,0,5,3,15
72,149,428,60,368,3,365,4,89,113,33,4,7,1,39,9,66
72,150,976,137,839,25,814,19,185,191,91,14,4,1,90,8,211
72,151,876,121,755,20,735,19,142,247,67,9,6,6,74,21,144
72,152,369,47,322,10,312,2,60,117,19,4,3,0,31,8,68
72,153,503,94,409,9,400,17,66,110,50,2,1,0,46,14,94
72,154,10896,2227,8669,228,8441,176,1393,2388,754,120,75,17,812,162,2544
72,155,1720,195,1525,34,1491,35,259,407,163,26,13,6,149,29,404
72,156,677,97,580,13,567,8,149,142,49,11,7,3,51,20,127
72,157,555,42,513,9,504,8,92,156,46,6,3,1,38,19,135
72,158,593,91,502,9,493,5,126,125,67,6,6,1,37,11,109
72,159,307,49,258,6,252,5,40,69,29,4,4,2,18,9,72
72,160,465,62,403,8,395,13,130,89,41,4,1,1,27,6,83
72,161,736,97,639,14,625,12,135,142,70,6,11,4,35,13,197
72,162,290,45,245,1,244,4,58,73,20,4,0,1,20,10,54
72,163,316,33,283,6,277,3,67,78,26,8,2,1,22,7,63
72,164,64,3,61,3,58,0,8,19,6,0,1,0,7,0,17
72,165,1520,209,1311,25,1286,24,297,287,141,18,12,2,113,34,358
72,166,258,31,227,3,224,4,35,62,18,5,1,0,15,5,79
72,167,455,65,390,15,375,12,86,113,29,5,3,1,31,8,87
72,168,1483,213,1270,36,1234,16,265,403,70,16,4,0,133,33,294
72,169,1117,141,976,29,947,13,201,231,112,21,8,2,87,25,247
72,170,133,15,118,1,117,5,24,38,12,1,2,1,14,4,16
72,171,110,10,100,3,97,1,26,22,7,0,1,0,8,3,29
72,172,1039,158,881,21,860,13,212,234,72,17,14,3,60,26,209
72,173,955,111,844,22,822,13,168,221,81,15,6,1,80,24,213
72,174,91,18,73,2,71,2,16,21,6,0,0,0,7,2,17
72,175,1328,237,1091,42,1049,16,212,322,111,19,8,4,67,16,274
72,176,2969,509,2460,58,2402,26,505,731,212,30,25,6,198,56,613
72,177,259,35,224,4,220,6,47,62,26,7,1,1,15,11,44
72,178,141,25,116,2,114,1,31,35,17,1,1,0,8,4,16
72,179,1452,267,1185,28,1157,21,239,306,105,21,12,3,108,32,310
72,180,3964,961,3003,63,2940,44,618,845,236,40,17,2,230,79,829
72,181,95473,23021,72452,1958,70494,1850,9432,16803,9107,731,420,150,6628,1061,24312
72,182,1217,259,958,26,932,16,214,241,126,10,6,0,69,23,227
72,183,811,112,699,19,680,10,155,270,52,7,3,2,50,16,115
72,184,264,23,241,5,236,2,60,78,17,4,1,0,33,1,40
72,185,436,69,367,14,353,5,74,101,25,4,3,1,30,10,100
72,186,634,96,538,4,534,5,132,148,51,10,3,0,47,18,120
72,187,1170,174,996,25,971,18,224,209,95,12,8,4,91,17,293
72,188,114,10,104,1,103,1,22,19,7,0,1,1,15,1,36
72,189,1598,274,1324,47,1277,16,289,395,69,29,20,2,108,35,314
72,190,236,33,203,5,198,5,38,40,24,6,0,0,20,3,62
72,191,2349,347,2002,53,1949,32,482,537,187,20,16,7,130,58,480
72,192,102,16,86,3,83,0,18,32,3,3,1,0,10,1,15
72,193,387,75,312,2,310,1,71,119,21,4,2,1,29,6,56
72,194,206,26,180,2,178,9,60,36,14,4,1,0,15,2,37
72,195,1263,162,1101,30,1071,16,290,224,110,16,8,1,85,23,298
72,196,465,71,394,11,383,4,85,101,38,4,6,2,32,10,101
72,197,437,58,379,12,367,5,78,94,64,5,3,0,30,6,82
72,198,1889,270,1619,32,1587,35,258,451,149,24,2,2,180,47,439
72,199,177,23,154,1,153,5,41,35,15,5,0,0,14,4,34
72,200,2458,334,2124,41,2083,31,426,441,240,32,18,6,197,49,643
72,201,199,26,173,4,169,4,57,37,16,5,1,1,15,4,29
72,202,190,33,157,4,153,3,39,43,16,1,1,0,16,4,30
72,203,598,79,519,7,512,11,104,124,70,8,6,0,42,12,135
72,204,450,81,369,14,355,5,81,105,27,5,6,0,46,6,74
72,205,1225,209,1016,24,992,19,221,199,115,10,6,3,92,20,307
72,207,37,1,36,0,36,0,6,15,1,1,0,0,4,1,8
72,208,344,74,270,1,269,11,59,106,13,0,0,0,28,2,50
72,209,242,32,210,4,206,3,61,53,12,3,4,1,17,6,46
72,210,207,42,165,4,161,6,46,40,18,2,0,0,4,2,43
72,211,565,119,446,10,436,7,99,155,25,10,4,0,50,8,78
72,212,575,80,495,10,485,12,100,97,63,4,1,1,62,15,130
72,213,3685,581,3104,79,3025,43,613,582,399,35,30,4,270,61,988
72,214,16,3,13,1,12,0,4,6,0,0,0,0,2,0,0
72,215,644,79,565,8,557,12,143,163,47,12,9,0,33,20,118
72,216,434,65,369,4,365,8,70,107,29,6,4,0,31,14,96
72,217,1837,162,1675,28,1647,36,257,492,143,13,12,3,155,41,495
72,218,222,39,183,8,175,7,43,47,10,3,2,0,19,11,33
72,219,284,37,247,7,240,12,45,67,32,5,2,0,36,3,38
72,220,693,149,544,14,530,5,114,168,58,9,0,1,39,7,129
72,221,331,64,267,7,260,8,64,77,21,2,2,0,18,0,68
72,222,221,45,176,2,174,3,45,51,12,4,0,0,12,5,42
72,223,1881,308,1573,30,1543,16,320,466,144,24,18,4,153,28,370
72,224,366,49,317,6,311,9,72,61,40,5,5,0,24,8,87
72,225,447,70,377,10,367,10,80,109,35,4,2,0,26,12,89
72,226,779,79,700,27,673,12,166,127,107,10,7,3,48,20,173
72,227,35,2,33,0,33,0,6,10,3,3,0,0,1,1,9
72,228,1572,260,1312,23,1289,18,284,375,113,22,8,1,116,29,323
72,229,349,70,279,5,274,4,76,78,29,2,2,0,31,9,43
72,230,743,72,671,10,661,15,157,142,57,10,6,4,70,11,189
72,231,3574,541,3033,68,2965,57,675,820,300,35,14,3,282,59,720
72,232,366,48,318,9,309,7,98,64,28,6,1,1,18,11,75
72,233,60,9,51,0,51,2,7,15,3,0,1,0,9,0,14
72,234,304,53,251,7,244,4,57,61,22,5,1,1,30,6,57
72,235,253,34,219,6,213,1,44,59,22,2,1,2,33,7,42
72,236,149,14,135,2,133,2,18,64,12,1,0,0,13,4,19
72,237,343,49,294,3,291,6,73,59,29,3,2,2,28,11,78
72,238,81,13,68,2,66,1,22,24,4,0,0,0,5,0,10
72,239,453,46,407,11,396,3,107,101,38,10,2,1,43,11,80
72,240,338,48,290,3,287,7,68,76,23,2,4,1,26,7,73
72,241,2112,286,1826,33,1793,26,394,437,166,31,10,4,129,42,554
72,243,1129,154,975,22,953,17,219,216,112,11,13,1,74,22,268
72,244,2019,292,1727,58,1669,24,379,592,123,24,15,3,155,48,306
72,245,479,68,411,13,398,5,96,94,37,5,4,2,28,10,117
72,246,162,24,138,4,134,4,41,27,18,2,4,0,10,5,23
72,247,965,109,856,24,832,19,108,205,97,13,2,1,89,28,270
72,248,592,65,527,16,511,13,112,114,75,12,3,0,43,17,122
72,249,564,70,494,12,482,5,100,137,49,7,6,0,57,6,115
72,250,171,30,141,2,139,3,37,54,7,0,1,0,15,3,19
72,251,264,42,222,3,219,3,58,71,16,3,0,0,13,6,49
72,252,883,98,785,15,770,12,215,138,108,11,9,1,52,9,215
72,253,1957,299,1658,36,1622,26,293,358,185,18,14,7,179,47,495
72,254,168,20,148,1,147,2,44,55,9,1,0,0,12,1,23
72,255,644,148,496,7,489,7,117,138,30,8,5,3,35,11,135
72,256,573,99,474,10,464,6,99,173,35,4,2,0,39,14,92
72,257,1722,181,1541,31,1510,37,182,419,152,16,2,3,194,38,467
72,258,202,31,171,5,166,3,41,57,14,1,1,0,18,4,27
72,259,234,26,208,5,203,6,62,51,16,1,2,0,18,4,43
72,260,2576,334,2242,32,2210,36,418,536,241,21,8,4,240,53,653
72,261,245,30,215,3,212,6,35,78,23,5,0,1,25,1,38
72,262,966,114,852,10,842,11,153,320,92,12,7,2,62,19,164
72,264,8270,1976,6294,165,6129,122,962,2041,509,77,58,12,585,108,1655
72,265,198,29,169,2,167,4,42,39,14,0,4,0,13,1,50
72,266,535,76,459,8,451,5,110,107,50,6,2,1,37,17,116
72,267,703,101,602,18,584,4,136,138,58,10,6,1,63,13,155
72,268,440,46,394,4,390,6,104,83,37,7,5,3,49,8,88
72,269,2304,454,1850,46,1804,17,318,523,156,39,28,5,171,34,513
72,270,154,16,138,1,137,1,35,45,11,1,0,1,18,4,21
72,271,495,61,434,14,420,7,117,95,39,11,2,0,40,16,93
72,272,281,38,243,14,229,2,42,74,33,4,1,2,18,7,46
72,273,175,17,158,5,153,2,33,42,13,1,2,0,14,4,42
72,274,144,14,130,5,125,1,30,54,4,1,1,0,10,5,19
72,275,829,110,719,22,697,8,143,201,63,9,6,1,61,22,183
72,276,1608,257,1351,32,1319,11,321,346,109,19,14,3,81,38,377
72,277,102,11,91,0,91,4,24,24,11,0,1,0,9,3,15
72,278,624,118,506,14,492,10,119,176,38,6,3,1,57,24,58
72,279,144,24,120,2,118,2,24,25,15,1,1,1,9,7,33
72,280,1584,229,1355,36,1319,21,213,256,173,14,13,4,136,17,472
72,281,322,50,272,8,264,1,84,60,17,6,2,1,15,8,70
72,282,396,80,316,4,312,7,57,116,23,4,3,1,27,6,68
72,283,294,42,252,8,244,3,48,86,22,7,4,0,17,7,50
72,284,404,58,346,6,340,9,102,99,21,6,1,1,28,2,71
72,286,331,43,288,12,276,4,64,77,38,4,3,1,14,9,62
72,287,1651,214,1437,29,1408,32,242,311,179,19,12,5,148,30,430
72,288,107,18,89,2,87,1,28,25,7,6,1,0,6,1,12
72,289,1463,190,1273,45,1228,16,262,241,153,12,13,4,83,24,420
72,290,1029,117,912,25,887,23,209,229,77,12,12,2,88,23,212
72,291,704,98,606,10,596,8,140,137,57,12,3,1,80,17,141
72,292,195,37,158,2,156,3,23,75,10,0,2,0,11,6,26
72,293,415,55,360,10,350,5,105,61,42,8,5,1,28,3,92
72,294,396,68,328,10,318,11,73,97,26,2,7,2,26,13,61
72,295,483,58,425,9,416,6,93,113,43,4,1,2,37,13,104
72,296,610,93,517,13,504,12,121,153,52,9,8,0,52,7,90
72,297,405,48,357,9,348,7,80,82,44,4,3,0,24,5,99
72,298,398,45,353,5,348,4,88,88,46,3,2,1,20,11,85
72,299,1669,238,1431,36,1395,28,336,346,166,18,10,3,127,46,315
72,300,1852,292,1560,30,1530,19,359,328,218,19,17,5,132,32,401
72,301,607,72,535,17,518,16,118,139,52,9,7,1,39,12,125
72,302,156,25,131,6,125,4,41,20,18,1,1,0,11,7,22
72,303,571,110,461,10,451,4,105,112,73,10,6,0,40,7,94
72,304,159,25,134,3,131,3,18,33,20,4,0,1,10,5,37
72,305,688,92,596,23,573,8,145,151,43,8,7,1,42,12,156
72,306,903,143,760,21,739,11,173,162,84,22,8,0,65,11,203
72,307,151,18,133,3,130,3,29,29,10,0,4,0,19,4,32
72,308,1178,162,1016,23,993,10,150,287,92,8,4,3,110,23,306
72,309,232,46,186,2,184,1,41,55,17,4,0,1,17,6,42
72,310,1604,181,1423,36,1387,31,121,490,117,16,6,3,161,27,415
72,311,288,41,247,6,241,2,62,75,21,4,1,0,19,3,54
72,312,151,18,133,3,130,0,34,45,8,1,0,0,15,6,21
72,313,190,28,162,1,161,3,38,38,18,2,2,0,18,3,39
72,314,287,36,251,6,245,11,55,53,30,6,5,0,24,4,57
72,315,643,108,535,22,513,14,94,153,44,9,7,1,47,13,131
72,316,569,73,496,9,487,5,109,138,41,8,10,0,28,21,127
72,317,439,63,376,12,364,4,93,114,29,4,2,0,41,4,73
72,318,340,50,290,7,283,6,61,85,24,5,1,2,23,5,71
72,319,504,60,444,7,437,6,94,108,51,9,0,1,33,10,125
72,320,1708,191,1517,27,1490,30,235,388,141,11,10,6,184,41,444
72,321,409,46,363,12,351,6,86,117,29,3,5,1,37,7,60
72,322,198,27,171,1,170,2,40,72,13,1,0,1,8,2,31
72,323,273,36,237,12,225,1,67,71,12,4,3,0,21,2,44
72,324,387,67,320,11,309,2,87,90,24,5,1,2,24,15,59
72,325,656,111,545,17,528,9,130,124,58,9,3,2,58,15,120
72,326,166,21,145,3,142,5,35,40,13,0,2,1,12,4,30
72,327,253,34,219,7,212,1,38,68,36,2,2,0,18,3,44
72,328,3124,480,2644,57,2587,51,322,791,219,18,10,6,301,39,830
72,329,3411,557,2854,79,2775,56,499,861,201,25,18,5,271,67,772
72,330,350,61,289,3,286,8,92,69,36,5,0,0,28,8,40
72,331,402,56,346,6,340,3,71,94,28,2,6,0,33,6,97
72,332,487,77,410,10,400,12,73,109,59,11,4,1,34,11,86
72,333,365,50,315,9,306,1,108,75,30,4,5,0,23,7,53
72,334,1693,385,1308,33,1275,21,226,451,89,30,7,2,133,33,283
72,335,831,114,717,11,706,12,152,216,71,10,5,1,60,18,161
72,336,1114,119,995,9,986,25,118,469,45,5,7,1,117,18,181
72,337,643,94,549,15,534,9,131,134,46,9,5,1,52,12,135
72,338,464,44,420,11,409,2,102,80,42,10,3,1,40,7,122
72,339,526,67,459,7,452,10,101,103,58,3,3,2,27,12,133
72,340,856,100,756,20,736,15,145,167,74,12,3,2,77,20,221
72,341,459,55,404,8,396,13,113,98,42,9,2,0,30,5,84
72,342,164,20,144,4,140,3,30,28,15,1,1,0,18,7,37
72,343,462,66,396,11,385,7,88,116,35,2,1,0,36,5,95
72,344,2334,337,1997,45,1952,43,387,433,260,24,12,5,209,30,549
72,345,250,27,223,8,215,5,62,26,28,3,1,1,16,1,72
72,346,3207,523,2684,63,2621,51,544,593,299,35,22,8,241,44,784
72,347,213,23,190,7,183,4,46,63,16,3,3,2,17,6,23
72,348,105,13,92,4,88,0,18,28,7,2,3,0,10,1,19
72,349,397,60,337,12,325,7,77,87,54,7,1,0,14,12,66
72,350,2241,257,1984,48,1936,33,429,489,208,27,11,2,176,49,512
72,351,743,117,626,23,603,23,143,193,49,4,4,2,76,4,105
72,352,103,25,78,2,76,1,23,23,8,0,0,0,3,5,13
72,353,187,26,161,5,156,2,43,42,11,5,0,0,11,3,39
72,354,134,23,111,3,108,2,23,40,5,2,0,0,10,2,24
72,355,76,10,66,0,66,1,27,19,3,1,0,0,2,0,13
72,356,326,54,272,9,263,6,68,66,29,2,2,0,21,4,65
72,357,537,82,455,19,436,7,123,82,44,10,8,0,50,8,104
72,358,1135,160,975,28,947,17,220,269,95,20,12,1,86,18,209
72,359,950,172,778,19,759,3,199,184,87,13,7,4,48,20,194
72,360,993,121,872,21,851,20,124,188,116,11,7,1,85,28,271
72,361,372,49,323,11,312,11,63,89,40,7,0,0,19,8,75
72,362,105,9,96,1,95,5,19,31,9,0,0,0,9,1,21
72,363,1252,244,1008,26,982,17,207,318,85,22,6,2,73,29,223
72,364,1229,193,1036,37,999,16,257,299,103,17,7,2,70,27,201
72,366,301,53,248,3,245,4,62,81,11,1,1,2,33,2,48
72,367,532,82,450,13,437,5,87,152,46,6,5,2,33,5,96
72,368,273,39,234,10,224,1,64,66,20,3,2,2,16,4,46
72,369,455,74,381,7,374,12,107,82,40,8,4,0,30,3,88
72,370,238,40,198,4,194,3,39,54,31,1,4,2,19,3,38
72,372,59,6,53,1,52,4,16,12,4,0,0,0,6,2,8
72,373,1921,259,1662,60,1602,17,314,525,112,28,21,3,153,44,385
72,374,150,19,131,4,127,4,28,44,10,2,1,1,12,3,22
72,375,406,48,358,9,349,6,76,102,27,6,5,2,42,12,71
72,376,502,62,440,18,422,9,100,126,44,9,3,0,44,11,76
72,377,735,95,640,22,618,1,140,180,61,14,7,0,40,21,154
72,378,983,117,866,31,835,13,200,245,87,14,7,4,51,24,190
72,379,155,24,131,0,131,2,30,41,15,1,1,2,14,4,21
72,380,705,92,613,12,601,9,140,178,47,8,4,0,49,8,158
72,381,840,95,745,13,732,9,165,151,108,8,6,0,51,15,219
72,382,624,94,530,15,515,3,159,107,56,16,8,3,32,12,119
72,383,86,9,77,4,73,0,17,12,13,4,0,0,10,3,14
72,384,628,103,525,13,512,8,107,123,72,9,3,0,52,18,120
72,385,1428,227,1201,32,1169,9,264,243,145,15,7,2,95,30,359
72,386,3499,484,3015,49,2966,51,376,915,293,17,11,7,278,57,961
73,1,232,14,218,2,216,8,37,88,16,1,0,0,20,2,44
73,2,666,137,529,8,521,8,143,106,86,8,2,0,28,15,125
73,3,2426,390,2036,44,1992,41,401,524,239,38,11,5,195,50,488
73,4,374,55,319,10,309,9,58,81,45,7,2,1,25,8,73
73,5,167,30,137,4,133,3,22,23,20,4,1,0,13,6,41
73,6,3038,514,2524,47,2477,85,379,809,286,32,17,7,265,68,529
73,7,794,118,676,11,665,16,230,127,86,6,2,1,43,27,127
73,8,20525,4596,15929,276,15653,501,2636,5332,1379,138,58,52,1609,291,3657
73,10,2460,347,2113,44,2069,53,475,640,160,26,12,4,226,50,423
73,11,11180,2678,8502,175,8327,221,1655,2220,1078,105,48,15,707,154,2124
73,12,136,33,103,1,102,11,13,26,14,3,0,0,9,0,26
73,13,477,95,382,6,376,6,83,85,50,12,0,0,38,11,91
73,14,179,34,145,3,142,4,31,35,16,0,0,3,26,6,21
73,15,1405,270,1135,28,1107,56,186,540,76,8,2,2,81,35,121
73,17,812,94,718,10,708,21,149,254,48,4,6,0,76,17,133
73,18,580,65,515,4,511,18,89,157,70,6,2,1,51,9,108
73,19,708,96,612,17,595,18,130,87,129,8,8,0,51,13,151
73,20,337,43,294,9,285,18,54,98,37,0,0,1,24,6,47
73,21,667,119,548,10,538,27,114,133,64,12,1,3,30,13,141
73,22,469,79,390,5,385,13,67,94,62,10,3,3,57,5,71
73,23,564,92,472,5,467,30,67,133,52,6,6,0,39,20,114
73,24,664,108,556,12,544,21,91,233,44,5,5,0,54,17,74
73,25,362,48,314,5,309,3,60,84,37,3,1,0,36,16,69
73,26,304,28,276,4,272,5,78,52,40,4,2,0,16,8,67
73,27,251,27,224,6,218,4,43,65,26,4,2,0,34,0,40
73,28,247,30,217,3,214,5,55,70,16,0,2,0,13,6,47
73,29,3438,518,2920,40,2880,113,405,909,282,30,11,11,331,60,728
73,30,1957,297,1660,32,1628,54,243,404,194,11,7,2,182,24,507
73,31,2759,472,2287,42,2245,77,432,654,242,26,9,3,198,66,538
73,32,1637,290,1347,22,1325,22,329,244,278,20,8,4,81,33,306
73,33,290,37,253,6,247,14,55,54,36,7,1,0,26,4,50
73,34,1740,195,1545,23,1522,56,230,487,157,23,12,7,208,38,304
73,36,550,85,465,10,455,23,74,120,68,5,1,2,56,9,97
73,38,841,114,727,19,708,38,122,268,92,6,3,2,56,17,104
73,39,436,56,380,5,375,11,63,94,38,3,2,2,47,18,97
73,40,387,70,317,6,311,10,65,96,33,4,1,0,20,10,72
73,41,227,33,194,6,188,2,49,53,18,3,0,0,24,1,38
73,42,235,27,208,8,200,21,39,53,21,1,1,0,15,7,42
73,43,1659,245,1414,38,1376,61,283,327,126,11,1,4,174,25,364
73,45,276,43,233,5,228,13,44,55,22,2,4,2,20,2,64
73,46,128,31,97,0,97,4,24,20,11,2,0,1,10,2,23
73,47,223,52,171,14,157,5,24,58,22,4,0,2,25,4,13
73,48,246,37,209,8,201,7,60,30,26,2,1,0,18,3,54
73,49,134,31,103,0,103,4,15,17,24,1,0,0,10,4,28
73,50,412,45,367,7,360,15,45,146,22,3,0,2,48,9,70
73,51,2935,416,2519,38,2481,96,358,839,279,16,3,11,271,56,552
73,52,129,7,122,4,118,4,19,42,22,2,2,0,13,8,6
73,53,456,64,392,6,386,9,105,87,58,4,4,1,27,13,78
73,54,5007,1075,3932,105,3827,188,619,1319,423,75,20,17,377,88,701
73,55,1553,306,1247,31,1216,53,146,429,157,16,8,2,113,26,266
73,56,449,79,370,5,365,18,79,111,57,5,0,1,39,8,47
73,57,416,62,354,4,350,12,63,154,29,3,2,0,32,8,47
73,58,887,177,710,26,684,26,127,154,105,9,6,5,57,18,177
73,59,1787,240,1547,28,1519,59,250,533,98,7,4,1,177,30,360
73,61,291,36,255,6,249,10,52,58,30,5,4,0,28,7,55
73,62,322,46,276,5,271,14,70,70,26,7,0,0,49,4,31
73,63,552,92,460,8,452,13,113,84,115,4,2,0,35,6,80
73,64,3762,574,3188,66,3122,101,509,1043,269,31,14,5,399,65,686
73,65,32502,6221,26281,490,25791,1084,3552,6416,3553,318,114,59,2451,395,7849
73,67,829,146,683,16,667,14,158,184,69,5,6,2,59,12,158
73,68,406,50,356,11,345,1,92,75,42,5,3,2,29,13,83
73,69,657,108,549,8,541,15,123,111,94,8,1,1,46,12,130
73,70,431,62,369,3,366,7,111,88,41,4,1,3,17,6,88
73,71,612,86,526,10,516,17,65,200,69,6,3,1,34,8,113
73,72,55,14,41,0,41,2,4,18,4,2,0,0,6,0,5
73,73,407,71,336,7,329,7,66,82,40,3,1,1,32,10,87
73,74,280,39,241,6,235,5,56,39,64,7,0,2,12,4,46
73,75,444,52,392,6,386,9,58,107,46,7,1,3,47,3,105
73,76,178,22,156,2,154,11,21,29,19,4,1,0,18,4,47
73,77,446,86,360,9,351,14,66,102,39,1,2,2,29,11,85
73,78,113,18,95,0,95,4,14,19,10,0,0,2,15,2,29
73,79,614,89,525,14,511,28,93,112,77,8,5,3,40,11,134
73,80,173,36,137,3,134,5,24,41,17,3,0,0,10,2,32
73,81,452,66,386,12,374,19,67,113,56,8,2,1,37,6,65
73,82,453,60,393,11,382,14,86,88,41,9,0,2,38,8,96
73,83,192,27,165,3,162,1,59,48,14,2,1,1,5,0,31
73,84,692,93,599,9,590,11,128,190,41,5,2,1,87,16,109
73,85,1005,148,857,20,837,24,163,258,76,12,3,3,71,22,205
73,86,354,64,290,8,282,19,79,61,34,2,0,0,35,10,42
73,87,4251,782,3469,67,3402,132,621,802,430,37,19,8,331,50,972
73,88,166,26,140,2,138,4,28,57,10,2,1,0,13,5,18
73,89,952,128,824,24,800,39,158,176,153,9,1,3,65,17,179
73,90,217,40,177,5,172,5,36,66,20,1,0,4,13,0,27
73,91,172,1,171,29,142,3,21,42,14,3,0,1,22,3,33
73,92,131,20,111,0,111,15,31,19,9,1,0,1,12,3,20
73,93,638,115,523,4,519,30,88,152,54,1,3,1,54,13,123
73,94,372,41,331,8,323,18,48,164,10,1,0,0,36,9,37
73,95,229,16,213,1,212,7,48,57,26,2,2,1,10,5,54
73,96,838,117,721,16,705,23,128,169,103,11,0,1,74,25,171
73,97,561,63,498,11,487,38,85,89,60,10,4,3,64,11,123
73,98,683,97,586,10,576,38,118,141,97,7,2,1,52,6,114
73,99,303,52,251,5,246,9,51,70,43,2,0,1,19,4,47
73,100,1395,215,1180,19,1161,28,245,347,109,9,9,5,133,30,246
73,101,95,15,80,1,79,5,4,22,19,4,2,0,8,1,14
73,103,1889,227,1662,32,1630,58,273,470,145,13,7,2,184,37,441
73,104,294,38,256,10,246,8,45,65,24,1,4,0,35,8,56
73,105,832,119,713,14,699,16,208,159,89,13,2,5,61,24,122
73,106,239,42,197,4,193,9,36,55,20,1,3,2,17,7,43
73,107,568,108,460,8,452,48,69,118,48,2,5,1,54,8,99
73,108,309,46,263,3,260,17,47,64,30,2,2,0,23,6,69
73,109,587,110,477,6,471,3,116,102,65,2,3,1,26,9,144
73,110,591,111,480,9,471,20,132,94,79,5,1,2,41,12,85
73,111,262,31,231,5,226,4,60,46,26,3,6,4,15,7,55
73,112,452,54,398,6,392,8,108,55,88,4,4,1,21,11,92
73,113,131,13,118,1,117,2,11,36,18,2,0,0,15,2,31
73,114,612,91,521,7,514,17,126,190,30,10,1,0,67,18,55
73,115,124,21,103,3,100,7,13,25,10,2,4,0,7,3,29
73,116,607,86,521,6,515,15,106,237,35,5,0,0,30,8,79
73,117,550,103,447,12,435,10,69,111,45,4,3,2,27,8,156
73,118,627,71,556,9,547,20,82,153,55,12,9,2,38,13,163
73,119,93,14,79,3,76,0,15,9,9,0,0,1,7,8,27
73,120,379,71,308,4,304,9,65,94,31,5,0,1,32,6,61
73,121,1067,154,913,21,892,26,205,201,107,12,3,1,66,27,244
73,122,337,72,265,4,261,6,45,74,31,1,2,2,30,4,66
73,123,374,59,315,10,305,14,55,115,20,2,1,1,54,14,29
73,124,2276,306,1970,33,1937,43,385,556,201,19,8,5,203,38,479
73,126,317,56,261,4,257,21,20,77,34,2,2,1,34,1,65
73,127,261,47,214,5,209,10,47,37,30,3,1,0,27,3,51
73,128,2947,409,2538,56,2482,86,521,687,249,18,9,10,302,67,533
73,129,854,128,726,12,714,25,190,166,92,12,7,1,50,15,156
73,130,1461,238,1223,41,1182,29,326,216,172,17,8,5,96,24,289
73,131,246,47,199,6,193,12,26,55,37,1,2,1,17,1,41
73,132,763,129,634,8,626,20,166,200,38,2,4,2,73,17,104
73,133,261,18,243,11,232,10,45,46,40,2,4,1,16,3,65
73,135,451,58,393,9,384,5,84,127,25,3,2,1,36,18,83
73,137,2274,403,1871,30,1841,80,192,598,191,18,9,2,199,30,522
73,138,438,45,393,15,378,15,74,101,43,0,1,5,30,7,102
73,139,261,42,219,4,215,9,24,50,43,3,0,0,29,4,53
73,140,210,24,186,5,181,0,46,63,10,3,0,0,13,4,42
73,141,489,107,382,11,371,12,100,90,46,3,1,0,30,5,84
73,142,563,85,478,9,469,36,69,110,65,18,7,1,46,16,101
73,143,513,56,457,6,451,11,54,209,34,7,9,3,50,7,67
73,144,392,68,324,7,317,19,53,112,22,6,1,3,42,17,42
73,145,364,49,315,7,308,10,67,100,42,4,1,0,22,1,61
73,146,495,79,416,11,405,18,65,99,69,4,4,0,42,6,98
73,147,167,33,134,4,130,3,40,21,16,1,0,0,11,3,35
73,149,247,32,215,8,207,7,58,51,24,3,4,0,10,2,48
73,150,1678,294,1384,34,1350,50,202,528,119,30,14,3,156,37,211
73,151,1773,251,1522,31,1491,61,295,399,143,15,2,4,152,39,381
73,152,159,24,135,1,134,6,23,38,16,1,0,1,15,2,32
73,153,1143,199,944,19,925,29,231,200,135,10,7,1,79,22,211
73,154,2269,297,1972,52,1920,57,366,539,232,26,3,5,206,34,452
73,155,1160,130,1030,17,1013,31,214,296,87,4,3,4,135,13,226
73,156,267,38,229,3,226,9,44,74,14,3,3,1,34,5,39
73,157,2114,470,1644,35,1609,48,320,403,158,25,9,1,150,48,447
73,158,348,51,297,12,285,9,68,77,24,5,0,3,26,9,64
73,159,533,83,450,6,444,11,109,86,65,13,8,1,26,12,113
73,160,697,63,634,12,622,28,113,221,51,6,3,6,70,15,109
73,161,527,101,426,11,415,11,79,155,27,5,2,1,35,4,96
73,162,497,70,427,10,417,8,99,92,57,8,3,0,37,11,102
73,163,184,40,144,3,141,5,35,46,11,0,0,0,15,0,29
73,164,696,84,612,11,601,25,136,208,58,6,4,3,53,12,96
73,166,49,10,39,0,39,1,8,8,10,2,1,0,4,0,5
73,167,143,41,102,2,100,4,14,45,13,0,0,0,5,1,18
73,168,111,22,89,2,87,1,25,13,28,0,0,0,6,0,14
73,169,394,73,321,6,315,7,70,90,37,4,0,0,29,14,64
73,170,413,77,336,7,329,9,82,62,68,7,1,0,22,8,70
73,171,2323,403,1920,41,1879,60,353,379,270,24,16,3,113,30,631
73,173,473,63,410,5,405,11,89,71,49,7,2,3,39,11,123
73,175,155,30,125,1,124,7,22,31,18,1,0,0,14,3,28
73,176,578,95,483,11,472,34,61,212,26,5,3,1,59,20,51
73,177,208,19,189,1,188,6,35,28,19,5,1,3,37,2,52
73,178,347,63,284,4,280,25,40,60,60,4,2,1,12,5,71
73,179,8291,1047,7244,112,7132,208,1278,2188,717,74,21,19,918,116,1593
73,180,336,42,294,8,286,2,55,72,41,6,2,0,27,9,72
73,181,1921,476,1445,37,1408,32,273,454,172,17,4,3,113,20,320
73,182,1667,203,1464,33,1431,44,244,444,121,15,2,3,189,41,328
73,183,861,77,784,15,769,25,170,246,61,5,3,5,84,9,161
73,184,371,41,330,5,325,5,66,96,33,2,0,2,31,9,81
73,186,468,89,379,6,373,9,70,177,21,1,2,1,40,5,47
73,187,1613,312,1301,35,1266,36,262,299,232,25,10,2,99,20,281
73,188,701,101,600,14,586,18,169,138,57,7,2,4,45,5,141
73,189,133,22,111,1,110,3,26,30,13,0,0,1,7,5,25
73,190,270,56,214,11,203,3,42,66,24,7,0,0,19,3,39
73,191,1417,215,1202,26,1176,47,211,360,110,11,3,3,136,28,267
73,192,168,21,147,3,144,10,35,21,25,0,4,0,15,4,30
73,193,77,11,66,1,65,0,12,22,12,0,0,0,4,3,12
73,194,348,67,281,11,270,14,64,52,28,4,4,1,25,8,70
73,196,579,102,477,7,470,13,108,130,59,6,1,1,50,10,92
73,197,527,97,430,5,425,23,29,163,48,8,1,0,65,11,77
73,198,308,64,244,11,233,13,42,77,22,4,0,0,24,3,48
73,200,395,46,349,10,339,8,61,65,36,4,2,1,52,8,102
73,201,345,80,265,6,259,2,58,77,34,7,6,0,17,2,56
73,202,306,25,281,2,279,11,44,72,46,5,2,0,33,4,62
73,203,375,72,303,3,300,8,81,51,38,4,2,2,22,8,84
73,204,1208,255,953,19,934,15,210,245,101,6,6,4,84,25,238
73,205,139,15,124,3,121,3,32,20,19,1,4,0,10,2,30
73,206,609,111,498,4,494,14,50,233,43,7,2,1,42,13,89
73,207,365,44,321,5,316,18,82,68,32,8,5,1,32,5,65
73,208,689,64,625,4,621,31,89,220,51,4,4,1,78,9,134
73,210,312,26,286,7,279,8,73,76,26,1,1,0,38,4,52
73,211,682,100,582,17,565,12,114,121,101,12,2,2,55,14,132
73,212,614,100,514,15,499,8,141,100,92,12,1,2,29,15,99
73,213,5513,809,4704,90,4614,159,801,1265,472,46,18,15,528,92,1218
73,214,177,20,157,1,156,3,32,64,16,3,1,0,10,7,20
73,215,2374,471,1903,30,1873,39,398,475,225,22,14,5,162,49,484
73,216,290,41,249,5,244,7,81,50,36,1,3,0,13,7,46
73,217,212,25,187,3,184,2,50,30,23,2,1,0,11,3,62
73,218,657,102,555,9,546,21,110,138,63,8,1,1,68,14,122
73,219,467,56,411,5,406,24,52,109,49,2,5,0,56,14,95
73,220,324,43,281,3,278,7,58,54,62,7,0,2,24,1,63
73,221,163,27,136,0,136,4,32,27,22,1,0,0,6,2,42
73,222,4373,698,3675,76,3599,126,644,988,393,40,8,4,384,76,936
73,223,419,60,359,2,357,6,80,92,41,2,5,0,22,12,97
73,224,543,69,474,13,461,10,127,135,43,6,3,0,33,10,94
73,225,2197,272,1925,28,1897,70,362,496,181,17,8,5,232,43,483
73,226,1211,202,1009,17,992,16,278,227,153,12,8,2,58,25,213
73,227,1545,24,1521,269,1252,45,147,708,75,4,4,4,102,30,133
73,228,596,64,532,15,517,12,107,160,49,3,1,0,48,8,129
73,229,361,53,308,6,302,9,104,55,37,2,2,0,36,5,52
73,230,308,75,233,5,228,7,25,78,17,3,2,3,17,6,70
73,231,942,183,759,21,738,12,190,166,108,7,6,1,56,9,183
73,232,645,138,507,18,489,9,73,172,60,8,5,2,51,11,98
73,233,142,26,116,2,114,10,25,20,20,7,0,0,14,4,14
73,234,150,26,124,0,124,12,22,37,12,0,0,1,6,2,32
73,235,204,37,167,1,166,6,21,76,18,3,0,0,15,8,19
73,236,1527,248,1279,29,1250,28,265,392,121,12,2,2,126,21,281
73,237,275,54,221,1,220,6,33,34,81,4,3,2,9,1,47
73,238,326,50,276,4,272,11,39,82,37,2,1,0,25,7,68
73,239,487,101,386,8,378,9,86,131,28,5,1,1,46,13,58
73,240,585,76,509,2,507,21,104,109,62,6,4,0,47,13,141
73,241,838,144,694,22,672,18,199,152,63,5,5,0,62,11,157
73,242,263,67,196,4,192,18,41,66,16,2,4,0,14,0,31
73,243,1235,186,1049,18,1031,53,167,239,155,13,4,1,118,11,270
73,244,439,83,356,6,350,15,53,105,35,6,1,0,44,11,80
73,245,571,77,494,10,484,22,116,133,52,7,3,3,46,5,97
73,246,175,14,161,4,157,4,36,28,17,4,0,0,8,9,51
73,247,709,93,616,10,606,25,103,128,98,7,6,0,54,5,180
73,248,5036,1072,3964,82,3882,83,806,1035,425,47,23,12,328,88,1035
73,249,852,98,754,8,746,22,165,224,87,8,3,1,72,15,149
73,250,1249,150,1099,16,1083,28,283,185,152,10,8,3,66,16,332
73,252,204,23,181,4,177,1,55,32,27,0,2,2,17,2,39
73,253,462,82,380,13,367,5,95,69,84,4,1,3,24,4,78
73,254,118,8,110,2,108,1,32,30,13,0,4,0,7,2,19
73,255,630,88,542,5,537,4,135,131,85,9,3,0,36,12,122
73,256,266,54,212,7,205,1,53,37,23,2,4,0,17,10,58
73,257,2104,319,1785,29,1756,58,206,844,150,16,6,3,163,34,276
73,258,561,77,484,5,479,12,84,60,71,18,2,4,60,2,166
73,259,384,55,329,9,320,6,72,83,32,5,3,2,33,7,77
73,260,164,12,152,6,146,10,24,30,27,1,2,0,15,3,34
73,261,1934,353,1581,36,1545,36,392,353,158,32,13,3,108,31,419
73,262,382,65,317,7,310,11,66,128,13,5,0,0,41,14,32
73,263,507,70,437,6,431,20,86,113,55,7,3,0,69,5,73
73,264,233,38,195,4,191,8,41,51,11,5,1,1,25,3,45
73,265,433,64,369,4,365,20,65,91,41,8,0,1,55,9,75
73,266,168,25,143,3,140,2,40,42,18,3,2,2,14,2,15
73,267,280,32,248,11,237,3,49,81,16,0,0,2,30,6,50
73,268,368,75,293,11,282,2,81,47,59,4,2,2,21,5,59
73,269,495,49,446,11,435,15,109,104,39,3,3,1,49,12,100
73,270,2617,403,2214,49,2165,82,417,570,311,28,11,4,206,34,502
73,271,206,21,185,3,182,9,36,44,12,0,0,2,27,4,48
73,272,151,24,127,0,127,4,38,24,14,1,1,0,5,3,37
73,273,268,24,244,1,243,4,68,53,20,2,0,0,33,6,57
73,274,327,41,286,4,282,21,53,69,36,8,1,2,36,6,50
73,275,261,27,234,2,232,10,60,57,30,1,2,1,29,10,32
73,276,331,56,275,6,269,9,52,80,35,5,0,0,26,5,57
73,277,133,19,114,4,110,4,20,36,15,0,2,3,8,2,20
73,278,1006,165,841,20,821,17,205,224,82,11,5,4,65,22,186
73,280,375,78,297,4,293,11,57,107,29,0,0,0,20,2,67
73,281,619,95,524,10,514,24,101,115,40,4,2,3,84,10,131
73,282,729,126,603,10,593,20,188,136,52,8,3,0,45,13,128
73,283,526,67,459,6,453,15,112,111,47,6,3,1,37,7,114
73,284,576,96,480,8,472,18,75,189,37,3,3,2,47,8,90
73,285,1666,255,1411,26,1385,55,315,369,145,28,6,4,118,66,279
73,286,794,134,660,13,647,18,179,161,59,16,2,1,60,15,136
73,287,204,35,169,8,161,7,22,60,21,0,1,0,16,6,28
73,288,1140,137,1003,17,986,39,206,280,80,9,3,1,100,21,247
73,289,317,44,273,7,266,16,69,66,34,1,0,0,16,4,60
73,290,331,58,273,7,266,4,87,78,25,6,2,0,16,10,38
73,292,222,24,198,3,195,7,59,27,27,4,0,0,27,4,40
73,293,391,58,333,7,326,20,56,72,50,3,0,3,27,4,91
73,294,261,49,212,2,210,9,41,49,35,3,1,0,12,2,58
73,296,1424,316,1108,25,1083,53,146,448,121,9,10,4,111,21,160
73,297,438,62,376,4,372,8,68,90,50,8,6,1,42,10,89
73,298,661,103,558,5,553,18,144,119,87,7,1,1,56,18,102
73,299,252,38,214,4,210,3,37,73,14,3,0,0,29,10,41
73,300,2635,614,2021,32,1989,55,287,878,139,15,6,3,238,34,334
73,301,534,71,463,5,458,26,96,135,33,6,2,0,55,14,91
73,302,227,37,190,2,188,6,37,44,28,1,1,1,27,4,39
73,303,4922,1023,3899,103,3796,81,910,903,534,50,22,8,341,100,847
73,304,1332,213,1119,27,1092,42,118,634,76,7,4,4,61,20,126
73,305,176,26,150,0,150,3,26,48,17,0,0,0,13,2,41
73,306,1106,203,903,13,890,16,142,390,77,9,4,4,82,21,145
73,307,351,75,276,1,275,18,50,57,38,2,2,2,19,9,78
73,308,469,57,412,8,404,6,114,91,46,1,0,2,28,7,109
73,309,215,28,187,4,183,5,48,43,23,1,1,1,27,3,31
73,310,391,40,351,5,346,13,46,129,33,2,4,2,30,2,85
73,311,70,5,65,2,63,0,11,17,10,0,1,1,2,3,18
73,312,633,79,554,13,541,22,114,140,62,12,2,3,55,4,127
73,313,163,29,134,6,128,6,31,50,4,0,1,0,18,3,15
73,314,203,23,180,0,180,10,30,45,29,6,0,0,13,5,42
73,315,359,44,315,9,306,8,79,71,42,3,0,0,34,11,58
73,316,208,22,186,7,179,1,49,42,11,5,0,1,27,3,40
73,317,547,76,471,9,462,31,127,95,41,12,5,0,42,14,95
73,318,271,66,205,2,203,9,58,68,12,2,1,0,14,3,36
73,320,711,98,613,12,601,11,175,121,54,2,5,0,37,16,180
73,321,306,47,259,15,244,1,41,74,36,6,1,0,18,4,63
73,322,417,89,328,13,315,9,60,106,25,3,2,1,26,8,75
73,323,391,84,307,3,304,9,64,97,28,3,0,2,36,11,54
73,324,199,18,181,4,177,3,37,43,21,2,0,3,24,10,34
73,326,1504,181,1323,16,1307,57,220,384,125,8,6,4,170,13,320
73,327,291,59,232,11,221,2,79,30,36,5,2,1,12,8,46
73,328,1519,216,1303,20,1283,27,225,446,97,12,7,4,138,22,305
73,329,1250,157,1093,16,1077,23,216,337,79,9,5,2,118,15,273
73,330,2135,330,1805,29,1776,57,478,478,188,20,10,5,134,34,372
74,1,1112,216,896,18,878,14,218,364,61,10,7,3,91,22,88
74,2,1323,151,1172,26,1146,39,240,267,145,11,9,4,141,37,253
74,3,778,123,655,17,638,38,79,226,70,4,2,0,91,9,119
74,4,264,55,209,5,204,8,43,65,15,6,3,0,17,5,42
74,5,3132,496,2636,68,2568,84,487,764,240,42,15,8,334,67,527
74,6,1092,130,962,14,948,50,180,267,110,9,3,4,145,27,153
74,7,1554,227,1327,35,1292,27,241,483,117,13,4,2,142,41,222
74,8,3936,1257,2679,53,2626,102,395,889,250,25,15,16,289,43,602
74,9,551,109,442,11,431,9,60,171,33,2,2,3,63,23,65
74,10,32387,6954,25433,333,25100,1001,3189,7977,2356,270,99,71,3197,406,6534
74,11,15429,3051,12378,181,12197,481,1331,4902,915,85,35,29,1677,200,2542
74,12,16384,4671,11713,173,11540,307,1763,3186,1351,106,68,41,1086,214,3418
74,13,1496,228,1268,23,1245,42,147,510,92,7,4,5,199,32,207
74,14,1438,294,1144,21,1123,64,115,457,133,21,1,12,114,16,190
74,15,740,131,609,8,601,28,141,178,53,10,2,4,62,21,102
74,16,1315,262,1053,17,1036,50,107,456,69,6,4,2,143,29,170
74,18,1081,162,919,18,901,43,185,337,67,10,2,5,98,13,141
74,19,1631,214,1417,20,1397,67,185,478,95,10,4,3,234,26,295
74,20,923,126,797,18,779,33,116,285,62,2,7,1,116,18,139
74,21,1022,143,879,9,870,23,184,354,68,8,3,2,87,26,115
74,22,549,57,492,7,485,22,80,132,60,7,2,3,63,16,100
74,24,1620,252,1368,28,1340,49,248,479,106,12,8,5,156,34,243
74,25,919,162,757,8,749,30,131,290,59,10,6,1,78,18,126
74,26,3360,577,2783,44,2739,85,541,809,242,24,10,11,330,68,619
74,27,275,26,249,5,244,5,67,90,16,3,2,0,31,5,25
74,29,339,49,290,5,285,6,69,81,16,1,3,0,49,4,56
74,30,197,53,144,1,143,3,28,60,14,5,2,1,12,2,16
74,31,1237,235,1002,18,984,60,115,378,64,3,5,0,148,30,181
74,32,1166,204,962,31,931,20,185,369,59,15,10,2,83,44,144
74,33,960,136,824,19,805,26,180,272,80,8,2,2,87,25,123
74,34,351,42,309,9,300,19,56,96,29,5,0,1,25,10,59
74,35,428,69,359,3,356,14,108,120,23,5,1,1,28,4,52
74,36,282,35,247,4,243,8,32,120,11,0,1,3,30,3,35
74,37,1206,190,1016,26,990,38,147,361,101,13,6,2,106,26,190
74,38,790,121,669,17,652,27,142,208,40,5,2,1,107,19,101
74,40,1944,315,1629,19,1610,71,243,594,160,18,8,4,209,33,270
74,41,236,52,184,5,179,4,54,52,8,2,0,1,23,9,26
74,42,7160,1739,5421,98,5323,141,1092,1413,578,50,35,13,484,109,1408
74,43,3330,556,2774,53,2721,94,484,919,252,34,17,3,375,84,459
74,44,433,91,342,6,336,17,29,155,17,3,4,1,56,7,47
74,45,181,20,161,2,159,8,36,55,8,3,0,0,13,10,26
74,46,389,51,338,7,331,19,72,81,37,5,2,0,40,18,57
74,48,718,141,577,9,568,20,130,178,47,7,9,1,68,24,84
74,49,360,46,314,3,311,8,71,125,22,2,1,0,26,4,52
74,50,508,92,416,7,409,16,57,117,54,3,5,1,56,25,75
74,51,403,66,337,5,332,21,49,106,33,6,0,0,42,12,63
74,52,660,105,555,9,546,24,72,201,38,6,5,1,97,16,86
74,53,717,103,614,7,607,29,88,161,115,4,4,1,72,14,119
74,54,490,67,423,4,419,23,67,117,42,3,3,3,58,10,93
74,55,373,67,306,9,297,10,73,65,31,2,0,4,45,10,57
74,56,7201,1712,5489,99,5390,266,547,2263,467,66,23,14,626,107,1011
74,57,726,92,634,11,623,14,81,200,68,11,5,1,92,18,133
74,58,642,133,509,7,502,9,78,263,25,2,0,1,49,18,57
74,59,177,29,148,2,146,4,34,52,11,1,2,1,24,2,15
74,60,113,10,103,3,100,2,22,17,12,4,1,0,16,4,22
74,61,575,65,510,11,499,18,77,172,40,5,1,2,75,11,98
74,62,872,123,749,20,729,30,118,233,63,9,2,3,114,16,141
74,63,960,166,794,7,787,9,137,453,34,8,3,1,69,20,53
74,64,936,131,805,21,784,20,157,284,58,10,5,6,93,28,123
74,65,341,52,289,5,284,12,52,83,35,4,1,0,37,9,51
74,66,134,22,112,4,108,2,12,23,15,0,0,2,24,8,22
74,67,1759,228,1531,38,1493,61,212,574,107,15,10,4,202,32,276
74,68,301,30,271,2,269,12,66,102,18,5,2,0,29,4,31
74,69,407,59,348,9,339,19,64,122,28,4,1,1,48,11,41
74,70,1033,194,839,20,819,36,114,285,104,9,8,1,100,22,140
74,71,145,26,119,5,114,3,21,37,10,3,0,0,19,2,19
74,72,139,21,118,2,116,5,12,41,13,4,0,0,15,4,22
74,73,442,65,377,9,368,13,115,100,28,6,2,0,30,17,57
74,74,266,39,227,4,223,8,33,69,19,3,1,1,47,5,37
74,75,880,149,731,8,723,13,156,249,60,7,0,3,79,19,137
74,76,1267,189,1078,18,1060,32,190,329,100,20,5,6,134,29,215
74,77,590,53,537,12,525,26,107,170,49,15,2,1,65,17,73
74,78,297,35,262,6,256,12,57,77,30,8,3,1,37,3,28
74,79,449,47,402,15,387,18,64,164,23,3,0,1,62,15,37
74,80,1482,203,1279,20,1259,37,108,819,49,12,3,8,103,29,91
74,81,9337,2290,7047,104,6943,130,1437,2261,632,71,45,19,560,134,1654
74,82,2065,477,1588,23,1565,100,166,619,95,8,6,13,227,35,296
74,83,1636,272,1364,17,1347,35,179,708,67,14,5,6,150,37,146
74,84,265,26,239,0,239,2,57,62,13,5,2,1,33,0,64
74,85,1057,198,859,28,831,26,100,372,68,7,7,3,104,22,122
74,86,457,73,384,9,375,13,61,144,25,2,0,6,51,14,59
74,87,1151,226,925,18,907,31,147,306,85,8,5,4,115,29,177
74,88,617,87,530,14,516,37,63,181,42,7,2,0,65,11,108
74,89,824,141,683,10,673,22,152,270,24,1,5,1,90,29,79
74,90,820,124,696,17,679,22,155,211,57,5,3,2,97,15,112
74,91,178,31,147,3,144,2,14,67,8,3,0,0,19,7,24
74,93,9905,2146,7759,112,7647,261,1201,1841,910,98,29,34,861,150,2262
74,94,4140,711,3429,66,3363,91,614,1245,270,30,12,19,411,69,602
74,95,188,21,167,4,163,5,33,60,12,0,0,0,30,6,17
74,96,2712,398,2314,36,2278,96,351,786,190,34,3,6,330,82,400
74,97,1321,189,1132,15,1117,47,177,291,108,12,4,2,156,38,282
74,98,812,86,726,11,715,32,95,275,40,8,1,2,114,18,130
74,99,704,113,591,9,582,14,82,378,14,4,0,0,47,13,30
74,100,552,73,479,9,470,10,83,184,44,3,1,0,54,17,74
74,101,395,59,336,10,326,12,55,88,31,1,5,2,44,10,78
74,102,963,128,835,21,814,36,113,225,75,6,5,10,124,22,198
74,103,1536,221,1315,31,1284,42,271,491,108,13,9,4,157,20,169
74,104,2393,360,2033,39,1994,81,358,647,203,16,8,7,213,46,415
74,105,2972,591,2381,36,2345,73,426,876,182,35,8,9,247,48,441
74,106,584,118,466,7,459,12,109,139,35,6,3,1,52,15,87
74,107,91,11,80,0,80,0,16,29,6,0,0,0,10,0,19
74,108,716,84,632,12,620,34,83,213,54,2,4,1,99,12,118
74,109,568,62,506,15,491,14,99,141,59,5,1,2,56,9,105
74,110,525,81,444,7,437,20,73,176,41,7,2,4,40,8,66
74,111,189,23,166,0,166,11,30,66,13,0,0,1,23,4,18
74,112,2615,295,2320,35,2285,82,326,764,181,22,7,2,327,61,513
74,114,341,59,282,2,280,8,40,128,32,6,1,0,25,3,37
74,116,1352,192,1160,22,1138,41,217,400,89,10,7,6,128,39,201
74,117,543,75,468,6,462,21,114,129,46,1,3,3,51,8,86
74,118,991,220,771,12,759,11,167,241,79,6,3,3,60,22,167
74,119,5608,1264,4344,82,4262,137,669,1457,410,63,16,13,411,82,1004
74,120,1021,155,866,11,855,35,145,258,76,8,2,3,134,28,166
74,121,696,125,571,4,567,19,96,246,31,1,0,1,70,20,83
74,122,399,55,344,6,338,16,63,95,46,6,3,0,44,15,50
74,123,4624,781,3843,84,3759,134,840,975,442,53,27,6,369,93,820
74,124,970,125,845,11,834,47,91,294,85,15,4,1,121,26,150
74,126,655,89,566,20,546,9,88,221,53,10,2,1,74,19,69
74,127,1042,164,878,20,858,32,193,231,109,17,6,0,97,29,144
74,128,2471,361,2110,34,2076,94,338,780,182,18,5,3,293,47,316
74,129,176,29,147,6,141,1,30,69,5,2,1,0,15,3,15
74,130,314,52,262,3,259,9,60,61,26,3,3,0,24,13,60
74,131,1304,249,1055,21,1034,28,202,364,79,18,3,6,132,22,180
74,133,5781,1732,4049,59,3990,137,632,1235,420,38,14,11,416,82,1005
74,134,1167,191,976,7,969,34,121,595,46,4,1,1,73,5,89
74,135,420,60,360,2,358,18,70,113,23,7,3,0,43,8,73
74,136,1885,222,1663,32,1631,35,175,964,60,8,4,0,198,40,147
74,137,2344,327,2017,39,1978,85,319,668,155,17,7,8,264,53,402
74,138,1062,127,935,19,916,50,140,230,109,5,1,3,137,27,214
74,139,680,140,540,10,530,33,90,134,60,9,2,4,72,14,112
74,140,933,128,805,16,789,36,146,255,77,5,3,5,76,19,167
74,141,676,92,584,8,576,32,129,182,61,11,2,5,58,8,88
74,142,690,109,581,11,570,23,97,161,67,3,1,1,77,13,127
74,143,2136,412,1724,29,1695,95,219,626,187,15,4,9,200,34,306
74,144,505,89,416,5,411,19,57,119,31,17,2,1,59,15,91
74,145,475,94,381,10,371,22,49,171,18,2,0,3,41,10,55
74,146,893,128,765,13,752,22,134,258,75,10,6,2,100,8,137
74,147,747,113,634,13,621,19,118,220,55,4,0,1,76,15,113
74,148,226,23,203,4,199,12,39,57,23,1,0,0,19,5,43
74,150,1022,211,811,15,796,30,145,286,74,13,5,1,95,32,115
74,151,363,56,307,6,301,18,78,79,29,6,2,1,18,5,65
74,152,809,89,720,7,713,27,117,244,50,3,2,0,105,14,151
74,153,1203,241,962,20,942,49,130,357,72,12,3,3,107,31,178
74,154,1689,324,1365,32,1333,37,258,426,119,22,7,4,143,29,288
74,155,653,114,539,16,523,14,104,171,66,14,3,3,57,15,76
74,156,538,102,436,8,428,10,54,158,46,7,2,0,60,10,81
74,157,1133,158,975,27,948,28,162,299,118,8,3,4,115,30,181
74,158,624,129,495,3,492,14,99,180,45,6,1,1,54,7,85
74,159,2191,436,1755,37,1718,24,450,658,128,20,13,0,151,38,236
74,160,792,80,712,10,702,38,107,302,59,8,1,0,89,23,75
74,161,1384,178,1206,21,1185,53,230,382,94,11,3,0,176,20,216
74,162,587,87,500,13,487,14,75,198,47,6,4,0,59,10,74
74,163,1421,225,1196,18,1178,51,158,407,144,16,4,3,134,19,242
74,164,4136,755,3381,83,3298,96,764,1100,281,41,14,6,325,72,599
74,165,491,54,437,11,426,14,80,148,18,8,7,0,55,7,89
74,166,1341,241,1100,28,1072,37,176,313,123,13,8,7,122,36,237
74,167,692,99,593,6,587,11,135,152,80,6,3,1,53,13,133
74,168,502,103,399,4,395,13,63,103,27,3,1,0,82,16,87
74,169,3038,669,2369,51,2318,52,500,822,186,29,14,7,243,48,417
74,170,602,76,526,15,511,25,107,160,52,8,3,0,61,14,81
74,171,1034,197,837,12,825,33,156,256,74,5,5,4,101,16,175
74,172,1061,193,868,19,849,22,151,274,95,19,4,3,98,21,162
74,173,3395,678,2717,35,2682,60,350,1636,86,23,5,8,261,41,212
74,174,391,88,303,6,297,18,72,83,27,8,0,1,32,9,47
74,175,223,60,163,5,158,2,38,57,13,1,1,0,11,3,32
74,176,1481,187,1294,18,1276,44,110,679,61,7,2,3,137,20,213
74,177,581,95,486,13,473,19,93,145,32,6,1,3,59,21,94
74,178,432,51,381,7,374,28,75,114,35,4,2,1,36,12,67
74,179,562,61,501,10,491,16,131,135,45,2,5,0,54,15,88
74,180,1174,249,925,18,907,34,107,358,75,11,2,4,130,24,162
74,181,1869,218,1651,36,1615,53,243,531,131,19,0,4,241,49,344
74,182,5506,1102,4404,91,4313,115,785,1126,473,54,19,13,494,71,1163
74,183,1700,263,1437,22,1415,50,297,471,171,21,6,6,135,30,228
74,184,521,73,448,8,440,21,68,131,30,14,3,4,68,13,88
74,185,1446,326,1120,14,1106,73,142,311,129,26,1,2,139,33,250
74,186,450,49,401,5,396,22,51,130,40,4,2,1,57,12,77
74,187,269,54,215,3,212,15,31,82,20,4,0,0,24,4,32
74,188,603,101,502,9,493,14,67,237,44,3,3,1,54,11,59
74,189,1212,198,1014,12,1002,40,197,308,97,11,6,2,111,17,213
74,190,550,96,454,5,449,16,84,150,70,9,0,0,43,12,65
74,191,2213,345,1868,32,1836,56,190,1059,100,18,5,3,166,36,203
74,192,761,87,674,12,662,21,172,184,46,7,1,2,74,19,136
74,193,620,96,524,13,511,33,120,126,61,7,1,2,68,16,77
74,194,564,83,481,5,476,14,75,176,53,2,1,0,58,10,87
74,195,248,33,215,5,210,6,44,80,15,3,3,1,17,3,38
74,196,393,70,323,4,319,12,62,93,33,5,4,0,41,15,54
74,197,846,131,715,9,706,21,109,262,65,6,1,4,75,17,146
74,198,812,94,718,9,709,43,91,204,53,7,1,7,125,9,169
74,199,384,113,271,1,270,7,14,134,18,2,1,1,32,6,55
74,200,1942,327,1615,27,1588,58,213,607,144,25,6,4,196,53,282
74,201,1038,184,854,15,839,37,100,359,61,5,1,5,135,21,115
74,202,398,46,352,4,348,14,71,95,30,3,0,2,62,7,64
74,203,84,20,64,0,64,1,11,23,5,1,0,2,5,1,15
74,204,717,120,597,7,590,25,84,226,39,5,1,3,94,13,100
74,205,916,153,763,22,741,30,172,197,84,7,9,6,78,33,125
74,206,717,95,622,21,601,18,133,210,43,10,2,2,56,18,109
74,208,7745,1559,6186,107,6079,238,1182,1641,850,88,31,23,580,122,1324
74,209,1010,136,874,10,864,29,121,294,83,12,3,5,128,30,159
74,210,1200,247,953,22,931,22,173,323,84,10,8,3,121,29,158
74,211,1966,292,1674,33,1641,70,315,471,148,23,7,5,252,50,300
74,212,872,161,711,14,697,26,153,248,66,6,4,2,82,17,93
74,213,4630,545,4085,76,4009,159,607,1400,289,43,9,12,533,77,880
74,215,1006,192,814,11,803,20,146,395,51,9,2,1,69,20,90
74,216,524,103,421,8,413,21,77,173,29,6,1,2,49,15,40
74,217,2794,363,2431,22,2409,79,323,921,143,15,10,4,375,51,488
74,218,4660,915,3745,80,3665,87,634,1203,387,65,20,8,414,95,752
74,219,872,97,775,12,763,21,97,337,36,6,0,1,113,12,140
74,220,4585,708,3877,86,3791,135,672,1169,361,36,15,19,546,100,738
74,221,382,44,338,8,330,12,33,142,28,8,1,0,67,7,32
74,222,397,83,314,12,302,5,76,96,24,7,1,1,39,17,36
74,223,353,58,295,2,293,13,69,94,20,5,3,0,29,8,52
74,224,6347,1087,5260,112,5148,247,793,1439,563,62,20,15,663,116,1230
74,225,8331,1639,6692,119,6573,213,1512,1647,635,81,39,21,654,170,1601
74,226,503,74,429,4,425,10,114,102,41,7,2,0,54,13,82
74,228,216,33,183,5,178,5,31,65,12,1,1,0,32,10,21
74,229,2249,512,1737,38,1699,43,300,662,114,18,5,3,219,49,286
74,231,380,51,329,8,321,8,55,135,21,2,1,1,26,11,61
74,232,388,40,348,9,339,14,67,114,21,0,1,0,62,6,54
74,233,1478,238,1240,19,1221,38,323,347,112,17,7,3,120,35,219
74,234,671,75,596,11,585,12,119,164,59,8,2,1,79,23,118
74,235,323,54,269,4,265,7,64,58,32,6,1,1,35,7,54
74,236,4542,984,3558,89,3469,144,600,1264,320,26,24,8,396,81,606
74,237,613,162,451,12,439,22,66,140,46,6,4,0,52,13,90
74,238,800,180,620,13,607,24,114,221,73,5,2,1,66,14,87
74,239,966,112,854,13,841,34,104,358,61,8,4,4,117,29,122
74,240,650,100,550,6,544,29,103,149,67,11,2,4,61,16,102
74,241,2163,387,1776,40,1736,51,444,476,203,20,10,7,137,40,348
74,242,4807,775,4032,70,3962,113,479,1583,256,40,11,11,577,76,816
74,243,6602,1584,5018,80,4938,217,627,1629,458,51,18,15,696,101,1126
74,244,613,78,535,8,527,19,106,137,59,8,6,1,70,13,108
74,245,1768,208,1560,34,1526,54,222,552,100,14,9,5,215,36,319
74,249,1721,310,1411,38,1373,33,256,446,143,15,12,5,182,45,236
74,250,3835,611,3224,79,3145,97,672,995,275,52,13,10,317,86,628
74,252,500,72,428,4,424,17,79,138,42,11,1,1,42,13,80
74,253,685,102,583,17,566,24,98,166,65,8,1,1,77,12,114
74,254,494,67,427,6,421,15,63,157,31,2,3,0,56,12,82
74,255,1357,205,1152,22,1130,26,237,341,106,7,6,4,146,37,220
74,256,11156,2276,8880,174,8706,319,1517,3136,832,84,24,34,876,182,1702
74,257,429,60,369,3,366,13,73,114,30,4,1,1,40,9,81
74,258,2040,368,1672,34,1638,64,240,642,138,20,6,2,191,53,282
74,259,308,52,256,8,248,13,46,90,23,2,0,0,30,4,40
74,260,491,68,423,12,411,27,68,149,39,3,4,2,44,16,59
74,261,280,42,238,5,233,21,45,73,25,7,1,1,23,7,30
74,262,683,93,590,11,579,12,158,181,44,8,2,2,70,23,79
74,263,3881,897,2984,34,2950,126,488,984,355,30,11,12,326,70,548
74,264,4078,974,3104,48,3056,44,703,1026,289,46,16,8,233,88,603
74,265,458,52,406,13,393,18,72,122,41,2,3,0,54,13,68
74,266,761,139,622,9,613,35,63,168,65,9,8,2,91,14,158
74,267,3095,408,2687,38,2649,101,298,1096,193,18,6,3,399,44,491
74,268,12814,2274,10540,200,10340,390,1489,2950,1086,117,35,38,1298,185,2752
74,269,1415,240,1175,18,1157,43,273,314,118,14,9,3,108,31,244
74,270,474,71,403,11,392,28,95,84,37,4,1,0,46,18,79
74,271,333,75,258,5,253,10,45,86,26,2,2,0,29,12,41
74,272,2743,303,2440,48,2392,69,429,795,200,31,16,2,292,71,487
74,273,629,94,535,13,522,16,76,257,43,11,1,1,41,9,67
74,274,382,59,323,4,319,19,84,92,26,3,0,0,40,11,44
74,275,1623,299,1324,26,1298,53,132,624,93,13,4,4,154,22,199
74,276,2468,430,2038,34,2004,62,362,632,229,35,16,5,200,39,424
74,278,3698,705,2993,78,2915,87,569,1003,284,24,21,7,278,64,578
74,279,584,74,510,16,494,17,120,189,38,1,1,4,39,11,74
74,280,4259,619,3640,60,3580,156,567,1420,299,50,22,11,384,114,557
74,281,21737,5433,16304,281,16023,491,2246,5219,1678,179,70,42,1694,316,4088
74,282,2165,256,1909,41,1868,99,297,502,238,19,13,15,239,44,402
74,283,771,103,668,18,650,15,138,187,42,10,6,0,73,23,156
74,284,700,118,582,13,569,11,116,157,67,5,2,1,70,21,119
74,285,297,54,243,2,241,9,49,93,15,4,0,2,25,7,37
74,286,588,100,488,12,476,13,130,156,38,4,1,2,46,11,75
74,287,621,114,507,13,494,14,110,143,42,13,7,2,68,18,77
74,288,1958,464,1494,27,1467,52,262,549,115,19,7,4,188,43,228
74,289,1069,138,931,20,911,22,205,290,68,4,4,2,115,32,169
74,290,341,42,299,6,293,33,25,63,32,9,5,5,47,5,69
74,291,221,39,182,2,180,4,42,61,16,3,1,2,21,7,23
74,292,693,121,572,11,561,27,114,196,51,5,3,0,73,20,72
74,293,1940,513,1427,13,1414,41,185,581,102,26,5,10,213,30,221
74,294,507,54,453,6,447,23,87,156,53,5,1,2,36,11,73
74,295,221,32,189,5,184,8,28,47,33,7,4,1,16,3,37
74,296,455,56,399,8,391,13,71,136,17,1,0,3,61,4,85
74,297,394,48,346,6,340,3,69,109,35,6,1,1,37,13,66
74,298,4427,901,3526,51,3475,104,572,1355,290,32,15,14,369,81,643
74,299,1958,349,1609,19,1590,45,128,944,65,7,0,4,161,25,211
74,301,549,61,488,4,484,13,83,166,49,6,4,1,56,11,95
74,302,798,125,673,12,661,29,108,227,55,14,7,1,102,23,95
74,303,2123,225,1898,30,1868,98,275,623,135,11,2,3,284,52,385
74,304,527,88,439,7,432,17,96,121,48,4,1,2,46,15,82
74,305,4790,987,3803,77,3726,123,593,1148,401,49,17,5,408,77,905
74,306,411,58,353,9,344,5,45,97,29,6,2,0,61,11,88
74,307,526,49,477,9,468,25,52,162,45,2,4,2,70,11,95
74,308,673,138,535,10,525,12,113,136,63,8,3,2,55,13,120
74,309,2414,565,1849,34,1815,116,270,646,150,20,9,2,233,46,323
74,310,1035,166,869,12,857,38,137,283,85,8,2,3,114,18,169
74,311,2967,454,2513,54,2459,108,484,785,260,24,10,6,261,58,463
74,312,984,199,785,19,766,20,218,238,58,13,6,4,50,21,138
74,313,299,55,244,5,239,7,21,103,19,1,0,2,47,5,34
74,314,742,110,632,13,619,24,106,245,42,10,1,2,76,13,100
74,315,651,134,517,31,486,27,69,155,79,12,3,0,52,9,80
75,56,1253322,248755,1004567,12093,992474,41495,61503,319482,110101,6644,2719,2272,92664,9959,345635
76,1,943,100,843,15,828,15,165,231,62,12,6,2,88,21,226
76,2,387,35,352,14,338,2,86,96,43,2,2,1,16,6,84
76,4,380,47,333,6,327,2,91,75,45,2,2,1,19,5,85
76,5,2205,517,1688,25,1663,22,311,296,260,29,17,3,128,28,569
76,6,111,12,99,1,98,3,24,32,12,0,1,0,4,1,21
76,7,558,72,486,8,478,8,82,137,64,4,4,2,44,11,122
76,8,540,51,489,10,479,2,100,138,55,5,1,0,40,6,132
76,9,183,10,173,6,167,3,29,42,16,4,3,0,19,2,49
76,10,305,40,265,6,259,4,69,87,18,5,0,0,26,6,44
76,11,157,23,134,0,134,3,33,33,11,3,0,0,8,3,40
76,12,153,33,120,1,119,1,27,34,18,1,0,1,9,6,22
76,13,708,118,590,18,572,5,119,149,57,3,4,0,31,10,194
76,14,1101,153,948,15,933,8,182,278,108,11,5,1,83,17,240
76,15,496,83,413,7,406,3,72,121,36,4,5,0,32,6,127
76,16,106,6,100,2,98,1,14,43,4,3,0,1,3,2,27
76,17,407,47,360,6,354,4,81,86,42,7,4,0,34,9,87
76,18,985,108,877,11,866,9,190,227,82,11,7,2,71,16,251
76,19,324,35,289,4,285,2,64,76,26,0,2,3,18,5,89
76,20,926,141,785,13,772,15,204,165,108,3,5,4,62,15,191
76,21,339,42,297,8,289,3,53,75,30,8,6,0,23,6,85
76,22,253,32,221,5,216,8,33,50,29,5,2,3,27,3,56
76,23,209,22,187,2,185,6,29,46,21,3,4,2,23,5,46
76,24,149,17,132,3,129,0,34,30,5,2,1,1,8,2,46
76,25,241,27,214,4,210,6,46,72,13,2,4,0,16,6,45
76,26,1939,350,1589,17,1572,30,344,310,360,27,10,6,83,29,373
76,27,271,41,230,5,225,2,52,65,35,3,2,2,11,5,48
76,28,143,30,113,2,111,0,58,19,5,0,3,0,3,1,22
76,29,185,36,149,2,147,1,44,40,14,6,2,2,9,4,25
76,30,384,57,327,4,323,1,62,73,63,6,1,0,28,10,79
76,31,481,46,435,7,428,2,88,114,66,11,2,0,36,8,101
76,32,106,12,94,0,94,3,16,33,5,1,2,0,11,2,21
76,33,308,33,275,2,273,2,72,67,36,7,3,3,12,7,64
76,34,1343,187,1156,16,1140,14,233,315,98,19,6,1,84,31,339
76,35,1687,332,1355,22,1333,12,308,527,80,14,12,2,90,25,263
76,36,508,64,444,6,438,6,96,124,45,3,2,0,24,9,129
76,37,210,24,186,4,182,2,46,37,20,3,2,0,23,7,42
76,38,333,35,298,11,287,6,61,82,38,3,1,0,21,9,66
76,39,922,95,827,12,815,13,116,260,94,4,2,3,85,22,216
76,40,175,33,142,3,139,3,31,32,11,0,2,0,5,1,54
76,41,571,54,517,14,503,6,58,114,96,7,4,1,48,11,158
76,42,87,13,74,2,72,2,28,20,5,0,1,0,4,5,7
76,43,667,64,603,7,596,4,117,157,74,3,6,2,55,9,169
76,44,207,16,191,5,186,0,42,58,15,0,1,0,19,5,46
76,45,303,39,264,6,258,3,62,51,44,3,2,0,24,5,64
76,46,491,38,453,13,440,8,97,91,59,6,2,0,42,14,121
76,47,129,11,118,1,117,0,21,43,8,0,1,0,19,1,24
76,48,256,32,224,5,219,4,71,64,19,4,0,0,25,2,30
76,49,227,41,186,5,181,5,52,54,9,5,0,0,12,1,43
76,50,787,114,673,12,661,5,137,161,78,5,2,0,53,17,203
76,51,1345,262,1083,16,1067,4,200,323,94,17,17,2,71,30,309
76,52,159,22,137,4,133,0,38,54,7,1,0,1,12,2,18
76,53,115,14,101,2,99,0,27,30,9,1,0,1,6,6,19
76,54,402,57,345,7,338,4,80,96,30,11,0,0,22,11,84
76,55,300,32,268,4,264,2,56,89,11,3,3,1,27,5,67
76,56,492,48,444,6,438,15,80,87,64,9,7,0,31,9,136
76,57,8690,1718,6972,127,6845,80,1433,1248,887,120,47,12,480,159,2379
76,58,209,29,180,4,176,1,49,57,10,0,1,0,8,4,46
76,59,296,36,260,4,256,5,74,58,24,2,1,0,14,8,70
76,60,373,69,304,6,298,7,77,82,35,6,3,0,10,5,73
76,62,186,37,149,3,146,5,35,31,11,2,1,0,23,5,33
76,63,372,68,304,8,296,7,60,78,25,9,1,1,33,4,78
76,64,360,37,323,5,318,7,67,103,36,4,1,0,25,11,64
76,65,318,68,250,5,245,0,77,53,20,2,1,1,24,5,62
76,66,116,13,103,1,102,0,26,33,11,0,0,0,11,4,17
76,67,463,83,380,6,374,6,89,111,37,3,6,1,36,4,81
76,68,536,87,449,8,441,5,105,117,50,5,4,0,34,8,113
76,69,1759,256,1503,18,1485,44,199,435,146,19,5,6,179,28,424
76,70,443,65,378,9,369,2,107,88,38,7,2,1,23,4,97
76,71,394,67,327,6,321,2,94,86,26,8,3,1,18,7,76
76,72,494,86,408,8,400,7,104,100,43,2,3,3,26,8,104
76,73,539,107,432,8,424,3,117,96,44,5,2,1,38,8,110
76,74,54,11,43,2,41,2,20,10,2,1,0,0,3,1,2
76,75,417,57,360,10,350,1,113,63,42,7,1,2,24,3,94
76,76,171,27,144,0,144,1,35,40,17,2,2,0,10,1,36
76,77,148,26,122,1,121,0,41,29,14,2,1,0,11,0,23
76,78,119,10,109,0,109,2,15,36,18,2,0,0,2,1,33
76,79,138,13,125,0,125,4,25,30,14,1,2,0,13,3,33
76,80,323,35,288,9,279,6,45,92,28,2,2,2,27,5,70
76,81,1017,174,843,16,827,14,170,215,111,10,6,5,64,16,216
76,82,498,71,427,8,419,5,96,119,48,11,4,0,38,18,80
76,83,74,8,66,3,63,0,22,15,0,3,1,0,1,3,18
76,84,89,17,72,1,71,0,21,21,3,0,0,0,2,2,22
76,85,284,34,250,6,244,7,40,94,31,2,0,0,22,2,46
76,86,161,25,136,3,133,1,39,38,7,3,1,0,12,3,29
76,87,410,49,361,9,352,5,75,88,35,5,3,1,27,4,109
76,88,382,41,341,4,337,1,84,76,35,3,3,0,24,10,101
76,89,396,41,355,4,351,6,68,86,47,3,7,0,40,7,87
76,90,869,139,730,13,717,13,146,210,76,10,7,0,72,13,170
76,91,154,25,129,1,128,1,31,42,8,0,1,0,13,2,30
76,92,515,68,447,5,442,5,98,85,70,6,5,0,25,14,134
76,93,274,49,225,3,222,4,58,69,22,1,0,0,20,6,42
76,94,211,35,176,6,170,4,36,51,23,5,1,0,11,2,37
76,96,494,63,431,11,420,4,84,107,33,6,2,1,41,9,133
76,97,84,9,75,0,75,2,24,28,6,0,0,0,6,1,8
76,98,556,53,503,11,492,4,119,104,70,3,3,1,36,9,143
76,99,470,72,398,11,387,7,74,123,26,10,2,1,40,11,93
76,100,911,124,787,12,775,14,129,240,86,7,3,1,78,31,186
76,101,2265,458,1807,22,1785,19,408,358,175,13,17,1,70,35,689
76,103,5189,936,4253,80,4173,84,493,1418,391,31,17,13,489,81,1156
76,104,257,36,221,1,220,5,48,47,15,3,3,0,22,4,73
76,105,605,107,498,10,488,8,122,133,68,4,0,2,39,8,104
76,106,460,59,401,4,397,8,79,110,50,3,5,2,42,5,93
76,107,187,8,179,3,176,8,29,66,23,3,1,0,11,3,32
76,108,17049,3273,13776,168,13608,368,1284,5261,1129,112,54,28,1596,204,3572
76,109,146,13,133,4,129,9,33,38,13,0,0,1,12,1,22
76,110,295,46,249,5,244,2,44,50,25,6,5,1,16,6,89
76,111,339,39,300,5,295,5,41,101,24,1,1,0,37,9,76
76,112,283,41,242,3,239,1,58,86,23,4,1,0,14,4,48
76,113,264,36,228,10,218,5,46,64,20,0,2,1,25,2,53
76,114,7741,1873,5868,134,5734,41,1291,1092,838,129,61,18,360,86,1818
76,115,462,67,395,2,393,4,97,126,55,5,1,0,22,5,78
76,116,2606,383,2223,51,2172,26,424,642,245,28,9,7,205,45,541
76,117,442,62,380,2,378,3,74,133,34,8,1,2,23,3,97
76,118,174,21,153,4,149,2,31,39,25,2,1,0,8,6,35
76,119,155,29,126,3,123,1,33,44,11,2,2,1,3,0,26
76,120,310,27,283,7,276,10,69,88,19,1,6,1,32,8,42
76,121,244,29,215,3,212,2,60,72,18,3,1,0,16,2,38
76,122,341,53,288,8,280,0,76,79,19,6,0,0,23,8,69
76,123,730,88,642,14,628,6,66,248,57,9,6,1,53,15,167
76,124,311,44,267,5,262,2,91,65,29,1,0,0,13,8,53
76,125,1118,169,949,17,932,7,204,293,68,10,11,9,100,20,210
76,126,211,25,186,9,177,4,51,38,24,2,1,0,11,2,44
76,127,520,85,435,4,431,9,99,141,36,6,3,0,37,9,91
76,128,381,54,327,5,322,5,85,84,36,6,2,0,17,5,82
76,129,148,16,132,1,131,3,36,32,8,2,3,0,14,1,32
76,130,198,28,170,2,168,0,45,56,16,2,0,0,3,1,45
76,131,533,61,472,13,459,14,74,144,58,3,0,0,41,6,119
76,132,341,58,283,6,277,0,84,89,24,4,1,0,14,5,56
76,133,368,36,332,4,328,3,70,124,30,2,3,0,21,3,72
76,134,226,23,203,0,203,2,28,59,14,3,3,0,9,1,84
76,135,784,120,664,16,648,4,101,198,65,5,1,1,83,15,175
76,136,560,82,478,8,470,9,88,104,72,4,9,0,19,9,156
76,137,737,91,646,10,636,5,141,165,84,8,8,0,43,12,170
76,138,276,44,232,3,229,9,58,74,29,3,1,2,9,13,31
76,139,157,28,129,6,123,2,39,33,13,0,0,0,7,0,29
76,140,132,22,110,1,109,3,17,25,9,2,2,0,7,3,41
76,141,918,123,795,12,783,9,161,228,79,16,9,1,57,8,215
76,142,373,82,291,2,289,3,88,90,25,1,1,0,40,8,33
76,143,949,133,816,28,788,7,178,217,108,18,8,1,66,14,171
76,144,139,15,124,1,123,0,18,49,6,2,3,0,7,0,38
76,145,168,37,131,0,131,0,36,38,16,1,0,0,8,2,30
76,146,1017,198,819,20,799,10,158,343,50,4,5,1,62,18,148
76,147,692,97,595,11,584,13,159,171,50,9,3,3,48,16,112
76,148,212,38,174,4,170,3,46,51,7,3,1,0,13,9,37
76,149,250,34,216,8,208,3,58,62,22,4,0,0,14,6,39
76,151,207,32,175,1,174,3,28,61,19,0,0,1,12,4,46
76,152,586,89,497,12,485,12,76,186,46,2,5,3,34,7,114
76,153,250,28,222,6,216,4,37,63,22,4,2,3,19,2,60
76,154,403,78,325,13,312,0,76,68,22,7,3,0,13,2,121
76,155,259,48,211,1,210,0,68,61,18,2,5,0,14,3,39
76,156,206,38,168,3,165,2,35,48,16,4,1,0,9,4,46
76,157,9057,1716,7341,140,7201,125,1248,1158,1001,100,47,12,442,109,2959
76,158,243,38,205,10,195,3,38,34,19,3,0,0,12,4,82
76,159,2310,359,1951,44,1907,19,343,492,215,28,19,8,144,40,599
76,160,265,52,213,5,208,2,52,44,27,3,1,0,20,4,55
76,161,91,22,69,0,69,1,12,26,3,0,0,0,7,4,16
76,162,181,13,168,8,160,2,36,48,17,4,2,1,9,4,37
76,163,553,54,499,10,489,5,71,134,46,4,5,6,86,9,123
76,164,1544,275,1269,14,1255,20,222,282,140,10,13,3,104,20,441
76,165,6589,1695,4894,87,4807,54,1009,927,685,81,35,12,295,78,1631
76,166,352,38,314,10,304,4,74,121,24,6,4,0,20,12,39
76,167,1056,104,952,14,938,16,203,300,101,7,4,2,75,16,214
76,168,43,7,36,0,36,2,5,8,4,0,0,0,2,1,14
76,169,994,165,829,21,808,8,183,219,106,10,5,1,54,14,208
76,170,115,19,96,3,93,2,25,23,12,0,2,0,5,2,22
76,171,78,12,66,1,65,0,20,23,2,0,0,2,6,2,10
76,172,181,34,147,2,145,4,28,55,12,1,0,0,6,2,37
76,173,356,37,319,6,313,0,89,82,35,1,2,0,23,4,77
76,174,235,14,221,6,215,6,59,55,31,6,2,0,11,3,42
76,175,192,21,171,2,169,1,31,76,10,1,0,3,18,4,25
76,176,214,35,179,3,176,0,26,57,25,1,1,0,12,4,50
76,177,206,27,179,3,176,2,38,64,9,3,3,0,13,6,38
76,178,3211,646,2565,59,2506,34,436,334,386,24,13,7,145,38,1089
76,179,1025,198,827,19,808,20,145,233,91,12,3,2,74,16,212
76,180,106,8,98,1,97,2,15,33,6,1,0,0,10,0,30
76,181,133,12,121,2,119,0,19,45,18,2,0,0,5,3,27
76,182,212,26,186,1,185,1,26,79,11,0,2,0,18,3,45
76,183,600,84,516,12,504,7,101,131,54,7,3,1,46,9,145
76,184,119,13,106,3,103,0,14,34,27,1,3,0,6,1,17
76,185,138,27,111,2,109,3,27,25,8,3,2,0,8,4,29
76,186,394,73,321,3,318,4,110,89,20,5,6,2,21,7,54
76,187,180,26,154,2,152,3,33,49,10,0,0,0,18,1,38
76,188,311,31,280,5,275,3,70,74,23,0,3,0,35,13,54
76,189,124,13,111,2,109,1,16,38,16,0,0,1,12,3,22
76,190,197,31,166,2,164,2,27,47,11,3,0,0,10,4,60
76,191,200,25,175,2,173,4,53,42,25,2,1,0,13,4,29
76,192,2186,392,1794,22,1772,15,433,487,234,16,13,3,120,37,414
76,193,269,44,225,5,220,3,59,65,22,8,1,0,15,7,40
76,194,306,41,265,11,254,6,61,58,24,3,5,5,13,4,75
76,195,123,19,104,2,102,1,34,22,9,2,0,0,8,1,25
76,196,1679,274,1405,37,1368,17,275,472,160,31,8,2,125,21,257
76,197,164,24,140,1,139,2,36,47,14,1,2,0,5,0,32
76,198,573,94,479,12,467,2,117,124,46,6,8,1,42,11,110
76,199,517,71,446,8,438,5,161,128,19,7,1,3,28,11,75
76,200,385,54,331,5,326,2,86,81,37,5,3,0,28,4,80
76,201,431,86,345,4,341,8,112,71,39,5,2,1,18,12,73
76,202,185,23,162,7,155,0,50,38,12,5,0,0,17,4,29
76,203,553,67,486,9,477,2,119,107,40,7,5,1,43,6,147
76,204,180,13,167,1,166,1,47,44,17,0,0,0,16,4,37
76,205,198,15,183,8,175,1,41,60,13,2,0,0,14,5,39
76,206,275,39,236,4,232,15,56,62,23,5,1,0,18,3,49
76,207,164,26,138,2,136,6,28,36,11,0,0,1,10,6,38
76,208,475,69,406,12,394,6,136,107,31,3,3,1,26,17,64
76,209,361,62,299,8,291,6,102,80,19,8,0,0,18,8,50
76,210,409,66,343,6,337,1,77,95,27,2,2,0,26,15,92
76,211,191,30,161,4,157,0,49,33,14,2,1,1,11,6,40
76,212,5761,1207,4554,93,4461,75,974,832,678,70,31,9,302,81,1409
76,213,284,37,247,9,238,6,59,72,29,2,4,0,15,0,51
76,214,203,32,171,1,170,3,29,46,19,2,1,1,16,3,50
76,215,442,74,368,6,362,6,98,76,48,9,6,0,28,11,80
76,216,7075,1665,5410,86,5324,93,1049,1039,727,59,34,15,372,107,1829
76,217,22266,5185,17081,348,16733,282,3063,3916,3021,194,151,39,1145,251,4671
76,218,68,3,65,1,64,4,15,18,5,0,1,0,8,1,12
76,219,1945,386,1559,28,1531,18,329,413,156,19,8,4,123,22,439
76,220,385,54,331,3,328,3,119,80,18,4,3,0,26,11,64
76,221,172,18,154,3,151,2,24,56,21,0,0,0,16,2,30
76,222,3077,510,2567,50,2517,42,474,707,276,27,8,5,182,35,761
76,223,434,62,372,5,367,11,94,76,51,4,2,4,21,8,96
76,224,802,107,695,9,686,24,153,204,77,10,7,1,46,14,150
76,225,319,49,270,3,267,5,58,68,18,9,2,0,18,3,86
76,226,116,18,98,3,95,2,14,25,11,3,1,1,10,1,27
76,227,427,55,372,5,367,9,64,102,25,0,1,1,32,10,123
76,228,305,51,254,4,250,2,44,60,28,2,2,0,34,10,68
76,229,319,55,264,5,259,2,80,71,23,4,3,2,20,8,46
76,230,307,47,260,2,258,5,62,57,43,1,1,0,27,7,55
76,231,9457,2472,6985,131,6854,90,1293,1197,840,106,50,19,389,126,2744
76,232,460,55,405,5,400,7,106,82,48,4,5,1,30,5,112
76,233,136,21,115,0,115,0,24,40,11,1,1,0,15,1,22
76,234,455,59,396,7,389,4,87,86,32,3,3,0,48,6,120
76,235,1466,226,1240,28,1212,6,279,386,117,11,10,1,90,32,280
76,236,268,33,235,6,229,6,56,54,27,5,0,1,14,5,61
76,237,369,62,307,4,303,0,79,78,43,3,2,0,16,13,69
76,238,2348,390,1958,31,1927,27,379,458,266,27,21,9,137,38,565
76,239,544,87,457,12,445,7,97,121,42,6,2,0,37,11,122
76,240,737,121,616,18,598,5,126,209,62,4,5,5,57,12,113
76,241,128,14,114,3,111,3,8,32,10,0,0,1,8,3,46
76,242,178,29,149,6,143,1,32,54,16,2,3,1,10,2,22
76,243,184,23,161,3,158,3,48,40,17,2,1,0,19,2,26
76,244,293,41,252,7,245,2,64,87,22,1,1,1,24,5,38
76,245,1075,117,958,22,936,13,189,207,128,8,9,1,81,21,279
76,247,379,60,319,3,316,4,78,116,30,6,0,1,24,4,53
76,248,330,50,280,4,276,2,60,90,32,1,3,0,30,10,48
76,249,555,46,509,10,499,7,132,138,40,6,4,0,50,12,110
76,250,785,116,669,16,653,15,153,169,81,15,3,3,60,12,142
76,251,326,51,275,9,266,4,52,74,24,11,4,0,16,10,71
76,252,831,105,726,16,710,6,140,207,87,6,4,4,64,12,180
76,253,530,64,466,10,456,8,65,123,61,15,2,0,52,13,117
76,254,1333,222,1111,17,1094,22,180,420,110,12,5,1,75,16,253
76,255,5935,1242,4693,92,4601,43,892,1359,610,50,36,8,315,81,1207
76,257,118,15,103,2,101,5,27,16,12,0,0,0,7,3,31
76,258,1524,209,1315,31,1284,11,216,395,132,21,18,3,88,19,381
76,259,14396,3540,10856,179,10677,189,2030,2404,1352,156,99,28,683,156,3580
76,260,1327,248,1079,23,1056,14,326,293,101,22,11,2,66,32,189
76,261,341,39,302,3,299,4,108,87,11,6,2,1,17,8,55
76,262,99,9,90,1,89,3,10,38,4,0,0,0,15,1,18
76,263,912,135,777,12,765,10,194,260,47,3,3,0,71,14,163
76,264,328,52,276,4,272,4,48,71,30,3,0,3,31,5,77
76,265,151,29,122,2,120,3,32,42,2,0,3,0,10,7,21
76,266,522,73,449,11,438,5,106,94,77,5,3,1,16,9,122
76,267,66,7,59,0,59,1,8,28,2,0,0,0,9,0,11
76,268,146,17,129,3,126,3,28,31,11,4,2,0,12,2,33
76,269,140,8,132,3,129,3,26,45,9,5,2,0,15,3,21
76,270,2287,323,1964,33,1931,30,268,708,162,18,4,3,221,37,480
76,271,1053,153,900,10,890,15,194,255,94,13,7,2,69,12,229
76,272,671,127,544,6,538,3,101,119,80,4,8,3,44,8,168
76,273,430,51,379,6,373,11,52,115,34,0,2,0,44,8,107
76,274,38,6,32,0,32,1,7,15,1,1,0,0,4,0,3
76,275,888,100,788,18,770,15,139,222,85,6,8,2,88,21,184
76,276,2767,719,2048,44,2004,23,428,758,126,22,18,3,160,45,421
76,277,361,44,317,2,315,7,114,98,12,2,1,0,20,5,56
76,278,623,138,485,14,471,5,111,106,45,8,7,1,31,4,153
76,279,273,43,230,2,228,2,69,72,14,6,6,3,14,1,41
76,280,115,15,100,1,99,1,27,37,13,1,0,0,4,4,12
76,281,1583,328,1255,22,1233,13,239,307,152,19,10,2,127,28,336
76,282,742,97,645,12,633,11,109,117,101,5,3,0,65,20,202
76,283,161,23,138,1,137,1,32,41,13,3,1,0,8,2,36
76,284,254,19,235,0,235,5,70,71,16,0,1,0,16,10,46
76,285,451,57,394,6,388,1,61,134,32,1,3,2,52,15,87
76,286,528,80,448,13,435,3,157,103,28,2,4,1,38,4,95
76,287,845,114,731,20,711,8,142,191,74,6,5,1,73,14,197
76,288,282,46,236,2,234,4,59,57,27,4,3,0,12,4,64
76,289,648,102,546,5,541,9,153,118,56,8,6,1,34,4,152
76,290,344,50,294,8,286,5,42,86,45,2,4,0,25,10,67
76,291,796,112,684,7,677,10,176,178,63,14,7,4,61,20,144
76,292,127,21,106,2,104,2,25,29,4,3,1,0,10,9,21
76,293,160,22,138,1,137,3,27,21,25,0,0,0,17,4,40
76,294,325,47,278,3,275,2,48,90,23,5,4,0,17,4,82
76,295,964,260,704,23,681,4,183,186,57,8,8,1,62,12,160
76,296,1966,347,1619,29,1590,16,319,312,345,26,9,1,105,39,418
76,297,186,19,167,5,162,2,54,44,10,1,1,1,12,6,31
76,298,414,71,343,7,336,3,54,99,51,7,2,0,19,6,95
76,299,297,38,259,5,254,2,54,83,18,2,2,3,12,8,70
76,300,308,56,252,5,247,5,54,58,34,2,1,1,11,10,71
76,301,153,17,136,1,135,1,33,29,15,2,4,1,13,2,35
76,302,2065,367,1698,39,1659,13,339,524,154,26,15,3,162,32,391
76,303,522,59,463,11,452,12,94,126,62,10,6,1,38,9,94
76,304,238,19,219,4,215,2,58,52,23,3,1,1,27,2,46
76,305,6316,1234,5082,82,5000,47,1130,521,1669,79,34,8,171,51,1290
76,306,127,18,109,4,105,2,26,29,13,0,0,0,12,4,19
76,307,970,139,831,21,810,12,156,271,76,10,7,5,61,9,203
76,308,326,50,276,6,270,6,85,72,19,5,3,3,21,10,46
76,309,97,16,81,1,80,2,19,29,9,1,0,0,8,2,10
76,310,165,19,146,5,141,1,31,52,15,2,2,0,6,2,30
76,311,332,35,297,10,287,1,74,72,27,4,2,1,15,1,90
76,312,4351,964,3387,98,3289,33,866,907,297,38,28,15,235,80,790
76,313,662,121,541,15,526,7,81,125,71,10,5,1,69,13,144
76,314,421,43,378,3,375,5,104,64,67,6,2,0,26,7,94
76,315,724,108,616,11,605,4,116,166,43,9,4,1,54,24,184
76,316,361,35,326,8,318,5,73,67,43,5,1,0,29,9,86
76,317,320,36,284,3,281,6,59,66,33,6,3,0,22,12,74
76,318,520,63,457,9,448,7,88,96,61,7,2,2,41,12,132
76,319,6875,1695,5180,89,5091,67,976,836,1023,54,35,8,323,82,1687
76,320,284,50,234,5,229,1,60,68,16,2,8,0,14,7,53
76,321,1352,229,1123,25,1098,13,295,314,101,11,6,7,85,20,246
76,322,18700,2819,15881,364,15517,151,2948,2450,2109,236,112,36,885,222,6368
76,323,98,9,89,2,87,2,24,20,6,4,0,0,7,0,24
76,324,670,116,554,9,545,4,137,173,75,4,4,1,22,11,114
76,325,258,33,225,4,221,0,47,78,26,1,4,0,15,1,49
76,326,100,10,90,0,90,1,23,26,12,0,2,0,8,0,18
76,327,275,32,243,4,239,1,47,47,20,2,0,0,21,7,94
76,328,268,33,235,3,232,3,67,63,22,3,1,2,15,7,49
76,329,2084,392,1692,36,1656,20,339,416,202,35,16,4,128,47,449
76,330,604,104,500,7,493,1,81,148,44,5,4,1,42,8,159
76,331,466,93,373,9,364,1,109,77,37,10,4,0,23,8,95
76,332,353,58,295,10,285,5,87,87,19,3,1,0,24,9,50
76,333,338,43,295,3,292,1,93,66,37,2,6,0,9,6,72
76,334,399,73,326,7,319,5,52,61,43,9,2,0,21,5,121
76,335,67,8,59,0,59,0,13,18,3,0,0,0,11,2,12
76,336,298,32,266,10,256,6,51,62,27,0,2,0,33,2,73
76,337,213,38,175,2,173,0,78,59,3,2,0,0,8,4,19
76,338,128,15,113,1,112,5,23,27,13,0,0,0,11,0,33
76,339,190,23,167,5,162,2,29,56,14,5,2,0,19,2,33
76,340,351,51,300,6,294,1,49,95,25,5,5,0,25,7,82
76,341,5495,1118,4377,77,4300,61,975,624,943,70,60,3,242,57,1265
76,342,446,43,403,5,398,2,100,104,34,11,4,2,41,6,94
76,343,184,20,164,4,160,1,63,40,15,2,0,0,15,4,20
76,344,375,66,309,10,299,2,92,108,10,1,2,0,21,11,52
76,345,223,49,174,1,173,0,39,66,7,0,2,0,18,13,28
76,346,227,26,201,5,196,0,48,49,23,3,1,0,13,3,56
76,347,253,32,221,8,213,2,38,83,22,1,0,0,14,5,48
76,348,470,55,415,8,407,4,87,106,44,7,4,0,47,12,96
76,349,1724,301,1423,20,1403,25,230,420,193,6,6,5,111,36,371
76,350,299,33,266,7,259,7,37,53,38,3,1,1,26,4,89
76,351,112708,30208,82500,2086,80414,1454,13994,18649,13297,1072,577,182,5745,1184,24260
76,352,275,47,228,3,225,3,51,53,32,1,2,0,22,7,54
76,353,88,16,72,0,72,1,16,15,10,0,0,2,6,0,22
76,354,1022,128,894,14,880,14,152,273,71,9,2,2,91,17,249
76,355,593,72,521,13,508,7,91,147,43,11,2,4,65,16,122
76,356,108,23,85,0,85,2,20,18,9,0,1,0,8,1,26
76,357,279,24,255,4,251,4,28,90,25,4,1,1,33,5,60
76,358,210,43,167,6,161,1,36,46,18,7,2,2,14,4,31
76,359,102,13,89,3,86,5,19,18,0,1,1,0,14,3,25
76,360,455,44,411,12,399,8,99,124,26,10,4,0,30,12,86
76,361,448,49,399,10,389,7,88,125,54,2,1,0,28,8,76
76,362,281,37,244,1,243,2,47,58,27,0,2,1,24,0,82
76,363,364,59,305,7,298,7,69,52,21,4,7,0,19,9,110
76,364,229,32,197,0,197,5,56,77,15,6,1,1,17,4,15
76,365,118,18,100,0,100,0,15,20,12,3,0,0,6,1,43
76,366,3048,633,2415,42,2373,33,513,451,389,32,22,6,153,41,733
76,367,2075,260,1815,33,1782,37,226,513,192,14,2,5,193,30,570
76,368,238,34,204,0,204,1,46,65,18,2,0,0,17,4,51
76,369,408,71,337,3,334,4,95,95,30,5,0,1,39,7,58
76,370,311,25,286,5,281,9,66,89,27,1,4,1,19,6,59
76,371,41,7,34,3,31,0,15,4,3,0,0,0,4,0,5
76,372,275,53,222,2,220,3,67,90,10,2,1,1,10,10,26
76,373,221,30,191,1,190,1,51,53,25,4,0,1,13,2,40
76,374,1053,231,822,13,809,2,200,135,104,10,7,4,45,13,289
76,375,262,35,227,3,224,0,35,62,30,0,3,0,20,11,63
76,376,207,39,168,6,162,1,43,32,20,1,1,0,19,4,41
76,377,2201,295,1906,22,1884,44,196,677,179,15,5,5,213,41,509
76,378,1450,258,1192,30,1162,11,263,263,139,16,8,5,105,20,332
76,379,140,27,113,0,113,1,20,43,11,0,1,0,8,2,27
76,380,278,35,243,2,241,5,48,82,23,1,3,1,18,4,56
76,381,120,23,97,0,97,0,32,29,11,0,0,0,6,1,18
76,382,813,137,676,10,666,7,170,151,69,11,6,0,71,19,162
76,383,77,7,70,3,67,1,19,14,8,0,1,0,5,0,19
76,384,6633,1869,4764,92,4672,63,934,953,658,70,39,15,343,84,1513
76,385,1101,186,915,17,898,16,199,213,110,16,10,3,74,19,238
76,386,240,23,217,0,217,3,47,57,42,3,4,0,6,3,52
76,387,262,21,241,5,236,5,55,64,10,5,4,0,23,2,68
76,388,366,65,301,9,292,4,48,68,44,3,2,1,29,4,89
76,389,156,20,136,3,133,4,28,36,16,0,3,0,4,5,37
76,390,882,149,733,14,719,15,146,189,115,13,1,2,56,14,168
76,391,1812,246,1566,31,1535,20,264,408,181,18,9,1,113,32,489
76,392,913,161,752,16,736,4,167,267,59,7,13,0,79,14,126
76,393,42,5,37,1,36,3,8,12,1,1,0,0,3,0,8
76,394,525,52,473,5,468,0,142,84,51,7,3,2,17,8,154
76,395,521,84,437,8,429,9,86,142,30,4,3,3,33,6,113
76,396,244,42,202,2,200,4,40,78,11,2,1,0,12,8,44
76,397,670,99,571,14,557,9,112,160,41,8,6,2,32,10,177
76,398,543,61,482,10,472,11,96,122,56,4,2,0,39,10,132
76,399,150,31,119,6,113,1,22,34,8,5,1,0,16,5,21
76,400,1735,287,1448,32,1416,14,284,415,107,14,8,4,95,25,450
76,401,1286,9,1277,22,1255,18,276,273,119,21,5,4,92,34,413
76,402,4618,987,3631,62,3569,49,808,703,478,42,37,3,215,72,1162
76,403,152,26,126,2,124,0,20,40,5,2,2,0,13,5,37
76,404,920,120,800,11,789,16,126,222,101,10,2,1,96,11,204
76,405,150,18,132,3,129,1,27,43,10,1,1,0,7,3,36
76,406,258,27,231,2,229,2,44,53,25,3,1,1,27,5,68
76,407,238,21,217,5,212,0,30,68,26,0,2,2,24,2,58
76,408,706,92,614,17,597,7,172,121,68,9,5,1,52,13,149
76,409,609,84,525,16,509,9,112,123,52,12,4,2,46,8,141
76,410,7334,1625,5709,99,5610,66,1086,1163,769,76,44,12,375,77,1942
76,411,176,25,151,5,146,1,47,54,12,2,1,0,6,6,17
76,412,554,84,470,8,462,8,110,119,54,3,6,3,53,11,95
76,413,352,44,308,6,302,1,69,82,31,3,1,0,21,9,85
76,414,1228,190,1038,27,1011,16,200,274,122,9,5,2,94,15,274
76,415,246,49,197,1,196,1,39,82,17,2,0,0,10,5,40
76,416,175,31,144,1,143,1,37,40,20,1,5,1,9,4,25
76,417,291,36,255,4,251,0,77,70,21,2,4,1,28,2,46
76,418,777,102,675,10,665,8,136,142,84,18,8,0,39,7,223
76,419,120,12,108,0,108,1,20,39,11,0,0,0,9,8,20
76,420,247,33,214,1,213,4,61,67,16,0,1,0,14,8,42
76,421,580,58,522,10,512,6,101,144,63,9,1,1,55,4,128
76,422,212,31,181,4,177,3,32,45,18,5,5,0,10,0,59
76,423,160,11,149,1,148,3,44,55,3,1,1,0,17,3,21
76,424,172,23,149,2,147,0,27,51,11,1,1,1,7,4,44
76,425,183,20,163,7,156,2,40,30,29,1,4,0,11,5,34
76,426,140,36,104,1,103,1,34,29,8,2,1,0,10,3,15
76,427,634,68,566,12,554,12,121,138,58,5,6,1,46,11,156
76,428,32,4,28,0,28,0,2,12,1,2,1,0,3,0,7
76,429,5918,947,4971,71,4900,94,586,1851,414,47,13,13,623,87,1172
76,430,103,13,90,2,88,2,23,24,16,1,1,0,7,2,12
76,431,86,18,68,0,68,2,29,15,3,0,0,0,8,1,10
76,432,179,21,158,5,153,4,57,35,12,4,3,0,14,1,23
76,433,476,62,414,7,407,6,105,121,33,0,3,0,33,8,98
76,434,643,76,567,7,560,11,118,155,51,7,3,0,76,7,132
76,435,460,65,395,8,387,4,115,93,32,5,2,1,25,10,100
76,436,495,93,402,8,394,11,82,96,58,4,4,2,30,4,103
76,437,414,71,343,4,339,5,101,58,28,9,3,1,29,8,97
76,438,212,27,185,5,180,0,50,38,26,3,2,1,13,5,42
76,439,240,25,215,3,212,0,51,84,27,3,0,0,12,2,33
76,440,126,28,98,1,97,1,25,32,11,1,0,0,2,4,21
76,441,541,74,467,3,464,5,133,93,61,5,2,1,13,7,144
76,442,431,43,388,6,382,4,87,95,47,7,4,1,32,3,102
76,443,492,93,399,5,394,4,78,105,59,5,1,0,34,13,95
76,444,80,7,73,1,72,1,21,16,8,1,0,0,4,1,20
76,445,404,71,333,4,329,7,97,75,47,2,2,0,27,19,53
76,446,952,120,832,18,814,21,88,347,49,3,2,1,106,16,181
76,447,12311,2507,9804,176,9628,151,1779,2185,1368,153,70,25,782,163,2952
76,448,1042,151,891,14,877,17,177,245,78,10,4,1,87,26,232
76,449,353,60,293,6,287,2,69,74,30,3,1,1,23,7,77
76,450,226,37,189,5,184,2,62,33,17,4,1,0,17,8,40
76,451,12809,2290,10519,139,10380,334,881,3746,1052,65,30,12,1202,151,2907
76,452,3749,719,3030,69,2961,45,733,778,308,36,23,5,235,53,745
76,453,801,141,660,11,649,16,126,175,72,8,6,3,63,25,155
76,454,83,16,67,1,66,0,31,19,3,1,0,0,5,1,6
76,455,190,22,168,6,162,3,46,37,15,0,0,2,24,4,31
76,456,539,58,481,11,470,4,97,125,39,7,6,2,38,9,143
76,457,677,132,545,13,532,10,125,76,74,10,2,4,41,9,181
76,458,109,14,95,2,93,2,14,23,15,0,0,0,9,2,28
76,459,251,27,224,4,220,6,38,71,29,1,3,0,32,0,40
76,460,423,64,359,9,350,1,99,75,20,7,8,1,20,7,112
76,461,292,41,251,4,247,2,71,78,28,0,1,0,22,4,41
76,462,3384,786,2598,51,2547,35,532,873,219,23,24,5,195,62,579
76,463,524,104,420,7,413,3,119,117,37,8,5,3,28,14,79
76,464,1682,222,1460,18,1442,19,228,458,152,16,4,3,152,32,378
76,465,424,68,356,7,349,1,91,117,25,4,3,2,15,9,82
76,467,954,205,749,13,736,3,177,143,96,14,6,2,54,19,222
76,468,924,131,793,18,775,12,171,157,103,9,14,2,63,29,215
76,469,290,47,243,4,239,5,79,66,25,2,1,0,17,7,37
76,470,499,43,456,17,439,4,86,113,46,7,3,1,36,7,136
76,471,749,112,637,16,621,8,148,149,72,16,7,1,47,12,161
76,472,482,67,415,16,399,3,120,119,29,10,9,1,29,8,71
76,473,588,124,464,10,454,7,86,91,56,4,2,3,38,10,157
76,474,5246,1118,4128,84,4044,84,724,855,512,41,24,11,380,56,1357
76,475,4714,726,3988,62,3926,70,517,1365,345,39,12,4,479,52,1043
76,476,6089,1313,4776,72,4704,66,939,1062,627,68,28,23,388,92,1411
76,477,322,40,282,3,279,7,59,56,41,2,0,2,35,5,72
76,478,152,29,123,2,121,3,34,28,17,0,1,0,8,4,26
76,479,98,23,75,4,71,0,17,20,2,1,0,0,9,4,18
76,480,354,51,303,3,300,2,64,77,46,2,0,1,29,2,77
76,481,4561,764,3797,71,3726,53,805,1240,381,33,19,7,341,78,769
76,482,2660,437,2223,35,2188,36,315,677,217,24,25,3,175,38,678
76,483,183,25,158,3,155,0,28,47,21,1,0,1,15,3,39
76,484,7144,1335,5809,125,5684,85,982,916,1420,88,44,15,299,61,1774
76,485,195,22,173,0,173,2,30,39,18,3,1,0,26,3,51
76,486,732,142,590,5,585,9,151,101,93,11,9,5,26,7,173
76,487,266,46,220,6,214,3,57,67,7,3,1,0,23,5,48
76,488,440,90,350,6,344,3,76,90,29,6,4,1,29,6,100
76,489,308,45,263,5,258,2,72,74,28,4,2,0,20,2,54
76,490,789,140,649,12,637,7,157,178,61,7,9,3,40,8,167
76,491,527,88,439,7,432,10,90,99,40,5,1,3,31,8,145
76,492,436,51,385,3,382,1,61,147,41,2,1,2,25,9,93
76,493,341,53,288,8,280,0,64,92,28,5,4,0,23,6,58
76,494,409,55,354,4,350,9,80,98,60,7,2,2,13,17,62
76,495,4724,947,3777,82,3695,36,852,731,415,52,43,8,249,60,1249
76,496,307,52,255,2,253,2,87,40,33,5,0,2,16,6,62
76,497,6253,1084,5169,96,5073,53,999,792,897,80,40,7,300,77,1828
76,498,12597,2591,10006,198,9808,184,1850,1486,1590,150,73,17,625,157,3676
76,499,834,134,700,14,686,5,179,142,85,16,9,3,63,15,169
76,500,367,54,313,5,308,2,101,68,25,3,5,0,17,5,82
76,501,98,9,89,1,88,2,11,38,12,0,0,1,8,5,11
76,502,336,28,308,4,304,2,55,96,26,8,1,1,30,8,77
76,503,995,116,879,13,866,11,167,247,83,16,4,2,88,20,228
76,504,132,23,109,2,107,0,24,41,4,0,0,0,13,2,23
76,505,84,11,73,1,72,6,10,23,8,0,0,0,6,1,18
76,506,292,39,253,5,248,6,70,63,23,1,0,4,17,3,61
76,507,664,148,516,9,507,4,92,121,54,7,4,3,41,15,166
76,508,294,41,253,6,247,5,44,75,33,3,3,1,27,5,51
76,509,1320,187,1133,6,1127,12,176,354,98,9,5,4,126,36,307
76,510,155,25,130,4,126,5,27,33,12,1,1,0,12,1,34
76,511,101,16,85,5,80,0,16,27,4,4,2,0,6,3,18
76,512,29,8,21,0,21,0,2,7,3,0,1,0,3,0,5
76,513,486,57,429,4,425,13,76,143,49,4,4,0,36,9,91
76,514,805,106,699,14,685,9,118,130,121,13,4,2,67,18,203
76,515,445,45,400,6,394,5,80,155,41,2,6,0,23,6,76
76,516,388,54,334,3,331,3,62,120,33,2,6,4,25,8,68
76,517,2484,317,2167,43,2124,25,305,767,185,22,5,7,258,42,508
76,518,395,61,334,5,329,3,66,75,30,8,3,2,33,11,98
76,519,66,12,54,1,53,0,9,27,1,1,0,1,2,0,12
76,520,506,78,428,5,423,4,125,106,28,8,4,0,22,7,119
76,521,113,8,105,1,104,4,22,37,12,1,0,0,9,2,17
76,522,1007,145,862,20,842,12,203,223,111,14,3,0,93,22,161
76,523,163,37,126,5,121,3,29,25,8,1,1,0,9,3,42
76,524,100,11,89,1,88,0,23,37,7,0,0,0,3,2,16
76,525,258,23,235,6,229,3,50,49,29,2,4,0,19,4,69
76,526,111,12,99,2,97,0,28,21,8,2,0,0,9,3,26
76,527,342,42,300,5,295,5,75,100,22,2,1,1,20,7,62
76,528,469,57,412,14,398,3,116,77,30,3,2,0,27,14,126
76,529,230,24,206,3,203,2,28,65,19,4,1,0,17,5,62
76,530,133,12,121,1,120,3,27,43,4,2,1,1,10,0,29
76,531,245,25,220,5,215,4,44,65,16,2,0,0,12,3,69
76,532,591,80,511,8,503,7,125,126,61,9,1,3,47,16,108
76,533,969,165,804,15,789,4,193,183,129,11,2,4,51,11,201
76,534,805,118,687,15,672,9,109,192,72,12,10,2,74,11,181
76,535,350,54,296,9,287,7,83,82,34,3,3,0,17,11,47
76,536,870,102,768,15,753,14,134,199,97,5,6,0,72,14,212
76,537,129,18,111,2,109,1,23,43,7,1,0,1,12,3,18
76,538,208,33,175,4,171,2,38,45,23,4,3,0,20,3,33
76,540,57599,11800,45799,691,45108,1468,4951,11436,6308,500,213,129,4149,634,15320
76,541,972,100,872,16,856,13,133,310,82,6,4,5,78,17,208
76,542,191,27,164,1,163,0,41,50,9,1,2,0,14,0,46
76,543,468,80,388,7,381,3,85,125,33,7,5,1,28,8,86
76,544,181,19,162,1,161,2,39,58,16,1,1,1,18,4,21
76,545,1570,250,1320,34,1286,20,277,249,217,11,11,0,80,31,390
76,546,187,18,169,1,168,2,35,43,23,1,2,0,17,2,43
76,547,441,54,387,4,383,5,64,124,46,6,1,3,37,9,88
76,548,533,65,468,16,452,6,78,162,45,6,2,1,34,7,111
76,549,125,17,108,1,107,0,25,46,2,0,1,0,14,1,18
76,550,993,110,883,24,859,13,124,252,89,5,4,2,89,16,265
76,551,719,97,622,12,610,18,133,197,61,7,3,0,54,22,115
76,552,5787,1008,4779,59,4720,114,474,2191,362,30,10,10,447,64,1018
76,553,253,53,200,4,196,1,83,58,6,3,1,0,5,2,37
76,554,239,39,200,6,194,5,60,49,15,2,3,0,15,3,42
76,555,687,84,603,11,592,12,115,170,70,6,7,1,44,20,147
76,556,790,109,681,13,668,10,141,162,93,10,4,2,52,13,181
76,557,919,117,802,10,792,15,177,148,85,17,11,5,62,20,252
76,558,699,69,630,10,620,13,124,153,94,10,2,2,53,5,164
76,559,436,71,365,13,352,3,76,78,34,6,2,3,24,5,121
76,560,773,86,687,13,674,19,123,186,95,9,4,2,57,12,167
76,561,5704,1194,4510,106,4404,42,953,978,564,62,34,9,237,99,1426
76,562,754,104,650,6,644,6,136,188,66,10,4,3,50,15,166
76,563,978,161,817,16,801,12,149,264,83,12,9,3,75,11,183
76,564,204,21,183,2,181,3,42,70,13,0,0,1,15,1,36
76,565,839,103,736,16,720,12,136,219,86,9,4,3,63,12,176
76,566,454,78,376,9,367,6,104,73,47,2,2,1,24,5,103
76,567,155,15,140,0,140,0,29,55,11,3,2,0,16,0,24
76,568,511,65,446,3,443,12,99,107,38,11,5,1,35,11,124
76,569,173,24,149,3,146,1,23,53,12,4,1,0,12,2,38
76,570,179,34,145,2,143,0,21,42,21,1,6,0,9,1,42
76,571,497,73,424,12,412,5,104,133,28,8,0,2,36,6,90
76,572,117,22,95,3,92,1,17,19,10,3,2,0,5,0,35
76,573,383,42,341,2,339,10,71,110,28,3,0,1,33,12,71
76,574,400,75,325,6,319,7,84,82,32,1,0,0,33,20,60
76,575,16565,3271,13294,205,13089,151,2213,1832,2897,145,74,24,704,187,4862
76,576,815,119,696,12,684,6,140,158,92,15,11,4,52,16,190
76,577,397,70,327,5,322,4,76,77,33,5,1,0,21,12,93
76,578,217,46,171,8,163,0,45,50,14,4,0,1,17,5,27
76,580,707,99,608,12,596,23,75,214,59,6,6,2,52,5,154
76,581,309,33,276,4,272,7,67,93,18,6,3,2,15,7,54
76,582,252,43,209,1,208,0,41,63,22,2,2,0,15,2,61
76,583,223,26,197,3,194,5,40,55,20,2,3,0,17,4,48
76,584,178,26,152,7,145,1,47,23,14,1,3,0,15,3,38
76,585,290,37,253,1,252,2,72,54,24,4,3,0,22,3,68
76,586,472,71,401,6,395,6,80,119,43,3,2,2,39,9,92
76,587,573,102,471,7,464,2,98,156,45,7,3,0,36,8,109
76,588,373,65,308,7,301,6,56,117,18,1,6,0,19,2,76
76,589,160,29,131,5,126,3,25,44,16,0,1,2,10,4,21
76,590,280,45,235,4,231,1,73,61,21,5,1,0,6,7,56
76,591,2169,293,1876,35,1841,36,323,559,175,13,7,5,209,35,479
76,592,629,91,538,13,525,8,138,154,41,8,3,1,33,13,126
76,593,454,63,391,5,386,7,84,110,56,5,3,1,33,15,72
76,594,1089,139,950,19,931,7,151,314,97,7,5,0,87,12,251
76,595,1378,237,1141,8,1133,26,266,307,144,12,3,3,97,19,256
76,596,1081,145,936,21,915,12,144,226,146,9,5,0,105,21,247
76,597,561,94,467,10,457,5,104,107,37,0,4,0,32,11,157
76,598,378,61,317,2,315,1,101,89,21,2,2,1,24,7,67
76,599,2494,393,2101,29,2072,37,343,477,312,31,9,8,167,40,648
76,600,1336,183,1153,24,1129,21,243,341,120,7,8,2,89,24,274
76,602,453,72,381,0,381,4,88,102,32,6,3,0,35,6,105
76,603,356,55,301,5,296,2,78,91,30,5,1,1,23,4,61
76,604,169,24,145,6,139,0,29,53,16,2,0,0,9,1,29
76,605,434,84,350,4,346,6,46,147,35,0,3,0,24,7,78
76,606,141,20,121,5,116,1,29,59,2,0,1,0,5,1,18
76,607,212,37,175,0,175,2,29,53,22,3,3,0,18,4,41
76,608,1358,165,1193,18,1175,14,262,232,164,6,6,3,90,23,375
76,609,244,31,213,3,210,1,56,65,30,3,0,0,18,4,33
76,610,1307,201,1106,19,1087,15,217,280,97,5,8,2,98,13,352
76,611,245,18,227,2,225,5,43,57,15,2,1,1,21,1,79
76,612,157,28,129,2,127,0,38,24,15,4,0,0,7,3,36
76,613,551,85,466,12,454,4,92,150,47,6,4,1,35,7,108
76,614,1215,155,1060,13,1047,31,120,412,67,6,5,4,123,20,259
76,615,522,107,415,6,409,6,88,102,56,5,2,3,43,6,98
76,616,1198,192,1006,29,977,14,131,334,100,12,3,7,124,20,232
76,617,1456,151,1305,10,1295,36,121,655,70,9,1,1,162,16,224
76,618,945,133,812,12,800,17,207,194,79,3,10,1,71,10,208
76,619,235,37,198,3,195,2,39,80,20,4,2,0,10,4,34
76,620,205,24,181,2,179,3,42,56,24,0,1,0,16,1,36
76,621,791,112,679,9,670,8,180,192,54,13,3,2,53,22,143
76,622,247,34,213,3,210,0,40,73,15,3,0,1,20,3,55
76,623,98,12,86,0,86,4,28,30,5,1,1,1,3,1,12
76,624,2830,486,2344,32,2312,19,555,586,268,27,19,9,151,41,637
76,625,438,55,383,4,379,10,71,77,52,2,2,0,33,2,130
76,626,319,32,287,6,281,1,56,69,43,3,3,0,27,9,70
76,627,1046,164,882,22,860,4,191,211,120,10,11,1,67,22,223
76,628,578,65,513,8,505,3,110,137,46,11,5,1,37,11,144
76,629,190,19,171,3,168,2,48,42,13,0,1,0,6,4,52
76,630,182,21,161,4,157,1,43,39,19,0,4,0,14,3,34
76,631,1043,159,884,26,858,11,172,193,106,6,8,3,68,24,267
76,632,245,41,204,0,204,4,59,46,12,3,3,0,2,1,74
76,634,612,61,551,11,540,8,97,158,53,5,4,0,46,19,150
76,635,77,9,68,0,68,0,16,26,3,0,2,0,5,2,14
76,636,1825,243,1582,32,1550,19,242,365,184,22,18,1,115,36,548
76,637,742,124,618,12,606,10,126,179,60,9,6,0,38,14,164
76,638,885,113,772,12,760,4,181,189,101,10,9,0,45,23,198
76,639,160,8,152,3,149,1,33,41,15,5,1,0,12,3,38
76,640,6407,1381,5026,108,4918,44,1044,1010,681,79,37,15,340,80,1588
76,641,168,24,144,2,142,0,21,59,14,1,2,1,8,2,34
76,642,209,29,180,0,180,0,55,39,24,3,3,1,12,0,43
76,643,75,12,63,2,61,0,15,33,5,0,0,0,0,2,6
76,644,597,82,515,14,501,2,116,135,59,6,5,1,33,13,131
76,645,105,21,84,1,83,0,24,24,8,1,0,0,3,3,20
76,646,446,44,402,8,394,3,71,107,38,5,8,2,28,18,114
76,647,2932,587,2345,38,2307,38,477,716,258,20,10,7,207,43,531
76,648,1698,241,1457,29,1428,23,288,408,130,21,14,4,105,30,405
76,649,442,64,378,7,371,7,98,116,32,10,6,1,32,9,60
76,650,881,148,733,19,714,10,133,219,98,9,9,3,58,15,160
76,651,157,16,141,1,140,4,27,51,13,3,3,0,12,3,24
76,652,467,74,393,1,392,7,100,98,45,4,1,6,20,7,104
76,653,281,56,225,2,223,2,55,61,27,2,3,0,20,2,51
76,654,337,38,299,6,293,5,68,65,21,5,2,0,28,15,84
76,655,3531,815,2716,59,2657,37,433,755,307,43,12,8,207,51,804
76,656,451,54,397,6,391,12,96,115,28,6,2,0,19,10,103
76,657,787,106,681,11,670,3,146,157,94,8,5,3,61,25,168
76,658,479,81,398,7,391,7,63,115,43,4,1,1,51,18,88
76,659,942,134,808,16,792,10,152,181,110,9,8,3,69,16,234
76,660,588,70,518,5,513,8,160,100,61,14,4,0,36,4,126
76,662,88,12,76,1,75,1,9,20,4,1,0,0,5,1,34
76,663,811,134,677,10,667,8,118,245,72,8,3,5,50,13,145
76,664,199,25,174,1,173,3,15,32,34,1,0,1,24,5,58
76,665,347,45,302,7,295,3,61,92,38,2,0,2,19,6,72
76,666,311,50,261,6,255,5,87,96,18,2,0,0,19,4,24
76,667,279,26,253,5,248,3,58,67,47,3,2,1,19,4,44
76,668,248,18,230,5,225,6,51,76,15,2,3,0,16,7,49
76,669,312,53,259,5,254,2,75,43,27,6,0,1,34,8,58
76,670,648,105,543,9,534,10,122,138,51,11,5,2,41,15,139
76,671,132,11,121,4,117,1,31,28,11,5,2,1,7,3,28
76,672,765,136,629,19,610,7,148,162,54,14,4,1,65,17,138
76,673,845,155,690,8,682,8,143,165,99,13,6,1,52,13,182
76,674,235,27,208,3,205,1,46,52,25,2,3,2,9,7,58
76,675,733,87,646,19,627,8,126,188,92,11,1,0,38,14,149
76,676,560,82,478,2,476,9,146,169,31,3,1,1,31,9,76
76,677,260,55,205,4,201,8,67,54,12,3,4,1,7,3,42
76,678,566,85,481,8,473,10,131,148,36,9,4,0,42,16,77
76,679,65,4,61,0,61,1,8,29,6,2,0,0,7,0,8
76,680,133,24,109,0,109,2,14,32,18,0,1,1,9,1,31
76,681,20087,3722,16365,331,16034,302,2570,2871,2549,214,113,36,1069,220,6090
76,682,537,64,473,8,465,6,101,94,65,8,6,1,41,7,136
76,683,314,28,286,6,280,2,52,98,24,3,1,0,22,5,73
76,684,935,152,783,13,770,7,171,132,131,15,7,4,54,15,234
76,685,417,72,345,11,334,4,83,116,45,4,7,2,20,7,46
76,686,344,48,296,5,291,1,85,84,24,1,3,1,13,9,70
76,688,283,49,234,4,230,3,53,55,22,7,3,0,18,4,65
76,689,285,32,253,2,251,2,60,84,29,1,1,0,13,6,55
76,690,453,76,377,5,372,5,73,103,54,5,5,0,28,4,95
76,691,184,18,166,2,164,5,49,51,15,2,0,0,15,7,20
76,692,205,34,171,8,163,4,30,43,13,3,1,0,17,4,48
76,693,501,53,448,11,437,8,81,146,57,9,0,0,45,5,86
76,694,105,2,103,0,103,0,19,41,5,0,0,0,8,0,30
76,695,203,23,180,3,177,0,54,38,25,6,2,0,15,6,31
76,696,170,25,145,3,142,0,42,29,13,2,1,1,20,9,25
76,697,558,97,461,6,455,4,121,94,53,2,5,1,37,10,128
76,698,376,74,302,5,297,1,77,80,16,2,2,1,21,4,93
76,699,273,31,242,2,240,0,70,52,15,3,2,1,24,6,67
76,700,1050,209,841,17,824,4,196,243,29,15,7,1,53,11,265
76,701,315,40,275,4,271,5,50,37,38,4,1,0,32,8,96
76,702,641,76,565,8,557,16,77,140,63,14,5,1,59,5,177
76,703,173,29,144,2,142,7,35,45,13,3,0,1,8,1,29
76,704,418,66,352,8,344,1,95,73,41,2,3,0,25,12,92
76,705,1815,280,1535,27,1508,15,280,257,469,16,8,1,72,20,370
76,706,453,53,400,6,394,3,86,118,40,5,0,0,34,10,98
76,707,969,171,798,22,776,5,144,213,104,7,5,0,63,16,219
76,708,581,81,500,15,485,5,92,127,62,3,3,1,35,10,147
76,709,4070,980,3090,48,3042,40,690,428,444,65,38,10,165,55,1107
76,710,90,10,80,2,78,1,8,29,7,3,0,0,6,0,24
76,711,4202,1026,3176,47,3129,37,791,491,700,48,30,7,146,57,822
76,712,589,97,492,8,484,3,102,97,58,8,5,1,25,19,166
76,713,314,50,264,5,259,2,53,62,38,5,0,0,22,8,69
76,714,595,72,523,10,513,5,116,160,53,6,2,1,53,13,104
76,715,498,55,443,13,430,6,78,150,36,5,1,0,59,9,86
76,716,1153,130,1023,18,1005,12,215,235,198,12,12,2,83,14,222
76,717,559,99,460,6,454,5,76,113,76,12,1,1,39,4,127
76,718,1027,142,885,15,870,12,149,312,67,6,7,1,83,17,216
76,719,714,104,610,17,593,9,142,205,46,4,4,1,40,12,130
76,720,1039,182,857,9,848,12,96,367,78,6,0,4,70,8,207
76,721,228,42,186,3,183,1,50,47,11,1,0,0,15,4,54
76,723,303,41,262,7,255,3,60,61,31,3,1,1,11,7,77
76,724,88,9,79,4,75,1,9,20,9,3,0,0,4,0,29
76,725,405,54,351,1,350,5,85,92,43,5,2,0,28,8,82
76,726,233,30,203,6,197,6,21,58,23,2,2,0,14,2,69
76,727,884,106,778,19,759,8,168,200,75,9,4,1,51,12,231
76,728,792,108,684,15,669,10,109,224,62,8,3,6,51,13,183
76,729,601,101,500,7,493,3,88,160,32,5,5,3,47,8,142
76,730,111,13,98,1,97,1,27,43,7,1,0,0,4,1,13
76,731,138,21,117,0,117,3,39,18,14,1,4,0,6,3,29
76,732,214,26,188,1,187,1,53,41,30,0,1,0,10,4,47
76,733,177,23,154,2,152,2,53,35,24,2,0,1,7,3,25
76,734,297,35,262,5,257,2,49,87,40,3,1,0,14,10,51
76,735,566,90,476,8,468,6,60,185,39,6,2,1,44,7,118
76,736,310,46,264,6,258,3,45,114,11,3,2,1,24,5,50
76,737,481,58,423,5,418,4,85,109,46,5,4,0,41,16,108
76,738,534,71,463,8,455,11,71,132,55,1,1,0,40,13,131
76,739,461,72,389,8,381,2,102,99,30,3,1,3,36,3,102
76,740,355,34,321,6,315,3,72,110,31,2,4,1,38,6,48
76,741,221,20,201,3,198,3,39,77,21,2,0,0,21,5,30
76,742,609,106,503,7,496,5,108,126,54,10,1,1,38,9,144
76,743,1373,222,1151,14,1137,14,230,245,116,11,8,5,97,17,394
76,744,178,36,142,6,136,3,30,45,13,1,0,0,11,2,31
76,745,157,30,127,2,125,2,42,44,13,1,2,0,5,1,15
76,746,177,22,155,4,151,2,30,57,12,1,5,0,9,3,32
76,747,233,21,212,4,208,4,50,45,34,3,2,0,9,5,56
76,748,497,70,427,9,418,4,74,129,38,2,0,0,39,11,121
76,749,251,51,200,5,195,2,58,69,11,1,0,0,15,5,34
76,750,868,122,746,7,739,9,152,96,106,21,6,0,40,16,293
76,751,960,168,792,29,763,9,148,195,85,14,6,0,62,9,235
76,752,1805,259,1546,27,1519,23,325,470,106,16,16,5,119,30,409
76,753,946,139,807,24,783,9,95,183,189,3,1,4,82,9,208
76,754,704,122,582,7,575,8,122,129,86,12,2,3,27,5,181
76,755,397,64,333,9,324,3,88,76,42,8,5,1,18,5,78
76,756,186,23,163,2,161,9,31,53,14,0,1,0,19,3,31
76,757,518,77,441,4,437,5,101,89,44,18,6,1,30,2,141
76,758,8287,1700,6587,126,6461,135,1086,1634,726,85,34,20,574,113,2054
76,759,369,57,312,3,309,7,68,59,36,1,4,1,31,9,93
77,1,906,148,758,15,743,22,126,280,62,2,0,3,96,14,138
77,2,553,94,459,8,451,8,148,136,35,7,1,0,37,9,70
77,3,277,36,241,1,240,2,49,83,16,1,0,1,26,6,56
77,4,266,44,222,3,219,2,41,78,18,1,1,0,17,7,54
77,5,2059,395,1664,24,1640,36,312,557,153,13,3,5,171,31,359
77,6,663,123,540,6,534,8,102,187,43,2,2,3,50,15,122
77,7,273,30,243,1,242,9,46,80,18,0,0,0,18,8,63
77,8,767,207,560,7,553,8,104,250,47,4,1,2,34,7,96
77,9,117,24,93,2,91,2,26,30,5,1,0,0,11,3,13
77,10,626,101,525,1,524,10,140,158,57,5,1,2,48,8,95
77,11,365,60,305,8,297,2,68,102,37,2,2,0,25,7,52
77,12,274,48,226,4,222,4,54,78,9,1,0,1,16,3,56
77,13,310,61,249,1,248,2,45,97,20,3,2,0,41,4,34
77,14,8839,1932,6907,90,6817,208,972,1927,715,50,36,24,734,147,2004
77,15,69,11,58,3,55,1,7,32,4,1,2,0,3,4,1
77,16,1042,172,870,14,856,9,226,186,115,7,8,1,65,16,223
77,18,3473,705,2768,39,2729,47,450,863,245,34,5,12,275,53,745
77,19,248,42,206,4,202,6,59,57,17,1,2,3,13,5,39
77,20,439,77,362,4,358,2,90,131,28,7,0,0,29,15,56
77,21,133,15,118,2,116,1,34,38,13,1,0,0,4,0,25
77,22,1208,242,966,12,954,15,101,534,56,5,3,0,93,15,132
77,23,179,32,147,0,147,1,20,59,13,4,0,0,19,3,28
77,24,253,46,207,6,201,1,64,69,17,2,2,1,12,3,30
77,25,633,117,516,12,504,9,159,140,37,6,8,1,32,10,102
77,26,254,40,214,4,210,6,42,73,17,6,0,1,12,3,50
77,27,690,126,564,7,557,8,141,138,74,6,5,4,45,19,117
77,28,488,91,397,6,391,9,96,147,37,6,1,3,29,8,55
77,29,160,22,138,1,137,1,32,53,18,0,0,0,7,0,26
77,30,537,96,441,8,433,10,130,105,40,10,2,0,38,13,85
77,31,623,100,523,5,518,9,96,201,55,6,2,0,35,21,93
77,32,523,127,396,5,391,5,98,131,30,7,3,1,36,13,67
77,33,147,21,126,4,122,1,31,42,14,1,0,0,11,3,19
77,34,554,66,488,9,479,9,97,146,59,6,2,0,48,8,104
77,35,440,78,362,9,353,4,107,78,37,10,2,4,31,9,71
77,36,94,16,78,1,77,0,22,23,6,0,1,0,13,4,8
77,37,4656,937,3719,46,3673,152,394,1307,337,26,10,14,483,70,880
77,38,344,56,288,1,287,7,43,121,11,6,1,1,34,3,60
77,39,724,147,577,5,572,13,87,233,53,2,1,0,59,6,118
77,40,2757,471,2286,32,2254,57,388,790,151,21,15,5,238,64,525
77,41,260,35,225,4,221,11,40,79,21,0,0,2,16,13,39
77,42,2316,423,1893,23,1870,21,506,522,178,16,8,7,167,47,398
77,43,254,49,205,1,204,2,65,58,18,1,1,0,22,6,31
77,44,656,104,552,7,545,11,133,143,72,4,5,2,32,16,127
77,45,553,112,441,7,434,4,125,125,44,8,2,1,45,12,68
77,46,300,58,242,2,240,11,56,71,18,6,3,0,24,5,46
77,47,1006,209,797,9,788,9,210,234,64,10,9,2,78,10,162
77,48,2070,385,1685,27,1658,57,243,668,115,17,12,3,166,34,343
77,49,681,100,581,8,573,8,108,247,35,6,0,0,53,8,108
77,50,369,56,313,6,307,10,70,106,12,4,1,1,28,4,71
77,51,1579,447,1132,22,1110,13,267,298,108,15,5,1,92,24,287
77,52,273,44,229,6,223,7,57,46,27,2,0,0,23,6,55
77,53,9969,2445,7524,127,7397,115,1451,2091,741,66,35,9,634,226,2029
77,54,520,104,416,15,401,13,107,85,49,3,1,1,25,12,105
77,55,2868,732,2136,44,2092,41,480,424,295,29,16,2,155,49,601
77,56,117,29,88,2,86,2,25,27,8,0,1,1,5,3,14
77,57,291,55,236,6,230,3,66,59,16,3,2,0,19,8,54
77,58,13033,3154,9879,143,9736,212,1057,3200,843,78,25,23,1214,173,2911
77,59,563,104,459,3,456,20,65,178,40,3,1,2,56,4,87
77,60,554,93,461,8,453,21,107,134,38,5,2,3,41,10,92
77,61,1582,310,1272,28,1244,17,323,334,121,11,9,2,88,22,317
77,62,289,46,243,5,238,11,41,82,23,0,0,3,19,3,56
77,63,880,142,738,14,724,12,196,200,84,8,2,1,53,13,155
77,65,898,154,744,13,731,15,161,246,47,8,6,4,74,17,153
77,66,243,42,201,1,200,12,44,65,13,4,0,2,21,6,33
77,67,6461,1102,5359,77,5282,144,767,1387,577,52,20,16,571,153,1595
77,68,178,25,153,3,150,4,40,63,0,1,0,0,16,3,23
77,69,1484,287,1197,10,1187,20,229,436,112,16,4,4,113,25,228
77,70,929,200,729,16,713,8,169,211,55,8,8,2,49,20,183
77,71,705,119,586,14,572,3,150,152,83,3,3,0,56,14,108
77,72,456,84,372,5,367,4,108,106,34,4,0,0,35,12,64
77,73,419,72,347,9,338,8,93,93,37,3,1,1,21,9,72
77,75,880,192,688,11,677,26,134,183,89,9,4,4,64,9,155
77,76,550,106,444,10,434,4,88,84,66,9,4,2,47,16,114
77,77,690,136,554,8,546,7,113,200,46,6,1,2,37,14,120
77,78,864,168,696,11,685,13,192,174,65,8,4,3,59,14,153
77,79,3734,778,2956,53,2903,48,630,589,363,49,21,5,215,58,925
77,80,115,12,103,1,102,2,21,39,4,1,1,2,6,4,22
77,81,415,73,342,7,335,1,98,82,36,2,1,0,26,15,74
77,82,567,79,488,8,480,4,118,139,45,7,1,2,40,8,116
77,83,14334,3402,10932,208,10724,283,1454,2329,1564,115,43,27,931,169,3809
77,84,838,180,658,9,649,12,143,187,51,17,1,2,59,11,166
77,85,1562,344,1218,22,1196,33,180,328,122,9,5,6,142,29,342
77,86,878,147,731,16,715,18,218,165,79,9,6,2,46,17,155
77,87,124,30,94,1,93,2,12,47,4,0,0,0,12,0,16
77,88,1706,392,1314,23,1291,12,335,344,108,9,12,1,131,40,299
77,89,600,83,517,6,511,7,144,134,50,3,0,0,38,18,117
77,90,129,15,114,1,113,0,43,21,14,0,1,0,6,2,26
77,91,296,52,244,7,237,4,74,67,26,2,0,0,19,5,40
77,93,302,69,233,1,232,4,64,70,18,0,1,1,12,6,56
77,94,184,19,165,2,163,3,43,54,14,3,1,0,14,2,29
77,95,817,137,680,21,659,6,184,171,68,7,4,0,45,20,154
77,96,1927,302,1625,25,1600,55,228,502,146,7,6,4,173,46,433
77,97,206,34,172,1,171,2,45,61,10,3,0,0,8,6,36
77,98,269,55,214,6,208,0,79,35,24,0,2,0,11,8,49
77,99,2128,510,1618,36,1582,39,394,438,140,29,11,8,121,44,358
77,100,3086,534,2552,43,2509,49,598,678,232,26,14,5,216,63,628
77,101,700,129,571,16,555,6,154,173,51,4,1,0,46,11,109
77,102,109,16,93,4,89,1,16,18,16,1,0,0,8,3,26
77,103,167,27,140,5,135,0,30,39,20,3,1,1,7,7,27
77,104,475,69,406,5,401,9,96,132,31,3,0,0,29,11,90
77,106,751,165,586,21,565,13,145,131,66,12,5,6,45,11,131
77,107,1986,467,1519,27,1492,32,354,456,114,15,7,8,159,32,315
77,108,30963,7613,23350,377,22973,441,3975,5563,2861,196,99,65,1815,338,7620
77,109,912,176,736,17,719,12,217,196,69,8,2,1,50,30,134
77,110,239,44,195,7,188,1,51,64,17,3,0,0,16,5,31
77,111,2515,554,1961,40,1921,54,301,586,159,14,6,6,214,52,529
77,112,187,35,152,3,149,1,39,44,12,0,2,0,12,9,30
77,113,680,108,572,15,557,5,184,124,62,4,3,0,24,8,143
77,114,2702,657,2045,36,2009,58,399,629,156,25,7,7,201,57,470
77,115,383,55,328,6,322,9,69,101,30,3,2,2,19,9,78
77,116,958,156,802,20,782,11,210,288,47,12,3,1,59,34,117
77,117,561,92,469,6,463,9,135,118,45,6,1,2,30,13,104
77,118,7296,1504,5792,81,5711,96,1211,1948,560,51,22,24,473,110,1216
77,119,210,35,175,3,172,2,56,40,7,1,2,1,19,6,38
77,120,392,75,317,4,313,0,101,92,24,5,3,0,17,6,65
77,121,2275,422,1853,29,1824,44,281,451,225,12,11,3,153,36,608
77,122,15067,3869,11198,197,11001,237,1729,2450,1332,94,45,37,952,355,3770
77,123,527,84,443,5,438,5,113,98,75,10,3,1,24,12,97
77,124,1249,245,1004,5,999,19,151,330,87,5,2,1,109,20,275
77,125,1017,157,860,13,847,23,163,292,87,14,4,0,66,21,177
77,126,1098,167,931,20,911,14,228,258,99,6,6,2,55,13,230
77,127,957,204,753,16,737,14,164,215,70,3,3,2,60,27,179
77,128,1331,223,1108,10,1098,16,234,419,104,9,6,1,99,26,184
77,129,458,94,364,4,360,3,80,125,32,6,0,0,20,6,88
77,130,297,59,238,6,232,5,44,96,20,1,4,1,19,3,39
77,131,9092,2413,6679,124,6555,139,1493,1848,660,94,36,12,492,135,1646
77,132,2036,313,1723,34,1689,31,336,509,174,16,6,2,150,49,416
77,133,179,19,160,3,157,3,60,49,5,2,2,1,8,3,24
77,134,104,10,94,4,90,1,27,34,6,0,0,1,3,2,16
77,135,979,211,768,6,762,13,252,163,86,10,7,1,65,23,142
77,136,147,28,119,8,111,3,38,33,9,2,1,0,13,0,12
77,137,166,32,134,2,132,2,36,46,10,2,0,0,11,6,19
77,138,424,65,359,7,352,9,76,95,33,5,0,1,28,4,101
77,139,4457,1012,3445,54,3391,63,706,959,370,23,10,6,291,79,884
77,140,205,29,176,6,170,3,42,44,14,2,0,1,20,4,40
77,141,581,111,470,9,461,15,82,149,43,8,3,3,40,15,103
77,142,2870,580,2290,42,2248,44,498,758,177,31,13,7,222,44,454
77,143,2875,574,2301,37,2264,37,479,492,244,21,12,6,174,39,760
77,144,218,30,188,7,181,2,35,66,15,3,1,0,11,10,38
77,145,473,88,385,8,377,5,86,125,43,3,0,2,32,7,74
77,146,1607,296,1311,34,1277,21,207,403,138,9,2,7,127,36,327
77,147,493,95,398,8,390,5,93,127,38,5,1,0,34,9,78
77,148,1132,208,924,14,910,26,207,278,114,7,1,3,54,18,202
77,149,170,33,137,1,136,1,43,40,9,2,1,1,10,3,26
77,150,280,54,226,5,221,5,77,71,23,1,1,0,10,1,32
77,151,241,31,210,3,207,4,58,66,16,2,1,0,13,6,41
77,152,12162,3439,8723,154,8569,177,1372,1920,1204,96,42,18,640,139,2961
77,153,5404,1107,4297,68,4229,60,965,1212,480,35,17,12,348,74,1026
77,154,595,104,491,16,475,10,103,123,52,7,3,1,47,9,120
77,155,2169,517,1652,36,1616,38,312,469,153,22,3,7,161,43,408
77,156,600,109,491,7,484,4,108,158,33,5,1,0,43,14,118
77,157,220,39,181,4,177,3,75,53,12,0,2,0,14,5,13
77,158,178,24,154,4,150,0,38,43,11,2,0,0,17,3,36
77,159,1876,326,1550,27,1523,39,405,406,162,15,13,1,93,31,358
77,161,612,103,509,6,503,26,88,148,56,4,0,1,50,15,115
77,162,740,150,590,4,586,13,144,157,63,8,3,2,65,19,112
77,163,187,33,154,4,150,5,40,41,17,2,3,0,7,1,34
77,164,388,50,338,9,329,3,76,93,38,2,0,4,23,11,79
77,165,512,92,420,2,418,7,120,135,38,5,0,2,43,10,58
77,166,1748,302,1446,27,1419,22,321,312,180,12,8,3,97,32,432
77,167,215,53,162,4,158,4,54,54,12,1,2,1,3,3,24
77,168,1553,333,1220,35,1185,12,337,352,126,8,4,4,86,34,222
77,169,4786,989,3797,70,3727,82,503,875,478,22,17,9,414,87,1240
77,170,403,78,325,2,323,11,63,98,33,3,1,1,24,6,83
77,171,3779,721,3058,41,3017,73,659,821,368,23,18,8,246,54,747
77,172,671,95,576,18,558,13,114,186,52,5,0,2,46,9,131
77,173,600,126,474,5,469,3,161,119,48,2,2,4,33,15,82
77,174,407,73,334,7,327,4,91,91,31,6,2,2,21,3,76
77,175,1829,330,1499,22,1477,24,302,465,118,16,3,2,130,43,374
77,176,1756,408,1348,27,1321,20,328,389,134,11,5,5,110,34,285
77,177,761,132,629,6,623,15,118,207,71,6,0,0,64,8,134
77,178,333,44,289,6,283,6,59,70,45,3,1,0,29,5,65
77,179,464,83,381,9,372,18,41,128,44,2,1,0,40,6,92
77,180,869,202,667,7,660,13,117,294,42,10,3,1,60,6,114
77,181,1386,201,1185,15,1170,26,200,352,120,10,4,4,100,24,330
77,182,2400,553,1847,34,1813,22,476,541,142,20,11,5,154,38,404
77,183,5935,1644,4291,62,4229,80,971,1157,481,45,26,12,315,101,1041
77,184,490,68,422,7,415,7,84,111,56,3,1,0,41,11,101
77,185,446,60,386,6,380,6,83,171,18,0,1,0,35,7,59
77,186,9781,2405,7376,73,7303,192,810,3041,561,57,24,16,823,144,1635
77,187,436,90,346,3,343,4,95,106,37,3,0,1,20,13,64
77,188,734,131,603,5,598,22,116,191,44,4,0,3,57,11,150
77,190,203,29,174,5,169,1,47,62,7,2,4,0,12,2,32
77,191,786,134,652,10,642,11,172,161,69,8,1,0,49,16,155
77,192,3485,833,2652,48,2604,38,600,750,296,38,16,5,197,66,598
77,193,178,38,140,3,137,0,47,49,12,2,0,0,7,3,17
77,194,262,48,214,0,214,5,55,57,18,2,1,0,16,2,58
77,195,427,72,355,12,343,7,97,92,27,1,3,0,26,12,78
77,196,418,75,343,7,336,4,100,84,50,0,0,4,34,6,54
77,197,103,13,90,5,85,0,26,20,13,0,1,0,7,3,15
77,198,157,25,132,4,128,3,31,53,4,4,1,2,12,0,18
77,199,801,168,633,8,625,17,157,177,54,7,3,3,47,17,143
77,200,82,15,67,0,67,0,13,28,11,0,0,0,6,1,8
77,201,534,99,435,10,425,4,157,115,38,7,1,1,30,14,58
77,202,448,100,348,5,343,12,75,102,30,4,3,1,26,14,76
77,203,1096,223,873,5,868,10,180,340,63,7,5,2,64,21,176
77,204,137,24,113,1,112,1,26,47,8,4,1,0,10,2,13
77,205,111,13,98,3,95,1,25,35,7,0,0,0,2,6,19
77,206,110,19,91,0,91,0,30,41,8,0,0,0,4,1,7
77,207,120,25,95,6,89,0,25,24,5,0,0,0,6,6,23
77,208,990,223,767,17,750,11,205,183,77,9,4,1,50,20,190
77,209,900,148,752,10,742,6,113,298,54,8,0,1,85,10,167
77,210,1798,399,1399,20,1379,21,324,334,170,9,10,3,97,32,379
77,211,655,100,555,13,542,8,168,148,48,10,2,0,35,14,109
77,212,146,26,120,2,118,4,30,45,8,1,0,0,2,4,24
77,214,744,131,613,8,605,4,92,284,32,1,1,0,61,12,118
77,215,4847,1066,3781,66,3715,77,765,956,403,47,13,8,315,91,1040
77,216,927,153,774,14,760,16,162,210,69,11,4,0,83,15,190
77,217,1593,364,1229,18,1211,21,264,427,88,9,8,0,120,50,224
77,218,100,26,74,1,73,3,17,25,4,2,1,0,4,5,12
77,219,1609,274,1335,28,1307,26,278,416,127,13,8,1,128,31,279
77,220,216,23,193,2,191,1,40,69,25,0,2,0,17,4,33
77,221,964,174,790,11,779,16,80,268,83,8,0,3,103,14,204
77,222,1986,432,1554,29,1525,25,383,406,160,28,8,6,118,50,341
77,223,362,60,302,4,298,3,84,76,32,3,2,1,20,5,72
77,224,124,22,102,1,101,2,25,35,11,3,1,0,11,2,11
77,225,199,53,146,4,142,2,26,51,11,3,1,0,9,8,31
77,226,1936,354,1582,28,1554,43,258,458,174,16,12,3,184,37,369
77,227,415,68,347,5,342,5,98,97,32,4,0,1,19,9,77
77,228,190,23,167,4,163,2,38,50,23,3,0,2,14,2,29
77,229,1106,191,915,20,895,16,222,263,110,9,6,0,87,15,167
77,230,148,29,119,1,118,5,29,36,15,0,0,0,16,4,13
77,231,481,74,407,12,395,9,103,110,44,13,4,0,17,9,86
77,232,577,111,466,7,459,8,112,122,60,10,2,1,39,10,95
77,233,344,42,302,10,292,4,84,90,27,7,0,2,21,6,51
77,234,429,70,359,7,352,12,74,105,35,4,0,3,34,8,77
77,235,221,39,182,1,181,1,49,50,28,5,0,0,10,3,35
77,236,282,46,236,3,233,4,59,92,15,3,0,0,23,5,32
77,237,426,91,335,4,331,4,68,104,23,2,2,1,35,8,84
77,238,2427,518,1909,30,1879,50,456,570,188,21,6,4,138,50,396
77,239,958,198,760,9,751,6,230,245,60,11,10,4,47,23,115
77,240,1540,373,1167,19,1148,13,302,366,90,18,6,2,86,31,234
77,241,1221,221,1000,16,984,11,281,224,98,9,4,4,79,21,253
77,242,373,79,294,7,287,5,86,79,25,4,0,1,13,3,71
77,243,12385,2805,9580,141,9439,261,1550,2617,1070,75,29,28,980,188,2641
77,244,595,93,502,8,494,14,70,172,62,4,0,2,48,13,109
77,245,352,58,294,4,290,6,74,92,30,5,0,2,29,11,41
77,246,388,73,315,5,310,7,77,99,24,2,4,1,27,12,57
77,247,362,73,289,12,277,7,74,71,35,3,2,2,25,7,51
77,248,463,77,386,5,381,5,59,126,40,5,2,3,32,13,96
77,249,5561,1221,4340,61,4279,91,642,1719,322,28,10,12,450,93,912
77,250,134,18,116,0,116,4,38,44,1,1,0,0,5,2,21
77,251,5809,1329,4480,105,4375,81,815,746,575,49,20,11,399,117,1562
77,252,303,51,252,6,246,2,64,78,14,1,1,1,30,5,50
77,253,135,19,116,2,114,1,28,35,6,1,0,1,6,2,34
77,254,899,154,745,9,736,20,177,228,73,10,4,1,58,23,142
77,255,1480,320,1160,23,1137,22,242,332,106,11,5,3,115,28,273
77,256,118,23,95,3,92,1,23,33,7,2,1,0,4,2,19
77,257,2133,678,1455,21,1434,18,432,347,154,15,7,1,78,29,353
77,258,8113,2065,6048,115,5933,135,547,1324,799,63,19,19,492,83,2452
77,259,1355,252,1103,22,1081,16,283,263,113,17,3,1,71,24,290
77,260,1120,234,886,13,873,15,229,179,111,7,2,0,44,19,267
77,261,900,181,719,15,704,18,169,200,88,12,6,0,51,15,145
77,262,388,73,315,7,308,6,66,94,33,5,3,1,28,7,65
77,263,180,23,157,5,152,4,49,60,9,1,0,1,4,8,16
77,264,1086,184,902,13,889,15,230,263,83,15,6,2,63,20,192
77,265,719,142,577,14,563,12,167,142,59,5,3,2,33,14,126
77,266,541,116,425,4,421,9,77,141,36,2,0,3,35,18,100
77,267,261,45,216,2,214,8,50,49,28,1,2,1,16,6,53
77,268,3440,769,2671,35,2636,57,405,964,220,22,5,9,263,65,626
77,269,1311,233,1078,18,1060,14,226,304,119,11,3,3,81,28,271
77,270,584,103,481,3,478,6,107,169,47,5,1,0,40,15,88
77,271,93,19,74,1,73,1,23,20,7,1,0,0,8,4,9
77,272,538,75,463,16,447,6,128,153,36,0,3,2,29,12,78
77,273,303,57,246,1,245,3,80,66,16,2,1,0,18,5,54
77,274,285,45,240,2,238,2,87,60,22,1,1,0,23,5,37
77,275,115,24,91,1,90,3,25,19,3,2,1,2,4,3,28
77,276,1399,236,1163,21,1142,23,243,354,92,4,9,2,117,19,279
77,277,985,183,802,11,791,15,189,259,76,8,2,2,52,28,160
77,278,322,57,265,5,260,6,72,86,22,2,2,0,27,2,41
77,279,1063,162,901,15,886,10,216,267,86,13,3,3,80,24,184
77,280,829,133,696,14,682,6,147,204,87,11,5,0,63,20,139
77,281,368,83,285,4,281,5,78,73,22,3,2,0,37,11,50
77,282,182,13,169,3,166,1,73,47,3,3,2,0,11,0,26
77,283,557,88,469,5,464,1,142,135,52,3,1,0,21,9,100
77,284,25506,6106,19400,337,19063,280,3378,5143,2056,191,93,39,1296,290,6297
77,285,11303,3049,8254,125,8129,140,1417,1697,1002,87,41,32,633,154,2926
77,286,173,16,157,5,152,1,33,48,14,2,0,0,8,6,40
77,287,409,91,318,4,314,10,74,72,47,4,0,0,25,10,72
77,288,18445,4932,13513,263,13250,295,2303,3076,1534,113,83,39,1132,263,4412
77,289,306,62,244,1,243,2,65,78,16,1,0,0,24,3,54
77,290,436,94,342,0,342,5,72,97,45,3,1,0,27,16,76
77,291,441,103,338,4,334,4,109,89,36,4,1,2,23,5,61
77,292,684,135,549,6,543,13,111,165,54,8,2,0,57,7,126
77,293,647,115,532,8,524,7,145,143,57,8,3,2,36,14,109
77,294,11259,2761,8498,157,8341,130,1869,1650,1564,86,49,11,513,125,2344
77,295,969,173,796,14,782,15,178,225,71,8,1,2,79,18,185
77,296,10161,2591,7570,222,7348,126,1182,1342,1062,60,33,11,554,176,2802
77,297,294,51,243,9,234,3,67,68,15,7,3,1,10,3,57
77,298,365,45,320,4,316,2,80,74,63,5,0,1,27,8,56
77,299,199,19,180,0,180,4,27,48,21,3,2,0,14,4,57
77,300,466,86,380,8,372,3,71,134,32,0,0,1,28,8,95
77,301,238,36,202,1,201,5,66,51,21,0,3,0,15,6,34
77,302,1637,340,1297,23,1274,26,261,334,125,9,3,7,116,35,358
77,303,171,37,134,1,133,0,46,46,9,0,0,0,10,4,18
77,304,37,7,30,0,30,1,5,20,1,0,0,0,1,1,1
77,305,8899,2531,6368,167,6201,90,1152,1247,883,56,34,12,356,73,2298
77,306,392,80,312,8,304,6,85,85,19,3,0,3,19,6,78
77,307,4469,827,3642,57,3585,80,554,1148,361,29,12,9,416,76,900
77,308,537,132,405,1,404,11,97,106,44,5,2,1,33,7,98
77,309,1058,176,882,13,869,15,268,237,72,12,1,1,73,8,182
77,310,243,39,204,6,198,5,49,58,22,0,0,0,18,4,42
77,311,903,131,772,9,763,6,181,222,89,9,7,0,66,15,168
77,312,2199,441,1758,23,1735,55,279,628,185,17,2,10,136,43,380
77,313,202,24,178,1,177,5,39,56,14,1,0,0,16,2,44
77,314,189,47,142,1,141,2,37,32,19,1,3,0,8,4,35
77,315,2301,475,1826,36,1790,28,416,526,161,20,1,7,143,40,448
77,316,3151,613,2538,53,2485,68,344,745,288,28,13,7,298,49,645
77,317,2739,634,2105,32,2073,20,569,452,234,21,16,6,133,48,574
77,318,893,135,758,15,743,21,187,237,60,4,4,0,75,28,127
77,319,118,19,99,2,97,1,28,24,11,1,4,0,8,1,19
77,320,3651,843,2808,51,2757,38,770,771,223,28,17,10,191,46,663
77,321,545,113,432,9,423,4,111,117,34,11,1,2,31,10,102
77,322,1980,439,1541,34,1507,16,391,454,154,21,12,1,98,32,328
77,323,668,134,534,9,525,7,140,127,58,5,2,1,32,8,145
77,325,299,48,251,5,246,2,75,78,16,4,2,0,19,10,40
77,326,3994,903,3091,68,3023,64,496,532,428,40,21,4,218,77,1143
77,327,5109,1331,3778,69,3709,45,994,836,460,43,16,6,253,79,977
77,328,349,51,298,5,293,0,60,118,30,0,3,1,21,8,52
77,329,412,62,350,10,340,5,96,102,26,2,1,0,39,12,57
77,330,3913,994,2919,56,2863,50,575,829,274,29,10,8,256,54,778
77,331,304,36,268,3,265,2,65,50,42,4,2,0,24,6,70
77,332,186,51,135,2,133,2,40,42,10,1,1,0,5,2,30
77,333,6983,1758,5225,105,5120,87,1026,1254,643,76,33,8,351,102,1540
77,335,1410,265,1145,12,1133,22,274,279,145,13,4,2,89,16,289
77,336,661,142,519,5,514,19,134,152,38,11,5,0,40,20,95
77,337,8836,2393,6443,107,6336,188,671,1131,922,62,30,17,466,88,2761
77,338,422,74,348,5,343,3,89,84,34,9,0,0,25,15,84
77,339,1547,286,1261,12,1249,46,223,515,86,6,1,5,132,35,200
77,340,475,60,415,10,405,2,65,134,60,4,0,0,36,6,98
77,341,301,49,252,1,251,6,58,64,31,2,2,2,20,7,59
77,342,87,14,73,1,72,1,28,22,1,0,1,0,7,1,11
77,343,246,50,196,2,194,0,43,70,25,1,1,1,8,5,40
77,344,1324,210,1114,28,1086,11,346,251,121,11,4,2,74,26,240
77,345,447,63,384,9,375,7,120,87,58,6,2,3,27,12,53
77,347,655,127,528,5,523,2,146,127,58,4,7,0,39,10,130
77,348,195,32,163,5,158,2,39,47,15,1,0,1,10,6,37
77,349,4594,935,3659,71,3588,48,880,756,525,40,22,7,270,68,972
77,350,13759,3481,10278,164,10114,195,1532,3286,994,92,46,24,1028,220,2697
77,352,1238,250,988,25,963,13,216,290,96,6,5,1,80,28,228
77,353,369,64,305,6,299,7,69,113,19,3,0,2,21,6,59
77,354,611,123,488,9,479,4,120,130,55,4,4,0,50,14,98
77,355,160,19,141,0,141,0,32,40,16,0,1,0,5,6,41
77,356,58,5,53,1,52,1,11,21,8,2,0,0,4,1,4
77,357,519,67,452,14,438,5,108,142,39,4,0,2,38,7,93
77,358,674,125,549,18,531,8,145,169,45,2,1,0,40,12,109
77,359,1512,304,1208,17,1191,33,221,456,92,9,3,5,113,37,222
77,360,265,55,210,5,205,9,52,65,30,1,1,1,15,6,25
77,361,308,49,259,4,255,2,70,94,25,2,1,1,18,3,39
77,363,995,204,791,10,781,8,201,253,68,3,4,2,55,13,174
77,364,145,25,120,3,117,0,42,36,9,3,0,0,3,5,19
77,365,384,57,327,4,323,8,100,99,28,1,0,0,28,12,47
77,366,188,22,166,3,163,0,52,57,11,1,1,0,9,4,28
77,367,202,36,166,1,165,2,44,37,15,5,2,1,12,5,42
77,368,338,56,282,8,274,0,70,70,19,4,0,0,27,4,80
77,369,534,68,466,7,459,4,131,174,19,3,6,1,27,7,87
77,370,646,135,511,9,502,8,105,143,58,7,1,2,55,8,115
77,371,1957,446,1511,26,1485,25,374,407,158,19,15,4,116,40,327
77,372,2265,479,1786,27,1759,34,283,540,190,11,2,4,209,49,437
77,373,21012,4949,16063,284,15779,280,2552,4145,1810,184,51,44,1427,323,4963
77,374,1398,291,1107,19,1088,20,214,316,136,6,6,2,106,19,263
77,376,505,114,391,14,377,4,113,117,26,4,2,1,37,10,63
77,377,1441,273,1168,20,1148,20,243,376,117,12,6,3,85,17,269
77,378,1858,361,1497,23,1474,21,296,425,115,19,11,3,172,35,377
77,379,6755,1903,4852,86,4766,64,970,1445,460,44,20,9,359,94,1301
77,380,216,34,182,5,177,1,41,68,19,0,0,2,10,2,34
77,381,437,72,365,12,353,7,118,97,30,3,4,0,29,9,56
77,382,3664,760,2904,51,2853,69,597,784,363,40,10,9,283,40,658
77,383,568,83,485,7,478,12,119,143,48,10,2,1,43,4,96
77,384,649,128,521,12,509,9,123,121,52,4,3,0,42,18,137
77,385,1341,289,1052,25,1027,18,351,282,92,8,7,3,77,27,162
77,386,553,109,444,2,442,13,62,167,26,8,3,1,50,7,105
77,387,334,46,288,4,284,7,61,100,29,4,2,1,21,13,46
77,388,541,97,444,15,429,0,103,113,67,7,2,0,28,12,97
77,389,2113,374,1739,22,1717,33,260,598,157,12,3,7,172,44,431
77,390,12996,2809,10187,203,9984,190,1590,2110,1297,104,41,24,806,233,3589
77,391,352,69,283,5,278,5,92,69,30,3,0,0,12,5,62
77,392,408,70,338,3,335,5,90,94,30,3,1,0,28,6,78
77,393,1826,408,1418,29,1389,35,312,383,135,19,10,3,135,43,314
77,394,1347,201,1146,20,1126,12,191,431,88,8,4,6,94,30,262
77,395,98,15,83,2,81,2,16,27,7,1,0,0,8,5,15
77,396,73,10,63,1,62,0,21,18,4,2,0,0,6,4,7
77,397,1204,214,990,17,973,21,216,287,95,13,5,1,63,33,239
77,398,506,108,398,4,394,9,123,94,43,0,4,0,30,12,79
77,399,176,33,143,5,138,4,35,46,11,2,2,0,15,5,18
77,400,1305,218,1087,14,1073,31,289,324,82,16,3,0,90,33,205
77,401,490,75,415,8,407,6,108,138,40,4,0,1,27,10,73
77,402,264,35,229,6,223,1,97,60,16,0,2,0,13,2,32
77,403,552,110,442,5,437,3,98,162,30,2,8,2,34,8,90
77,404,1265,229,1036,19,1017,8,269,253,96,19,10,1,62,23,276
77,405,1351,287,1064,22,1042,29,246,289,118,17,7,4,89,23,220
77,406,663,93,570,10,560,17,143,173,53,4,4,2,40,20,104
77,407,8359,1796,6563,104,6459,125,1267,1998,610,65,28,29,624,165,1548
77,408,274,43,231,2,229,3,47,58,25,4,1,1,27,4,59
77,409,1928,370,1558,35,1523,19,394,293,160,25,9,7,109,43,464
77,410,428,71,357,2,355,2,74,129,18,1,0,1,34,13,83
77,411,326,65,261,4,257,4,57,95,23,2,5,1,18,4,48
77,412,290,45,245,1,244,2,53,87,22,4,0,0,24,7,45
77,413,2374,518,1856,29,1827,38,374,549,211,16,8,2,154,42,433
77,414,356,56,300,8,292,2,97,83,21,4,2,0,23,7,53
77,415,824,174,650,5,645,8,155,222,65,6,2,1,35,16,135
77,416,175,29,146,4,142,0,53,30,14,3,0,0,6,3,33
77,417,149,26,123,0,123,1,35,31,20,3,1,0,12,3,17
77,418,617,92,525,8,517,7,123,119,59,5,7,0,30,10,157
77,419,2310,483,1827,39,1788,48,374,423,228,18,7,5,141,45,499
77,420,2750,610,2140,43,2097,20,515,586,232,28,10,4,129,42,531
77,421,227,46,181,3,178,2,68,58,12,3,1,0,15,7,12
77,423,515,98,417,7,410,2,134,108,32,5,4,0,35,11,79
77,424,188,31,157,0,157,5,49,37,14,3,1,1,14,8,25
77,425,623,106,517,7,510,20,74,227,33,5,1,1,44,9,96
77,426,284,41,243,8,235,8,39,78,23,0,0,0,35,10,42
77,427,360,57,303,4,299,2,86,83,32,5,0,0,27,2,62
77,428,680,127,553,17,536,6,142,134,59,8,2,2,49,11,123
77,429,408,48,360,8,352,8,90,105,28,7,6,2,22,7,77
77,430,3888,716,3172,52,3120,42,834,738,304,35,12,8,238,54,855
77,431,4010,804,3206,57,3149,76,627,826,367,27,24,5,257,61,879
77,432,756,143,613,9,604,12,190,168,55,6,2,2,54,12,103
77,433,960,180,780,12,768,11,168,243,81,9,2,0,63,25,166
77,434,271,48,223,5,218,2,70,80,13,0,2,0,5,5,41
77,435,835,130,705,6,699,13,111,268,74,5,6,2,74,16,130
77,436,628,124,504,4,500,6,128,142,49,6,1,0,39,12,117
77,437,2126,411,1715,46,1669,20,500,446,182,24,6,4,144,27,316
77,438,4260,970,3290,46,3244,59,422,945,396,28,14,4,364,66,946
77,439,763,157,606,13,593,14,167,153,54,5,5,2,36,18,139
77,440,702,126,576,13,563,7,138,158,64,8,3,0,35,13,137
77,441,1598,297,1301,11,1290,72,127,427,125,13,3,3,141,32,347
77,442,1772,306,1466,19,1447,31,219,457,157,15,6,1,160,29,372
77,443,277,49,228,4,224,3,62,73,23,0,1,0,13,9,40
77,444,249,32,217,6,211,4,61,65,19,2,0,1,10,2,47
77,445,16179,4287,11892,318,11574,222,1719,2002,1607,123,53,34,882,261,4671
77,446,408,57,351,6,345,10,87,72,54,5,1,2,34,10,70
77,447,1514,288,1226,20,1206,38,193,424,109,11,2,0,113,24,292
77,448,314,51,263,6,257,2,77,60,18,2,2,0,19,10,67
77,449,4049,1054,2995,42,2953,64,445,751,322,23,12,12,332,51,941
77,450,2350,484,1866,19,1847,30,335,623,183,12,11,10,163,42,438
77,451,435,71,364,5,359,7,99,91,27,7,2,1,38,7,80
77,452,59,5,54,2,52,0,8,28,5,0,0,0,4,2,5
77,453,783,109,674,8,666,10,162,185,62,5,4,0,59,14,165
77,454,305,58,247,4,243,7,64,74,28,2,0,0,21,6,41
77,455,1460,263,1197,31,1166,26,313,299,117,12,7,3,103,32,254
77,456,577,98,479,8,471,2,129,114,46,7,6,1,38,12,116
77,457,882,176,706,14,692,11,174,174,94,6,5,1,58,18,151
77,458,3505,903,2602,40,2562,49,624,568,284,37,19,8,179,57,737
77,459,819,123,696,14,682,8,203,208,66,4,2,2,39,16,134
77,460,243,29,214,6,208,3,46,63,23,4,0,2,15,6,46
77,461,233,40,193,2,191,2,51,63,21,1,1,0,17,3,32
77,462,380,85,295,8,287,2,111,70,26,4,0,0,19,3,52
77,463,2524,476,2048,26,2022,94,259,626,211,17,8,6,229,37,535
77,464,6009,1387,4622,55,4567,102,815,1276,479,48,27,14,450,87,1269
77,465,487,71,416,14,402,12,101,108,53,6,3,1,32,14,72
77,466,256,45,211,6,205,4,50,73,13,5,1,1,13,5,40
77,467,188,42,146,1,145,2,43,41,15,0,1,2,4,8,29
77,468,12230,3090,9140,168,8972,203,1125,1738,1259,81,40,21,696,156,3653
77,469,789,166,623,7,616,11,152,188,50,7,4,2,45,22,135
77,470,5592,1404,4188,69,4119,90,839,1098,476,44,17,9,395,98,1053
77,471,299,58,241,3,238,6,44,77,30,1,1,1,19,3,56
77,472,289,56,233,2,231,6,48,73,20,2,0,0,18,11,53
77,473,373,63,310,4,306,5,107,79,18,1,2,2,20,11,61
77,474,391,84,307,4,303,6,94,86,25,2,0,2,30,11,47
77,475,3527,726,2801,63,2738,42,620,708,280,23,15,7,203,46,794
77,476,197,34,163,4,159,1,38,51,21,2,0,0,14,6,26
77,477,619,96,523,12,511,5,99,196,45,5,1,2,50,8,100
77,478,703,180,523,9,514,13,138,131,52,5,3,4,41,22,105
77,479,8327,1780,6547,105,6442,134,1002,1820,759,70,35,17,574,123,1908
77,480,483,61,422,4,418,9,104,108,58,3,1,0,35,6,94
77,481,155,40,115,0,115,0,43,21,7,2,1,0,11,9,21
77,482,2198,427,1771,31,1740,29,386,360,355,26,13,1,84,28,458
77,483,1147,173,974,13,961,14,228,323,82,6,6,1,69,21,211
77,484,172,23,149,3,146,0,46,47,10,3,0,1,12,1,26
77,485,638,115,523,9,514,18,78,198,52,3,3,2,37,14,109
77,486,559,101,458,11,447,6,144,131,42,4,6,0,25,10,79
77,487,8043,1664,6379,111,6268,126,1088,1645,645,40,25,19,620,144,1916
77,489,133,25,108,2,106,8,23,34,3,3,0,0,6,1,28
77,490,500,94,406,6,400,4,132,92,46,6,5,1,25,5,84
77,491,3698,709,2989,51,2938,104,433,804,294,31,14,12,366,61,819
77,492,540,107,433,5,428,9,92,127,65,2,0,1,36,7,89
77,493,2159,474,1685,31,1654,17,445,336,178,31,9,2,129,45,462
77,494,2050,447,1603,35,1568,30,313,402,197,31,8,4,132,30,421
77,495,5326,1084,4242,89,4153,83,713,903,545,45,20,15,395,111,1323
77,496,154,26,128,1,127,3,24,28,19,1,2,0,13,2,35
77,498,177,22,155,3,152,4,36,61,9,0,1,0,12,3,26
77,500,392,80,312,4,308,11,56,90,51,3,0,1,20,10,66
77,501,636,136,500,7,493,9,124,149,49,5,1,2,34,4,116
77,504,619,68,551,15,536,12,127,153,38,13,4,1,47,13,128
77,505,283,42,241,6,235,2,54,81,17,5,2,1,19,3,51
77,506,505,96,409,5,404,6,109,112,50,6,3,0,39,13,66
77,507,348,52,296,3,293,0,90,82,26,5,3,2,21,12,52
77,508,1239,268,971,17,954,20,200,289,85,6,4,2,88,24,236
77,509,407,72,335,4,331,1,113,67,28,4,0,0,20,15,83
77,510,438,53,385,5,380,9,71,122,48,2,0,0,28,10,90
77,511,327,72,255,4,251,0,77,69,22,1,0,1,14,9,58
77,512,846,177,669,11,658,7,160,210,74,10,3,3,40,17,134
77,513,2568,549,2019,68,1951,34,436,458,219,27,11,4,139,37,586
77,514,13948,3827,10121,164,9957,194,2005,2129,1363,90,52,28,657,198,3241
77,515,435,78,357,6,351,4,108,99,33,7,1,0,27,12,60
77,516,577,125,452,10,442,10,77,130,34,4,0,0,38,7,142
77,517,1293,354,939,21,918,16,246,297,84,5,1,1,69,11,188
77,518,173,13,160,1,159,5,28,55,17,1,2,0,21,3,27
77,519,733,118,615,14,601,9,168,193,35,5,5,1,49,14,122
77,520,599,104,495,6,489,17,85,133,48,5,4,0,61,7,129
77,521,1194,242,952,22,930,18,186,301,82,9,6,3,85,22,218
77,522,245,40,205,4,201,2,67,66,12,2,0,0,10,8,34
77,523,208,38,170,1,169,3,50,33,14,4,0,0,18,8,39
77,524,377,71,306,7,299,4,103,95,14,4,0,0,20,9,50
77,525,232,39,193,6,187,0,57,55,13,5,0,0,11,2,44
77,526,178,30,148,4,144,0,56,31,22,3,2,0,10,4,16
77,527,365,59,306,6,300,3,50,122,21,4,0,1,35,14,50
77,528,829,156,673,12,661,10,148,219,59,8,3,0,49,15,150
77,529,1090,208,882,12,870,15,203,322,56,9,5,2,73,29,156
77,530,255,33,222,2,220,5,63,74,12,2,1,1,15,17,30
77,531,1236,279,957,14,943,15,231,259,100,13,3,0,77,22,223
77,532,52,4,48,0,48,1,13,18,3,0,0,0,4,4,5
77,533,1848,319,1529,17,1512,37,252,491,135,19,5,7,194,33,339
77,534,429,72,357,8,349,2,85,109,31,3,4,2,33,10,70
78,3,2067,327,1740,40,1700,30,312,465,165,19,13,1,144,31,520
78,5,13072,3493,9579,176,9403,219,1401,2037,1540,86,56,26,850,171,3017
78,6,630,102,528,3,525,17,87,200,36,5,1,1,54,16,108
78,7,756,135,621,6,615,12,62,333,26,0,2,2,78,8,92
78,9,230,29,201,6,195,3,61,51,17,2,2,0,8,7,44
78,10,882,131,751,12,739,14,109,327,43,5,0,0,62,16,163
78,13,305,50,255,5,250,5,42,80,24,4,0,1,31,5,58
78,15,9055,2013,7042,118,6924,224,897,2225,603,82,25,19,788,106,1955
78,20,648,78,570,6,564,10,99,258,39,6,1,2,50,9,90
78,29,7114,1663,5451,104,5347,76,1072,1405,583,55,36,19,411,110,1580
78,30,1627,291,1336,20,1316,51,150,435,124,9,2,7,163,26,349
78,31,462,75,387,2,385,7,87,130,43,4,0,1,27,6,80
78,33,799,133,666,8,658,21,158,191,58,12,2,0,52,20,144
78,34,685,84,601,9,592,8,83,230,31,5,1,0,59,18,157
78,36,367,40,327,5,322,11,38,122,34,3,0,1,35,3,75
78,43,3183,647,2536,28,2508,57,183,1360,102,16,2,8,349,47,384
78,48,1078,188,890,9,881,21,147,319,79,6,1,3,100,18,187
78,49,1255,237,1018,15,1003,12,146,408,60,5,2,6,106,29,229
78,50,441,67,374,3,371,8,31,182,30,3,1,0,37,3,76
78,53,402,65,337,6,331,14,37,138,21,5,1,0,32,8,75
78,57,1334,248,1086,21,1065,31,207,283,136,11,11,4,100,20,262
78,62,5747,1067,4680,71,4609,131,674,1351,446,46,16,12,587,117,1229
78,68,742,123,619,6,613,10,117,239,56,6,4,3,45,13,120
78,70,248,30,218,3,215,1,47,89,16,1,0,1,32,2,26
78,71,435,55,380,5,375,10,69,114,36,8,3,1,42,6,86
78,72,221,27,194,2,192,7,37,77,18,1,1,0,17,5,29
78,73,8468,1653,6815,136,6679,127,908,2036,631,52,25,17,807,149,1927
78,76,231,38,193,2,191,7,32,83,23,2,0,2,8,5,29
78,77,522,79,443,6,437,9,66,126,47,2,0,3,49,8,127
78,82,421,63,358,4,354,11,93,89,26,4,0,2,31,9,89
78,84,399,59,340,6,334,9,36,125,18,1,2,1,51,6,85
78,87,1483,197,1286,24,1262,40,167,301,129,20,6,6,166,28,399
78,89,2659,557,2102,66,2036,26,541,502,192,22,18,4,130,38,563
78,90,1509,315,1194,18,1176,25,256,402,91,15,3,4,101,32,247
78,92,5615,1275,4340,61,4279,100,402,1875,269,24,11,9,522,62,1005
78,96,450,67,383,2,381,10,51,166,20,3,1,1,51,6,72
78,104,471,64,407,9,398,9,87,143,32,3,2,0,40,13,69
78,107,1330,164,1166,26,1140,20,247,374,91,12,4,2,83,29,278
78,108,843,117,726,10,716,21,130,237,52,2,3,2,73,19,177
78,113,444,65,379,2,377,7,75,173,26,5,1,2,30,8,50
78,117,4231,845,3386,37,3349,90,315,1266,224,18,5,12,509,48,862
78,118,1792,359,1433,34,1399,33,282,373,128,9,6,7,111,25,425
78,120,1325,172,1153,17,1136,33,122,401,120,7,2,4,108,26,313
78,123,8146,2259,5887,98,5789,99,785,1485,629,41,22,9,589,75,2055
78,124,9021,1986,7035,86,6949,220,729,2326,587,47,23,16,896,96,2009
78,125,733,110,623,13,610,21,70,218,53,1,1,2,89,10,145
78,126,14495,3209,11286,152,11134,297,936,4731,789,65,28,28,1318,123,2819
78,128,1138,157,981,9,972,40,106,361,80,4,0,1,107,20,253
78,133,4107,879,3228,37,3191,77,371,1504,192,20,5,12,376,54,580
78,138,4942,1333,3609,65,3544,62,474,727,444,34,21,8,231,58,1485
78,140,891,163,728,8,720,13,127,280,55,2,2,5,82,11,143
78,143,1123,209,914,14,900,45,62,301,83,6,4,5,135,16,243
78,146,19745,4197,15548,215,15333,466,1341,6361,1022,97,33,53,2114,239,3607
78,147,284,35,249,2,247,3,54,94,14,2,2,0,17,10,51
78,152,1346,210,1136,14,1122,19,90,640,44,3,1,3,146,15,161
78,158,20261,3821,16440,164,16276,310,1433,8510,784,67,29,41,1932,235,2935
78,160,4031,774,3257,45,3212,105,300,1240,267,21,8,11,427,63,770
78,162,433,72,361,5,356,18,44,158,16,1,0,0,40,7,72
78,163,291,43,248,1,247,5,38,107,25,5,0,0,17,5,45
78,164,584,82,502,4,498,10,48,228,35,1,2,4,62,8,100
78,165,11739,2753,8986,147,8839,193,1141,2289,1036,94,55,24,934,179,2894
78,168,2550,619,1931,29,1902,31,241,424,235,19,5,6,205,34,702
78,171,834,125,709,7,702,16,96,253,56,7,1,4,77,15,177
78,172,23783,5299,18484,312,18172,563,2672,4473,2015,176,98,45,1814,289,6027
78,185,339,56,283,4,279,5,43,104,29,4,0,0,28,9,57
78,188,306,58,248,4,244,7,56,77,20,2,0,1,18,9,54
78,189,1239,268,971,10,961,28,98,479,59,0,5,0,114,13,165
78,190,7050,1284,5766,64,5702,151,465,2851,275,24,10,13,754,58,1101
78,192,792,159,633,8,625,5,149,173,68,13,5,1,75,6,130
78,193,756,106,650,11,639,15,67,256,60,3,1,3,77,8,149
78,194,193,27,166,1,165,7,20,61,19,3,1,0,21,3,30
78,196,228,32,196,2,194,1,10,121,7,0,0,0,22,6,27
78,202,372,48,324,6,318,7,61,110,35,6,0,0,33,8,58
78,206,2634,601,2033,42,1991,18,350,641,189,23,2,5,177,36,550
78,208,16672,3694,12978,231,12747,305,1400,3361,1399,142,47,36,1454,207,4396
78,209,638,98,540,6,534,17,66,158,41,3,3,6,68,17,155
78,217,4235,785,3450,52,3398,65,609,1009,333,28,11,5,292,69,977
78,220,4815,1072,3743,49,3694,70,491,1172,333,30,10,14,474,68,1032
78,224,3567,720,2847,33,2814,75,168,1387,141,11,3,6,399,44,580
78,227,591,88,503,7,496,15,75,191,28,5,0,0,48,15,119
78,230,421,56,365,4,361,12,84,107,32,4,0,2,47,8,65
78,231,120,21,99,2,97,1,18,29,7,0,1,0,23,3,15
78,233,2201,387,1814,23,1791,55,157,909,87,11,3,8,257,17,287
78,234,108,17,91,1,90,1,26,35,3,0,1,0,9,0,15
78,236,494,69,425,5,420,12,39,163,33,2,2,0,43,9,117
78,237,113,20,93,2,91,1,21,32,4,0,0,0,8,1,24
78,238,1603,297,1306,31,1275,22,312,390,102,12,5,3,114,29,286
78,239,1190,184,1006,21,985,27,238,285,85,8,3,2,91,17,229
78,242,8051,1543,6508,83,6425,158,646,1974,687,50,13,29,733,143,1992
78,245,320,38,282,2,280,6,40,116,26,3,1,0,32,8,48
78,246,784,115,669,8,661,9,126,217,76,9,2,1,78,13,130
78,251,3058,587,2471,35,2436,71,147,1250,107,13,5,8,372,20,443
78,255,2784,579,2205,33,2172,34,547,594,262,32,11,4,135,44,509
78,261,525,81,444,9,435,10,66,128,52,2,2,1,46,10,118
78,262,847,146,701,15,686,15,90,256,43,3,4,3,87,18,167
78,263,1919,386,1533,20,1513,32,210,603,94,15,10,5,177,32,335
78,264,67,7,60,0,60,1,3,36,6,0,0,0,6,2,6
78,265,1681,263,1418,18,1400,33,231,459,130,9,5,5,168,28,332
78,267,5020,1243,3777,76,3701,48,840,1012,394,40,17,10,300,74,966
78,269,923,136,787,15,772,35,108,222,73,5,3,6,103,18,199
78,276,469,75,394,5,389,15,75,104,64,4,3,3,33,7,81
78,278,371,72,299,4,295,4,47,136,19,2,0,4,33,5,45
78,281,454,82,372,7,365,10,94,113,26,9,0,0,43,7,63
78,283,211,22,189,1,188,3,36,61,9,2,1,2,20,4,50
78,285,440,55,385,3,382,10,67,157,16,5,1,1,44,12,69
78,289,754,133,621,9,612,29,68,307,16,3,0,3,69,12,105
78,290,662,90,572,11,561,13,136,173,63,2,3,1,46,16,108
78,291,1503,278,1225,19,1206,21,285,367,118,7,8,2,128,25,245
78,296,466,67,399,9,390,5,102,138,25,8,3,6,26,2,75
78,297,17379,3921,13458,230,13228,402,1339,2868,1710,125,50,29,1517,223,4965
78,299,1365,242,1123,17,1106,23,193,349,113,10,5,3,107,15,288
78,300,278,37,241,2,239,2,51,87,21,2,2,0,27,5,42
78,302,218,52,166,0,166,7,16,95,8,0,0,3,17,1,19
78,305,226,38,188,3,185,9,25,75,27,1,0,0,17,1,30
78,307,743,109,634,8,626,20,81,250,43,3,0,3,88,9,129
78,310,2171,384,1787,44,1743,36,297,612,139,27,5,5,188,29,405
78,311,20697,4615,16082,235,15847,474,1904,4433,1685,149,49,44,1886,276,4947
78,314,2722,488,2234,31,2203,30,536,477,230,25,11,5,202,48,639
78,317,560,78,482,9,473,20,85,150,44,5,1,2,44,6,116
78,320,332,46,286,7,279,5,76,94,25,3,3,1,20,11,41
78,321,3775,654,3121,51,3070,109,393,1210,224,23,8,7,360,65,671
78,322,4819,830,3989,60,3929,140,322,1590,270,15,11,10,545,59,967
78,324,406,56,350,9,341,3,73,96,45,3,1,0,33,5,82
78,325,465,68,397,4,393,7,82,142,36,5,0,0,33,11,77
78,327,2664,541,2123,36,2087,41,442,697,195,13,13,4,182,44,456
78,329,664,88,576,10,566,10,111,206,37,8,5,2,60,14,113
78,334,1340,246,1094,15,1079,36,130,387,100,17,6,2,139,16,246
78,335,9795,2231,7564,146,7418,106,1437,1444,1303,82,46,14,453,137,2396
78,337,1484,290,1194,20,1174,16,274,356,135,14,3,5,105,26,240
78,343,1066,187,879,8,871,41,69,378,40,5,0,6,129,10,193
78,344,486,85,401,2,399,18,90,139,30,6,3,0,34,7,72
78,346,1102,192,910,18,892,13,218,297,85,8,2,3,73,18,175
78,349,360,57,303,5,298,11,51,110,16,3,0,1,35,8,63
78,350,5451,1043,4408,41,4367,110,377,2211,198,22,2,19,589,55,784
78,354,3966,746,3220,60,3160,44,683,699,360,39,27,16,255,53,984
78,356,6404,1148,5256,93,5163,152,642,1331,663,39,24,16,597,109,1590
78,358,16614,3770,12844,186,12658,398,1065,5555,716,73,16,41,1740,210,2844
78,361,20869,5992,14877,287,14590,266,1682,2961,2031,113,52,36,908,172,6369
78,362,11766,3229,8537,124,8413,134,1656,1781,1198,70,54,20,606,114,2780
78,364,505,51,454,7,447,15,49,194,33,5,2,0,45,9,95
78,366,276,34,242,4,238,9,30,97,17,2,1,0,27,5,50
78,367,2566,487,2079,16,2063,64,175,969,105,10,2,4,300,29,405
78,368,1324,216,1108,15,1093,29,141,468,63,5,4,5,150,16,212
78,372,11978,2349,9629,122,9507,303,810,3622,718,65,18,21,1249,175,2526
78,380,4220,861,3359,48,3311,80,517,1212,249,28,6,6,360,83,770
78,381,517,73,444,7,437,8,75,167,37,5,3,2,36,11,93
78,382,2916,499,2417,47,2370,72,395,663,251,24,11,7,261,41,645
78,383,13734,3074,10660,156,10504,247,1265,2990,1179,93,48,21,1216,171,3274
78,384,996,183,813,13,800,27,122,358,49,3,1,1,97,13,129
78,385,141,16,125,1,124,1,28,43,3,1,3,0,8,0,37
78,389,1380,181,1199,15,1184,40,137,532,73,10,0,4,124,19,245
78,391,272,60,212,4,208,7,45,72,15,2,4,2,23,3,35
78,396,4676,999,3677,57,3620,109,409,1555,199,23,6,10,449,71,789
78,397,5044,927,4117,58,4059,123,374,1548,288,21,12,11,560,83,1039
78,398,715,91,624,7,617,30,57,280,44,3,2,1,64,8,128
78,401,5440,1475,3965,69,3896,63,785,1089,437,34,15,11,360,81,1021
78,402,2599,578,2021,36,1985,30,428,580,181,28,9,16,202,37,474
78,403,1385,236,1149,19,1130,30,183,371,90,15,3,3,146,22,267
78,404,191,24,167,3,164,8,21,68,5,0,0,0,22,6,34
78,406,275,40,235,1,234,10,24,139,6,1,0,0,25,1,28
78,407,498,69,429,2,427,12,71,162,40,4,3,0,47,8,80
78,410,708,99,609,17,592,17,114,204,50,5,6,1,51,16,128
78,413,285,52,233,2,231,1,55,67,20,3,0,1,18,14,52
78,415,449,73,376,3,373,10,49,167,27,1,0,3,34,7,75
78,416,249,32,217,3,214,5,63,76,9,1,1,2,16,4,37
78,417,233,22,211,2,209,8,28,96,13,2,0,1,24,9,28
78,418,10134,2042,8092,122,7970,217,858,2940,649,60,20,17,1057,146,2006
78,420,1972,310,1662,29,1633,52,183,729,103,10,6,1,223,27,299
78,423,24310,5154,19156,330,18826,603,1712,4987,1905,173,65,52,2754,326,6249
78,431,1714,278,1436,25,1411,20,167,726,67,11,1,2,183,22,212
78,437,540,127,413,6,407,8,96,132,38,4,1,0,39,9,80
78,439,84,16,68,4,64,0,13,27,4,0,0,0,5,3,12
78,440,15693,4881,10812,211,10601,149,1452,1633,1561,109,63,16,595,146,4877
78,442,2168,438,1730,18,1712,60,210,625,112,15,4,3,217,42,424
78,443,603,76,527,4,523,11,51,232,36,1,1,0,67,9,115
78,444,596,92,504,13,491,12,142,142,40,4,6,0,34,3,108
78,451,680,119,561,9,552,6,137,178,42,4,5,0,62,10,108
78,455,5876,1032,4844,53,4791,96,328,2698,196,24,12,6,615,75,741
78,460,862,116,746,22,724,25,100,252,71,9,5,1,68,26,167
78,464,569,67,502,10,492,6,65,198,38,3,0,3,48,11,120
78,465,1791,280,1511,25,1486,48,220,491,132,14,7,4,159,30,381
78,466,4288,926,3362,39,3323,82,394,1634,118,16,4,4,426,48,597
78,470,710,106,604,11,593,16,101,215,54,5,4,2,50,19,127
78,472,232,33,199,1,198,0,49,72,17,3,3,0,16,3,35
78,474,502,88,414,5,409,6,63,144,39,1,0,0,53,8,95
78,475,263,35,228,3,225,6,31,85,18,3,1,1,25,3,52
78,478,140,14,126,1,125,0,21,40,9,1,0,0,18,11,25
78,481,11072,2518,8554,109,8445,232,847,3308,666,63,24,27,1013,120,2145
78,484,440,58,382,8,374,10,96,118,32,4,2,5,29,9,69
78,486,4918,1015,3903,55,3848,79,572,1173,369,32,15,8,478,84,1038
78,490,18604,3831,14773,234,14539,354,1667,3674,1590,174,55,50,1645,260,5070
78,497,749,115,634,15,619,17,101,266,36,3,1,2,62,11,120
78,498,21987,4997,16990,263,16727,401,1962,5065,1754,140,61,39,1752,261,5292
78,499,401,58,343,5,338,8,54,113,30,2,2,1,39,7,82
78,501,1646,263,1383,26,1357,13,366,361,148,14,10,3,90,35,317
78,502,2828,646,2182,24,2158,46,311,801,154,17,7,5,246,20,551
78,503,183,29,154,3,151,3,38,51,6,0,0,1,16,3,33
78,505,312,54,258,4,254,7,42,100,13,3,3,1,32,4,49
78,506,665,95,570,8,562,12,89,198,45,9,2,1,63,11,132
78,513,1415,204,1211,26,1185,40,148,438,87,8,5,4,180,28,247
78,516,663,122,541,4,537,12,80,178,82,6,0,2,34,19,124
78,517,18191,3433,14758,241,14517,408,1937,4823,1393,126,61,36,1744,306,3683
78,518,103,16,87,0,87,5,8,53,5,0,0,0,11,0,5
78,520,939,141,798,14,784,24,122,267,65,18,4,3,96,23,162
78,522,649,74,575,7,568,24,69,242,53,3,2,1,65,10,99
78,524,2470,448,2022,18,2004,33,164,1241,80,10,2,3,158,8,305
78,528,257,61,196,4,192,1,51,58,16,3,6,0,14,4,39
78,530,292,61,231,4,227,3,40,96,15,0,0,0,22,3,48
78,531,3661,637,3024,82,2942,63,654,705,333,39,24,11,226,61,826
78,536,276,41,235,3,232,3,63,91,10,1,0,1,15,1,47
78,537,4458,844,3614,45,3569,98,518,1185,345,32,16,9,385,98,883
78,545,10898,2751,8147,121,8026,202,942,2313,888,70,36,25,935,148,2467
78,548,414,92,322,6,316,12,37,135,28,0,0,1,34,9,60
78,550,1379,220,1159,18,1141,28,119,402,79,3,1,4,164,21,320
78,551,26417,6093,20324,249,20075,528,1807,8990,1310,103,49,51,2433,283,4521
78,557,644,60,584,12,572,17,93,191,50,3,1,4,63,12,138
78,558,256,45,211,2,209,1,57,58,21,3,0,0,24,7,38
78,559,314,44,270,9,261,3,70,101,17,1,1,0,19,6,43
78,561,325,32,293,5,288,9,29,140,12,3,1,0,40,8,46
78,562,1117,160,957,12,945,35,111,367,80,12,3,4,94,15,224
78,564,474,68,406,3,403,13,70,124,47,6,3,1,41,15,83
78,565,245,28,217,3,214,7,21,85,20,1,0,3,29,7,41
78,567,643,90,553,11,542,10,133,186,45,3,1,5,42,11,106
78,569,629,92,537,7,530,27,79,141,75,2,2,3,60,9,132
78,571,3600,618,2982,27,2955,58,186,1787,82,7,3,9,373,44,406
78,575,5711,927,4784,67,4717,180,379,1619,419,36,8,24,685,113,1254
78,576,1038,161,877,10,867,19,149,359,52,6,1,2,101,22,156
78,586,28941,7178,21763,349,21414,478,2743,5459,2595,207,97,79,2007,354,7395
78,588,533,82,451,3,448,13,72,158,35,6,2,2,48,18,94
78,590,409,76,333,1,332,15,41,129,20,3,0,0,31,4,89
78,591,1536,273,1263,19,1244,24,204,453,96,17,8,6,137,37,262
78,597,434,60,374,7,367,12,71,103,28,0,6,1,33,8,105
78,601,1230,219,1011,18,993,41,163,346,86,5,6,5,111,19,211
78,605,754,118,636,8,628,15,105,192,67,9,1,1,72,14,152
78,606,37,2,35,1,34,0,7,19,2,0,0,0,2,0,4
78,608,87,5,82,3,79,0,19,41,5,1,0,0,8,0,5
78,609,732,110,622,13,609,11,158,173,46,8,2,0,65,14,132
78,615,592,119,473,11,462,14,53,133,45,3,1,2,51,9,151
78,616,861,153,708,18,690,14,72,283,48,5,1,3,69,20,175
78,618,417,52,365,4,361,7,69,155,20,6,1,3,37,9,54
78,620,700,112,588,11,577,14,77,201,38,4,3,4,88,8,140
78,621,13488,3642,9846,220,9626,118,940,1221,1724,89,63,24,518,127,4802
78,623,600,89,511,6,505,13,76,198,34,4,0,1,67,8,104
78,624,8201,1851,6350,94,6256,177,964,2170,471,41,21,19,734,119,1540
78,638,3049,591,2458,45,2413,72,402,792,193,20,12,7,234,45,636
78,640,14177,2832,11345,192,11153,261,1481,3776,1040,113,44,41,1194,232,2971
78,642,10609,2292,8317,123,8194,183,1090,2830,757,61,36,28,1005,151,2053
78,643,5756,1059,4697,66,4631,100,476,1648,394,32,18,12,516,78,1357
78,644,2972,798,2174,42,2132,30,213,346,429,23,10,1,131,44,905
78,646,55765,11491,44274,538,43736,997,4902,20327,2432,228,74,101,5408,681,8586
78,647,632,106,526,10,516,9,118,170,43,2,2,1,49,9,113
78,650,11657,2242,9415,84,9331,280,669,4999,384,24,8,26,1168,128,1645
78,653,203,28,175,3,172,4,13,75,19,5,0,3,16,2,35
78,655,557,90,467,9,458,19,46,170,51,2,2,1,46,11,110
78,668,437,44,393,5,388,11,81,130,37,5,2,2,34,12,74
78,672,3822,799,3023,42,2981,72,239,1596,142,17,10,9,343,40,513
78,674,7057,1631,5426,87,5339,138,606,1577,527,51,26,8,628,93,1685
78,677,414,87,327,3,324,7,70,127,32,3,1,1,29,5,49
78,681,470,71,399,7,392,6,65,156,25,1,3,2,36,8,90
78,683,2032,340,1692,24,1668,60,198,543,149,17,8,3,179,40,471
78,686,10894,2045,8849,115,8734,350,578,3218,645,60,19,29,1368,128,2339
78,688,9354,1850,7504,108,7396,216,578,2807,491,34,22,20,1155,114,1959
79,1,745,129,616,11,605,5,79,181,45,13,4,0,65,9,204
79,2,226,24,202,13,189,0,25,48,19,3,0,2,38,2,52
79,3,4129,506,3623,60,3563,75,398,775,383,45,20,15,380,75,1397
79,4,444,51,393,11,382,9,48,66,52,11,1,1,46,10,138
79,5,2351,365,1986,53,1933,22,300,489,225,24,21,3,195,41,613
79,6,200,35,165,3,162,5,31,39,11,2,0,1,9,7,57
79,7,477,57,420,10,410,12,66,122,48,7,2,1,69,14,69
79,8,574,81,493,11,482,7,83,149,37,13,0,1,52,16,124
79,9,319,33,286,9,277,8,54,50,31,3,2,3,30,6,90
79,10,493,80,413,8,405,22,72,86,43,3,2,0,45,8,124
79,11,133,14,119,4,115,2,13,27,18,4,0,0,4,2,45
79,12,966,130,836,14,822,29,132,170,95,10,2,0,97,15,272
79,13,1174,201,973,16,957,17,124,356,78,16,15,5,132,22,192
79,14,1209,230,979,28,951,5,186,239,117,15,11,2,78,17,281
79,15,161,35,126,5,121,4,12,35,15,0,1,0,9,5,40
79,16,672,93,579,19,560,12,139,180,44,6,3,2,56,11,107
79,18,165,33,132,3,129,3,27,26,12,2,0,0,13,3,43
79,19,136,18,118,1,117,2,26,37,15,2,1,0,8,0,26
79,20,656,99,557,16,541,14,77,120,69,6,3,5,60,10,177
79,22,178,27,151,0,151,4,19,46,13,5,2,1,18,7,36
79,23,69,15,54,0,54,0,6,24,3,2,1,0,6,3,9
79,24,1363,168,1195,28,1167,14,217,228,117,20,9,4,111,36,411
79,25,800,109,691,17,674,8,82,221,54,14,8,2,78,13,194
79,27,74,18,56,2,54,0,11,6,5,1,0,0,5,1,25
79,29,503,68,435,13,422,15,51,100,51,6,7,3,51,10,128
79,30,364,49,315,6,309,3,51,44,38,6,3,1,19,4,140
79,31,1253,180,1073,12,1061,13,157,244,105,27,11,2,108,28,366
79,32,420,70,350,16,334,14,54,52,45,16,2,1,38,11,101
79,33,103,13,90,2,88,0,23,19,6,3,0,0,3,2,32
79,34,1263,192,1071,23,1048,31,102,292,102,18,3,4,124,30,342
79,35,235,30,205,3,202,7,25,52,33,4,1,0,20,6,54
79,38,915,163,752,26,726,12,97,204,76,10,6,3,110,19,189
79,39,47,9,38,2,36,1,9,12,2,0,0,0,3,1,8
79,40,195,23,172,4,168,2,20,47,18,1,0,2,28,7,43
79,42,148,23,125,2,123,6,26,14,19,4,1,1,16,3,33
79,43,757,146,611,12,599,3,113,171,54,9,11,2,42,11,183
79,44,302,61,241,8,233,9,50,63,15,3,2,0,25,2,64
79,45,97,17,80,2,78,0,13,24,4,2,0,0,11,2,22
79,46,409,73,336,5,331,10,54,70,50,7,3,3,34,6,94
79,47,339,46,293,15,278,4,54,92,20,3,3,0,30,7,65
79,48,4313,673,3640,92,3548,61,437,673,370,55,24,20,405,101,1402
79,49,13562,2275,11287,277,11010,228,1282,3052,954,176,91,27,1532,222,3446
79,50,452,57,395,9,386,11,38,96,45,12,4,1,43,7,129
79,51,354,45,309,7,302,1,22,96,25,6,4,3,44,4,97
79,53,344,42,302,4,298,7,39,104,17,5,1,1,38,14,72
79,54,186,37,149,0,149,1,22,46,10,4,2,1,7,10,46
79,55,53,4,49,0,49,0,4,4,6,3,1,0,7,2,22
79,56,546,83,463,4,459,10,80,106,45,12,3,3,33,13,154
79,57,1086,174,912,13,899,13,149,254,71,19,5,1,103,19,265
79,58,528,89,439,11,428,8,85,71,45,11,2,3,39,23,141
79,59,577,89,488,20,468,7,108,134,36,8,2,1,40,15,117
79,60,128,17,111,4,107,1,18,36,8,0,2,0,4,1,37
79,61,2814,488,2326,64,2262,31,304,460,268,46,30,5,178,50,890
79,62,3136,526,2610,74,2536,42,303,646,189,38,30,7,249,40,992
79,63,741,123,618,19,599,7,104,193,36,7,1,3,75,13,160
79,64,387,45,342,14,328,4,38,78,43,4,1,0,27,8,125
79,66,1151,201,950,26,924,26,137,232,99,14,11,0,101,30,274
79,68,257,41,216,2,214,3,61,36,29,4,2,1,15,2,61
79,69,771,139,632,18,614,10,82,179,47,12,6,4,85,13,176
79,70,273,27,246,5,241,12,22,53,29,4,3,0,32,4,82
79,71,383,47,336,9,327,10,41,86,47,2,2,0,44,4,91
79,72,179,37,142,4,138,5,19,44,10,4,1,1,25,3,26
79,74,150,25,125,4,121,2,13,24,18,1,1,0,11,4,47
79,75,273,33,240,6,234,7,18,57,30,2,0,1,40,8,71
79,76,1416,187,1229,29,1200,23,157,392,77,22,10,6,188,28,297
79,77,319,54,265,17,248,3,41,84,15,1,1,0,37,10,56
79,78,467,69,398,8,390,7,69,101,33,14,7,2,24,5,128
79,79,5708,696,5012,152,4860,66,678,1576,400,69,36,8,725,124,1178
79,80,2180,321,1859,49,1810,18,211,540,127,32,22,6,201,37,616
79,81,4690,655,4035,77,3958,58,430,900,394,55,12,13,466,83,1547
79,83,1588,287,1301,43,1258,22,192,303,118,20,6,4,116,12,465
79,84,389,89,300,2,298,4,68,67,25,6,3,0,27,7,91
79,85,128,14,114,4,110,0,16,32,9,2,1,0,18,1,31
79,86,1271,214,1057,28,1029,27,110,197,96,11,5,3,128,23,429
79,87,436,72,364,19,345,7,74,68,37,10,0,1,27,5,116
79,88,1184,163,1021,22,999,18,162,329,58,17,4,2,134,24,251
79,89,150,13,137,4,133,2,19,19,21,1,4,1,12,3,51
79,90,610,104,506,12,494,14,59,106,75,9,0,2,46,7,176
79,91,688,117,571,26,545,12,78,141,33,14,8,3,79,16,161
79,92,277,53,224,5,219,4,53,34,25,5,1,1,11,6,79
79,94,744,118,626,23,603,7,97,208,45,18,3,4,95,12,114
79,95,417,75,342,8,334,2,75,92,24,8,2,0,29,16,86
79,96,879,95,784,22,762,20,66,225,62,12,4,2,128,31,212
79,98,220,33,187,3,184,5,26,38,19,0,1,1,26,7,61
79,99,174,10,164,3,161,3,25,51,17,1,0,0,20,7,37
79,100,1721,214,1507,33,1474,33,220,339,194,18,8,4,141,28,489
79,101,1651,279,1372,31,1341,26,178,381,110,20,11,4,152,38,421
79,102,320,56,264,5,259,0,42,71,21,2,5,0,27,4,87
79,103,1857,278,1579,59,1520,23,211,346,120,24,13,3,236,37,507
79,104,350,27,323,8,315,6,27,74,22,4,3,2,49,10,118
79,105,130,14,116,2,114,3,13,28,14,0,0,1,10,3,42
79,106,301,50,251,5,246,4,43,77,21,5,1,1,16,4,74
79,107,44,9,35,0,35,1,7,5,5,0,0,1,3,2,11
79,108,187,18,169,7,162,3,15,61,10,4,1,3,21,7,37
79,109,2649,329,2320,55,2265,49,219,521,232,26,10,7,284,39,878
79,111,246,41,205,5,200,5,42,55,21,2,1,0,21,5,48
79,112,582,92,490,11,479,7,69,93,51,7,5,0,61,9,177
79,113,243,47,196,7,189,0,30,78,12,3,1,1,24,6,34
79,114,1042,114,928,29,899,18,182,247,67,13,5,1,84,24,258
79,115,475,62,413,14,399,16,62,99,42,11,3,2,43,14,107
79,116,728,105,623,21,602,9,92,178,40,4,7,0,74,15,183
79,117,409,53,356,5,351,7,44,101,37,2,3,0,43,14,100
79,118,232,50,182,6,176,1,33,40,12,2,1,0,24,2,61
79,119,561,107,454,8,446,17,83,101,47,8,3,2,56,13,116
79,120,619,78,541,17,524,6,120,140,51,7,3,2,50,18,127
79,121,302,37,265,8,257,5,59,67,31,4,1,1,26,6,57
79,122,457,69,388,13,375,0,75,74,36,9,2,1,20,12,146
79,123,1779,227,1552,56,1496,18,209,451,129,20,6,3,167,28,465
79,124,108,22,86,2,84,2,10,27,11,1,1,0,4,3,25
79,125,1235,147,1088,20,1068,11,99,234,130,13,7,2,107,21,444
79,126,302,33,269,3,266,8,49,59,33,5,0,1,27,9,75
79,127,588,83,505,13,492,8,79,107,62,7,3,0,53,13,160
79,128,749,88,661,12,649,14,72,131,88,19,6,2,76,13,228
79,129,1128,122,1006,23,983,13,87,157,132,24,12,4,119,22,413
79,130,2180,284,1896,27,1869,18,274,373,231,26,8,2,182,47,708
79,131,257,40,217,6,211,3,47,59,18,2,0,0,29,4,49
79,132,264,62,202,9,193,2,35,60,20,1,3,1,36,4,31
79,133,811,95,716,13,703,19,92,121,76,8,5,2,88,9,283
79,134,442,62,380,9,371,4,58,91,26,10,2,1,34,12,133
79,135,695,77,618,13,605,8,104,173,55,9,3,5,72,14,162
79,136,458,59,399,16,383,4,71,113,22,12,4,1,26,12,118
79,137,721,111,610,11,599,11,66,91,63,17,6,2,91,17,235
79,139,48,5,43,0,43,2,2,17,3,1,0,0,5,1,12
79,140,189,40,149,6,143,4,32,34,9,3,0,0,9,3,49
79,141,164,23,141,1,140,0,24,55,9,2,0,0,8,5,37
79,142,90,15,75,1,74,0,10,22,4,3,0,0,7,3,25
79,144,277,37,240,4,236,1,31,56,26,5,1,1,31,4,80
79,145,278,40,238,4,234,3,54,49,28,4,0,0,23,10,63
79,147,570,78,492,13,479,6,69,154,35,10,7,2,74,15,107
79,148,1612,324,1288,37,1251,21,186,300,101,28,10,4,135,18,448
79,149,106,12,94,7,87,3,8,40,6,2,0,0,11,1,16
79,150,598,112,486,10,476,8,94,81,53,7,5,0,49,17,162
79,152,189,24,165,7,158,4,20,49,19,3,0,0,17,2,44
79,153,132,21,111,0,111,1,15,22,11,4,0,0,11,5,42
79,154,285,62,223,6,217,3,34,64,21,2,2,0,10,4,77
79,156,570,84,486,11,475,1,91,124,54,10,3,0,32,10,150
79,157,911,100,811,16,795,8,128,195,70,21,10,0,67,28,268
79,158,113,18,95,1,94,1,13,29,4,0,0,0,9,1,37
79,159,326,45,281,5,276,8,51,80,26,6,1,1,28,6,69
79,160,143,29,114,5,109,2,15,32,9,0,1,0,18,4,28
79,161,478,88,390,11,379,4,58,98,37,9,2,4,31,12,124
79,162,2441,348,2093,38,2055,37,236,489,233,30,13,1,202,44,770
79,163,429,68,361,13,348,8,56,79,48,4,4,0,19,2,128
79,164,193,29,164,9,155,1,24,36,12,3,0,0,20,3,56
79,165,129,10,119,1,118,2,11,59,8,1,2,0,9,2,24
79,166,662,85,577,14,563,17,74,127,62,13,2,1,69,16,182
79,167,196,29,167,6,161,4,31,43,20,1,0,1,15,1,45
79,168,431,78,353,7,346,6,75,79,35,6,4,2,48,8,83
79,170,1988,318,1670,38,1632,39,242,349,196,20,12,3,160,47,564
79,171,1831,354,1477,41,1436,21,247,389,140,38,6,3,147,45,400
79,172,755,105,650,13,637,17,104,157,71,7,2,0,98,17,164
79,173,294,51,243,3,240,0,33,59,22,1,2,1,27,10,85
79,174,2484,471,2013,42,1971,60,220,376,259,30,16,7,152,29,822
79,175,394,63,331,9,322,8,74,78,27,7,1,0,30,5,92
79,176,659,86,573,14,559,9,87,163,49,5,4,3,58,12,169
79,177,137,13,124,1,123,2,21,35,10,0,1,1,9,3,41
79,178,736,109,627,14,613,10,79,187,51,8,6,0,68,24,180
79,179,2357,313,2044,68,1976,31,227,623,146,29,7,7,233,44,629
79,180,229,33,196,3,193,1,49,36,19,3,2,0,23,4,56
79,183,262,45,217,12,205,14,17,43,20,3,1,0,33,2,72
79,184,1237,204,1033,19,1014,19,141,216,118,12,9,0,96,23,380
79,185,1531,230,1301,34,1267,22,155,226,165,23,5,4,139,20,508
79,187,455,79,376,14,362,13,54,121,24,3,4,1,47,10,85
79,188,461,42,419,21,398,3,53,134,20,2,2,1,56,12,115
79,189,1194,183,1011,24,987,13,185,254,94,21,5,1,80,26,308
79,190,368,52,316,13,303,6,51,123,21,7,4,0,25,5,61
79,191,39161,8253,30908,553,30355,887,2794,6733,3812,389,184,59,3134,461,11902
79,195,3951,699,3252,76,3176,34,567,1050,187,57,19,4,466,89,703
79,196,682,141,541,11,530,11,106,133,36,11,8,1,64,21,139
79,197,95,6,89,3,86,2,15,32,1,4,0,1,11,2,18
79,198,178,24,154,5,149,3,26,24,32,0,4,0,11,3,46
79,199,363,52,311,5,306,8,40,54,42,9,2,0,24,9,118
79,200,213,32,181,5,176,0,25,55,16,6,0,0,19,7,48
79,201,1313,204,1109,31,1078,23,201,230,93,26,5,4,106,12,378
79,202,7359,1458,5901,145,5756,169,624,1454,607,74,45,4,556,107,2116
79,203,294,63,231,6,225,0,58,68,18,5,2,0,21,2,51
79,204,778,126,652,25,627,17,71,176,67,18,6,2,53,24,193
79,205,40,6,34,0,34,1,4,15,4,0,0,0,2,0,8
79,207,518,74,444,5,439,8,58,144,21,6,4,1,61,14,122
79,208,811,103,708,20,688,17,106,226,48,11,5,2,86,21,166
79,209,201,28,173,5,168,3,24,57,11,3,0,4,28,6,32
79,210,772,112,660,19,641,17,74,191,55,13,7,1,73,21,189
79,211,242,47,195,6,189,5,44,48,18,3,2,0,20,4,45
79,212,155,35,120,2,118,2,19,37,14,0,1,0,13,4,28
79,213,1666,198,1468,39,1429,28,170,371,137,13,8,4,161,40,497
79,214,301,51,250,8,242,7,30,61,28,4,2,1,22,7,80
79,215,271,52,219,5,214,10,46,69,10,6,3,1,37,4,28
79,216,1581,216,1365,35,1330,28,148,307,129,17,16,3,150,35,497
79,217,510,75,435,6,429,12,63,65,78,8,3,1,37,7,155
79,218,165,21,144,2,142,2,32,48,6,1,1,2,9,8,33
79,219,97,12,85,3,82,0,20,23,6,3,1,1,14,0,14
79,220,427,67,360,11,349,7,62,49,54,10,2,0,39,15,111
79,222,167,25,142,7,135,2,15,37,8,0,1,0,32,2,38
79,223,32,3,29,0,29,0,3,7,10,0,0,0,4,0,5
79,225,253,38,215,2,213,0,42,45,26,1,4,1,20,1,73
79,226,219,27,192,6,186,6,28,59,23,2,2,0,32,2,32
79,229,354,48,306,2,304,16,41,60,30,12,3,1,35,6,100
79,230,644,78,566,13,553,9,102,160,54,14,7,0,56,13,138
79,231,512,71,441,8,433,7,84,85,54,8,4,2,41,13,135
79,235,1003,125,878,18,860,16,122,337,62,9,8,3,112,32,159
79,236,511,66,445,11,434,8,65,113,49,7,4,0,52,6,130
79,238,425,34,391,8,383,13,51,116,15,5,4,1,67,18,93
79,239,1392,203,1189,33,1156,24,167,283,119,24,7,3,129,30,370
79,240,491,66,425,8,417,5,70,76,40,13,2,0,40,14,157
79,241,440,52,388,8,380,8,52,109,40,12,2,0,34,7,116
79,242,362,63,299,11,288,6,32,100,32,6,3,0,42,5,62
79,243,173,25,148,2,146,2,23,44,10,0,2,1,20,4,40
79,244,296,76,220,7,213,6,45,69,21,2,2,0,12,3,53
79,246,459,67,392,10,382,5,87,59,50,3,4,0,21,14,139
79,247,106,13,93,0,93,0,9,28,8,4,3,0,11,1,29
79,249,1454,213,1241,27,1214,31,117,274,145,14,10,4,141,20,458
79,250,284,45,239,8,231,4,43,61,19,7,2,0,27,9,59
79,251,274,38,236,2,234,5,24,80,25,0,0,1,30,2,67
79,252,277,37,240,8,232,6,38,55,30,2,4,1,29,2,65
79,253,532,91,441,9,432,13,64,113,47,8,4,1,55,14,113
79,254,311,38,273,6,267,12,49,60,44,3,2,0,25,1,71
79,255,267,41,226,4,222,2,47,55,18,2,2,1,23,3,69
79,256,150,12,138,2,136,2,36,37,10,0,2,0,13,1,35
79,257,1215,178,1037,26,1011,22,213,249,109,18,6,3,82,38,271
79,258,365,49,316,11,305,5,58,80,27,5,1,2,35,6,86
79,259,1054,113,941,33,908,22,109,233,68,16,3,2,116,16,323
79,260,466,84,382,15,367,3,78,103,26,7,1,0,36,2,111
79,261,155,19,136,3,133,3,24,31,8,1,0,0,16,1,49
79,263,401,52,349,8,341,3,49,94,36,10,1,2,28,15,103
79,264,859,132,727,21,706,13,93,140,69,7,3,3,76,15,287
79,265,987,131,856,21,835,8,141,194,101,17,8,1,67,18,280
79,267,251,33,218,3,215,3,40,57,15,7,2,0,27,4,60
79,268,716,91,625,21,604,13,111,134,45,10,3,0,48,14,226
79,269,295,46,249,6,243,2,41,64,22,7,0,0,31,9,67
79,270,4044,814,3230,78,3152,36,545,930,298,51,28,9,277,69,909
79,271,223,32,191,3,188,3,30,55,27,2,1,0,16,4,50
79,273,624,91,533,12,521,14,92,84,66,14,5,3,37,11,195
79,274,256,31,225,9,216,0,49,64,21,3,0,2,10,6,61
79,276,752,86,666,15,651,4,129,188,53,10,6,2,59,18,182
79,277,680,106,574,19,555,6,136,141,44,15,3,0,65,15,130
79,278,182,28,154,7,147,1,31,45,11,2,0,0,15,5,37
79,279,587,62,525,11,514,12,56,119,60,10,1,1,42,8,205
79,280,384,54,330,14,316,2,51,128,28,12,0,1,55,7,32
79,281,953,113,840,24,816,15,76,189,91,22,5,0,86,22,310
79,282,104,17,87,2,85,2,20,23,6,1,0,0,8,2,23
79,283,943,103,840,17,823,18,105,157,100,14,4,2,87,18,318
79,284,581,90,491,13,478,5,79,97,44,17,4,2,46,11,173
79,285,1188,220,968,33,935,26,149,250,105,10,5,2,121,27,240
79,286,348,44,304,6,298,5,46,121,15,7,2,0,45,3,54
79,289,975,91,884,17,867,13,123,324,83,4,8,3,110,24,175
79,290,712,104,608,14,594,11,82,127,59,8,3,6,66,17,215
79,292,1469,203,1266,24,1242,16,144,296,147,21,9,7,119,26,457
79,293,756,115,641,24,617,8,88,148,64,5,2,1,57,18,226
79,294,141,23,118,5,113,1,14,24,18,2,1,0,22,3,28
79,295,529,78,451,10,441,9,83,62,39,12,8,3,42,6,177
79,297,296,38,258,4,254,5,49,74,7,2,2,1,31,6,77
79,298,1460,180,1280,19,1261,33,171,311,126,8,9,0,144,28,431
79,299,1772,299,1473,48,1425,25,234,364,135,38,16,2,147,24,440
79,300,1072,124,948,15,933,13,140,227,111,12,11,4,72,18,325
79,301,488,49,439,11,428,6,61,73,57,9,5,1,31,7,178
79,302,1064,138,926,23,903,23,126,190,91,10,10,9,95,26,323
79,303,242,41,201,9,192,4,38,40,29,1,2,0,17,1,60
79,304,550,68,482,6,476,14,56,89,48,6,4,1,42,10,206
79,306,144,16,128,0,128,5,19,42,9,1,1,0,23,2,26
79,307,1254,221,1033,22,1011,14,158,252,128,9,14,0,76,17,343
79,308,470,57,413,8,405,10,36,108,36,4,3,1,52,8,147
79,309,300,46,254,6,248,3,26,67,25,2,0,4,29,7,85
79,310,391,67,324,8,316,9,57,56,42,10,4,0,45,9,84
79,311,1378,195,1183,47,1136,11,135,396,99,28,7,5,145,30,280
79,312,106,28,78,0,78,3,16,9,4,3,1,0,13,0,29
79,313,467,76,391,15,376,20,54,65,45,8,7,0,37,16,124
79,314,203,29,174,3,171,5,19,55,15,1,6,0,25,3,42
79,316,318,44,274,3,271,4,58,60,28,9,4,2,16,7,83
79,318,211,38,173,6,167,3,22,55,20,0,0,0,18,4,45
79,319,700,98,602,14,588,14,95,118,81,15,1,0,55,15,194
79,320,446,51,395,7,388,12,49,73,43,8,3,1,49,8,142
79,321,644,102,542,14,528,11,102,141,40,6,2,0,55,15,156
79,322,1605,224,1381,28,1353,24,173,343,125,23,13,2,160,25,465
79,325,230,33,197,2,195,1,36,53,14,2,0,0,36,8,45
79,326,1038,177,861,18,843,22,155,244,73,18,5,2,77,9,238
79,327,878,105,773,15,758,10,97,124,92,14,4,1,39,16,361
79,328,69,6,63,1,62,0,9,21,6,0,1,0,7,2,16
79,329,6538,1406,5132,116,5016,88,634,1223,547,68,32,13,428,131,1852
79,330,221,28,193,1,192,2,17,70,19,3,2,2,24,3,50
79,331,113,26,87,4,83,1,19,18,8,3,1,0,6,0,27
79,332,99,18,81,2,79,1,18,29,7,1,0,0,9,4,10
79,333,52,3,49,1,48,1,4,25,3,0,0,0,5,1,9
79,334,633,87,546,5,541,9,89,114,72,7,6,1,63,18,162
79,335,583,53,530,14,516,17,56,96,66,10,4,1,54,10,202
79,336,201,31,170,2,168,7,27,39,15,3,0,2,31,1,43
79,337,694,123,571,9,562,16,86,116,65,8,5,1,48,16,201
79,338,160,26,134,4,130,2,16,46,9,2,1,0,16,2,36
79,339,1281,194,1087,27,1060,28,144,342,112,16,5,2,126,23,262
79,340,267,36,231,3,228,3,44,62,26,4,3,1,24,5,56
79,341,99,16,83,0,83,1,14,24,11,0,0,0,12,3,18
79,342,459,74,385,7,378,6,56,137,37,9,3,0,47,14,69
79,343,172,22,150,6,144,2,20,52,11,3,2,0,10,4,40
79,345,711,92,619,13,606,18,79,153,63,11,5,1,88,18,170
79,346,100,22,78,5,73,2,7,15,5,5,0,0,5,2,32
79,347,807,74,733,18,715,4,100,187,69,13,11,2,66,11,252
79,348,165,37,128,2,126,1,20,33,15,3,0,1,13,2,38
79,349,122,27,95,1,94,0,13,27,8,2,0,0,7,3,34
79,350,119,22,97,3,94,5,13,18,14,2,0,0,1,2,39
79,351,1165,161,1004,25,979,19,124,202,118,15,8,4,116,25,348
79,352,145,23,122,0,122,3,26,36,15,3,2,1,8,0,28
79,353,452,83,369,6,363,10,35,63,50,9,1,0,43,9,143
79,354,301,48,253,8,245,8,19,65,49,4,2,1,30,6,61
79,355,2556,393,2163,47,2116,33,212,399,230,25,11,2,259,47,898
79,356,390,47,343,5,338,7,57,104,31,2,3,0,42,9,83
79,357,185,25,160,5,155,6,12,36,20,2,0,0,17,1,61
80,1,18320,4875,13445,291,13154,137,3041,3052,1495,146,126,22,818,228,4089
80,2,194,31,163,6,157,2,54,37,12,0,0,1,7,3,41
80,3,413,56,357,10,347,4,93,79,51,6,1,2,36,5,70
80,4,405,49,356,1,355,1,70,77,40,2,4,0,33,9,119
80,5,83,10,73,2,71,0,13,13,10,2,3,0,3,5,22
80,6,151,18,133,5,128,0,35,48,6,1,0,0,10,3,25
80,8,632,80,552,11,541,6,107,123,75,2,5,0,31,11,181
80,9,762,128,634,11,623,3,157,146,51,8,2,0,55,19,182
80,10,2079,336,1743,28,1715,29,397,366,178,36,11,1,164,28,505
80,11,2433,463,1970,26,1944,18,517,364,254,28,23,3,113,33,591
80,13,1584,196,1388,25,1363,4,371,296,138,18,11,2,60,27,436
80,14,42,8,34,0,34,0,11,6,2,1,0,0,6,3,5
80,15,63,12,51,3,48,1,12,15,6,1,0,1,1,0,11
80,16,7429,1617,5812,111,5701,49,1333,1113,734,94,53,10,464,98,1753
80,17,319,48,271,5,266,0,74,70,20,3,2,1,17,6,73
80,18,201,18,183,7,176,3,61,41,24,2,0,0,7,4,34
80,19,653,107,546,15,531,4,161,127,58,5,6,0,23,14,133
80,20,561,68,493,3,490,12,103,123,50,3,0,0,70,14,115
80,21,74984,18559,56425,894,55531,1223,9197,12550,7219,615,377,129,4650,833,18738
80,22,185,32,153,3,150,2,51,42,9,0,2,0,8,7,29
80,23,186,24,162,3,159,2,61,44,7,1,3,0,6,1,34
80,24,471,58,413,5,408,3,108,136,19,3,5,0,30,8,96
80,25,186,28,158,5,153,2,32,60,18,0,0,0,10,3,28
80,26,26,2,24,1,23,0,4,6,5,0,0,0,1,0,7
80,27,19,1,18,0,18,0,5,6,0,0,0,0,3,0,4
80,28,142,23,119,3,116,1,30,45,7,0,1,2,9,3,18
80,29,660,96,564,13,551,6,104,102,79,4,8,2,29,15,202
80,30,146,19,127,0,127,3,33,42,10,5,0,1,6,1,26
80,31,557,90,467,11,456,3,129,131,33,8,7,2,24,5,114
80,32,89,5,84,2,82,1,25,21,4,2,1,0,5,2,21
80,33,207,22,185,3,182,1,52,40,19,2,3,0,18,4,43
80,34,455,70,385,7,378,6,81,98,48,11,4,1,27,12,90
80,35,48,6,42,2,40,2,12,11,2,0,0,1,7,0,5
80,36,375,39,336,5,331,3,77,91,26,4,1,1,19,13,96
80,37,81,12,69,1,68,2,15,24,10,3,1,0,4,0,9
80,38,98,8,90,1,89,0,23,29,10,2,0,0,5,2,18
80,39,1376,249,1127,23,1104,12,256,285,153,9,17,1,48,21,302
80,40,171,28,143,1,142,0,32,37,12,1,1,0,13,1,45
80,41,114,26,88,4,84,2,16,33,7,0,0,1,6,3,16
80,42,89,16,73,1,72,0,12,36,8,0,0,0,5,1,10
80,43,222,42,180,1,179,3,40,53,22,3,1,0,18,7,32
80,44,303,41,262,3,259,2,76,46,25,1,7,1,24,5,72
80,45,130,16,114,3,111,0,20,28,10,1,0,2,15,1,34
80,46,54,2,52,0,52,0,11,12,3,1,0,0,5,1,19
80,47,401,43,358,5,353,2,66,96,51,4,2,0,25,5,102
80,48,56,6,50,1,49,1,8,26,0,0,1,0,4,1,8
80,49,154,18,136,2,134,5,35,26,17,2,1,0,16,7,25
80,50,386,29,357,7,350,13,60,121,36,3,1,1,28,1,86
80,51,203,18,185,2,183,1,32,72,7,2,5,0,29,4,31
80,52,186,24,162,2,160,1,66,38,6,1,0,1,13,2,32
80,53,65,9,56,0,56,0,21,10,5,4,1,0,3,0,12
80,54,231,38,193,4,189,1,50,47,15,2,1,0,16,6,51
80,55,142,23,119,2,117,1,31,36,8,0,0,0,16,0,25
80,56,76,6,70,0,70,1,19,21,10,0,0,0,2,3,14
80,57,65,6,59,1,58,1,27,3,4,0,1,1,5,0,16
80,58,275,46,229,1,228,5,42,67,25,5,3,1,20,7,53
80,59,73,9,64,1,63,1,21,22,2,0,0,0,4,1,12
80,60,81,18,63,0,63,0,23,20,6,0,1,0,2,0,11
80,61,187,28,159,5,154,3,49,41,7,6,3,1,12,1,31
80,62,1058,155,903,18,885,7,221,187,133,17,9,1,55,19,236
80,63,741,90,651,26,625,1,121,150,81,9,14,2,37,16,194
80,64,135,16,119,1,118,1,18,50,10,0,0,0,11,0,28
80,65,66,8,58,1,57,0,19,12,6,2,0,2,7,0,9
80,66,202,21,181,2,179,1,48,57,13,1,0,0,15,2,42
80,67,119,21,98,1,97,1,32,31,8,0,0,0,7,2,16
80,68,186,32,154,3,151,1,36,31,7,1,1,0,7,5,62
80,69,184,35,149,1,148,0,27,43,16,7,0,0,7,1,47
80,70,970,144,826,16,810,4,189,209,91,10,6,2,84,22,193
80,71,1477,217,1260,28,1232,11,332,237,141,20,13,3,78,16,381
80,73,133,9,124,1,123,1,39,16,12,3,7,0,12,6,27
80,74,97,10,87,1,86,0,23,19,15,2,0,0,8,0,19
80,76,396,60,336,7,329,0,104,81,39,2,1,0,35,16,51
80,77,279,31,248,4,244,2,62,75,23,3,1,1,17,2,58
80,78,422,41,381,5,376,2,90,102,30,4,0,1,33,6,108
80,79,280,40,240,3,237,0,75,65,16,3,4,0,22,6,46
80,80,140,18,122,2,120,1,38,36,2,0,2,1,9,1,30
80,81,71,4,67,1,66,0,20,20,4,0,2,0,7,1,12
80,82,578,58,520,12,508,7,106,162,59,12,1,0,37,9,115
80,83,129,10,119,2,117,2,20,50,7,1,1,0,8,1,27
80,84,177,24,153,3,150,1,51,31,5,2,2,0,8,4,46
80,85,44,3,41,2,39,1,7,10,4,1,1,0,4,2,9
80,86,794,99,695,8,687,4,224,166,42,12,5,1,39,7,187
80,87,179,33,146,4,142,1,28,48,12,0,0,1,7,1,44
80,88,263,32,231,3,228,0,85,36,18,2,3,1,13,3,67
80,89,219,39,180,2,178,2,63,45,12,3,2,0,16,5,30
80,90,143,21,122,1,121,0,30,37,8,2,0,0,7,1,36
80,92,479,73,406,5,401,6,59,118,36,3,1,1,38,11,128
80,93,859,138,721,11,710,9,198,128,80,9,5,1,27,10,243
80,94,362,36,326,4,322,2,77,62,36,0,1,2,25,4,113
80,95,181,27,154,1,153,1,32,40,11,4,1,0,8,5,51
80,96,770,123,647,22,625,3,115,79,207,8,8,1,32,17,155
80,97,95,11,84,1,83,3,31,20,5,1,1,0,3,3,16
80,98,73,8,65,2,63,0,14,20,6,2,0,0,5,2,14
80,99,191,36,155,2,153,0,43,46,5,1,0,1,27,1,29
80,100,421,67,354,8,346,4,86,71,43,11,3,2,15,8,103
80,101,552,86,466,10,456,3,162,113,34,6,9,1,35,17,76
80,102,357,67,290,4,286,1,79,50,24,4,4,0,21,6,97
80,103,57,10,47,0,47,0,16,16,5,0,0,0,4,1,5
80,104,99,8,91,3,88,0,27,7,12,1,3,0,4,1,33
80,105,130,24,106,0,106,1,24,33,8,1,2,0,4,1,32
80,106,155,19,136,4,132,3,39,34,11,0,1,0,11,4,29
80,107,414,39,375,5,370,9,56,85,51,2,4,3,36,5,119
80,108,62,13,49,1,48,0,20,9,3,1,0,0,2,0,13
80,109,319,47,272,5,267,6,48,81,29,3,8,2,16,6,68
80,110,422,76,346,1,345,3,84,115,23,5,6,1,20,10,78
80,112,203,22,181,3,178,1,44,36,11,2,5,0,16,1,62
80,113,254,28,226,3,223,0,80,40,17,0,1,0,14,5,66
80,114,232,27,205,8,197,1,49,59,18,3,5,0,30,2,30
80,115,249,36,213,3,210,0,76,45,20,3,3,1,8,1,53
80,116,194,26,168,1,167,0,55,50,4,4,2,0,8,7,37
80,117,123,19,104,3,101,0,29,17,9,2,0,0,7,2,35
80,118,97,11,86,1,85,0,23,29,6,1,0,0,11,2,13
80,119,343,48,295,3,292,3,67,104,23,5,4,0,26,5,55
80,120,425,49,376,5,371,3,83,99,27,5,2,2,23,3,124
80,121,107,15,92,0,92,0,30,27,13,2,0,1,9,3,7
80,122,388,58,330,8,322,2,91,83,37,2,9,1,19,9,69
80,123,290,59,231,5,226,5,52,71,20,3,0,0,22,1,52
80,124,558,81,477,8,469,7,108,130,55,7,6,3,25,9,119
80,125,56,7,49,1,48,0,15,15,2,0,0,0,2,0,14
80,126,781,99,682,16,666,6,116,169,76,7,7,4,44,21,216
80,127,661,98,563,15,548,4,114,103,80,9,11,0,31,21,175
80,128,126,26,100,1,99,0,27,25,9,0,1,0,10,3,24
80,129,449,68,381,9,372,3,85,100,45,4,3,0,29,6,97
80,130,320,21,299,7,292,5,39,118,29,5,0,0,26,4,66
80,131,2279,352,1927,33,1894,26,419,466,210,18,13,2,192,38,510
80,132,173,25,148,2,146,0,41,28,33,3,0,0,9,3,29
80,133,210,32,178,2,176,0,51,60,8,1,1,0,14,3,38
80,134,56,13,43,1,42,0,11,18,1,0,0,1,5,1,5
80,135,199,14,185,4,181,1,56,39,30,2,2,0,7,7,37
80,136,954,148,806,17,789,10,210,159,86,10,8,2,59,17,228
80,137,363,46,317,5,312,3,64,97,26,4,5,0,24,14,75
80,138,87,8,79,3,76,1,26,12,5,0,1,2,5,3,21
80,139,71,8,63,0,63,0,16,24,2,2,3,0,2,1,13
80,140,73,5,68,0,68,0,18,12,6,1,1,0,5,2,23
80,141,265,40,225,2,223,3,51,62,20,6,2,2,20,7,50
80,142,143,16,127,3,124,3,27,32,11,2,1,0,16,2,30
80,143,87,10,77,0,77,1,17,24,7,0,0,1,4,1,22
80,144,460,58,402,6,396,9,85,82,45,3,1,1,25,7,138
80,145,110,7,103,5,98,0,34,27,8,2,2,0,5,1,19
80,146,145,20,125,3,122,1,35,28,18,2,1,1,15,3,18
80,147,268,32,236,5,231,0,47,73,11,1,3,0,23,5,68
80,148,331,48,283,3,280,1,58,87,25,4,2,0,19,4,80
80,149,478,98,380,6,374,5,96,116,29,4,2,0,30,8,84
80,150,195,32,163,3,160,1,39,40,11,1,5,0,17,7,39
80,151,243,23,220,1,219,3,65,40,24,4,2,0,19,4,58
80,152,111,14,97,2,95,1,22,20,8,2,3,1,11,0,27
80,153,137,16,121,1,120,1,38,27,6,0,6,0,9,0,33
80,154,174,26,148,2,146,1,25,48,23,2,1,0,8,4,34
80,155,246,24,222,6,216,2,54,63,17,2,1,1,11,11,54
80,156,290,46,244,6,238,11,36,71,39,0,2,1,25,4,49
80,157,77,13,64,1,63,2,14,17,7,0,0,0,3,0,20
80,158,35,10,25,0,25,0,6,6,1,0,0,2,3,1,6
80,159,195,33,162,2,160,2,54,43,12,2,0,1,14,5,27
80,160,1132,163,969,16,953,17,124,253,110,3,9,4,109,24,300
80,161,153,21,132,3,129,1,26,42,15,0,3,2,11,2,27
80,162,486,63,423,7,416,6,131,79,34,5,5,1,26,9,120
80,163,612,67,545,9,536,6,134,140,39,5,4,0,32,14,162
80,164,3295,464,2831,43,2788,43,512,682,457,23,17,4,196,47,807
80,165,151,21,130,2,128,0,37,38,6,0,1,0,18,7,21
80,166,480,62,418,4,414,6,126,74,49,2,5,0,27,7,118
80,167,252,39,213,3,210,0,57,50,16,3,2,0,21,11,50
80,168,781,104,677,17,660,7,156,164,60,8,5,2,45,8,205
80,169,78,11,67,0,67,1,13,27,4,4,0,0,3,3,12
80,170,83,4,79,0,79,2,21,22,4,0,1,0,11,0,18
80,171,480,62,418,6,412,5,102,129,29,3,1,2,27,12,102
80,172,385,72,313,2,311,2,92,72,29,5,4,0,15,7,85
80,173,390,35,355,7,348,1,65,101,45,3,0,0,28,9,96
80,174,61,7,54,2,52,0,13,23,1,0,0,0,1,3,11
80,175,74,8,66,2,64,0,18,16,9,0,0,0,5,3,13
80,176,200,24,176,0,176,1,52,27,20,1,1,0,21,3,50
80,177,574,135,439,3,436,2,124,94,44,4,8,1,24,11,124
80,179,167,23,144,2,142,5,47,45,5,0,1,1,11,10,17
80,180,87,6,81,1,80,1,17,22,6,3,2,0,11,1,17
80,181,76,9,67,0,67,2,21,14,10,1,0,0,9,1,9
80,182,2224,465,1759,29,1730,19,491,438,183,25,16,4,75,38,441
80,183,207,34,173,3,170,3,49,38,19,2,2,0,11,2,44
80,184,359,44,315,6,309,0,109,63,33,5,0,1,15,8,75
80,185,207,29,178,2,176,2,51,47,18,6,1,0,11,3,37
80,186,1401,238,1163,20,1143,14,308,245,91,11,13,1,81,22,357
80,187,591,61,530,7,523,5,109,157,59,4,3,0,33,4,149
80,188,500,62,438,5,433,4,126,114,44,21,1,2,27,9,85
80,189,51,6,45,0,45,0,13,12,5,3,0,0,4,0,8
80,190,931,125,806,26,780,1,165,175,113,12,5,0,61,5,243
80,191,146,12,134,3,131,0,37,31,16,0,1,0,11,7,28
80,192,132,14,118,1,117,0,21,43,2,2,1,0,13,4,31
80,193,97,10,87,0,87,2,21,27,5,2,0,0,2,3,25
80,194,97,20,77,0,77,2,15,30,0,2,1,0,8,2,17
80,195,123,12,111,2,109,0,28,31,11,1,0,0,5,1,32
80,196,218,22,196,2,194,2,58,52,21,2,0,0,11,2,46
80,197,33,9,24,0,24,0,7,3,1,0,0,0,3,2,8
80,198,344,36,308,5,303,4,77,95,23,1,2,0,38,6,57
80,199,408,52,356,4,352,3,77,78,37,13,2,0,20,10,112
80,200,163,26,137,3,134,1,35,43,18,1,1,1,14,5,15
80,201,39,4,35,0,35,0,10,13,3,0,0,0,4,1,4
80,202,244,23,221,4,217,5,57,65,15,8,2,0,30,8,27
80,203,79,16,63,2,61,1,11,21,6,2,0,0,10,1,9
80,204,525,97,428,8,420,2,124,101,46,3,3,1,20,17,103
80,205,669,113,556,9,547,4,201,103,55,3,7,2,34,10,128
80,206,89,10,79,1,78,2,23,13,8,0,1,0,12,3,16
80,207,304,42,262,4,258,4,81,64,32,4,5,0,9,0,59
80,208,162,29,133,3,130,1,37,42,10,3,2,0,5,0,30
80,209,318,52,266,2,264,3,86,60,20,3,3,0,19,10,60
80,210,116,14,102,2,100,0,20,48,8,3,0,0,9,4,8
80,211,1229,204,1025,24,1001,12,271,268,80,15,9,4,78,15,249
80,212,4486,900,3586,63,3523,38,877,711,385,52,33,8,226,77,1116
80,213,318,52,266,1,265,4,47,80,19,1,1,0,29,5,79
80,214,247,48,199,3,196,0,72,41,12,1,0,1,17,2,50
80,215,174,14,160,1,159,0,58,50,8,3,1,1,14,2,22
80,216,131,28,103,2,101,0,24,28,7,6,0,1,12,0,23
80,217,64,13,51,1,50,0,11,22,2,0,0,1,2,4,8
80,218,119,22,97,2,95,2,24,24,8,2,0,0,10,1,24
80,219,52,14,38,0,38,1,10,12,1,0,0,0,2,1,11
80,220,80,11,69,0,69,0,17,19,5,0,0,0,9,1,18
80,221,232,44,188,6,182,1,47,73,9,3,2,0,10,4,33
80,222,1163,221,942,18,924,6,244,248,66,8,8,2,72,20,250
80,223,70,12,58,1,57,1,16,20,3,0,1,0,5,4,7
80,224,86,8,78,1,77,0,22,27,4,2,0,0,7,2,13
80,225,177,26,151,3,148,3,29,42,14,0,2,0,11,6,41
80,226,234,24,210,6,204,3,57,66,18,3,3,1,13,5,35
80,227,293,50,243,5,238,3,49,70,21,2,2,2,20,2,67
80,228,2045,446,1599,33,1566,11,587,425,96,15,10,4,80,20,318
80,229,250,43,207,3,204,1,26,81,16,3,1,0,8,4,64
80,230,247,37,210,1,209,0,63,63,25,2,0,0,3,5,48
80,231,116,9,107,2,105,0,26,40,7,2,0,0,4,1,25
80,232,162,13,149,5,144,0,44,24,11,1,0,0,21,3,40
80,233,114,18,96,0,96,1,33,30,8,1,0,0,10,0,13
80,234,531,72,459,5,454,4,136,114,38,2,3,2,31,6,118
80,235,958,136,822,22,800,5,206,143,172,10,5,1,30,9,219
80,236,334,69,265,2,263,3,61,60,35,2,3,3,22,7,67
80,237,329,46,283,9,274,3,61,71,31,1,1,0,21,13,72
80,238,383,59,324,6,318,5,61,65,45,5,3,0,35,12,87
80,239,55,3,52,3,49,0,8,21,6,0,1,0,5,1,7
80,240,1045,159,886,13,873,8,213,238,75,13,9,3,59,19,236
80,241,778,95,683,9,674,3,198,138,74,9,12,0,25,12,203
80,242,363,49,314,7,307,6,79,70,31,4,1,0,34,8,74
80,243,44,2,42,0,42,0,17,11,5,0,0,1,3,0,5
80,244,144,20,124,2,122,0,31,35,17,3,2,0,8,2,24
80,245,276,54,222,2,220,0,62,64,20,2,1,2,15,1,53
80,246,307,35,272,6,266,7,84,72,22,3,5,0,16,1,56
80,247,515,88,427,8,419,0,113,120,34,8,5,1,28,15,95
80,248,366,53,313,8,305,2,82,86,16,5,3,0,42,5,64
80,249,232,34,198,2,196,0,45,69,9,2,3,0,14,4,50
80,250,235,30,205,2,203,3,64,71,8,4,3,0,8,6,36
80,251,204,32,172,10,162,0,56,42,14,3,4,0,8,2,33
80,252,202,44,158,0,158,0,65,40,17,5,0,0,3,1,27
80,253,4537,1201,3336,47,3289,35,904,741,318,55,33,6,221,62,914
80,256,1191,216,975,14,961,7,219,233,97,12,4,2,90,23,274
80,258,68,18,50,1,49,0,11,10,9,0,1,0,4,2,12
80,259,89,15,74,3,71,0,18,20,3,1,2,0,11,1,15
80,260,749,97,652,14,638,16,104,232,79,3,6,0,57,17,124
80,261,877,122,755,13,742,10,100,322,38,6,5,0,88,17,156
80,262,339,55,284,4,280,5,64,56,37,3,1,1,25,11,77
80,263,56,9,47,0,47,0,17,13,5,1,0,1,4,0,6
80,264,76,12,64,2,62,0,24,13,7,1,0,0,2,0,15
80,265,478,93,385,7,378,1,69,63,66,10,8,3,15,14,129
80,266,206,47,159,1,158,1,34,44,13,0,0,0,11,12,43
80,267,187,25,162,4,158,2,52,42,13,4,0,0,13,3,29
80,268,503,59,444,9,435,8,107,123,37,3,6,1,37,11,102
80,269,98,18,80,1,79,0,27,24,5,2,0,0,8,0,13
80,270,8,0,8,0,8,0,5,1,0,1,0,0,1,0,0
80,271,801,137,664,13,651,5,231,140,66,5,10,0,41,18,135
80,272,95,13,82,3,79,0,21,23,5,1,0,1,6,2,20
80,273,300,43,257,4,253,1,72,55,13,7,2,0,37,4,62
80,274,1506,289,1217,18,1199,7,366,203,114,21,19,5,65,15,384
80,275,233,23,210,4,206,3,75,44,16,4,4,0,7,11,42
80,276,252,37,215,6,209,3,58,69,18,4,1,1,13,13,29
80,278,119,17,102,2,100,0,43,24,6,3,0,0,2,2,20
80,279,563,95,468,8,460,1,166,111,34,8,5,1,34,7,93
80,280,96,10,86,3,83,0,23,28,3,4,1,0,7,0,17
80,281,141,9,132,4,128,3,31,38,7,3,1,0,4,0,41
80,282,353,20,333,4,329,6,91,37,69,5,2,2,21,12,84
80,283,131,15,116,3,113,1,35,25,7,2,2,1,6,2,32
80,284,582,96,486,6,480,4,142,148,46,15,5,2,29,10,79
80,285,167,10,157,4,153,4,42,29,13,1,4,1,13,6,40
80,287,213,26,187,7,180,0,51,49,17,4,0,1,10,3,45
80,288,206,21,185,2,183,2,49,48,22,2,0,2,9,8,41
80,290,305,43,262,3,259,0,51,78,22,3,5,2,24,1,73
80,291,230,35,195,3,192,3,33,66,16,0,0,0,23,5,46
80,292,97,9,88,3,85,1,23,22,14,3,2,0,5,2,13
80,293,296,49,247,4,243,0,56,64,30,4,4,0,15,7,63
80,294,122,16,106,5,101,2,23,28,6,2,2,1,6,2,29
80,295,292,50,242,3,239,2,51,82,20,3,0,0,14,6,61
80,296,876,140,736,11,725,4,224,80,115,13,5,1,26,10,247
80,297,43,4,39,2,37,1,8,22,0,0,0,0,4,0,2
80,298,372,46,326,5,321,0,101,79,28,2,2,0,25,14,70
80,299,168,24,144,4,140,2,39,36,18,1,2,0,11,3,28
80,300,114,13,101,1,100,1,24,31,11,1,1,0,6,1,24
80,301,193,22,171,2,169,2,45,45,10,7,1,0,11,4,44
80,302,126,11,115,2,113,3,25,24,6,5,0,0,13,3,34
80,303,415,72,343,3,340,2,102,118,30,3,0,1,15,6,63
80,304,72,5,67,0,67,0,28,20,4,2,0,0,4,0,9
80,305,410,76,334,3,331,3,76,102,28,0,0,1,29,9,83
80,306,128,9,119,3,116,1,31,26,10,4,3,0,11,1,29
80,307,103,12,91,0,91,1,33,32,3,2,0,0,4,2,14
80,308,1995,234,1761,26,1735,11,404,313,245,22,22,4,79,24,611
80,310,438,55,383,12,371,5,89,94,37,3,3,1,30,4,105
80,311,106,12,94,1,93,0,25,16,13,2,1,0,11,4,21
80,312,212,40,172,2,170,2,64,38,10,2,2,0,10,0,42
80,313,259,33,226,5,221,2,73,30,27,7,8,1,10,8,55
80,314,131,20,111,0,111,1,37,32,4,0,1,1,16,4,15
80,315,331,32,299,5,294,5,70,86,25,0,2,3,18,6,79
80,316,1557,219,1338,25,1313,16,293,277,130,21,6,5,114,24,427
80,317,186,23,163,3,160,2,50,32,10,4,1,0,20,5,36
80,318,2316,444,1872,20,1852,9,570,252,353,18,13,2,62,13,560
80,319,273,52,221,5,216,1,63,71,5,2,1,0,19,5,49
80,320,109,9,100,1,99,0,40,24,9,0,0,0,7,3,16
80,321,126,23,103,0,103,3,25,28,11,3,0,0,4,4,25
80,322,92,8,84,0,84,0,25,21,6,1,0,0,3,0,28
80,324,137,23,114,0,114,1,21,34,10,0,1,0,10,0,37
80,325,37,2,35,1,34,0,8,9,2,0,0,0,2,1,12
80,326,115,15,100,3,97,2,30,36,5,1,1,0,4,5,13
80,327,130,16,114,3,111,2,32,35,7,0,0,0,16,3,16
80,328,430,53,377,7,370,2,122,94,29,1,0,0,24,9,89
80,329,154,27,127,3,124,3,19,40,8,1,0,0,6,4,43
80,330,228,27,201,1,200,1,40,37,24,1,2,1,15,7,72
80,331,242,29,213,3,210,3,44,48,17,1,3,2,15,6,71
80,332,291,37,254,10,244,4,64,91,17,5,1,0,14,6,42
80,333,1178,204,974,24,950,16,229,362,59,6,4,3,66,19,186
80,334,83,18,65,0,65,1,9,6,12,0,0,0,11,1,25
80,335,178,26,152,3,149,2,50,35,7,2,5,0,16,4,28
80,336,61,5,56,0,56,2,23,14,3,0,0,0,6,1,7
80,337,184,25,159,2,157,2,54,34,11,2,1,0,10,2,41
80,338,1289,211,1078,22,1056,11,230,201,122,12,9,5,87,21,358
80,339,118,18,100,1,99,1,41,17,10,4,2,0,10,2,12
80,340,142,7,135,0,135,4,40,47,10,5,1,1,7,1,19
80,341,280,24,256,0,256,1,88,72,9,2,1,0,22,4,57
80,342,298,37,261,7,254,1,81,74,23,2,1,0,21,6,45
80,343,132,19,113,3,110,0,25,25,20,0,1,1,4,1,33
80,344,142,18,124,4,120,1,22,38,12,0,2,0,12,5,28
80,345,376,57,319,10,309,3,83,78,49,2,4,0,16,8,66
80,346,121,18,103,0,103,2,29,22,10,1,0,0,7,2,30
80,347,110,20,90,2,88,4,34,12,9,1,2,0,13,4,9
80,348,128,8,120,3,117,0,57,24,5,1,2,0,7,2,19
80,349,98,8,90,2,88,0,17,26,11,0,1,0,9,2,22
80,350,430,63,367,10,357,4,93,101,29,3,1,1,26,11,88
80,351,217,27,190,4,186,1,40,52,21,1,0,0,7,5,59
80,352,152,31,121,0,121,2,33,32,5,6,0,1,10,5,27
80,353,83,6,77,2,75,1,32,19,0,4,0,0,1,2,16
80,354,118,14,104,0,104,0,29,16,12,0,1,0,12,2,32
80,355,83,11,72,0,72,0,16,27,1,0,2,0,6,2,18
80,356,76,13,63,1,62,1,18,13,5,0,5,1,2,1,16
80,357,214,38,176,3,173,2,43,56,15,1,2,0,10,1,43
80,358,94,8,86,1,85,3,39,21,9,0,0,1,2,0,10
80,359,216,32,184,1,183,0,51,63,11,1,1,1,18,3,34
80,360,1793,230,1563,42,1521,5,311,236,320,21,14,0,77,26,511
80,361,59,10,49,0,49,2,9,12,8,1,0,0,9,1,7
80,362,245,44,201,3,198,5,62,46,22,3,1,0,13,5,41
80,364,588,72,516,19,497,5,117,114,73,12,11,2,26,15,122
80,365,100,17,83,0,83,0,31,15,6,0,0,0,17,0,14
80,366,372,47,325,3,322,2,65,71,42,5,4,0,32,3,98
80,367,164,23,141,4,137,0,38,38,12,2,1,0,13,1,32
80,368,3496,584,2912,68,2844,21,598,505,546,44,30,5,155,60,880
80,369,173,23,150,2,148,2,52,34,11,1,3,0,16,5,24
80,371,84,8,76,3,73,0,35,24,0,0,0,0,3,1,10
80,372,93,4,89,0,89,2,16,33,10,1,0,2,13,0,12
80,373,2055,277,1778,42,1736,18,389,319,249,40,17,4,81,35,584
80,374,210,28,182,6,176,2,48,67,12,3,0,0,12,5,27
80,375,291,38,253,2,251,2,75,44,14,1,0,3,21,4,87
80,376,419,36,383,2,381,10,67,71,50,5,2,0,50,5,121
80,377,329,43,286,10,276,1,91,69,16,6,2,0,16,7,68
80,378,54,4,50,2,48,1,16,17,2,1,1,0,5,0,5
80,379,471,52,419,3,416,7,83,122,33,4,2,1,45,3,116
80,380,196,30,166,1,165,1,55,47,15,2,2,0,6,1,36
80,381,46,4,42,2,40,0,12,20,0,0,0,0,2,0,6
80,383,73,13,60,1,59,0,22,17,2,1,0,0,7,2,8
80,384,164,26,138,4,134,1,37,28,18,2,2,0,12,1,33
80,385,311,49,262,4,258,6,53,67,31,3,1,0,13,3,81
80,386,128,19,109,2,107,0,30,27,5,0,0,2,20,4,19
80,387,248,23,225,4,221,4,60,38,17,5,1,0,23,5,68
80,388,168,27,141,1,140,0,62,40,12,3,2,0,7,4,10
80,389,22,6,16,1,15,0,2,6,1,1,0,0,3,0,2
80,390,288,52,236,3,233,0,55,68,24,1,0,2,20,11,52
80,391,59,4,55,3,52,0,16,15,3,1,0,0,7,0,10
80,392,440,61,379,12,367,1,111,66,32,2,3,0,32,18,102
80,393,272,63,209,4,205,1,45,69,17,5,0,0,9,3,56
80,395,192,26,166,6,160,2,41,29,26,3,1,1,20,2,35
80,396,258,39,219,3,216,5,61,69,16,2,0,0,12,10,41
80,397,97,12,85,1,84,1,18,31,5,0,3,0,9,3,14
80,399,217,34,183,1,182,3,36,55,14,2,0,0,14,3,55
80,400,283,35,248,5,243,4,70,39,39,7,2,1,17,6,58
80,401,103,19,84,0,84,0,24,16,7,4,2,0,11,1,19
80,402,98,11,87,1,86,0,19,31,8,2,2,0,9,5,10
80,403,150,15,135,1,134,3,14,30,16,0,1,0,14,5,51
80,404,118,11,107,2,105,0,35,41,5,0,3,0,7,2,12
80,405,339,49,290,6,284,4,81,58,28,5,0,0,19,10,79
80,406,1112,201,911,15,896,7,237,221,78,10,5,4,50,28,256
80,407,118,17,101,0,101,4,16,43,9,1,3,1,8,1,15
80,408,298,40,258,2,256,5,76,57,24,1,2,0,12,3,76
80,409,148,26,122,2,120,0,44,20,7,7,2,0,4,1,35
80,410,3120,710,2410,40,2370,23,595,509,252,33,39,8,131,48,732
80,411,386,56,330,4,326,7,106,38,45,1,1,1,24,4,99
80,412,418,65,353,0,353,4,91,62,40,5,2,1,28,5,115
80,413,96,11,85,0,85,1,26,27,12,1,0,0,6,1,11
80,414,96,10,86,5,81,2,23,22,6,3,1,0,6,1,17
80,415,724,95,629,9,620,5,187,182,49,5,5,3,40,17,127
80,416,617,88,529,10,519,6,148,128,53,6,3,1,32,11,131
80,417,923,155,768,6,762,10,220,130,64,11,12,1,33,20,261
80,418,75,9,66,1,65,0,12,18,4,2,2,0,4,0,23
80,419,274,36,238,7,231,3,68,42,20,3,1,0,14,3,77
80,420,136,20,116,5,111,2,27,36,7,0,0,0,14,1,24
80,421,213,41,172,3,169,2,60,28,21,2,5,0,3,2,46
80,422,411,35,376,4,372,0,99,88,27,2,5,0,20,10,121
80,423,334,34,300,9,291,5,67,74,25,3,0,1,24,8,84
80,424,360,42,318,7,311,5,42,108,19,1,1,0,27,7,101
80,425,103,12,91,1,90,0,25,30,11,2,0,0,5,0,17
80,426,346,69,277,9,268,3,49,62,17,7,0,0,21,3,106
80,427,286,45,241,5,236,1,63,49,25,2,1,3,16,3,73
80,428,107,10,97,1,96,0,30,31,5,3,4,0,1,1,21
80,429,158,20,138,3,135,1,39,36,12,3,1,0,9,0,34
80,430,117,26,91,0,91,0,29,25,11,1,1,0,4,1,19
80,431,444,41,403,5,398,2,87,129,26,4,0,3,56,11,80
80,432,111,21,90,2,88,2,23,31,10,2,0,0,1,2,17
80,433,36,1,35,0,35,0,8,10,3,0,0,1,1,3,9
80,434,148,18,130,1,129,4,55,21,12,2,0,0,13,1,21
80,435,65,6,59,0,59,0,17,23,4,0,0,0,6,1,8
80,436,403,44,359,11,348,4,82,125,21,2,2,0,26,9,77
80,437,89,2,87,0,87,0,27,19,7,2,0,0,8,3,21
80,438,360,47,313,3,310,2,112,79,24,1,2,1,11,6,72
80,439,119,11,108,2,106,1,28,28,3,0,2,0,8,7,29
80,440,119,22,97,4,93,1,20,29,10,1,0,0,7,4,21
80,442,806,113,693,8,685,12,179,127,96,15,17,0,45,20,174
80,443,1307,227,1080,18,1062,4,282,331,80,12,7,2,85,24,235
80,444,554,86,468,13,455,6,107,105,40,2,6,0,37,13,139
80,445,230,35,195,4,191,2,50,63,11,2,4,2,10,5,42
80,446,658,97,561,20,541,6,132,159,44,3,10,3,49,15,120
80,447,60,8,52,0,52,2,18,19,1,0,0,0,2,0,10
80,449,64,16,48,2,46,0,20,9,5,0,0,0,3,1,8
80,450,72,9,63,0,63,0,10,26,7,0,0,0,1,0,19
80,451,102,11,91,4,87,0,20,30,14,0,0,1,7,1,14
80,452,351,45,306,7,299,4,90,73,23,5,4,1,17,6,76
80,453,110,16,94,2,92,0,19,30,10,2,0,0,11,3,17
80,455,61,12,49,0,49,0,11,18,1,2,1,0,5,2,9
80,456,445,72,373,8,365,3,110,123,17,3,3,2,35,11,58
80,458,317,52,265,11,254,4,71,67,16,7,6,0,23,6,54
80,459,92,24,68,0,68,0,22,16,2,0,1,0,8,2,17
80,460,68,9,59,1,58,0,16,22,1,0,2,0,5,3,9
80,461,184,20,164,5,159,2,35,41,14,1,0,0,16,1,49
80,462,261,26,235,0,235,5,73,73,13,1,1,0,8,5,56
80,463,460,80,380,8,372,2,129,81,45,2,0,1,23,14,75
80,464,722,99,623,13,610,2,236,126,72,5,9,2,33,18,107
80,465,165,18,147,3,144,0,39,25,25,2,1,1,7,5,39
80,466,107,11,96,1,95,0,31,24,13,2,0,0,3,1,21
80,467,140,13,127,2,125,0,36,38,16,2,1,0,8,4,20
80,468,119,15,104,3,101,1,33,26,8,2,0,1,6,0,24
80,469,135,22,113,3,110,0,33,36,4,4,4,0,5,4,20
80,470,141,21,120,1,119,2,17,36,15,3,2,0,12,3,29
80,472,117,17,100,0,100,0,40,22,3,1,0,0,10,0,24
80,473,205,26,179,3,176,2,62,41,14,0,1,0,16,5,35
80,474,305,49,256,8,248,1,51,63,28,3,6,5,6,5,80
80,475,172,25,147,4,143,2,38,39,16,2,0,0,4,2,40
80,476,266,22,244,4,240,0,60,47,25,10,1,0,14,2,81
80,477,188,33,155,1,154,2,46,37,25,0,0,0,6,2,36
80,478,114,13,101,2,99,0,24,20,7,4,3,0,8,4,29
80,479,252,24,228,4,224,0,65,77,10,4,1,1,15,9,42
80,480,87,15,72,0,72,1,14,25,2,0,0,0,5,3,22
80,481,285,55,230,5,225,1,77,58,12,4,0,0,11,3,59
80,482,107,8,99,1,98,2,33,15,9,0,0,0,14,5,20
80,484,295,55,240,5,235,2,58,48,28,2,2,2,13,1,79
80,485,600,63,537,10,527,10,141,123,50,7,7,2,49,10,128
80,486,477,74,403,4,399,3,128,105,23,1,2,0,23,6,108
80,487,86,13,73,1,72,0,23,27,3,1,1,0,1,1,15
80,488,1202,157,1045,18,1027,11,316,198,86,8,6,2,56,22,322
80,489,4132,651,3481,65,3416,44,693,382,679,58,27,5,201,71,1256
80,490,212,30,182,3,179,4,54,47,21,1,0,0,11,2,39
80,491,66,9,57,3,54,1,16,13,0,1,0,0,7,0,16
80,493,212,34,178,1,177,2,50,56,15,4,3,1,13,3,30
80,494,146,21,125,3,122,2,21,28,16,0,3,0,12,4,36
80,495,426,56,370,8,362,8,91,77,23,5,2,0,33,11,112
80,496,146,23,123,1,122,3,37,41,9,0,0,2,5,5,20
80,497,117,24,93,3,90,0,29,35,2,0,0,0,6,3,15
80,498,446,72,374,10,364,3,100,106,32,8,2,2,19,5,87
80,499,158,18,140,1,139,4,30,46,13,0,2,0,8,4,32
80,500,363,49,314,15,299,2,60,86,36,6,3,0,23,3,80
80,501,242,42,200,4,196,1,64,48,14,2,2,1,13,5,46
80,502,94,11,83,2,81,1,17,31,7,1,0,0,7,2,15
80,503,116,11,105,0,105,0,28,27,8,1,0,0,3,2,36
80,504,57,10,47,0,47,0,20,8,3,0,0,0,1,0,15
80,505,137,20,117,0,117,1,25,24,13,2,1,0,5,2,44
80,507,787,124,663,15,648,11,165,132,70,7,3,1,46,18,195
80,508,58,12,46,1,45,0,18,12,1,1,0,0,3,1,9
80,509,337,47,290,6,284,0,97,62,17,5,4,1,12,4,82
80,511,76,12,64,0,64,0,17,24,10,0,0,0,2,2,9
80,512,704,97,607,12,595,4,153,139,61,10,5,1,37,18,167
80,513,150,21,129,7,122,0,26,39,12,0,1,2,9,4,29
80,514,94,7,87,0,87,0,19,28,12,3,0,0,5,2,18
80,515,115,17,98,0,98,3,30,20,7,1,0,0,7,3,27
80,516,179,30,149,1,148,1,49,24,17,0,2,0,10,3,42
80,517,120,13,107,2,105,2,30,31,6,0,0,0,8,5,23
80,518,318,55,263,3,260,2,82,44,33,5,6,3,16,5,64
80,519,409,80,329,1,328,2,121,58,26,6,9,2,14,11,79
80,520,121,16,105,1,104,0,42,30,8,0,2,0,5,0,17
80,521,187,40,147,3,144,2,42,37,16,4,1,0,7,8,27
80,522,82,9,73,1,72,2,17,21,11,1,0,0,3,0,17
80,523,991,153,838,19,819,11,212,154,101,6,4,1,61,17,252
80,524,428,85,343,3,340,3,97,62,41,7,1,1,19,15,94
80,525,128,28,100,1,99,0,22,32,1,1,2,0,17,0,24
80,526,117,18,99,0,99,0,31,27,8,2,2,0,5,1,23
80,527,263,25,238,6,232,0,49,78,33,4,1,0,18,3,46
80,528,13,1,12,2,10,1,2,2,2,0,0,0,3,0,0
80,529,140,19,121,1,120,0,24,46,10,2,0,1,10,2,25
80,530,439,43,396,11,385,2,109,56,64,5,2,0,17,13,117
80,531,100,10,90,2,88,0,24,12,19,0,3,0,2,5,23
80,532,159,16,143,1,142,3,37,41,7,2,2,1,15,0,34
80,533,2517,529,1988,50,1938,13,472,471,291,34,16,4,102,28,507
80,535,145,0,145,0,145,1,40,33,12,0,2,0,11,4,42
80,536,266,54,212,2,210,1,57,61,25,6,3,1,10,3,43
80,537,62,5,57,2,55,0,12,16,6,2,1,0,5,3,10
80,538,116,15,101,1,100,0,21,26,4,0,1,0,10,2,36
80,540,194,34,160,3,157,2,37,41,21,5,1,0,11,1,38
80,541,138,11,127,0,127,1,29,33,12,1,2,0,4,11,34
80,542,465,77,388,3,385,2,95,95,50,9,6,1,24,3,100
80,543,77,7,70,1,69,4,19,10,5,3,0,2,4,2,20
80,544,151,19,132,2,130,0,34,26,11,3,8,0,11,1,36
80,545,417,61,356,5,351,4,86,82,54,4,1,0,20,10,90
80,546,458,72,386,14,372,5,69,101,33,8,0,1,21,15,119
80,547,179,20,159,3,156,3,35,35,12,2,2,1,9,2,55
80,548,293,25,268,7,261,2,60,70,25,2,2,0,14,5,81
80,549,490,76,414,8,406,2,122,78,37,8,0,0,34,16,109
80,550,124,20,104,0,104,4,29,13,11,3,0,0,9,2,33
80,551,118,24,94,2,92,1,29,32,7,2,1,0,9,1,10
80,552,1026,222,804,16,788,4,225,134,89,16,5,0,42,19,254
80,553,272,26,246,6,240,8,57,67,21,2,0,1,33,4,47
80,554,700,158,542,8,534,4,143,152,45,4,4,7,52,17,106
80,555,548,93,455,11,444,4,113,101,43,6,4,1,44,8,120
80,556,436,62,374,14,360,1,88,80,52,5,7,3,21,8,95
80,557,482,91,391,8,383,5,113,112,29,3,2,0,32,3,84
80,558,186,25,161,1,160,3,53,40,11,4,0,0,14,2,33
80,559,133,24,109,4,105,2,25,28,6,3,0,0,9,4,28
80,560,164,15,149,7,142,1,38,44,13,3,1,1,7,7,27
80,561,4449,1056,3393,67,3326,33,801,655,376,62,27,11,230,57,1074
80,562,156,20,136,2,134,6,33,28,13,0,0,0,15,0,39
80,563,82,8,74,1,73,0,17,31,2,0,1,0,5,1,16
80,565,71,5,66,2,64,1,17,19,1,0,0,0,9,1,16
80,566,272,30,242,5,237,4,57,53,24,3,3,0,21,4,68
80,568,240,36,204,3,201,1,51,38,22,1,6,0,17,6,59
80,569,235,34,201,6,195,0,61,56,15,3,0,0,12,1,47
80,570,2887,628,2259,49,2210,18,595,478,233,33,25,5,141,41,641
80,571,365,44,321,3,318,5,77,78,39,4,4,0,20,13,78
80,572,284,46,238,3,235,2,61,63,13,2,4,0,18,4,68
80,573,324,42,282,4,278,4,79,86,10,6,2,3,28,9,51
80,574,67,11,56,1,55,0,20,14,1,2,0,0,1,1,16
80,575,67,1,66,1,65,0,23,21,0,1,0,0,4,1,15
80,576,227,47,180,5,175,3,60,27,23,3,1,0,11,6,41
80,577,155,23,132,0,132,0,42,43,8,1,0,1,7,1,29
80,578,573,68,505,11,494,4,133,124,62,6,4,0,25,7,129
80,579,649,140,509,8,501,1,121,118,59,6,4,1,38,17,136
80,580,191,28,163,3,160,2,44,69,9,1,2,1,9,4,19
80,582,859,118,741,11,730,6,174,196,81,8,11,2,54,4,194
80,583,211,31,180,4,176,2,29,53,16,0,1,0,25,0,50
80,584,957,150,807,14,793,6,178,183,73,8,11,2,87,29,216
80,585,1740,314,1426,29,1397,9,347,289,203,29,21,4,79,15,401
80,586,128,19,109,1,108,0,26,19,16,0,0,0,6,2,39
80,587,80,3,77,4,73,0,32,16,9,0,1,0,0,3,12
80,588,332,56,276,4,272,0,78,51,31,3,3,0,16,11,79
80,589,90,9,81,0,81,0,27,20,6,0,2,0,5,1,20
80,590,241,29,212,1,211,1,54,68,11,3,2,1,18,2,51
80,591,127,16,111,3,108,1,37,30,10,1,4,0,1,1,23
80,592,474,99,375,9,366,1,107,48,56,10,10,1,16,10,107
80,593,217,22,195,1,194,1,67,53,16,1,1,0,9,7,39
80,594,78,10,68,1,67,0,18,23,4,1,0,0,6,0,15
80,595,211,39,172,2,170,2,46,41,17,2,2,0,14,8,38
80,596,175,28,147,4,143,1,47,27,18,2,1,0,9,2,36
80,597,729,83,646,13,633,0,162,91,92,9,10,1,34,18,216
80,598,1029,162,867,14,853,14,242,194,78,17,10,2,38,20,238
80,599,219,32,187,6,181,0,70,58,11,1,1,0,6,2,32
80,600,576,86,490,8,482,5,138,150,48,4,2,2,20,5,108
80,601,314,41,273,5,268,1,76,61,18,6,4,1,21,10,70
80,602,114,25,89,4,85,2,16,37,5,0,0,0,5,3,17
80,603,248,36,212,1,211,2,41,36,25,1,2,0,12,8,84
80,604,69,6,63,0,63,0,15,35,2,0,1,0,2,1,7
80,605,163,25,138,1,137,0,34,33,6,1,3,0,9,4,47
80,606,939,170,769,20,749,3,190,193,72,7,11,2,46,11,214
80,607,198,17,181,2,179,8,36,41,19,2,0,0,26,2,45
80,608,179,30,149,2,147,2,31,47,8,2,5,0,4,2,46
80,609,274,26,248,1,247,1,70,62,24,1,2,1,22,6,58
80,611,643,76,567,12,555,8,133,161,51,6,6,1,55,9,125
80,613,522,91,431,9,422,4,95,92,59,7,1,1,20,15,128
80,614,203,21,182,2,180,2,49,67,7,4,2,0,17,1,31
80,615,331,38,293,5,288,0,81,76,14,4,0,0,24,11,78
80,616,133,18,115,4,111,0,36,20,11,3,3,0,5,5,28
80,617,149,25,124,1,123,6,29,33,4,1,1,0,10,2,37
80,618,885,156,729,12,717,2,238,176,68,7,9,1,49,15,152
80,619,534,75,459,11,448,2,158,70,40,8,2,0,21,13,134
80,620,5543,1380,4163,85,4078,53,876,1066,396,53,34,6,304,105,1185
80,621,259,36,223,4,219,0,69,38,18,5,2,0,8,11,68
80,622,895,120,775,17,758,4,254,134,84,12,7,1,52,13,197
80,623,278,48,230,9,221,2,61,68,14,5,1,0,18,1,51
80,624,196,16,180,0,180,4,36,57,20,1,1,0,6,3,52
80,625,422,54,368,2,366,5,93,68,30,4,4,0,28,6,128
80,626,274,43,231,1,230,2,43,89,15,3,0,0,18,6,54
80,627,712,94,618,7,611,13,107,186,59,6,6,1,65,14,154
80,628,523,89,434,10,424,5,136,100,36,10,10,1,24,14,88
80,629,91,8,83,0,83,3,20,13,10,1,0,0,9,0,27
80,630,1613,307,1306,13,1293,16,235,354,109,21,13,3,97,57,388
80,631,99,17,82,1,81,0,19,19,17,4,1,0,8,3,10
80,632,1512,222,1290,18,1272,17,214,371,107,8,6,1,130,26,392
80,633,499,75,424,5,419,1,109,152,36,2,3,0,22,15,79
80,634,646,97,549,14,535,10,125,140,49,8,3,1,47,10,142
80,635,1036,158,878,20,858,8,281,151,99,10,5,1,31,17,255
80,637,274,69,205,3,202,1,65,47,21,1,0,0,12,5,50
80,638,91,10,81,0,81,1,31,11,11,0,2,0,6,2,17
80,639,964,135,829,10,819,13,165,197,66,11,5,0,72,10,280
80,640,202,19,183,2,181,0,62,45,11,0,2,0,15,5,41
80,642,240,38,202,1,201,4,48,41,17,6,2,0,14,8,61
80,643,411,34,377,6,371,6,92,118,30,4,5,0,40,4,72
80,644,456,82,374,10,364,5,117,93,33,6,5,1,23,13,68
80,645,445,72,373,1,372,4,119,74,39,4,4,1,29,8,90
80,646,63,12,51,1,50,0,12,8,4,0,0,0,5,3,18
80,647,188,20,168,1,167,1,34,30,11,2,7,0,9,2,71
80,648,93,21,72,1,71,2,37,10,3,1,3,0,6,2,7
80,649,1233,260,973,21,952,7,242,357,70,11,11,1,75,16,162
80,650,556,64,492,18,474,2,125,160,25,3,3,1,35,5,115
80,651,204,26,178,0,178,0,45,24,21,1,1,0,11,6,69
80,652,566,105,461,12,449,6,134,133,37,4,5,1,29,12,88
80,654,459,78,381,13,368,2,81,68,48,4,4,0,21,3,137
80,655,363,76,287,5,282,4,77,66,25,4,1,0,31,3,71
80,656,850,154,696,12,684,4,180,200,56,6,9,1,66,10,152
80,657,231,31,200,5,195,1,57,58,13,3,2,1,16,2,42
80,658,126,41,85,0,85,2,33,10,11,4,0,1,5,4,15
80,659,260,36,224,2,222,0,46,69,22,2,1,0,14,6,62
80,661,663,71,592,8,584,6,118,163,46,10,6,1,61,10,163
80,662,206,38,168,0,168,0,52,50,12,4,2,0,4,2,42
80,663,287,59,228,3,225,0,59,64,25,1,4,2,11,4,55
80,664,150,34,116,2,114,2,31,37,10,3,1,1,7,3,19
80,665,105,20,85,2,83,0,21,31,3,2,3,0,11,2,10
80,666,33,5,28,0,28,1,4,6,1,0,0,0,1,1,14
80,667,95,14,81,1,80,0,30,16,10,1,2,0,9,2,10
80,668,159,34,125,3,122,1,28,26,16,1,0,1,14,5,30
80,669,259,29,230,6,224,1,80,39,22,4,2,3,23,4,46
80,670,467,76,391,5,386,4,91,83,43,4,2,1,31,8,119
80,671,185,44,141,3,138,0,52,33,11,3,2,4,4,3,26
80,672,457,78,379,5,374,7,90,71,41,13,1,1,22,5,123
80,673,152,21,131,2,129,1,38,42,11,3,1,0,10,2,21
80,674,2745,478,2267,41,2226,38,457,523,268,18,11,4,182,39,686
80,675,100,7,93,1,92,2,29,16,23,1,2,0,5,2,12
80,676,141,18,123,0,123,3,29,39,9,1,0,1,5,1,35
80,677,1412,249,1163,23,1140,9,341,204,126,29,23,2,55,20,331
80,678,550,83,467,11,456,1,166,110,37,8,8,1,29,7,89
80,679,497,91,406,4,402,1,152,92,38,8,3,0,20,9,79
80,680,2358,487,1871,35,1836,14,413,412,155,26,24,3,106,36,647
80,681,227,32,195,6,189,2,44,63,21,3,0,0,19,7,30
80,682,152,16,136,7,129,3,33,31,13,4,0,0,9,2,34
80,683,90,11,79,0,79,3,24,15,12,0,0,0,6,4,15
80,684,102,11,91,1,90,0,24,31,10,2,2,0,4,0,17
80,685,4377,1126,3251,61,3190,33,710,585,325,50,30,10,197,88,1162
80,686,546,77,469,8,461,6,116,137,42,1,1,1,55,14,88
80,687,112,10,102,4,98,0,31,22,11,1,3,0,6,1,23
80,688,2342,410,1932,41,1891,9,498,527,155,23,23,4,126,48,478
80,690,445,60,385,6,379,12,65,107,34,2,1,0,43,12,103
80,691,344,41,303,5,298,1,75,92,28,4,6,0,13,6,73
80,692,827,182,645,16,629,4,152,141,66,3,13,1,24,15,210
80,693,228,22,206,3,203,3,39,57,26,1,1,0,20,6,50
80,694,273,27,246,7,239,6,77,36,22,8,2,1,22,4,61
80,695,319,62,257,5,252,1,71,57,58,3,2,0,11,2,47
80,696,1011,112,899,18,881,15,97,299,64,7,2,2,141,27,227
80,697,28,3,25,0,25,1,9,8,1,0,1,0,1,0,4
80,698,203,35,168,3,165,4,38,44,15,1,2,0,12,5,44
80,699,102,13,89,3,86,0,18,24,4,0,5,0,10,1,24
80,700,798,117,681,17,664,9,172,114,99,8,8,0,31,20,203
80,701,344,59,285,1,284,4,94,48,24,6,4,0,18,8,78
80,702,821,100,721,10,711,17,81,309,54,5,4,0,99,12,130
80,703,158,13,145,3,142,4,32,48,9,1,7,1,8,3,29
80,704,298,32,266,4,262,6,45,84,26,5,0,1,19,7,69
80,705,83,6,77,3,74,0,25,27,4,0,1,0,5,3,9
80,706,1155,153,1002,15,987,3,288,125,119,14,5,0,37,17,379
80,707,61,5,56,1,55,0,21,9,2,2,1,0,2,2,16
80,708,162,23,139,1,138,1,34,30,15,2,0,0,6,5,45
80,709,200,24,176,3,173,1,50,48,15,2,0,0,14,11,32
80,710,317,30,287,5,282,0,82,71,24,5,1,0,11,9,79
80,711,1239,263,976,15,961,5,277,135,104,9,8,2,40,19,362
80,713,277,47,230,4,226,1,73,72,17,0,0,0,21,2,40
80,714,1101,186,915,11,904,8,196,222,132,12,9,5,60,23,237
80,716,854,87,767,20,747,10,143,216,93,9,7,0,62,23,184
80,717,690,74,616,8,608,9,119,152,54,12,3,2,46,12,199
80,718,1171,201,970,14,956,9,231,178,126,10,10,1,79,15,297
80,719,59,6,53,1,52,2,5,20,2,1,0,0,6,4,12
80,721,1900,328,1572,23,1549,25,349,430,147,19,19,2,126,40,392
80,722,391,47,344,2,342,6,90,104,26,1,0,0,33,2,80
80,723,177,19,158,2,156,2,27,50,11,0,0,0,16,5,45
80,724,1919,327,1592,28,1564,15,353,331,194,19,9,5,103,31,504
80,725,2306,356,1950,34,1916,34,302,588,152,16,11,5,260,37,511
80,726,249,42,207,4,203,1,52,65,11,3,1,1,11,6,52
80,728,58,6,52,0,52,1,12,16,6,0,0,0,9,0,8
80,729,133,29,104,3,101,0,26,35,4,1,0,0,2,1,32
80,730,668,76,592,7,585,9,99,194,50,2,2,2,78,16,133
80,732,548,74,474,6,468,6,111,80,48,10,3,1,28,6,175
80,733,237,29,208,2,206,1,60,72,16,0,0,0,9,0,48
80,734,168,24,144,7,137,2,46,29,10,2,2,2,6,2,36
80,735,146,19,127,2,125,2,31,38,3,3,2,1,11,6,28
80,736,186,25,161,5,156,0,38,46,19,1,0,1,15,2,34
80,737,122,21,101,2,99,0,26,28,12,1,3,0,3,2,24
80,738,109,10,99,1,98,0,26,31,2,0,0,1,4,2,32
80,740,236,15,221,2,219,3,32,66,22,7,0,2,24,4,59
80,741,172,35,137,4,133,3,38,44,8,0,2,0,17,4,17
80,742,63,11,52,0,52,0,13,10,3,2,2,0,3,1,18
80,743,156,15,141,0,141,0,36,55,9,0,2,0,13,2,24
80,744,61,6,55,2,53,1,13,17,4,1,2,1,4,0,10
80,746,933,132,801,14,787,9,211,209,61,6,2,0,81,26,182
80,747,127,20,107,2,105,0,27,18,18,1,1,1,8,5,26
80,748,154,19,135,0,135,0,35,13,23,1,1,0,9,2,51
80,749,248,34,214,4,210,3,50,50,23,1,4,0,23,4,52
80,750,129,14,115,1,114,2,39,28,7,2,2,3,5,1,25
80,751,322,54,268,5,263,6,71,68,20,1,2,2,14,3,76
80,752,362,36,326,3,323,1,76,83,42,4,3,0,24,4,86
80,753,85,5,80,3,77,0,24,18,7,0,0,0,6,1,21
80,754,267,45,222,2,220,1,59,53,8,2,2,1,24,10,60
80,755,112,16,96,6,90,0,27,24,8,1,3,0,8,1,18
80,756,56,13,43,0,43,1,16,17,0,1,1,0,4,1,2
80,757,129,32,97,3,94,3,20,39,3,1,0,1,9,0,18
80,758,136,26,110,0,110,0,26,43,5,2,1,1,14,5,13
80,759,252,34,218,5,213,3,46,53,15,5,2,1,27,5,56
80,760,302,30,272,1,271,1,58,63,34,5,3,0,15,5,87
80,761,207,24,183,2,181,1,52,59,15,0,0,0,16,3,35
80,762,290,33,257,3,254,0,81,64,38,0,4,0,9,7,51
80,763,281,34,247,3,244,2,65,61,22,3,2,0,10,7,72
80,764,263,28,235,5,230,5,56,62,25,4,4,0,17,1,56
80,765,729,132,597,20,577,6,157,136,46,10,3,4,34,10,171
80,766,405,54,351,8,343,5,73,83,26,5,1,1,27,11,111
80,767,168,21,147,8,139,1,33,45,9,2,2,0,8,1,38
80,769,188,20,168,3,165,0,47,36,14,0,0,0,12,3,53
80,770,473,67,406,2,404,2,92,42,131,5,3,0,9,4,116
80,771,38,4,34,1,33,0,4,14,6,2,0,0,1,0,6
80,773,74,14,60,2,58,1,11,14,10,3,0,0,7,1,11
80,774,229,38,191,11,180,3,52,37,23,4,1,0,9,2,49
80,775,565,66,499,18,481,1,114,115,95,6,2,0,18,6,124
80,776,181,18,163,1,162,2,48,44,11,1,1,2,17,3,33
80,777,119,11,108,1,107,1,18,35,6,0,0,0,8,0,39
80,778,110,20,90,2,88,1,16,23,9,1,1,0,9,5,23
80,779,721,96,625,18,607,14,139,137,80,2,3,0,52,10,170
80,780,365,53,312,9,303,4,53,86,36,5,2,1,19,6,91
80,781,212,34,178,7,171,3,64,40,14,1,2,0,7,5,35
80,782,338,30,308,8,300,6,86,89,25,7,4,0,22,14,47
80,783,75,13,62,0,62,1,16,22,7,1,0,0,2,1,12
80,784,267,39,228,5,223,4,44,42,23,3,3,1,17,4,82
80,785,411,49,362,7,355,2,106,92,36,7,6,1,20,5,80
80,786,127,23,104,2,102,1,44,26,4,2,1,0,2,1,21
80,787,71,19,52,0,52,0,12,21,2,1,1,2,2,2,9
80,788,160,25,135,2,133,0,39,55,3,4,0,0,11,1,20
80,789,83,7,76,1,75,1,24,21,3,4,0,0,3,0,19
80,790,113,25,88,1,87,2,16,32,5,3,1,0,7,1,20
80,791,634,98,536,11,525,17,105,151,50,1,7,0,53,7,134
80,792,172,22,150,2,148,1,53,41,8,0,0,0,14,4,27
80,793,1919,335,1584,31,1553,33,387,372,175,24,17,3,119,24,399
80,794,58,13,45,1,44,0,10,15,8,0,0,0,1,6,4
80,795,363,61,302,3,299,2,56,51,73,1,2,0,19,5,90
80,796,180,27,153,3,150,1,38,33,11,3,1,1,12,4,46
80,797,103,11,92,1,91,3,20,20,16,1,0,0,8,1,22
80,798,1205,175,1030,16,1014,24,191,306,64,10,6,4,97,17,295
80,799,3232,630,2602,57,2545,36,600,493,296,43,26,13,228,67,743
80,800,114,20,94,1,93,0,24,37,5,0,1,2,8,2,14
80,801,249,26,223,3,220,0,74,56,22,3,3,1,12,12,37
80,802,534,118,416,5,411,2,139,79,38,8,7,0,24,13,101
80,803,195,26,169,6,163,4,43,42,11,1,0,1,10,3,48
80,804,156,18,138,2,136,4,47,25,9,0,0,0,5,3,43
80,805,124,21,103,4,99,2,15,37,5,3,2,1,14,3,17
80,806,298,30,268,4,264,5,65,80,23,1,0,2,19,5,64
80,807,224,25,199,3,196,5,42,40,37,4,2,2,14,2,48
80,808,363,48,315,6,309,3,76,94,16,5,3,2,25,9,76
80,809,343,35,308,11,297,0,62,110,20,7,2,0,16,4,76
80,810,103,12,91,1,90,3,24,23,6,0,0,0,3,2,29
80,811,482,66,416,5,411,5,140,93,40,10,8,0,15,3,97
80,812,133,33,100,3,97,0,23,32,12,2,0,0,8,1,19
80,813,71,16,55,1,54,0,14,13,4,0,1,0,3,1,18
80,814,325,49,276,4,272,4,68,59,36,1,3,1,13,10,77
80,815,626,86,540,4,536,2,152,152,42,6,3,0,34,7,138
80,819,74,9,65,2,63,2,10,12,13,2,0,0,10,1,13
80,820,594,114,480,8,472,5,134,104,58,5,4,0,26,10,126
80,821,182,29,153,2,151,0,29,36,14,3,2,1,9,2,55
80,822,113,21,92,0,92,1,24,17,6,0,0,0,11,0,33
80,823,85,6,79,1,78,1,28,28,6,0,0,0,8,1,6
80,824,209,23,186,3,183,3,40,52,18,1,3,0,12,2,52
80,825,97,15,82,3,79,0,26,28,5,0,0,0,5,1,14
80,826,683,73,610,10,600,1,196,144,84,5,5,0,24,17,124
80,827,1112,249,863,23,840,7,201,117,195,8,12,1,54,22,223
80,828,37,3,34,1,33,0,7,11,1,0,0,0,5,3,6
80,829,69,13,56,1,55,0,17,14,4,2,0,0,3,2,13
80,830,190,24,166,3,163,0,47,39,20,4,1,1,14,2,35
80,832,220,44,176,2,174,1,40,53,12,6,3,0,14,4,41
80,833,138,17,121,4,117,2,29,26,18,3,4,1,11,3,20
80,834,432,67,365,7,358,0,112,87,44,4,2,0,13,10,86
80,835,186,20,166,1,165,3,34,48,23,4,1,0,9,3,40
80,836,181,8,173,3,170,1,39,60,15,1,1,0,12,2,39
81,1,195,20,175,7,168,6,36,37,16,0,0,1,23,5,44
81,2,2153,240,1913,28,1885,42,449,381,211,31,14,4,152,28,573
81,3,731,115,616,13,603,4,96,175,47,9,7,1,89,6,169
81,4,31566,5372,26194,554,25640,641,3527,6078,3351,257,93,47,2319,334,8993
81,5,447,60,387,14,373,9,65,67,37,6,5,5,30,5,144
81,6,188,16,172,1,171,8,20,40,38,0,2,1,13,5,44
81,7,80,8,72,5,67,2,24,11,5,1,1,0,6,0,17
81,8,272,21,251,10,241,5,28,44,31,5,0,1,34,5,88
81,9,57,12,45,2,43,0,6,7,5,0,1,0,5,3,16
81,10,365,30,335,6,329,5,52,82,38,9,2,1,33,8,99
81,11,749,89,660,14,646,20,103,172,77,15,3,4,50,18,184
81,12,104,15,89,2,87,3,14,23,21,2,1,0,5,3,15
81,13,354,39,315,9,306,16,34,56,34,2,1,0,27,9,127
81,14,511,101,410,6,404,11,101,106,33,3,0,0,63,7,80
81,15,57,7,50,0,50,3,13,5,13,0,1,0,4,2,9
81,16,188,24,164,3,161,6,20,39,30,1,0,0,11,4,50
81,17,142,19,123,7,116,0,20,21,14,2,1,0,19,0,39
81,18,1935,213,1722,30,1692,14,300,334,222,19,5,2,138,33,625
81,19,129,15,114,1,113,3,26,31,4,1,0,0,10,2,36
81,20,212,23,189,3,186,2,31,42,21,1,2,1,13,6,67
81,21,4781,883,3898,56,3842,47,738,941,382,32,16,14,266,55,1351
81,22,141,17,124,2,122,1,30,26,7,2,0,0,12,1,43
81,23,200,29,171,6,165,0,27,72,7,2,1,1,21,7,27
81,24,221,27,194,7,187,10,46,33,30,1,0,0,20,2,45
81,25,166,16,150,2,148,2,24,50,21,2,1,2,22,1,23
81,26,327,27,300,8,292,5,68,67,32,3,3,1,27,6,80
81,27,142,7,135,3,132,2,25,35,10,1,1,1,12,1,44
81,28,104,10,94,4,90,1,13,12,14,3,0,0,11,2,34
81,29,137,7,130,5,125,2,35,31,17,0,0,0,12,0,28
81,30,81,7,74,3,71,4,14,15,11,0,0,0,4,4,19
81,31,688,80,608,13,595,7,118,187,50,9,7,5,87,11,114
81,32,758,76,682,17,665,5,176,137,89,9,6,3,60,10,170
81,33,2305,334,1971,37,1934,29,378,198,353,26,15,4,88,19,824
81,34,309,42,267,9,258,7,81,48,40,0,0,0,19,4,59
81,35,160,13,147,1,146,4,21,29,24,2,0,0,17,6,43
81,36,932,101,831,13,818,17,206,206,67,8,15,2,64,17,216
81,37,1112,160,952,19,933,15,164,274,94,17,8,1,113,17,230
81,38,1593,237,1356,22,1334,24,271,328,172,12,3,1,142,20,361
81,39,1510,223,1287,24,1263,23,266,282,164,9,5,3,108,21,382
81,40,302,33,269,4,265,10,68,47,39,4,0,0,34,2,61
81,41,90,14,76,2,74,2,14,27,4,1,0,0,7,3,16
81,42,1539,180,1359,36,1323,27,300,369,135,13,3,4,121,29,322
81,43,575,58,517,15,502,7,145,107,43,6,5,0,24,5,160
81,44,197,12,185,2,183,5,28,46,16,0,0,0,26,5,57
81,45,320,67,253,5,248,9,37,82,26,3,0,2,32,2,55
81,46,1057,102,955,19,936,21,183,205,101,11,5,0,108,12,290
81,47,217,28,189,5,184,2,42,36,18,5,0,0,26,2,53
81,48,1802,229,1573,35,1538,23,362,243,231,21,11,2,100,28,517
81,49,161,28,133,4,129,4,32,20,19,3,1,1,6,5,38
81,50,208,38,170,1,169,12,30,49,14,5,2,0,7,3,47
81,51,824,91,733,17,716,14,94,186,111,8,5,1,94,11,192
81,52,1602,162,1440,43,1397,23,268,312,144,11,6,5,162,29,437
81,53,321,43,278,12,266,7,85,42,20,3,2,1,35,2,69
81,54,617,63,554,7,547,8,108,110,50,8,3,0,82,10,168
81,55,236,20,216,4,212,4,41,55,25,1,0,2,21,4,59
81,56,102,13,89,2,87,5,27,24,11,1,0,0,7,2,10
81,58,169,14,155,3,152,6,43,51,6,1,1,0,18,3,23
81,59,599,68,531,11,520,8,98,123,57,9,2,1,62,9,151
81,60,7389,1258,6131,122,6009,70,1019,883,969,73,28,13,364,67,2523
81,61,158,19,139,5,134,3,28,32,15,2,1,0,20,1,32
81,62,731,130,601,15,586,19,150,125,55,10,7,3,82,9,126
81,63,1151,145,1006,30,976,21,188,235,111,9,4,2,100,23,283
81,64,762,109,653,20,633,24,110,169,92,12,6,3,59,8,150
81,65,29664,5478,24186,523,23663,444,4467,6349,2436,276,97,48,2156,369,7021
81,66,244,26,218,2,216,1,41,32,31,3,0,0,17,3,88
81,67,417,49,368,6,362,16,71,75,52,8,3,0,48,5,84
81,68,129,12,117,5,112,2,20,16,19,0,0,1,7,1,46
81,69,630,85,545,11,534,31,63,144,56,8,2,3,49,9,169
81,70,1950,278,1672,24,1648,61,285,306,242,27,11,0,142,27,547
81,71,72,10,62,1,61,0,16,19,5,1,0,0,5,2,13
81,72,114,23,91,1,90,1,8,11,11,0,0,0,10,3,46
81,73,151,13,138,4,134,1,32,13,17,2,1,0,11,5,52
81,74,1231,102,1129,30,1099,17,183,196,134,10,4,8,85,19,443
81,75,381,48,333,3,330,12,74,72,38,6,1,0,43,9,75
81,76,508,60,448,5,443,6,99,97,76,4,4,0,55,5,97
81,77,440,80,360,4,356,9,83,93,33,4,2,2,49,8,73
81,78,825,123,702,16,686,21,136,130,90,14,9,0,47,21,218
81,79,589,71,518,14,504,10,101,131,55,6,6,0,67,3,125
81,80,67,7,60,1,59,0,12,15,5,0,0,0,7,1,19
81,81,962,110,852,15,837,13,113,224,90,8,5,5,117,15,247
81,82,108,16,92,1,91,0,13,26,10,1,0,0,11,1,29
81,83,194,22,172,1,171,5,33,38,23,3,0,0,15,4,50
81,84,508,70,438,8,430,10,117,94,62,7,2,1,22,9,106
81,85,64,13,51,2,49,0,6,21,7,0,0,0,3,0,12
81,86,137,23,114,2,112,4,15,18,20,3,0,1,9,2,40
81,87,265,34,231,3,228,2,33,43,40,1,3,0,23,6,77
81,88,400,44,356,12,344,7,66,59,51,3,3,2,51,4,98
81,89,142,13,129,2,127,3,24,33,4,2,1,1,17,3,39
81,90,194,29,165,0,165,8,33,23,17,0,0,0,14,10,60
81,91,152,20,132,3,129,2,16,17,13,7,0,0,18,4,52
81,92,655,76,579,10,569,18,79,136,87,7,2,0,42,13,185
81,93,506,62,444,9,435,11,72,96,43,4,1,3,55,6,144
81,94,81,7,74,1,73,3,9,8,7,1,2,0,6,0,37
81,95,76,5,71,0,71,0,9,28,9,1,1,0,8,0,15
81,96,343,41,302,10,292,14,54,65,32,5,1,2,52,6,61
81,97,1036,116,920,18,902,20,173,195,150,9,3,1,74,17,260
81,98,504,49,455,15,440,6,93,145,42,5,2,1,38,11,97
81,99,9709,1897,7812,167,7645,180,1452,1863,1033,84,48,22,626,114,2223
81,100,252,25,227,4,223,3,69,44,21,3,0,1,25,4,53
81,101,1081,161,920,16,904,10,174,157,144,11,6,0,77,8,317
81,102,228,31,197,2,195,9,33,42,34,1,0,1,29,3,43
81,103,122,12,110,5,105,3,14,26,11,2,0,1,10,3,35
81,104,1138,157,981,32,949,31,181,239,111,8,2,6,95,21,255
81,105,8870,1743,7127,168,6959,98,1518,1637,761,95,30,15,394,76,2335
81,106,380,48,332,8,324,23,53,92,43,4,1,1,18,5,84
81,108,107,12,95,1,94,9,26,22,10,2,0,0,4,3,18
81,109,367,44,323,7,316,9,80,87,17,7,2,0,49,5,60
81,110,84,9,75,1,74,1,6,9,15,1,0,0,9,3,30
81,111,76,7,69,2,67,4,17,13,6,0,2,0,8,2,15
81,112,782,69,713,12,701,22,146,133,101,13,2,2,72,10,200
81,113,260,25,235,3,232,6,35,54,35,3,0,1,32,7,59
81,114,378,38,340,8,332,5,86,48,34,3,1,0,28,1,126
81,115,1160,223,937,22,915,23,190,139,170,9,5,2,71,9,297
81,116,1408,143,1265,24,1241,28,229,261,181,23,6,2,101,27,383
81,117,634,61,573,20,553,8,123,129,58,8,1,0,53,5,168
81,118,124,11,113,1,112,2,16,35,16,0,0,0,9,1,33
81,119,353,43,310,14,296,7,78,58,21,7,0,0,24,10,91
81,120,4740,706,4034,88,3946,59,833,905,456,55,21,8,318,69,1222
81,121,240,26,214,4,210,2,35,64,35,3,0,1,18,3,49
81,122,62,14,48,0,48,0,11,2,6,0,0,0,9,0,20
81,123,100,14,86,2,84,3,10,25,10,0,1,0,12,4,19
81,124,1996,285,1711,65,1646,26,307,485,121,22,12,4,166,27,476
81,125,318,58,260,9,251,11,49,70,27,4,1,1,27,0,61
81,126,132,10,122,3,119,8,25,34,21,1,0,0,14,0,16
81,127,108,9,99,4,95,2,29,16,7,1,2,0,8,1,29
81,128,1475,196,1279,20,1259,23,346,515,73,19,5,3,100,28,147
81,129,190,26,164,2,162,7,40,28,22,2,0,0,13,2,48
81,130,1401,187,1214,14,1200,27,269,291,118,11,4,1,93,19,367
81,131,1419,182,1237,18,1219,22,245,297,147,16,6,6,118,18,344
81,132,640,68,572,15,557,10,133,113,63,10,2,3,64,13,146
81,133,348,35,313,9,304,8,61,80,28,7,0,0,30,4,86
81,134,82,6,76,0,76,3,16,19,9,2,0,0,10,0,17
81,135,88,8,80,1,79,4,10,23,5,0,1,0,13,0,23
81,136,137,27,110,1,109,3,10,28,28,1,2,0,9,5,23
81,137,72,4,68,2,66,2,13,21,6,2,0,0,6,0,16
81,138,338,43,295,5,290,4,55,46,49,7,0,0,25,2,102
81,139,1259,130,1129,32,1097,31,177,328,118,20,5,1,124,17,276
81,140,7573,1310,6263,141,6122,159,912,1589,785,64,31,10,535,89,1948
81,141,156,25,131,2,129,2,20,40,20,2,0,0,17,3,25
81,142,597,68,529,17,512,14,97,124,74,4,3,1,57,9,129
81,143,444,54,390,9,381,6,116,83,37,7,3,3,22,6,98
81,144,3370,404,2966,68,2898,38,531,553,343,33,19,9,231,53,1088
81,145,3443,494,2949,77,2872,74,529,658,433,43,13,9,268,62,783
81,146,210,37,173,6,167,8,43,35,13,4,3,0,20,5,36
81,147,863,82,781,19,762,24,164,183,79,10,7,1,81,14,199
81,148,73,8,65,2,63,7,11,22,7,1,0,0,2,0,13
81,149,323,39,284,4,280,6,46,56,41,3,3,0,31,7,87
81,150,323,34,289,7,282,16,37,71,38,5,1,3,38,10,63
81,151,123,12,111,1,110,3,15,26,17,0,0,0,3,4,42
81,152,201,20,181,8,173,3,47,44,16,0,0,1,10,4,48
81,153,51,5,46,2,44,0,14,17,0,1,1,1,6,1,3
81,154,67,13,54,1,53,1,13,13,2,0,1,0,5,2,16
81,155,240,41,199,1,198,4,58,48,21,2,0,1,25,5,34
81,156,2196,205,1991,38,1953,32,368,434,215,22,10,3,200,28,641
81,157,239,25,214,5,209,19,30,53,22,3,0,1,25,5,51
81,158,258,50,208,7,201,4,32,57,17,5,2,1,40,3,40
81,159,249,35,214,0,214,5,20,74,16,3,0,0,26,8,62
81,160,356,68,288,4,284,9,57,39,37,1,0,1,29,4,107
81,161,122,11,111,2,109,1,16,26,9,1,0,0,27,0,29
81,162,133,25,108,2,106,2,16,23,17,1,1,1,5,3,37
81,163,7455,1632,5823,101,5722,102,1136,1750,528,64,36,13,457,102,1534
81,164,323,46,277,7,270,11,39,49,47,6,2,0,27,3,86
81,165,259,45,214,6,208,1,35,62,33,4,2,0,15,2,54
81,166,76,9,67,1,66,2,13,18,4,0,0,0,7,0,22
81,167,107,16,91,1,90,3,8,20,12,1,0,0,16,1,29
81,168,932,139,793,16,777,10,114,129,110,13,1,3,75,12,310
81,169,92,11,81,2,79,2,17,21,10,2,0,0,12,1,14
81,170,1087,100,987,15,972,21,180,137,174,28,6,3,63,15,345
81,171,1033,161,872,18,854,29,168,219,95,11,4,0,80,11,237
81,172,44,2,42,1,41,0,9,17,0,1,0,0,5,0,9
81,173,169,17,152,5,147,5,30,43,15,2,0,0,8,6,38
81,174,417,44,373,10,363,9,77,86,41,8,1,0,23,8,110
81,175,264,52,212,6,206,5,55,52,23,3,2,1,19,7,39
81,176,92,20,72,4,68,2,13,16,9,1,1,0,3,2,21
81,177,307,26,281,7,274,5,61,91,21,1,2,1,33,1,58
81,178,279,30,249,4,245,5,63,55,37,6,2,0,16,1,60
81,179,234,29,205,13,192,4,29,47,23,3,0,0,13,3,70
81,180,249,34,215,1,214,8,22,29,31,0,2,1,33,5,83
81,181,136,11,125,2,123,3,27,43,13,0,0,1,10,4,22
81,182,1614,172,1442,40,1402,34,213,367,169,15,8,3,175,24,394
81,183,175,20,155,5,150,4,18,27,17,5,0,0,21,2,56
81,184,34,2,32,1,31,1,1,6,0,1,0,0,9,0,13
81,185,173,27,146,1,145,2,29,24,27,1,0,1,12,5,44
81,186,279,36,243,8,235,2,30,49,32,3,1,0,21,5,92
81,187,154,24,130,3,127,4,32,44,19,1,0,1,10,1,15
81,188,307,37,270,11,259,2,64,84,13,2,4,1,41,2,46
81,189,94,2,92,2,90,2,17,14,18,0,0,0,14,0,25
81,190,312,25,287,10,277,6,65,40,36,5,3,0,25,4,93
81,191,229,23,206,4,202,6,26,42,28,5,3,0,21,6,65
81,192,784,138,646,15,631,8,104,176,69,7,4,1,78,7,177
81,193,327,51,276,9,267,3,76,77,16,3,0,0,24,9,59
81,195,632,70,562,7,555,12,103,111,80,7,1,0,61,13,167
81,196,712,76,636,19,617,9,133,153,59,10,3,1,70,10,169
81,197,173,32,141,0,141,10,26,33,13,2,0,0,5,7,45
81,198,265,36,229,3,226,4,39,47,31,2,0,0,32,7,64
81,199,181,19,162,8,154,2,29,35,16,1,0,1,21,5,44
81,200,357,39,318,5,313,2,56,77,46,7,1,0,22,7,95
81,201,611,67,544,9,535,8,105,68,89,11,3,1,33,6,211
81,202,691,79,612,14,598,11,120,132,84,11,4,1,66,17,152
81,203,475,60,415,8,407,13,69,125,36,4,3,2,85,5,65
81,204,1885,227,1658,49,1609,15,365,411,171,28,10,0,138,32,439
81,205,150,11,139,0,139,2,27,29,16,0,0,0,20,0,45
81,206,455,52,403,12,391,31,48,63,95,8,2,2,29,7,106
81,207,82,2,80,4,76,0,8,19,8,4,0,0,4,0,33
81,208,331,34,297,4,293,3,59,71,43,1,1,0,22,3,90
81,209,2253,241,2012,47,1965,25,453,572,145,28,9,5,180,28,520
81,210,175,20,155,2,153,2,42,41,12,1,1,0,12,3,39
81,211,359,44,315,10,305,8,68,59,35,3,1,0,43,8,80
81,212,113,15,98,3,95,2,25,27,10,1,0,0,10,1,19
81,213,72,5,67,2,65,1,9,25,6,0,2,1,2,1,18
81,214,76,13,63,1,62,3,9,14,6,1,0,0,6,1,22
81,215,489,78,411,6,405,8,95,100,42,1,5,2,33,5,114
81,216,182,13,169,2,167,8,39,35,18,1,0,2,20,6,38
81,217,369,42,327,6,321,21,61,72,52,4,2,1,25,3,80
81,218,2547,273,2274,53,2221,39,340,627,216,31,4,4,248,49,663
81,219,2430,345,2085,64,2021,67,409,443,246,29,15,5,239,24,544
81,220,3864,508,3356,35,3321,132,552,706,487,47,25,7,295,63,1007
81,221,215,26,189,4,185,0,35,73,8,0,2,0,20,5,42
81,222,2441,271,2170,49,2121,38,416,573,203,27,12,6,216,38,592
81,223,86,9,77,2,75,0,20,20,8,0,1,0,7,0,19
81,224,112,18,94,0,94,2,18,16,10,1,0,0,13,1,33
81,225,626,79,547,12,535,10,116,120,81,4,4,1,52,9,138
81,226,219,22,197,8,189,9,37,36,21,1,2,1,27,5,50
81,227,1775,196,1579,48,1531,23,369,349,163,21,14,2,157,18,415
81,228,305,31,274,3,271,10,61,65,34,6,5,1,26,6,57
81,229,108,10,98,3,95,17,5,20,19,1,0,0,19,1,13
81,230,652,55,597,19,578,4,107,77,91,4,4,2,33,4,252
81,231,316,57,259,6,253,4,74,52,27,0,2,2,24,4,64
81,232,520,39,481,17,464,7,85,99,66,7,2,3,47,4,144
81,233,186,22,164,3,161,11,30,32,21,1,0,0,27,1,38
81,234,73,10,63,0,63,2,13,8,10,1,0,1,7,0,21
81,235,600,81,519,9,510,13,143,92,55,8,4,1,49,7,138
81,236,184,21,163,4,159,6,28,39,16,3,2,1,12,3,49
81,237,136,5,131,0,131,7,20,27,19,2,1,0,7,1,47
81,238,1227,161,1066,36,1030,16,254,251,102,19,5,4,83,19,277
81,239,828,141,687,19,668,15,179,161,55,14,4,2,73,17,148
81,240,97,10,87,0,87,1,15,8,19,0,0,0,11,1,32
81,241,204,22,182,2,180,6,22,47,30,2,0,0,31,1,41
81,242,188,20,168,5,163,2,36,44,7,5,1,1,16,1,50
81,243,101,15,86,2,84,5,21,12,13,1,1,0,9,2,20
81,244,1842,287,1555,28,1527,13,307,136,365,27,10,0,72,12,585
81,245,103,15,88,1,87,2,17,12,12,0,2,1,12,0,29
81,246,94,14,80,3,77,8,15,12,9,1,0,0,6,2,24
81,247,189,31,158,3,155,1,25,30,19,5,0,0,13,2,60
81,248,626,77,549,14,535,7,131,122,64,5,9,1,64,5,127
81,249,706,113,593,16,577,13,124,97,76,4,3,0,48,4,208
81,250,208,12,196,7,189,1,53,44,20,0,0,0,18,0,53
81,251,659,83,576,17,559,13,146,106,66,9,5,0,56,6,152
81,252,121,11,110,4,106,0,17,38,13,2,0,3,13,1,19
81,253,377,34,343,8,335,5,88,72,37,5,0,0,22,4,102
81,254,299,35,264,9,255,7,44,40,37,7,2,3,28,9,78
81,255,319,46,273,1,272,1,39,60,23,5,0,1,32,5,106
81,256,72,6,66,1,65,0,14,21,8,0,0,1,12,2,7
81,257,5179,723,4456,127,4329,58,756,750,601,54,15,7,328,47,1713
81,258,331,54,277,10,267,7,53,66,32,5,1,0,37,4,62
81,259,204,19,185,3,182,4,38,51,12,1,1,2,24,4,45
81,260,367,39,328,11,317,5,75,35,44,12,1,0,23,8,114
81,261,702,71,631,20,611,15,132,150,77,8,5,3,40,10,171
81,262,191,25,166,3,163,12,36,31,7,4,3,0,17,5,48
81,263,327,62,265,5,260,7,45,71,27,6,0,0,31,4,69
81,264,87,15,72,0,72,1,13,19,4,0,0,0,12,2,21
81,265,58,6,52,0,52,4,13,11,3,0,0,0,3,1,17
81,266,808,93,715,24,691,18,135,128,88,16,1,1,74,6,224
81,267,473,57,416,21,395,7,75,70,31,11,7,0,80,14,100
81,268,81,15,66,3,63,2,9,20,1,1,0,0,15,1,14
81,269,562,97,465,11,454,7,135,150,30,7,1,0,44,8,72
81,270,101,8,93,1,92,0,34,17,9,0,0,0,12,1,19
81,271,5448,702,4746,57,4689,118,812,953,699,60,23,17,417,83,1507
81,272,171,35,136,2,134,4,30,22,25,2,1,0,9,0,41
81,273,2712,306,2406,62,2344,22,496,587,244,23,17,5,233,38,679
81,274,686,95,591,15,576,8,105,118,65,4,2,0,57,8,209
81,275,177,30,147,2,145,9,30,20,31,2,0,0,13,0,40
81,276,823,121,702,12,690,22,124,148,119,6,1,1,61,6,202
81,277,386,26,360,11,349,10,77,71,40,4,1,4,41,10,91
81,278,145,18,127,7,120,2,39,22,12,4,0,0,18,3,20
81,279,194,30,164,1,163,13,39,37,22,5,0,2,14,5,26
81,280,223,31,192,6,186,5,32,45,20,1,0,1,9,7,66
81,281,1645,235,1410,35,1375,13,341,294,177,21,10,2,122,24,371
81,282,54,12,42,0,42,0,4,13,7,1,0,0,3,4,10
81,283,872,118,754,14,740,16,137,171,109,8,1,1,79,19,199
81,284,1318,179,1139,22,1117,29,223,242,116,11,4,4,97,13,378
81,285,324,40,284,9,275,8,55,51,22,3,0,0,32,5,99
81,286,393,36,357,7,350,5,61,80,34,4,5,2,38,2,119
81,287,190,33,157,3,154,2,43,27,18,0,1,0,18,7,38
81,288,1907,247,1660,37,1623,36,347,428,168,25,14,3,144,43,415
81,289,1705,223,1482,43,1439,17,379,369,129,12,6,2,117,24,384
81,290,146,19,127,6,121,3,25,25,18,0,3,1,16,2,28
81,291,323,40,283,5,278,4,55,47,35,2,4,1,19,9,102
81,292,427,48,379,6,373,10,51,96,41,3,1,1,46,4,120
81,293,228,31,197,2,195,4,51,51,29,3,2,0,16,6,33
81,294,648,88,560,16,544,9,131,118,76,9,0,0,61,7,133
81,295,388,44,344,9,335,3,75,69,33,5,7,1,37,5,100
81,296,215,23,192,8,184,6,42,49,14,1,1,0,27,9,35
81,297,854,82,772,14,758,9,160,195,87,4,3,2,64,5,229
81,298,372,40,332,2,330,12,65,91,62,5,2,0,22,5,66
81,299,309,29,280,5,275,12,44,54,48,7,0,6,27,6,71
81,300,104,21,83,1,82,2,25,19,5,2,0,0,14,2,13
81,301,103,13,90,5,85,0,20,30,5,1,0,1,11,2,15
81,302,40,9,31,2,29,0,4,6,1,0,0,0,2,2,14
81,303,283,50,233,3,230,7,29,40,39,1,1,2,13,4,94
81,304,175,21,154,3,151,8,27,26,17,1,1,0,21,0,50
81,305,711,96,615,17,598,20,69,103,100,14,2,2,68,13,207
81,306,722,82,640,12,628,17,105,108,79,3,5,2,70,10,229
81,307,581,62,519,8,511,10,147,127,42,7,3,2,40,6,127
81,308,922,149,773,9,764,12,139,230,67,9,1,3,47,18,238
81,309,246,43,203,6,197,15,24,15,43,3,1,1,8,5,82
81,310,102,14,88,3,85,3,9,18,13,1,6,0,8,1,26
81,311,532,60,472,11,461,8,100,128,37,2,6,0,73,11,96
81,312,656,96,560,12,548,12,89,93,84,11,6,1,53,9,190
81,313,205,21,184,2,182,7,29,30,33,4,1,1,15,1,61
81,314,526,84,442,9,433,11,83,110,47,5,2,0,51,14,110
81,315,1082,113,969,26,943,21,201,184,131,17,5,1,79,28,276
81,316,157,22,135,5,130,6,22,34,23,0,0,0,13,2,30
81,317,871,76,795,28,767,10,156,154,99,7,1,2,87,9,242
81,318,134,19,115,2,113,7,15,25,17,0,0,0,10,2,37
81,319,389,44,345,8,337,4,74,78,33,3,2,0,34,14,95
81,320,147,19,128,1,127,6,21,40,17,2,0,0,12,0,29
81,321,81,13,68,3,65,2,18,15,6,0,0,1,5,4,14
81,322,187,25,162,3,159,0,20,40,18,2,0,2,25,4,48
81,323,271,17,254,6,248,3,44,60,34,4,0,0,29,4,70
81,324,170,26,144,8,136,4,17,40,16,2,1,0,11,0,45
81,325,1426,161,1265,45,1220,16,271,285,153,17,6,3,116,27,326
81,326,289,24,265,5,260,7,35,45,35,1,1,1,30,8,97
82,1,476,57,419,11,408,10,83,102,51,8,1,0,29,10,114
82,2,2181,356,1825,48,1777,34,469,507,146,23,9,5,150,22,412
82,3,164,23,141,2,139,4,26,31,30,2,0,0,20,5,21
82,4,111,16,95,5,90,3,26,28,6,1,0,0,9,2,15
82,5,790,94,696,11,685,17,138,197,80,10,1,0,66,18,158
82,6,58,10,48,2,46,0,7,15,4,0,0,0,5,0,15
82,7,102,5,97,0,97,0,16,22,23,1,0,0,3,2,30
82,8,670,62,608,13,595,13,100,173,81,13,1,1,50,9,154
82,9,27,6,21,1,20,1,11,5,0,0,0,0,1,0,2
82,10,185,17,168,5,163,3,45,30,30,7,1,3,7,4,33
82,11,590,73,517,12,505,6,140,130,43,8,1,0,28,10,139
82,12,350,44,306,6,300,2,71,72,29,3,1,1,41,10,70
82,13,2549,358,2191,55,2136,31,401,603,230,18,9,4,160,28,652
82,14,202,30,172,0,172,5,48,32,20,0,0,0,18,3,46
82,15,92,3,89,2,87,1,22,20,10,0,0,0,7,1,26
82,16,122,15,107,0,107,0,23,30,9,0,1,0,15,4,25
82,17,904,114,790,26,764,13,194,168,98,7,3,4,73,8,196
82,18,817,91,726,15,711,14,190,132,82,12,5,1,56,14,205
82,19,524,99,425,9,416,4,123,107,32,11,0,0,30,6,103
82,20,438,51,387,11,376,11,67,98,51,4,3,1,36,2,103
82,21,158,6,152,6,146,8,22,46,13,2,0,2,18,5,30
82,22,314,47,267,5,262,9,42,77,43,4,4,0,25,6,52
82,23,543,72,471,3,468,3,138,84,49,2,2,4,33,13,140
82,24,199,31,168,1,167,2,40,51,14,4,0,0,24,1,31
82,25,2569,292,2277,48,2229,35,559,559,228,26,10,7,164,41,600
82,26,597,75,522,10,512,33,92,107,88,6,1,0,36,5,144
82,27,856,103,753,11,742,12,180,143,92,8,3,3,62,12,227
82,28,533,66,467,5,462,3,120,116,49,5,1,2,48,13,105
82,29,202,35,167,3,164,4,17,43,14,3,2,1,18,2,60
82,30,314,36,278,4,274,6,63,70,26,6,3,3,30,6,61
82,31,748,101,647,9,638,9,212,124,53,5,4,2,49,16,164
82,32,387,48,339,6,333,4,86,98,32,4,3,0,26,9,71
82,33,9526,2026,7500,146,7354,103,1881,1768,795,87,25,12,528,116,2039
82,34,115,18,97,1,96,3,19,25,13,0,1,0,11,2,22
82,35,273,45,228,5,223,3,62,52,16,3,0,1,21,4,61
82,36,138,11,127,2,125,1,17,26,9,4,2,0,9,2,55
82,37,4624,720,3904,81,3823,68,785,1003,409,38,16,13,285,72,1134
82,38,1139,182,957,21,936,38,179,244,119,10,6,1,95,21,223
82,39,381,26,355,9,346,4,76,93,42,7,2,2,33,3,84
82,40,219,22,197,3,194,3,52,37,30,2,1,0,22,12,35
82,41,188,21,167,4,163,7,27,21,42,4,0,0,18,8,36
82,42,929,116,813,27,786,33,161,256,85,4,1,1,87,18,140
82,43,201,24,177,8,169,3,33,33,13,7,1,1,18,6,54
82,44,1133,161,972,25,947,19,195,233,117,9,4,2,79,11,278
82,45,237,26,211,3,208,7,42,45,27,5,1,0,23,4,54
82,46,85,4,81,0,81,0,14,20,12,2,2,0,16,1,14
82,47,58,6,52,0,52,1,9,16,5,0,0,0,5,2,14
82,48,894,98,796,9,787,22,163,156,96,11,13,2,76,12,236
82,49,735,83,652,13,639,7,193,162,55,8,2,1,41,13,157
82,50,986,176,810,14,796,8,217,218,84,9,3,4,76,22,155
82,51,629,94,535,7,528,13,154,143,56,8,1,0,36,8,109
82,52,703,71,632,8,624,7,134,134,86,6,7,1,54,11,184
82,53,227,31,196,4,192,1,42,55,15,3,0,1,21,1,53
82,54,283,36,247,6,241,4,55,37,47,4,1,0,14,11,68
82,55,232,30,202,3,199,7,47,44,19,2,1,0,16,2,61
82,56,140,14,126,3,123,9,17,42,8,0,0,0,16,1,30
82,57,364,22,342,10,332,8,76,83,25,6,1,1,26,4,102
82,58,82,6,76,1,75,2,19,20,9,3,0,1,4,2,15
82,59,253,31,222,9,213,5,50,52,16,3,3,0,20,6,58
82,60,159,22,137,2,135,1,22,48,8,5,0,1,12,2,36
82,61,139,21,118,2,116,4,28,23,11,2,1,1,11,3,32
82,62,1021,153,868,20,848,15,209,227,98,8,5,0,62,10,214
82,63,499,73,426,14,412,4,114,91,42,2,6,0,30,7,116
82,64,88,17,71,3,68,3,13,21,5,0,2,0,11,1,12
82,65,358,54,304,9,295,8,69,68,31,1,0,2,25,7,84
82,66,468,62,406,10,396,8,96,114,46,5,1,0,35,6,85
82,67,95,6,89,2,87,1,12,27,7,1,0,0,13,2,24
82,68,152,31,121,1,120,2,26,27,17,2,0,0,9,7,30
82,69,172,31,141,3,138,7,29,18,19,1,4,1,29,2,28
82,70,45,4,41,2,39,1,3,14,2,1,0,0,3,0,15
82,71,34,3,31,0,31,0,5,6,0,0,0,0,5,3,12
82,72,638,59,579,15,564,9,156,105,71,9,8,4,36,12,154
82,73,679,85,594,11,583,8,135,134,54,7,2,1,43,18,181
82,74,113,11,102,1,101,8,18,27,8,1,1,0,8,6,24
82,75,2545,331,2214,49,2165,39,500,487,226,28,11,3,163,45,663
82,76,1222,163,1059,28,1031,21,264,273,106,9,2,1,81,23,251
82,77,290,45,245,2,243,7,63,59,22,1,3,1,23,6,58
82,78,126,14,112,0,112,4,18,43,15,5,1,1,2,3,20
82,79,2481,413,2068,42,2026,27,489,527,203,23,6,3,159,33,556
82,80,738,76,662,15,647,8,175,192,45,5,2,0,41,15,164
82,81,122,12,110,3,107,1,20,29,11,2,1,0,7,3,33
82,82,159,25,134,2,132,3,14,32,15,3,1,0,25,3,36
82,83,95,13,82,1,81,0,20,29,4,1,0,0,5,2,20
82,84,143,26,117,1,116,2,20,25,20,1,0,0,12,4,32
82,85,793,107,686,12,674,9,192,140,68,6,3,0,44,8,204
82,86,196,15,181,5,176,0,32,40,21,1,0,1,25,2,54
82,87,2261,272,1989,42,1947,52,440,467,224,25,8,11,177,44,499
82,88,545,108,437,9,428,6,69,103,62,2,3,0,56,13,114
82,89,759,101,658,14,644,6,157,155,71,14,5,2,49,10,175
82,90,793,85,708,21,687,18,157,191,83,14,6,1,47,12,158
82,91,87,10,77,1,76,1,10,28,9,1,0,0,4,2,21
82,92,175,12,163,2,161,2,35,46,19,1,0,0,22,1,35
82,93,419,52,367,6,361,7,65,101,71,2,1,0,26,8,80
82,94,1023,139,884,16,868,33,131,231,94,14,4,0,95,13,253
82,95,173,22,151,3,148,8,42,27,24,4,1,0,15,2,25
82,96,1675,258,1417,29,1388,21,405,318,145,17,10,2,91,26,353
82,97,916,131,785,19,766,11,153,151,71,17,8,0,68,20,267
82,98,946,126,820,22,798,16,143,200,105,13,3,5,81,13,219
82,99,333,39,294,7,287,4,74,84,31,1,0,0,27,7,59
82,100,104,6,98,5,93,4,9,22,14,3,0,0,11,1,29
82,101,819,125,694,11,683,10,172,139,99,10,1,1,52,11,188
82,102,224,42,182,2,180,1,45,42,17,1,0,1,24,3,46
82,103,78,11,67,1,66,0,13,16,6,0,1,1,11,5,13
82,104,128,16,112,3,109,1,24,27,6,0,0,0,13,1,37
82,105,877,105,772,9,763,12,173,207,109,2,10,4,61,7,178
82,106,132,17,115,3,112,9,16,16,18,2,0,0,11,3,37
82,107,43,5,38,0,38,1,3,2,11,1,1,2,1,2,14
82,108,906,82,824,15,809,13,217,184,80,14,5,1,50,14,231
82,109,158,24,134,3,131,1,34,33,15,1,1,0,18,0,28
82,110,820,101,719,16,703,13,174,187,58,13,2,3,74,16,163
82,111,256,46,210,10,200,4,34,59,33,2,4,0,19,5,40
82,112,8807,1567,7240,195,7045,155,1605,1842,764,90,27,19,525,89,1929
82,113,925,118,807,9,798,14,187,209,83,12,9,1,77,25,181
82,114,411,46,365,5,360,3,122,78,41,5,1,0,26,7,77
82,115,1209,177,1032,26,1006,27,252,256,126,16,6,1,79,27,216
82,116,164,26,138,3,135,3,38,35,12,1,0,2,14,2,28
82,117,1014,126,888,19,869,14,169,292,94,10,7,2,75,9,197
82,118,85,10,75,2,73,3,22,17,6,1,0,0,4,0,20
82,119,510,74,436,11,425,15,94,137,30,3,2,1,48,7,88
82,120,255,34,221,3,218,3,62,78,14,3,0,1,8,4,45
82,121,39008,6821,32187,629,31558,664,5759,8496,3494,313,97,76,2567,463,9629
82,122,131,19,112,0,112,4,27,26,28,1,0,0,11,1,14
82,123,834,127,707,20,687,10,202,147,85,6,2,2,47,22,164
82,124,2567,432,2135,61,2074,23,485,511,223,24,16,4,136,29,623
82,125,4127,610,3517,90,3427,62,816,806,360,48,26,8,282,68,951
82,126,988,105,883,20,863,22,201,221,101,19,4,1,77,19,198
82,127,595,76,519,9,510,9,101,144,55,2,3,1,57,6,132
82,128,109,16,93,2,91,1,7,36,6,2,1,0,13,2,23
82,129,82,10,72,0,72,2,14,16,9,2,1,0,7,4,17
82,130,135,21,114,4,110,1,29,35,2,2,0,0,13,2,26
82,131,1192,162,1030,27,1003,19,197,257,136,7,4,2,122,19,240
82,132,847,101,746,17,729,16,157,167,98,9,6,1,63,6,206
82,133,74,7,67,1,66,2,10,7,13,2,1,0,6,2,23
82,134,3519,490,3029,66,2963,36,731,688,317,43,12,2,239,59,836
82,135,858,87,771,15,756,19,194,153,87,6,6,3,67,14,207
82,136,1003,99,904,13,891,15,265,181,87,10,6,1,55,22,249
82,137,451,75,376,7,369,3,55,107,37,1,4,1,39,10,112
82,138,99,14,85,3,82,1,18,28,4,0,0,0,5,1,25
82,139,116,9,107,4,103,2,16,43,7,1,1,1,9,3,20
82,140,308,27,281,1,280,6,72,73,26,0,1,1,20,9,72
82,141,405,65,340,12,328,1,61,73,50,6,2,2,25,5,103
82,142,969,98,871,17,854,11,182,202,100,5,7,0,84,16,247
82,143,66,16,50,0,50,0,12,14,6,2,0,0,7,1,8
82,144,518,54,464,10,454,20,95,119,70,6,0,0,30,9,105
82,145,240,24,216,5,211,4,67,45,19,3,0,1,17,3,52
82,146,51,8,43,1,42,0,9,9,6,0,0,1,5,1,11
82,147,309,39,270,9,261,5,45,55,41,1,0,1,35,6,72
82,148,565,90,475,9,466,9,100,104,70,9,3,1,46,10,114
82,149,1348,150,1198,21,1177,12,260,270,142,16,9,4,97,17,350
82,150,688,80,608,11,597,6,137,145,67,9,4,4,48,5,172
82,151,286,51,235,3,232,8,41,50,33,7,1,1,18,6,67
82,152,352,51,301,6,295,2,77,73,29,7,0,0,22,5,80
82,153,142,18,124,1,123,2,23,29,21,2,3,0,13,2,28
82,154,177,17,160,2,158,7,30,56,13,1,0,2,17,2,30
82,155,1443,206,1237,24,1213,67,189,267,212,14,8,1,112,18,325
82,156,126,20,106,3,103,3,17,21,20,4,0,0,9,3,26
82,157,86,19,67,2,65,1,8,11,11,1,0,0,7,3,23
82,158,126,26,100,1,99,2,25,18,14,0,0,1,14,1,24
82,159,416,49,367,15,352,6,76,87,46,6,5,2,42,7,75
82,160,206,24,182,5,177,6,47,32,22,3,1,1,15,1,49
82,161,2560,273,2287,52,2235,27,577,615,177,26,17,2,160,44,590
82,162,183,18,165,5,160,3,44,41,24,2,1,0,16,3,26
82,163,52,4,48,1,47,1,12,12,4,0,2,0,2,1,13
82,164,94,8,86,2,84,1,18,32,7,2,2,0,7,2,13
82,165,379,53,326,11,315,4,91,73,35,1,2,0,22,8,79
82,166,192,38,154,2,152,2,37,40,15,5,1,0,15,1,36
82,167,1271,120,1151,16,1135,25,279,310,113,7,3,3,96,24,275
82,168,274,36,238,5,233,5,41,79,26,1,2,0,29,6,44
82,169,1722,281,1441,30,1411,31,327,339,118,24,9,5,114,27,417
82,170,477,55,422,8,414,9,108,125,34,4,3,1,55,8,67
82,171,865,88,777,9,768,6,231,161,76,10,4,1,50,12,217
82,172,234,32,202,5,197,3,20,41,43,4,1,0,16,1,68
82,173,630,70,560,18,542,7,139,85,54,4,3,2,48,11,189
82,174,238,30,208,6,202,6,56,69,12,1,0,0,20,3,35
82,175,210,22,188,2,186,5,40,40,23,0,2,2,20,3,51
82,176,526,59,467,10,457,5,126,96,64,10,3,3,43,8,99
82,177,140,12,128,4,124,3,30,32,11,2,0,1,13,3,29
82,178,498,44,454,9,445,12,88,99,51,8,3,1,47,5,131
82,179,1658,290,1368,40,1328,17,348,315,167,16,3,3,90,24,345
82,180,410,30,380,8,372,8,75,88,43,3,1,1,36,8,109
82,181,163,19,144,4,140,1,33,20,26,2,0,0,13,5,40
82,182,256,39,217,8,209,6,43,71,25,3,1,2,15,5,38
82,183,189,23,166,1,165,15,30,42,16,1,0,0,25,2,34
82,184,594,67,527,10,517,11,116,139,53,3,6,2,40,15,132
82,185,168,14,154,4,150,7,35,30,18,4,1,0,14,3,38
82,186,3651,656,2995,76,2919,52,591,682,299,36,14,17,222,40,966
82,187,555,87,468,9,459,7,72,86,81,13,3,2,35,10,150
82,188,438,69,369,9,360,5,88,95,40,1,2,1,22,15,91
82,189,590,93,497,2,495,15,96,135,66,4,3,2,56,10,108
82,190,3080,490,2590,53,2537,47,539,565,334,43,13,7,203,48,738
82,191,312,55,257,5,252,11,37,52,37,5,2,2,24,2,80
82,192,379,30,349,9,340,10,94,69,52,5,1,3,32,4,70
82,193,106,10,96,3,93,2,22,27,9,1,1,0,4,2,25
82,194,912,97,815,13,802,17,197,169,105,16,3,6,54,11,224
82,195,598,56,542,7,535,15,113,126,62,9,3,3,54,4,146
83,1,2062,324,1738,31,1707,38,421,595,146,11,7,6,158,36,289
83,2,225,38,187,3,184,4,42,66,18,0,2,1,7,6,38
83,3,751,117,634,6,628,23,142,184,94,8,5,1,39,14,118
83,4,5075,983,4092,62,4030,95,1035,1304,337,38,10,9,259,57,886
83,5,283,41,242,3,239,9,102,40,29,1,1,0,11,5,41
83,6,198,19,179,1,178,2,64,55,18,1,0,1,10,8,19
83,7,1629,258,1371,28,1343,36,341,381,203,8,8,5,88,28,245
83,8,1771,297,1474,21,1453,33,383,531,98,13,6,3,103,28,255
83,9,7973,1470,6503,68,6435,102,1225,2876,454,36,10,17,415,98,1202
83,10,150,29,121,2,119,5,25,31,18,1,4,0,3,1,31
83,11,1018,190,828,16,812,22,204,253,74,13,5,2,56,10,173
83,12,2300,410,1890,36,1854,54,463,421,289,25,11,8,92,31,460
83,13,174,21,153,6,147,4,26,53,16,0,0,1,8,6,33
83,14,193,31,162,1,161,11,38,45,20,3,0,0,9,0,35
83,15,312,47,265,0,265,13,41,99,43,5,1,1,12,7,43
83,16,7341,1335,6006,80,5926,140,1361,2050,615,48,14,14,447,110,1127
83,17,1838,357,1481,18,1463,21,405,438,128,14,3,5,124,18,307
83,18,2230,397,1833,18,1815,41,582,502,197,16,9,2,130,31,305
83,19,6506,1377,5129,88,5041,103,1053,2367,313,40,7,9,278,73,798
83,20,39,6,33,0,33,0,8,10,2,0,0,0,5,0,8
83,21,1774,341,1433,20,1413,39,384,367,169,15,9,4,121,28,277
83,22,35,6,29,1,28,0,0,12,0,0,0,0,6,1,9
83,23,10997,2364,8633,130,8503,142,2445,2519,828,72,28,19,480,110,1860
83,25,906,147,759,22,737,10,216,179,95,8,6,2,50,13,158
83,26,1363,201,1162,14,1148,28,367,257,206,17,7,1,62,20,183
83,27,3843,602,3241,48,3193,100,601,1234,371,25,7,5,223,62,565
83,28,1362,269,1093,16,1077,29,330,314,76,7,4,2,81,16,218
83,29,2216,396,1820,19,1801,37,438,647,161,20,6,3,140,34,315
83,30,1493,273,1220,26,1194,31,351,346,123,14,5,5,77,24,218
83,31,3088,505,2583,46,2537,37,686,820,215,30,7,3,168,65,506
83,32,2501,446,2055,37,2018,49,499,658,243,19,7,5,131,28,379
83,33,2498,518,1980,17,1963,45,578,436,351,19,8,3,86,41,396
83,34,8648,1701,6947,122,6825,167,1312,2920,511,37,17,15,495,88,1263
83,35,3550,515,3035,52,2983,71,726,1074,281,21,13,8,250,43,496
83,36,5634,1056,4578,71,4507,55,945,2298,228,30,19,5,244,73,610
83,37,929,121,808,26,782,16,252,269,49,8,0,2,46,12,128
83,38,343,44,299,6,293,14,75,86,34,5,2,2,16,3,56
83,39,134,24,110,2,108,9,15,33,16,1,0,0,14,1,19
83,40,82,9,73,0,73,9,23,17,6,1,0,0,5,0,12
83,41,446,72,374,4,370,9,77,101,59,2,3,2,30,7,80
83,42,7064,1372,5692,92,5600,96,1546,1995,437,48,17,13,329,77,1042
83,43,1382,239,1143,22,1121,32,226,323,167,12,9,5,67,17,263
83,44,294,53,241,5,236,10,51,57,28,4,2,0,12,8,64
83,45,671,104,567,11,556,26,109,126,93,9,2,0,21,10,160
83,46,1789,319,1470,29,1441,40,294,565,128,14,5,1,105,24,265
83,47,12996,2281,10715,153,10562,172,2908,3538,882,89,41,23,726,182,2001
83,48,2584,432,2152,35,2117,44,355,1049,129,21,7,8,152,25,327
83,49,7292,1369,5923,91,5832,116,1628,1640,624,56,17,10,429,104,1208
83,50,26553,5876,20677,303,20374,340,5411,6570,1837,186,64,32,1336,326,4272
83,51,859,143,716,6,710,29,182,199,90,9,3,0,41,17,140
83,52,235,46,189,1,188,3,63,46,15,1,1,0,6,2,51
83,53,1719,260,1459,28,1431,40,374,436,141,18,5,5,108,25,279
83,54,6038,924,5114,70,5044,78,1327,1751,445,44,19,9,355,80,936
83,55,3791,679,3112,50,3062,67,820,1197,207,24,15,4,181,56,491
83,56,1903,278,1625,19,1606,37,451,517,177,15,3,10,106,37,253
83,57,2268,423,1845,30,1815,35,555,537,196,24,13,6,98,37,314
83,58,3710,642,3068,43,3025,66,785,1046,267,33,7,2,219,66,534
83,59,1803,258,1545,22,1523,14,486,477,110,18,3,5,124,33,253
83,60,431,57,374,7,367,8,97,114,34,9,0,0,29,11,65
83,61,35260,6964,28296,421,27875,409,7402,10491,1759,213,71,55,1895,408,5172
83,62,19186,3773,15413,270,15143,254,3569,4663,1705,159,53,33,1042,244,3421
83,63,1231,204,1027,19,1008,44,188,390,90,10,5,6,65,10,200
83,64,4696,922,3774,61,3713,52,1019,1271,335,31,8,13,232,88,664
83,65,2011,329,1682,19,1663,30,340,888,85,12,8,6,66,20,208
83,66,1166,166,1000,13,987,9,256,274,148,9,3,3,50,18,217
83,67,3101,568,2533,52,2481,35,698,711,266,33,15,7,160,48,508
83,68,3341,606,2735,31,2704,53,607,1396,126,18,4,3,154,29,314
83,69,39364,7819,31545,474,31071,700,6760,12002,2630,240,93,73,1983,479,6111
83,70,4947,880,4067,51,4016,76,856,1945,252,25,10,9,212,60,571
83,71,8731,1520,7211,123,7088,103,1677,2642,597,54,24,20,508,112,1351
83,72,6788,1044,5744,88,5656,128,1281,2022,521,64,18,4,374,82,1162
83,73,6483,1425,5058,100,4958,77,1529,1423,395,51,25,16,296,95,1051
83,74,137,10,127,0,127,0,32,35,23,2,0,0,8,1,26
83,75,521,82,439,5,434,16,76,131,57,9,3,0,25,7,110
83,76,600,73,527,10,517,14,136,114,70,4,4,3,29,1,142
83,77,1519,299,1220,15,1205,24,305,384,111,15,2,6,107,23,228
83,78,247,22,225,3,222,6,45,92,21,0,0,1,10,9,38
83,79,798,113,685,4,681,31,162,266,57,9,3,1,48,12,92
83,80,749,114,635,9,626,25,122,233,53,2,2,1,52,14,122
83,81,4023,800,3223,38,3185,88,758,1156,254,27,9,9,265,79,540
83,82,536,88,448,9,439,17,147,86,76,5,1,2,29,8,68
83,83,857,116,741,15,726,19,197,189,94,13,1,1,36,15,161
83,84,529,84,445,7,438,4,137,150,54,5,3,0,17,1,67
83,85,2198,308,1890,23,1867,47,522,627,148,19,3,2,154,31,314
83,86,5972,1087,4885,73,4812,69,1364,1636,307,41,11,8,252,70,1054
83,87,2918,468,2450,36,2414,34,705,777,223,21,5,6,167,27,449
83,88,1935,318,1617,15,1602,54,397,462,159,24,3,2,125,30,346
83,89,462,73,389,4,385,4,106,119,33,3,3,1,33,7,76
83,90,9577,1687,7890,112,7778,151,1840,2637,775,64,17,15,531,123,1625
83,91,4098,635,3463,66,3397,52,881,1042,407,35,7,5,209,66,693
83,92,2583,413,2170,54,2116,61,598,595,252,31,7,8,140,42,382
83,93,1193,157,1036,11,1025,30,341,273,114,6,2,0,63,19,177
83,94,2269,465,1804,24,1780,48,409,787,140,15,6,8,92,25,250
83,95,550,82,468,8,460,15,94,134,73,5,6,0,29,3,101
83,96,815,111,704,13,691,12,200,164,96,6,5,1,35,15,157
83,97,3668,549,3119,54,3065,81,812,874,311,33,8,5,267,59,615
83,98,8733,1488,7245,122,7123,169,1521,2486,637,64,17,16,563,124,1526
83,99,5482,1209,4273,62,4211,62,1221,1540,282,40,14,11,247,52,742
83,100,2755,474,2281,45,2236,51,544,634,246,22,8,6,194,59,472
83,101,1787,291,1496,30,1466,32,244,730,98,2,3,4,58,21,274
83,102,1753,269,1484,26,1458,22,513,389,129,12,3,4,68,24,294
83,103,3091,546,2545,46,2499,60,615,760,265,25,3,3,186,37,545
83,104,3393,721,2672,51,2621,48,778,647,341,22,9,7,148,55,566
83,105,61,7,54,0,54,2,14,27,5,0,0,1,2,0,3
83,106,3205,576,2629,47,2582,38,808,776,248,24,10,3,168,43,464
83,107,10926,1924,9002,138,8864,142,2245,3597,566,59,21,13,606,186,1429
83,108,1809,319,1490,17,1473,36,444,389,151,16,5,2,114,25,291
83,109,213,33,180,2,178,5,34,66,22,1,0,1,14,1,34
83,110,1068,162,906,13,893,31,202,198,141,11,6,3,56,18,227
83,111,1506,247,1259,27,1232,17,361,347,153,15,9,2,87,19,222
83,112,10427,1957,8470,123,8347,182,1854,3247,700,53,20,15,568,133,1575
83,113,1635,246,1389,22,1367,18,439,348,157,11,12,2,88,30,262
83,114,186,26,160,1,159,1,38,40,12,4,0,2,30,0,32
83,115,10499,1904,8595,126,8469,84,1944,4210,405,55,22,13,439,111,1186
83,116,11927,2097,9830,171,9659,160,2704,2716,1013,99,47,24,638,152,2106
83,117,1099,145,954,15,939,19,204,390,106,7,3,1,52,21,136
83,118,29512,5504,24008,274,23734,333,5114,11365,1230,141,57,41,1464,349,3640
83,119,4705,916,3789,50,3739,58,653,2180,183,11,12,4,175,45,418
83,120,4033,613,3420,55,3365,89,940,914,392,25,14,10,301,46,634
83,121,3216,671,2545,55,2490,55,577,679,355,36,15,5,168,56,544
83,122,228,23,205,3,202,12,23,75,26,0,1,1,18,1,45
83,123,15194,3116,12078,162,11916,198,2498,5312,822,73,26,24,850,180,1933
83,124,1774,405,1369,23,1346,24,311,470,129,16,6,4,91,31,264
83,125,1522,261,1261,23,1238,29,321,331,158,10,2,5,94,19,269
83,126,44341,9959,34382,536,33846,568,8522,9283,4408,332,161,71,2057,513,7931
83,127,2235,427,1808,19,1789,55,590,436,198,27,14,2,111,30,326
83,128,526,74,452,6,446,14,98,131,71,7,1,1,30,10,83
83,129,29342,5927,23415,352,23063,409,5906,8518,1813,169,70,35,1675,397,4071
83,130,8517,1486,7031,110,6921,128,1893,2131,689,60,22,22,457,96,1423
83,131,4176,756,3420,65,3355,63,806,933,396,40,12,4,245,74,782
83,132,1935,352,1583,28,1555,40,355,609,144,16,4,4,105,24,254
83,133,1205,217,988,19,969,20,235,405,76,5,2,1,70,18,137
83,134,1386,225,1161,15,1146,16,324,384,101,12,7,0,87,23,192
83,135,968,159,809,9,800,11,225,238,85,7,4,2,37,21,170
83,136,1673,230,1443,23,1420,41,435,406,132,16,6,4,90,24,266
83,137,106559,24134,82425,1298,81127,1547,18963,26129,7697,740,335,159,5664,1252,18641
83,138,1855,349,1506,18,1488,19,421,514,115,7,1,3,114,34,260
83,139,531,99,432,6,426,9,92,160,55,2,4,0,25,4,75
83,140,3446,664,2782,51,2731,41,803,663,397,32,16,2,182,48,547
83,141,4333,772,3561,54,3507,42,1033,1204,281,35,9,5,230,67,601
83,142,174,20,154,1,153,13,15,20,31,2,1,1,5,4,61
83,143,3227,556,2671,47,2624,30,681,809,303,38,6,5,197,68,487
83,144,16966,3267,13699,252,13447,222,3588,4400,1103,118,75,34,972,217,2718
83,145,892,136,756,15,741,15,206,186,98,13,2,1,42,14,164
83,146,1220,235,985,18,967,20,321,233,122,12,4,1,46,16,192
83,147,28,3,25,0,25,0,0,23,0,0,0,0,0,1,1
83,148,7152,1373,5779,93,5686,83,1940,1714,477,52,26,10,313,97,974
83,149,1012,148,864,12,852,35,196,241,105,11,6,7,52,23,176
83,150,3084,572,2512,60,2452,28,672,631,281,14,13,5,175,43,590
83,151,653,86,567,10,557,9,115,158,89,4,1,2,51,15,113
83,152,774,157,617,6,611,14,116,325,36,3,3,1,21,6,86
83,153,4338,896,3442,53,3389,68,860,1192,271,30,11,8,243,69,637
83,154,542,102,440,14,426,19,95,142,49,2,1,0,38,10,70
84,1,1960,221,1739,20,1719,39,463,529,148,19,6,4,128,27,356
84,2,857,135,722,19,703,24,146,234,92,4,1,3,56,6,137
84,3,7280,1433,5847,104,5743,124,1368,1559,699,55,27,14,356,91,1450
84,4,3612,541,3071,50,3021,61,968,856,260,28,6,5,178,38,621
84,5,162,23,139,3,136,5,39,27,19,3,2,1,5,5,30
84,6,73,7,66,1,65,1,3,13,11,0,0,0,5,1,31
84,7,55098,12275,42823,671,42152,1197,8647,9745,5672,387,162,88,2702,539,13013
84,8,525,56,469,20,449,23,135,135,40,1,0,2,40,10,63
84,9,1050,181,869,15,854,18,250,192,92,7,4,5,57,25,204
84,10,619,102,517,9,508,24,77,111,75,12,0,1,43,5,160
84,11,283,58,225,0,225,14,54,46,37,6,0,0,18,2,48
84,12,1700,192,1508,38,1470,23,348,502,159,11,0,2,106,22,297
84,13,182,28,154,5,149,2,42,52,13,2,1,0,11,0,26
84,14,804,138,666,8,658,24,180,155,115,3,7,1,33,9,131
84,15,252,16,236,7,229,5,53,79,25,3,2,0,13,2,47
84,16,3892,518,3374,55,3319,57,1358,882,259,36,13,10,175,38,491
84,17,2524,349,2175,41,2134,59,482,658,242,21,4,6,144,29,489
84,18,362,31,331,6,325,8,69,83,38,4,4,0,33,5,81
84,19,9963,2058,7905,148,7757,95,2559,1737,944,76,23,17,446,96,1764
84,20,1215,171,1044,26,1018,39,213,296,118,12,3,4,82,16,235
84,21,89,7,82,4,78,6,11,16,15,3,0,0,4,1,22
84,22,220,23,197,8,189,7,45,52,23,4,2,1,13,2,40
84,23,103,13,90,2,88,6,6,35,13,0,1,0,2,1,24
84,24,668,106,562,11,551,16,119,125,94,8,5,2,36,8,138
84,25,1343,176,1167,17,1150,26,233,402,132,5,7,2,95,17,231
84,26,3124,539,2585,40,2545,107,581,674,325,32,15,13,151,23,624
84,27,2104,314,1790,36,1754,37,552,544,166,11,3,3,125,36,277
84,28,764,85,679,13,666,19,172,246,53,7,2,2,51,16,98
84,29,3577,559,3018,46,2972,38,867,918,320,22,10,4,212,63,518
84,30,2378,303,2075,27,2048,48,596,611,195,21,4,3,144,35,391
84,31,18408,3945,14463,229,14234,309,4063,4167,1411,162,50,22,819,189,3042
84,32,373,51,322,5,317,9,62,98,39,9,0,2,23,5,70
84,33,111,12,99,1,98,1,13,28,13,3,1,0,10,3,26
84,34,3657,472,3185,39,3146,80,983,857,309,22,11,5,191,46,642
84,35,17050,3851,13199,232,12967,222,4069,3522,1329,107,55,20,673,199,2771
84,36,2712,372,2340,58,2282,65,538,720,225,19,5,8,182,25,495
84,37,1559,212,1347,22,1325,23,332,486,92,15,3,1,101,17,255
84,38,3100,476,2624,50,2574,38,900,750,226,20,15,3,165,38,419
84,39,3834,586,3248,56,3192,53,976,874,352,36,12,7,226,52,604
84,40,339,72,267,12,255,7,59,62,32,4,0,1,21,5,64
84,41,406,49,357,4,353,12,89,127,29,3,2,2,18,7,64
84,42,1531,238,1293,18,1275,44,241,364,170,11,5,1,86,19,334
84,43,6117,1146,4971,92,4879,76,1531,1191,739,46,29,9,301,76,881
84,44,845,100,745,19,726,18,200,146,122,14,8,2,50,7,159
84,45,314,44,270,2,268,10,60,72,53,3,1,1,20,6,42
84,46,307,34,273,6,267,12,49,77,31,9,1,0,18,5,65
84,47,2428,363,2065,37,2028,43,608,590,176,32,7,5,128,47,392
84,48,64,11,53,0,53,3,17,7,10,0,0,0,3,4,9
84,49,484,95,389,5,384,17,77,145,31,0,4,2,26,10,72
84,50,1722,199,1523,20,1503,48,272,684,84,11,4,1,112,18,269
84,51,973,113,860,8,852,21,174,263,111,8,3,1,66,7,198
84,52,930,161,769,17,752,22,166,226,73,5,1,1,89,18,151
84,53,1397,205,1192,24,1168,12,360,275,128,18,11,2,87,31,244
84,54,14601,2710,11891,185,11706,305,2917,3182,1348,145,41,28,837,161,2742
84,55,1164,133,1031,23,1008,14,298,290,83,10,4,3,74,16,216
84,56,3404,551,2853,35,2818,33,975,776,274,24,11,5,210,48,462
84,57,292,35,257,4,253,4,66,95,15,0,0,1,23,5,44
84,58,318,37,281,2,279,8,48,66,56,3,2,0,21,4,71
84,59,80,7,73,2,71,3,10,23,11,0,0,0,8,3,13
84,60,47,11,36,1,35,1,14,9,2,0,0,0,3,0,6
84,61,248,30,218,2,216,4,44,69,14,0,0,1,21,3,60
84,62,1288,180,1108,24,1084,29,197,327,148,9,1,4,76,22,271
84,63,288,41,247,4,243,6,69,87,26,3,0,1,15,6,30
84,64,2584,433,2151,54,2097,26,755,487,218,14,12,3,104,24,454
84,65,2952,418,2534,52,2482,86,621,717,285,20,8,3,181,41,520
84,66,207,39,168,2,166,9,33,40,27,4,0,1,13,2,37
84,67,1751,208,1543,31,1512,27,477,484,122,19,3,2,103,28,247
84,68,1117,209,908,11,897,27,87,369,125,16,1,3,68,8,193
84,69,2159,320,1839,54,1785,36,461,488,222,27,8,0,95,22,426
84,70,1082,130,952,14,938,21,265,264,91,11,4,1,60,11,210
84,71,1450,203,1247,29,1218,28,316,329,137,21,4,2,84,13,284
84,72,4424,783,3641,54,3587,90,1010,1096,326,32,14,10,261,67,681
84,73,975,174,801,12,789,27,146,292,83,6,5,4,59,12,155
84,74,1590,248,1342,37,1305,37,307,384,146,9,9,1,102,26,284
84,75,323,30,293,7,286,11,51,60,50,4,3,0,28,5,74
84,76,896,111,785,14,771,15,147,223,102,5,1,1,61,18,198
84,77,352,50,302,8,294,8,91,89,23,3,1,0,28,11,40
84,78,2771,536,2235,30,2205,32,702,521,268,20,8,2,109,37,506
84,79,282,53,229,3,226,12,55,35,29,1,0,0,13,7,74
84,80,8169,1366,6803,113,6690,107,2329,1900,564,50,37,9,403,91,1200
84,81,6080,904,5176,70,5106,110,1402,1488,522,42,14,13,350,74,1091
84,82,1288,169,1119,12,1107,47,270,258,142,17,2,2,74,19,276
84,83,1897,357,1540,25,1515,15,555,423,131,13,8,6,94,37,233
84,84,983,136,847,10,837,25,226,202,139,8,7,3,56,8,163
84,85,370,61,309,3,306,14,64,109,27,4,0,1,27,5,55
84,86,1081,139,942,18,924,31,240,263,97,13,2,1,62,14,201
84,87,18791,3787,15004,299,14705,213,4344,4572,1260,93,40,28,991,233,2931
84,88,8483,1379,7104,113,6991,139,2061,2049,718,67,26,13,547,87,1284
84,89,14535,3240,11295,194,11101,263,2329,2894,1443,101,41,32,982,171,2845
84,90,567,102,465,8,457,17,87,129,77,7,1,1,33,9,96
84,91,3882,695,3187,50,3137,41,1029,978,245,24,8,2,237,57,516
84,92,11187,2015,9172,181,8991,143,2799,2136,934,84,31,16,583,120,2145
84,93,559,92,467,11,456,16,105,156,38,1,2,0,36,6,96
84,94,536,81,455,9,446,15,91,115,70,8,1,4,59,7,76
84,95,561,95,466,8,458,14,109,163,44,7,1,0,31,11,78
84,96,558,87,471,15,456,17,84,124,68,2,3,3,42,6,107
84,97,440,54,386,6,380,10,123,77,40,4,2,1,42,10,71
84,98,428,55,373,8,365,9,86,102,37,5,1,4,20,8,93
84,99,3366,572,2794,49,2745,70,796,817,301,22,5,5,176,48,505
84,100,51,9,42,0,42,4,10,8,6,2,1,0,2,2,7
84,101,339,57,282,8,274,22,60,97,25,2,1,1,21,5,40
84,102,1060,139,921,15,906,27,169,331,88,11,7,2,78,13,180
84,103,557,97,460,5,455,21,93,126,66,3,3,1,27,13,102
84,104,948,161,787,20,767,7,150,292,89,5,2,0,81,8,133
84,105,828,126,702,6,696,21,171,209,66,6,1,1,48,10,163
84,106,1754,211,1543,28,1515,19,352,523,144,7,5,0,95,32,338
84,107,460,98,362,8,354,10,103,78,36,8,1,0,19,10,89
84,108,1622,219,1403,19,1384,26,377,453,127,8,5,5,87,22,274
84,109,162,22,140,5,135,3,46,51,5,1,2,0,7,3,17
84,110,35,4,31,0,31,0,6,4,2,1,0,0,6,0,12
84,111,245,42,203,6,197,5,33,65,24,3,0,0,23,5,39
84,112,625,120,505,8,497,18,78,142,78,4,5,0,30,12,130
84,113,635,98,537,11,526,16,118,144,69,6,2,1,36,8,126
84,114,146,14,132,0,132,2,20,31,21,0,1,0,15,4,38
84,115,409,52,357,5,352,10,118,105,19,2,1,1,25,5,66
84,116,627,69,558,5,553,10,172,143,56,9,2,3,38,12,108
84,117,263,56,207,3,204,3,79,58,14,1,0,0,21,2,26
84,118,2089,306,1783,33,1750,61,322,568,185,19,6,3,159,20,407
84,119,3823,553,3270,53,3217,56,1026,925,294,17,8,9,250,39,593
84,120,95,14,81,2,79,3,22,13,11,2,0,2,4,2,20
84,121,133,20,113,2,111,0,27,41,19,1,0,0,9,3,11
84,122,4303,842,3461,68,3393,43,1093,1030,347,33,22,8,206,52,559
84,123,1063,144,919,26,893,28,177,248,134,14,6,4,61,23,198
84,124,683,87,596,10,586,20,141,184,68,4,4,2,34,8,121
84,125,76,11,65,5,60,0,13,7,8,4,1,0,6,1,20
84,126,643,84,559,8,551,21,101,148,66,9,3,1,59,10,133
84,127,2030,271,1759,35,1724,33,481,527,188,15,4,4,135,36,301
84,128,37,0,37,1,36,7,1,2,9,1,0,0,6,0,10
84,129,12013,2236,9777,152,9625,141,3467,2233,1129,91,44,15,510,127,1868
84,130,125,16,109,0,109,6,16,31,19,1,1,0,11,3,21
84,131,1629,212,1417,20,1397,37,425,453,102,14,3,0,94,20,249
84,132,5821,761,5060,77,4983,178,1421,1288,555,57,19,19,330,106,1010
84,133,3182,476,2706,49,2657,89,544,716,348,24,7,8,204,40,677
84,134,499,67,432,5,427,17,131,133,45,2,0,1,20,9,69
84,135,1203,154,1049,18,1031,22,277,351,90,7,0,4,85,19,176
84,136,828,135,693,21,672,11,153,211,74,5,1,0,49,6,162
84,137,4729,826,3903,84,3819,81,767,1195,399,46,17,1,256,49,1008
84,138,6713,1290,5423,104,5319,104,1625,1336,565,43,29,9,367,72,1169
84,139,554,95,459,13,446,15,119,127,42,6,1,1,32,5,98
84,140,454,62,392,6,386,16,48,102,60,5,1,1,42,10,101
84,141,7487,1217,6270,133,6137,115,1897,1512,685,53,31,13,439,74,1318
84,142,2562,417,2145,35,2110,31,588,552,284,18,5,4,136,34,458
84,143,927,107,820,5,815,13,130,396,67,6,2,0,59,13,129
84,144,463,73,390,7,383,16,70,100,96,3,2,0,21,1,74
84,145,631,84,547,8,539,27,153,110,80,7,6,0,29,13,114
84,146,416,46,370,6,364,15,67,122,43,4,1,2,34,6,70
84,147,2465,365,2100,35,2065,53,477,575,248,21,7,6,176,37,465
84,148,919,99,820,24,796,28,212,147,119,15,5,3,39,9,219
84,149,1225,185,1040,21,1019,14,297,282,100,8,7,3,77,20,211
84,150,1436,216,1220,18,1202,22,358,332,139,8,10,2,73,20,238
84,151,180,21,159,8,151,3,18,39,19,1,1,1,18,3,48
85,1,1999,335,1664,39,1625,16,345,582,103,23,7,1,122,43,383
85,2,1381,164,1217,25,1192,19,236,451,93,19,6,6,125,32,205
85,3,5970,701,5269,142,5127,114,695,1575,469,71,33,16,686,130,1338
85,4,2118,319,1799,35,1764,19,396,536,155,22,10,1,129,46,450
85,5,789,106,683,29,654,7,95,345,24,9,9,1,62,17,85
85,6,1141,155,986,16,970,19,177,278,93,18,11,1,122,28,223
85,8,2412,271,2141,44,2097,39,228,543,238,30,17,4,267,46,685
85,9,478,69,409,8,401,6,52,133,40,15,4,0,48,10,93
85,10,1011,139,872,14,858,4,172,302,63,10,7,0,104,25,171
85,11,1530,285,1245,22,1223,23,214,441,95,16,9,3,121,17,284
85,12,1762,259,1503,39,1464,19,287,489,135,20,17,3,129,31,334
85,13,821,61,760,9,751,12,120,276,56,16,7,4,86,14,160
85,14,852,170,682,21,661,7,109,270,47,20,4,1,72,18,113
85,15,944,100,844,19,825,20,133,242,72,17,7,1,131,17,185
85,16,1528,217,1311,34,1277,32,188,412,123,18,7,4,151,35,307
85,17,1525,160,1365,45,1320,25,197,485,78,23,15,2,215,36,244
85,18,3153,512,2641,56,2585,46,493,847,242,29,23,11,241,65,588
85,19,2925,457,2468,49,2419,55,271,654,220,47,12,6,330,62,762
85,20,2906,382,2524,46,2478,54,319,652,288,37,15,8,277,63,765
85,21,1114,114,1000,41,959,26,192,241,83,13,8,4,116,40,236
85,22,868,107,761,8,753,10,149,242,72,18,4,0,64,19,175
85,23,315,38,277,7,270,8,58,78,16,1,1,1,28,3,76
85,24,1274,169,1105,24,1081,21,239,387,74,16,11,4,116,26,187
85,25,1537,148,1389,34,1355,24,187,490,112,18,19,3,199,31,272
85,26,988,130,858,15,843,19,120,265,95,10,3,1,99,19,212
85,27,2048,211,1837,46,1791,42,233,528,164,16,5,2,298,41,462
85,28,367,40,327,7,320,8,34,77,31,6,1,0,43,4,116
85,29,1762,284,1478,30,1448,32,270,565,123,24,10,6,118,49,251
85,30,576,38,538,14,524,7,79,145,56,5,5,2,90,20,115
85,31,2285,282,2003,61,1942,10,262,856,103,23,15,3,346,38,286
85,33,611,74,537,11,526,12,98,147,47,12,5,2,60,6,137
85,34,2277,310,1967,69,1898,24,259,592,161,51,15,7,262,50,477
85,35,3785,560,3225,49,3176,75,531,1322,198,27,13,7,292,73,638
85,36,409,48,361,5,356,9,69,97,32,6,3,1,31,8,100
85,37,450,54,396,3,393,10,61,150,27,4,4,0,46,17,74
85,38,1997,218,1779,38,1741,23,250,673,133,23,11,8,237,45,338
85,39,2694,389,2305,69,2236,52,341,648,194,44,17,9,338,59,534
85,40,826,138,688,21,667,9,99,217,63,9,12,3,87,11,157
85,41,221,22,199,5,194,0,31,88,12,1,0,1,19,13,29
85,42,1379,228,1151,21,1130,11,232,290,101,23,10,2,95,19,347
85,43,946,109,837,26,811,22,138,229,91,12,5,1,84,25,204
85,44,345,37,308,6,302,5,62,83,26,9,2,0,42,9,64
85,45,689,83,606,15,591,12,103,210,55,8,6,0,65,17,115
85,46,2444,307,2137,36,2101,54,337,546,194,21,14,3,277,50,605
85,47,15161,2801,12360,278,12082,183,1826,4326,884,151,63,27,1414,290,2918
85,48,1213,169,1044,30,1014,24,124,412,74,20,3,3,173,38,143
85,49,1291,194,1097,24,1073,13,283,237,117,14,6,1,57,25,320
85,50,1286,249,1037,20,1017,15,181,314,98,11,6,2,87,37,266
85,51,6113,906,5207,147,5060,91,702,1640,402,105,25,11,681,114,1289
85,52,1260,134,1126,32,1094,28,175,327,94,26,10,3,136,23,272
85,53,211,44,167,4,163,4,28,70,12,0,0,0,26,4,19
85,54,653,69,584,17,567,8,109,158,48,14,4,3,59,11,153
85,55,676,89,587,12,575,15,89,163,81,10,8,1,92,17,99
85,56,302,48,254,7,247,3,36,67,21,7,1,1,27,8,76
85,58,510,76,434,12,422,5,87,119,41,7,1,2,49,8,103
85,59,1932,342,1590,38,1552,24,231,549,98,24,10,3,209,41,363
85,60,11065,1616,9449,172,9277,157,1401,3339,670,100,51,20,990,220,2329
85,61,1026,128,898,36,862,12,106,204,86,15,5,2,145,23,264
85,62,714,106,608,13,595,8,125,185,69,12,9,0,76,20,91
85,63,551,63,488,17,471,8,42,178,30,9,2,1,89,26,86
85,64,1782,223,1559,42,1517,15,275,650,72,23,9,4,178,47,244
85,65,2646,323,2323,47,2276,40,335,908,165,31,14,6,351,56,370
85,66,590,73,517,17,500,0,94,143,35,8,6,1,70,11,132
85,67,742,105,637,19,618,13,59,291,32,16,3,2,80,12,110
85,69,1961,248,1713,37,1676,36,206,489,157,29,6,4,205,35,509
85,70,2224,284,1940,58,1882,30,311,694,119,40,10,3,232,35,408
85,71,2504,377,2127,51,2076,36,376,642,175,42,19,6,245,81,454
85,72,618,58,560,14,546,10,79,238,36,12,4,7,66,10,84
85,73,648,70,578,12,566,7,141,162,37,8,1,0,46,13,151
85,74,151,11,140,9,131,2,17,41,14,1,0,0,24,4,28
85,76,2391,248,2143,53,2090,43,268,606,194,27,9,4,277,57,605
85,77,320,58,262,1,261,9,52,84,19,4,1,0,13,10,69
85,78,662,103,559,9,550,7,124,135,50,7,3,1,48,15,160
85,80,656,104,552,14,538,7,104,185,51,9,1,0,54,4,123
85,81,3148,409,2739,64,2675,45,307,695,242,38,16,14,392,51,875
85,82,2055,232,1823,47,1776,32,208,627,148,34,15,4,321,55,332
85,83,1616,330,1286,27,1259,23,240,480,103,17,3,3,91,22,277
85,84,3584,370,3214,94,3120,46,489,1111,217,36,22,5,481,69,644
85,86,1060,162,898,25,873,10,209,280,66,11,6,0,106,19,166
85,87,199,52,147,4,143,1,28,46,8,1,3,0,27,3,26
85,88,3715,530,3185,83,3102,35,467,1186,250,42,21,8,368,77,648
85,89,3631,434,3197,64,3133,66,382,781,274,54,21,5,417,65,1068
85,90,1795,191,1604,44,1560,28,254,515,108,24,10,6,244,53,318
85,91,619,93,526,19,507,15,57,139,43,11,5,2,74,20,141
85,92,9402,1657,7745,139,7606,172,947,2330,769,93,54,19,798,155,2269
85,93,821,92,729,18,711,13,100,181,83,11,3,4,103,22,191
85,94,951,114,837,15,822,32,91,273,70,4,6,3,105,26,212
85,95,1131,175,956,19,937,14,207,301,83,14,8,0,105,20,185
85,96,3451,493,2958,68,2890,57,510,990,221,35,23,8,374,72,600
85,97,2284,265,2019,77,1942,29,242,755,134,37,13,4,312,61,355
85,98,1282,129,1153,37,1116,17,146,333,94,13,11,7,142,23,330
85,99,660,92,568,9,559,14,115,159,50,13,5,0,65,9,129
85,100,1476,174,1302,24,1278,15,231,456,100,10,10,4,173,40,239
85,101,355,33,322,7,315,7,55,112,33,5,1,2,34,12,54
85,102,399,66,333,6,327,7,96,87,28,9,5,3,32,5,55
85,103,1435,187,1248,35,1213,21,244,357,128,16,11,1,142,42,251
85,104,692,85,607,6,601,5,127,224,43,8,7,1,34,13,139
85,105,388,59,329,5,324,0,72,92,25,5,0,1,30,8,91
85,106,1294,235,1059,12,1047,26,183,363,80,12,5,3,108,16,251
85,107,2006,211,1795,49,1746,34,258,549,175,20,9,2,254,46,399
85,108,1972,193,1779,43,1736,35,247,585,145,28,12,3,247,32,402
85,109,11177,1676,9501,360,9141,208,929,3238,666,149,72,24,1604,193,2058
85,110,630,89,541,11,530,7,83,169,61,6,3,1,64,10,126
85,111,1066,170,896,16,880,6,185,203,112,15,7,0,56,19,277
85,112,2075,329,1746,48,1698,57,339,480,152,37,5,4,184,31,409
85,113,4162,840,3322,75,3247,89,538,1052,363,83,28,11,345,81,657
85,114,2495,361,2134,35,2099,26,339,900,128,15,11,2,174,57,447
85,115,457,51,406,9,397,3,80,125,28,4,3,2,55,3,94
85,116,333,45,288,3,285,3,50,83,25,4,2,1,30,5,82
85,117,458,69,389,7,382,11,82,94,42,10,1,0,45,12,85
85,118,1696,188,1508,43,1465,37,242,326,154,20,7,2,169,29,479
85,119,1750,214,1536,46,1490,15,202,540,81,34,6,3,263,50,296
85,120,961,82,879,19,860,9,183,332,50,14,8,1,108,24,131
85,121,828,131,697,22,675,9,131,178,82,11,2,2,61,14,185
85,123,202,23,179,6,173,6,39,40,15,3,1,1,18,6,44
85,125,297,45,252,4,248,0,62,102,13,2,0,0,26,6,37
85,126,883,68,815,29,786,7,96,217,94,15,6,1,118,17,215
85,127,1956,302,1654,32,1622,22,289,556,124,20,5,1,142,38,425
85,128,7565,1552,6013,147,5866,92,889,1815,518,58,34,12,592,142,1714
85,129,2378,301,2077,55,2022,41,381,634,155,27,15,5,281,55,428
85,130,976,170,806,14,792,12,165,244,68,18,9,1,96,20,159
85,131,1228,184,1044,17,1027,12,222,246,95,14,6,3,112,28,289
85,132,588,72,516,10,506,4,75,173,51,10,1,1,59,18,114
85,133,786,107,679,15,664,20,110,214,60,8,2,1,57,23,169
85,134,218,24,194,6,188,6,19,82,13,1,2,1,23,3,38
85,135,2029,287,1742,31,1711,28,270,522,148,26,7,2,243,26,439
85,136,82,16,66,4,62,2,15,17,8,2,0,0,7,1,10
85,137,390,50,340,10,330,9,70,123,24,3,5,0,26,12,58
85,138,665,83,582,16,566,10,91,177,56,11,5,2,63,13,138
85,139,371,39,332,8,324,4,47,89,39,6,0,0,30,13,96
85,140,1170,156,1014,33,981,5,143,320,76,26,18,2,137,31,223
85,141,431,44,387,10,377,0,47,190,19,6,3,0,59,12,41
85,142,621,57,564,14,550,9,89,167,43,7,4,2,82,22,125
85,143,816,117,699,9,690,12,132,194,74,16,5,4,54,18,181
85,144,908,88,820,22,798,12,111,278,47,21,5,1,124,34,165
85,145,663,55,608,21,587,10,118,155,45,6,7,1,89,25,131
85,146,3739,626,3113,63,3050,77,336,1062,273,30,17,3,396,59,797
85,147,1370,244,1126,29,1097,19,188,364,68,24,9,4,147,29,245
85,148,578,52,526,7,519,15,88,139,75,6,2,0,46,24,124
85,149,265,26,239,4,235,4,67,64,18,4,2,0,27,2,47
85,150,810,84,726,17,709,8,102,305,65,14,4,0,81,29,101
85,151,4708,716,3992,91,3901,100,395,1202,372,58,27,13,544,97,1093
85,152,2023,353,1670,42,1628,17,278,525,131,15,12,8,227,36,379
85,153,2134,223,1911,44,1867,50,242,631,170,24,12,5,277,33,423
85,154,914,133,781,25,756,9,117,266,43,13,5,4,124,14,161
85,155,3723,493,3230,65,3165,61,365,934,257,45,3,7,428,60,1005
85,156,1482,224,1258,34,1224,22,233,403,92,7,6,5,122,22,312
85,157,505,62,443,10,433,5,47,181,22,8,2,1,66,15,86
85,158,922,115,807,16,791,23,114,185,100,10,5,1,79,11,263
85,159,1688,271,1417,28,1389,13,247,346,121,20,9,3,129,28,473
85,160,1970,207,1763,47,1716,36,260,458,169,17,13,8,188,48,519
85,161,1763,241,1522,33,1489,26,272,499,127,21,15,9,187,45,288
85,162,897,105,792,16,776,19,121,253,76,16,6,1,113,20,151
85,163,4251,737,3514,57,3457,93,494,1407,279,29,15,9,310,63,758
85,164,1679,261,1418,27,1391,27,228,566,102,17,9,6,105,34,297
85,165,786,73,713,10,703,11,105,266,38,12,3,3,116,12,137
85,166,10931,1754,9177,168,9009,169,1500,3052,745,109,51,21,844,189,2329
85,167,657,50,607,16,591,15,51,154,71,12,5,1,94,15,173
85,168,583,73,510,14,496,10,101,128,50,9,4,0,54,11,129
85,169,690,116,574,14,560,10,106,172,53,6,7,3,60,17,126
85,171,445,82,363,12,351,8,55,89,53,7,4,1,29,8,97
85,172,1483,257,1226,28,1198,14,243,475,85,23,3,3,116,25,211
85,174,466,65,401,12,389,4,61,125,42,6,2,1,33,7,108
85,175,411,47,364,7,357,8,76,107,25,2,7,1,50,9,72
85,176,934,111,823,18,805,11,125,245,56,16,2,0,100,17,233
85,177,499,68,431,10,421,3,80,95,51,9,2,0,34,8,139
85,178,5583,602,4981,137,4844,95,629,1553,392,62,30,11,723,110,1239
85,179,678,89,589,12,577,7,146,176,66,11,1,3,46,7,114
85,180,834,112,722,21,701,15,97,292,43,8,5,2,83,17,139
85,181,471,69,402,11,391,5,68,89,34,9,4,0,48,15,119
85,182,4136,600,3536,106,3430,56,346,1080,245,46,19,11,495,85,1047
85,184,249,35,214,7,207,9,36,67,33,3,0,0,14,2,43
85,185,442,71,371,13,358,2,87,96,43,1,1,2,23,15,88
85,186,653,82,571,7,564,9,104,193,52,6,4,3,87,19,87
85,187,629,67,562,16,546,5,78,207,35,9,2,0,91,10,109
85,188,763,99,664,16,648,13,143,173,52,10,7,0,78,11,161
85,189,1474,199,1275,23,1252,15,289,413,105,28,14,3,135,39,211
85,190,2260,344,1916,50,1866,41,277,597,184,24,17,4,273,47,402
85,191,36020,6673,29347,571,28776,854,2667,7009,3148,364,155,44,3248,423,10864
85,192,695,69,626,26,600,7,74,248,39,9,4,5,85,14,115
85,193,413,39,374,9,365,4,70,86,38,8,1,0,40,7,111
85,194,13132,2754,10378,147,10231,216,1338,4229,730,87,39,18,903,191,2480
85,196,1269,130,1139,28,1111,9,172,386,85,18,11,4,173,23,230
85,197,989,90,899,27,872,21,144,280,63,19,4,1,133,26,181
85,198,992,144,848,24,824,20,97,250,60,15,5,0,148,28,201
85,199,337,40,297,10,287,1,70,74,36,5,6,0,34,8,53
85,200,714,61,653,11,642,10,121,190,71,6,1,1,66,14,162
85,201,329,42,287,4,283,3,61,96,25,6,0,1,20,5,66
85,202,1098,136,962,31,931,9,149,276,78,20,8,2,141,27,221
85,204,1715,284,1431,24,1407,23,298,447,121,23,10,6,156,42,281
85,205,385,55,330,10,320,1,44,133,24,8,2,1,33,6,68
85,206,277,35,242,5,237,6,63,77,13,3,1,0,13,5,56
85,207,341,55,286,3,283,6,56,48,32,2,0,0,27,2,110
85,208,1521,168,1353,45,1308,26,152,535,103,14,7,4,156,31,280
85,209,364,67,297,8,289,5,45,85,32,6,1,2,26,2,85
85,210,1336,204,1132,27,1105,34,226,376,83,25,6,6,111,27,211
85,211,1622,234,1388,40,1348,25,199,420,117,14,7,2,155,39,370
85,212,868,90,778,27,751,17,105,281,49,16,9,0,134,18,122
85,213,2141,327,1814,47,1767,42,196,545,170,27,12,4,253,40,478
85,214,1437,197,1240,38,1202,25,257,436,97,17,3,3,106,35,223
85,215,2550,280,2270,51,2219,25,311,793,160,24,13,7,331,46,509
85,216,1452,268,1184,29,1155,20,188,321,80,17,7,1,145,32,344
85,217,2859,302,2557,67,2490,52,358,737,210,42,28,6,429,54,574
85,218,1154,134,1020,20,1000,15,231,322,74,15,4,2,99,31,207
85,219,311,32,279,11,268,3,42,79,19,7,2,0,37,5,74
85,220,1101,116,985,29,956,16,152,360,66,17,9,0,124,19,193
85,221,1820,290,1530,25,1505,24,285,563,141,24,9,5,167,46,241
85,222,6243,1078,5165,97,5068,98,647,1915,402,57,10,7,547,122,1263
85,223,1922,284,1638,38,1600,32,237,442,149,16,6,3,177,20,518
85,224,3290,312,2978,63,2915,51,438,877,266,43,25,5,417,73,720
85,226,9754,1801,7953,145,7808,120,1324,2780,647,95,48,12,761,149,1872
85,227,1368,170,1198,23,1175,31,179,287,138,18,13,5,139,27,338
85,229,473,83,390,8,382,2,62,163,31,3,0,0,55,8,58
85,231,608,89,519,11,508,10,115,170,51,6,6,0,54,3,93
85,232,642,78,564,15,549,8,116,125,75,14,8,4,53,15,131
85,233,391,67,324,12,312,4,62,84,20,5,6,0,36,10,85
85,234,7257,1330,5927,125,5802,92,953,2401,416,88,30,21,583,113,1105
85,235,363,63,300,2,298,7,49,119,32,4,1,1,19,3,63
85,236,1082,124,958,22,936,17,179,333,70,12,3,2,101,30,189
85,237,280,35,245,5,240,5,37,96,14,3,2,2,27,8,46
85,238,2682,448,2234,53,2181,50,249,839,106,31,15,5,369,66,451
85,239,719,96,623,14,609,8,108,226,46,18,1,6,72,16,108
85,240,1058,84,974,27,947,17,105,340,60,20,5,1,197,34,168
85,242,683,78,605,15,590,11,83,187,37,7,1,2,112,9,141
85,243,2050,285,1765,35,1730,19,348,631,112,15,10,3,190,38,364
85,244,649,76,573,10,563,3,83,146,65,8,6,0,83,9,160
85,245,136,27,109,2,107,1,24,34,7,1,0,0,12,2,26
85,246,1627,193,1434,45,1389,17,232,481,89,31,4,3,189,39,304
85,247,713,91,622,20,602,11,80,211,43,19,6,3,88,17,124
85,248,319,44,275,8,267,15,38,87,18,6,0,0,34,6,63
85,250,1389,150,1239,30,1209,12,249,405,79,24,2,3,157,18,260
85,251,489,56,433,7,426,6,64,196,19,3,0,3,59,8,68
85,252,454,68,386,15,371,4,57,149,24,5,2,1,57,11,61
85,254,1387,167,1220,47,1173,22,165,350,74,27,4,5,152,28,346
85,255,1923,299,1624,25,1599,15,305,581,123,21,5,2,128,41,378
85,256,959,107,852,19,833,4,133,231,95,17,6,3,90,16,238
85,257,1416,120,1296,39,1257,15,194,460,112,25,9,1,197,26,218
85,259,863,89,774,24,750,15,73,303,55,11,4,4,131,27,127
85,260,533,73,460,8,452,13,84,124,37,9,2,5,61,9,108
85,261,169,28,141,4,137,3,18,38,12,1,1,1,28,3,32
85,262,2133,219,1914,41,1873,35,326,554,176,33,16,5,223,48,457
85,264,953,122,831,22,809,5,123,338,46,9,5,2,99,23,159
85,265,738,118,620,14,606,9,111,135,60,22,6,1,73,13,176
85,266,1076,94,982,43,939,7,141,307,84,14,1,1,136,15,233
85,267,648,109,539,15,524,10,113,136,58,4,0,0,55,10,138
85,268,1026,128,898,22,876,13,216,305,62,11,5,3,84,13,164
85,269,298,46,252,4,248,7,37,58,34,4,1,1,28,6,72
85,271,312,41,271,11,260,0,23,103,21,4,4,0,30,10,65
85,272,686,63,623,21,602,14,114,212,61,6,4,1,72,9,109
85,273,1108,147,961,31,930,12,247,295,64,21,6,2,101,24,158
85,274,403,65,338,5,333,5,57,84,46,7,2,0,42,14,76
85,276,510,67,443,14,429,3,73,131,40,4,7,2,43,12,114
85,277,1006,117,889,15,874,16,166,317,91,10,3,3,95,19,154
85,278,1119,147,972,12,960,11,207,347,56,7,7,3,70,27,225
85,279,1230,116,1114,44,1070,26,170,273,98,17,15,5,132,31,303
85,280,2187,308,1879,40,1839,23,322,669,172,25,16,9,238,30,335
85,281,750,84,666,16,650,14,124,198,56,9,2,2,71,20,154
85,282,637,74,563,18,545,14,77,182,45,11,5,2,70,16,123
85,284,3297,528,2769,57,2712,46,504,1009,225,39,13,6,263,65,542
85,285,497,52,445,21,424,16,64,111,44,4,7,1,40,12,125
85,286,399,49,350,3,347,9,68,81,39,5,4,0,29,8,104
85,287,363,43,320,9,311,9,39,136,23,3,1,2,29,12,57
85,288,5621,776,4845,112,4733,75,819,1792,333,61,26,11,527,101,988
85,289,1026,150,876,32,844,9,114,362,62,12,6,5,106,22,146
85,290,382,47,335,8,327,0,51,89,27,6,1,0,24,9,120
85,291,803,95,708,12,696,21,115,227,54,9,4,1,112,15,138
85,292,474,65,409,10,399,3,56,122,32,5,6,1,46,6,122
85,293,1149,140,1009,26,983,16,129,283,102,20,11,3,169,34,216
85,294,2830,485,2345,20,2325,42,350,1010,185,18,8,3,206,39,464
85,295,2179,257,1922,58,1864,24,289,641,153,37,22,6,262,26,404
85,296,868,122,746,25,721,14,126,232,51,9,3,3,119,19,145
85,297,793,102,691,18,673,7,134,189,48,10,5,1,65,10,204
85,298,1068,139,929,19,910,19,188,307,73,11,8,3,107,24,170
85,299,445,58,387,6,381,9,70,101,34,4,2,1,35,12,113
85,300,3282,380,2902,82,2820,61,379,764,264,42,26,6,359,75,844
85,301,1132,131,1001,21,980,13,142,282,80,22,3,2,156,51,229
85,302,2965,333,2632,75,2557,52,270,996,185,38,20,3,440,72,481
85,303,1232,180,1052,24,1028,12,175,304,100,18,9,2,105,22,281
85,304,492,82,410,13,397,10,108,67,38,11,7,1,20,9,126
85,305,629,85,544,16,528,3,67,214,33,6,0,1,76,13,115
85,306,528,62,466,11,455,9,56,109,42,6,3,3,51,8,168
85,307,891,178,713,19,694,17,119,269,46,1,3,1,60,19,159
86,1,565,75,490,12,478,7,70,128,54,7,6,0,25,9,172
86,2,383,49,334,4,330,3,80,87,27,8,6,0,33,6,80
86,3,275,38,237,5,232,16,38,64,28,3,1,2,18,3,59
86,4,335,43,292,10,282,14,31,96,28,2,1,0,12,6,92
86,5,486,76,410,9,401,5,107,101,38,4,1,1,36,6,102
86,6,448,71,377,14,363,2,53,103,30,4,1,1,31,9,129
86,7,892,114,778,23,755,5,156,198,83,7,5,3,99,15,184
86,8,343,88,255,10,245,2,70,53,20,7,2,0,35,8,48
86,9,845,135,710,14,696,20,156,201,72,6,7,4,49,14,167
86,10,795,104,691,8,683,25,106,121,106,9,3,5,79,18,211
86,11,122,17,105,4,101,0,24,23,17,0,2,0,8,5,22
86,12,119,15,104,2,102,0,16,24,13,1,0,0,4,9,35
86,13,92,16,76,2,74,2,13,36,5,0,1,0,8,1,8
86,14,1259,163,1096,21,1075,16,196,255,114,11,8,2,116,34,323
86,15,998,174,824,24,800,13,143,180,95,6,14,2,46,18,283
86,16,1299,131,1168,35,1133,19,183,246,129,17,6,1,130,28,374
86,17,807,121,686,19,667,10,136,175,63,14,5,3,62,8,191
86,18,294,52,242,10,232,2,48,70,20,3,1,0,16,6,66
86,19,1401,167,1234,27,1207,19,301,232,148,17,14,6,111,35,324
86,20,207,34,173,2,171,3,38,54,14,6,2,0,17,2,35
86,21,655,107,548,18,530,10,100,129,64,7,3,1,74,25,117
86,22,211,38,173,5,168,2,46,65,9,0,0,0,17,4,25
86,23,222,25,197,5,192,3,53,45,15,5,0,0,13,7,51
86,24,1003,131,872,14,858,32,106,158,112,13,7,2,97,18,313
86,25,356,51,305,8,297,3,57,128,18,6,2,0,27,8,48
86,26,400,59,341,4,337,1,87,115,25,4,1,0,26,6,72
86,27,1177,184,993,15,978,19,119,234,116,18,8,8,107,17,332
86,28,887,115,772,14,758,12,86,168,88,13,4,2,57,15,313
86,29,641,98,543,13,530,7,120,145,51,18,4,0,62,6,117
86,30,411,63,348,10,338,12,63,87,29,9,1,1,29,6,101
86,31,1390,167,1223,23,1200,32,203,298,148,12,8,3,108,22,366
86,32,1531,214,1317,30,1287,37,256,335,104,18,8,2,121,29,377
86,34,473,85,388,11,377,3,60,123,28,7,2,1,33,6,114
86,35,164,24,140,3,137,6,23,41,15,3,1,0,20,2,26
86,36,536,84,452,10,442,3,135,120,41,8,5,2,33,11,84
86,37,367,73,294,9,285,1,56,94,8,6,2,0,22,12,84
86,38,188,19,169,1,168,6,43,40,22,5,1,1,17,2,31
86,39,555,99,456,10,446,6,113,121,47,7,2,2,49,4,95
86,40,306,49,257,9,248,2,44,75,28,5,1,1,20,9,63
86,41,7254,1194,6060,95,5965,150,667,1366,644,54,28,19,709,93,2235
86,42,771,102,669,12,657,5,155,152,63,6,5,0,53,16,202
86,43,396,50,346,6,340,8,69,85,40,8,2,1,27,6,94
86,44,486,75,411,12,399,6,89,164,13,4,4,0,27,7,85
86,45,954,145,809,16,793,18,148,178,92,7,8,2,76,32,232
86,46,1439,197,1242,22,1220,16,265,265,149,15,9,1,125,22,353
86,47,352,48,304,11,293,2,78,50,36,6,2,0,16,5,98
86,48,685,103,582,13,569,6,98,127,68,8,4,1,62,7,188
86,49,458,88,370,9,361,6,63,120,27,5,2,3,36,7,92
86,50,559,82,477,19,458,15,80,137,36,6,5,3,51,18,107
86,51,158,24,134,3,131,5,27,49,5,1,1,0,10,5,28
86,52,707,115,592,18,574,19,111,119,66,11,4,0,59,13,172
86,53,749,76,673,14,659,13,87,183,85,14,5,1,52,7,212
86,54,307,44,263,12,251,3,64,70,16,4,1,0,26,9,58
86,55,285,53,232,5,227,6,32,65,19,6,2,1,33,7,56
86,56,495,61,434,10,424,9,76,110,36,5,4,0,46,12,126
86,58,496,46,450,13,437,14,72,101,51,5,3,0,43,8,140
86,59,357,67,290,8,282,3,53,76,37,5,1,0,21,4,82
86,60,664,102,562,14,548,8,83,133,68,10,4,2,52,19,169
86,61,868,137,731,16,715,5,109,203,70,5,6,2,68,23,224
86,62,2770,487,2283,49,2234,39,342,583,218,16,8,2,247,39,740
86,63,225,49,176,7,169,1,27,53,9,2,3,0,7,11,56
86,64,472,72,400,8,392,3,61,132,29,11,4,0,22,13,117
86,65,767,139,628,17,611,14,103,153,75,6,10,1,61,18,170
86,66,23893,6345,17548,341,17207,302,3007,4230,2020,220,114,29,1487,276,5522
86,67,173,16,157,1,156,4,37,36,15,0,1,2,15,6,40
86,68,789,165,624,17,607,6,104,169,55,9,1,5,58,11,189
86,69,148,26,122,6,116,5,33,27,7,4,1,0,9,3,27
86,70,5508,992,4516,75,4441,82,763,1064,490,43,32,9,412,74,1472
86,71,244,28,216,6,210,5,30,41,14,3,1,1,18,7,90
86,72,357,60,297,3,294,7,86,60,34,6,2,0,33,8,58
86,73,407,58,349,12,337,6,65,86,22,3,3,2,33,8,109
86,74,648,93,555,15,540,18,83,111,74,7,9,2,52,21,163
86,75,556,97,459,15,444,9,92,101,39,9,5,4,43,19,123
86,76,1943,267,1676,38,1638,40,232,418,146,25,7,1,157,44,568
86,77,698,102,596,9,587,10,141,117,67,8,11,3,50,7,173
86,78,1925,347,1578,33,1545,18,225,398,134,26,11,2,130,20,581
86,79,451,81,370,5,365,3,89,96,27,5,7,2,39,9,88
86,80,358,36,322,8,314,6,53,78,34,7,0,2,28,10,96
86,81,1149,193,956,25,931,19,199,209,101,15,14,1,82,25,266
86,82,1382,275,1107,22,1085,12,170,272,84,16,8,3,95,22,403
86,83,810,104,706,15,691,3,112,176,92,14,5,2,59,19,209
86,84,209,42,167,4,163,4,27,41,11,1,2,0,13,3,61
86,85,227,24,203,2,201,3,42,38,20,4,1,1,19,4,69
86,86,741,100,641,10,631,12,156,134,60,8,3,2,68,10,178
86,87,149,15,134,1,133,0,30,47,10,2,1,0,9,2,32
86,88,581,71,510,18,492,5,46,126,45,13,6,3,67,19,162
86,89,294,55,239,10,229,4,49,57,18,2,0,1,24,11,63
86,90,166,39,127,2,125,2,12,54,7,3,0,0,23,6,18
86,91,353,47,306,11,295,13,76,69,29,11,3,1,20,4,69
86,92,2376,377,1999,50,1949,16,449,439,222,32,23,5,176,43,544
86,93,126,26,100,2,98,3,21,32,9,0,0,0,6,1,26
86,94,365,38,327,8,319,2,59,113,27,5,1,0,30,9,73
86,95,2276,319,1957,26,1931,45,373,407,227,22,20,2,183,50,602
86,96,474,92,382,8,374,1,115,86,31,6,5,0,28,9,93
86,97,253,41,212,4,208,1,68,51,18,2,1,0,23,8,36
86,98,124,25,99,1,98,5,16,26,11,2,0,0,4,4,30
86,99,681,91,590,19,571,6,124,132,52,10,2,2,64,9,170
86,100,2904,379,2525,55,2470,27,293,559,234,38,12,4,292,46,965
86,102,375,17,358,5,353,4,66,113,22,6,4,2,35,5,96
86,103,1323,265,1058,13,1045,21,148,284,93,20,5,0,87,22,365
86,104,376,53,323,5,318,1,50,73,36,6,1,1,20,11,119
86,105,300,44,256,2,254,10,25,51,47,8,0,1,28,9,75
86,106,105,14,91,1,90,0,23,22,8,1,0,0,8,3,25
86,107,373,46,327,8,319,3,60,58,38,4,2,0,21,9,124
86,108,340,73,267,6,261,5,45,107,21,2,2,1,30,5,43
86,109,198,0,198,30,168,12,32,32,9,2,1,0,22,8,50
86,110,170,21,149,4,145,1,38,49,9,0,0,0,10,5,33
86,111,1369,90,1279,118,1161,13,301,250,102,13,11,2,95,28,346
86,112,895,142,753,18,735,11,113,191,72,10,4,2,55,20,257
86,113,2214,295,1919,31,1888,38,260,394,228,23,15,2,180,35,713
86,114,852,96,756,16,740,10,116,170,92,7,6,1,81,16,241
86,115,4233,773,3460,72,3388,79,531,905,355,48,25,9,383,68,985
86,116,636,74,562,23,539,17,88,131,58,6,5,0,60,11,163
86,117,376,57,319,10,309,7,51,69,44,5,2,0,24,10,97
86,118,280,33,247,6,241,4,48,75,17,4,4,2,11,10,66
86,119,271,34,237,7,230,0,42,82,10,1,1,1,23,1,69
86,120,959,169,790,26,764,7,140,195,85,8,5,3,78,19,224
86,121,1073,169,904,16,888,18,157,229,88,6,7,3,79,21,280
86,122,60,11,49,2,47,3,5,15,6,1,1,0,8,0,8
86,123,562,96,466,12,454,12,77,119,52,6,3,0,55,10,120
86,124,868,105,763,13,750,15,101,180,78,12,2,4,71,19,268
86,125,443,67,376,10,366,9,67,93,45,7,1,0,40,14,90
86,126,426,67,359,9,350,2,64,101,34,5,6,1,36,7,94
86,127,365,56,309,6,303,5,82,75,27,3,1,1,36,9,64
86,128,1841,344,1497,33,1464,18,384,416,137,13,17,2,102,39,336
86,129,413,61,352,7,345,2,78,107,26,5,1,0,36,13,77
86,130,327,49,278,6,272,0,77,69,27,1,1,0,18,5,74
86,131,553,67,486,10,476,4,84,121,52,10,3,0,34,9,159
86,132,242,48,194,3,191,3,36,49,18,2,0,0,18,7,58
86,133,2402,310,2092,42,2050,61,246,533,196,21,9,8,197,39,740
86,134,157,36,121,4,117,5,21,28,10,1,2,1,12,2,35
86,135,410,58,352,12,340,11,56,54,37,4,3,0,38,5,132
86,136,302,33,269,5,264,7,33,42,43,10,2,0,17,4,106
86,137,5387,1168,4219,112,4107,67,760,1189,361,74,32,12,487,89,1036
86,138,175,31,144,1,143,5,19,36,16,2,0,0,14,13,38
86,139,1893,308,1585,42,1543,39,230,338,179,15,15,5,157,30,535
86,140,1824,319,1505,39,1466,31,241,357,165,20,11,2,113,41,485
86,141,534,52,482,7,475,12,86,121,54,3,5,0,35,14,145
86,142,418,91,327,10,317,3,75,73,35,8,5,2,15,5,96
86,143,156,21,135,2,133,2,29,35,15,0,0,0,14,2,36
86,144,253,38,215,10,205,4,45,43,16,3,1,0,30,4,59
86,145,709,88,621,11,610,11,114,116,74,11,6,2,54,9,213
86,146,871,111,760,11,749,9,182,161,75,9,5,3,86,11,208
86,147,395,44,351,7,344,11,73,68,27,6,1,0,37,9,112
86,148,549,67,482,18,464,10,61,102,65,10,8,1,40,14,153
86,149,336,33,303,4,299,2,74,102,21,6,2,2,30,5,55
86,150,218,31,187,2,185,2,50,46,18,2,0,0,12,3,52
86,151,157,25,132,5,127,0,29,50,11,1,2,0,13,4,17
86,152,528,80,448,8,440,3,64,133,24,8,8,2,42,10,146
86,153,638,91,547,12,535,7,103,119,75,12,4,0,32,8,175
86,154,202,20,182,5,177,1,31,56,26,2,1,0,16,4,40
86,156,181,31,150,2,148,2,26,58,9,0,0,1,9,8,35
86,157,2959,370,2589,56,2533,62,230,629,319,16,10,8,289,55,915
86,158,4592,749,3843,69,3774,89,477,923,439,42,14,7,404,61,1318
86,159,429,82,347,9,338,2,68,53,43,8,5,1,22,16,120
86,160,1487,287,1200,21,1179,18,290,306,107,21,4,6,99,14,314
86,161,726,87,639,11,628,12,126,191,42,12,6,1,53,9,176
86,162,103,11,92,2,90,0,12,30,9,2,1,0,11,2,23
86,163,2530,324,2206,34,2172,47,248,501,250,16,16,4,235,43,812
86,164,553,92,461,13,448,9,104,96,50,4,4,2,48,14,117
86,165,4719,823,3896,93,3803,36,509,1055,396,54,32,11,335,77,1298
86,166,517,70,447,8,439,13,80,85,54,8,1,1,57,13,127
86,167,434,78,356,9,347,7,72,92,27,5,0,1,20,10,113
86,169,238,40,198,0,198,1,48,50,19,5,6,0,16,7,46
86,170,322,61,261,9,252,6,51,52,29,1,3,0,27,10,73
86,171,414,82,332,7,325,9,47,66,42,7,0,1,29,10,114
86,172,118,21,97,1,96,1,16,26,9,5,1,0,11,4,23
86,173,539,103,436,14,422,2,125,94,56,5,4,0,47,4,85
86,174,4327,661,3666,100,3566,52,803,708,414,42,22,6,300,85,1134
86,175,251,34,217,5,212,3,51,34,22,5,3,0,21,3,70
86,176,106,14,92,2,90,3,2,15,11,1,1,0,4,0,53
86,177,3542,563,2979,68,2911,60,425,819,300,38,18,2,285,58,906
86,178,1682,192,1490,38,1452,26,221,356,179,26,5,2,156,36,445
86,180,2224,277,1947,34,1913,47,217,373,234,21,7,5,224,36,749
86,181,191,21,170,3,167,2,35,54,10,1,3,0,16,4,42
86,182,331,62,269,11,258,8,77,54,27,4,4,0,21,4,59
86,183,1210,185,1025,17,1008,13,268,204,82,20,12,6,82,28,293
86,184,564,65,499,12,487,4,108,118,66,5,1,0,35,15,135
86,186,796,105,691,15,676,11,144,182,60,10,5,0,63,18,183
86,187,331,43,288,14,274,1,62,74,19,7,6,0,14,12,79
86,188,728,102,626,19,607,16,121,135,54,13,7,4,62,10,185
86,189,300,44,256,7,249,1,32,74,20,6,1,1,23,5,86
86,190,658,84,574,20,554,6,74,140,96,9,1,0,37,17,174
86,191,219,28,191,2,189,4,33,37,24,4,2,0,23,2,60
86,192,143,26,117,3,114,5,18,24,17,0,1,0,10,2,37
86,193,919,108,811,22,789,12,135,209,87,6,8,2,65,14,251
86,194,47732,10937,36795,631,36164,1391,3729,7888,4968,443,192,68,3259,543,13683
86,195,369,50,319,6,313,3,77,68,36,3,8,0,26,6,86
86,196,200,32,168,8,160,2,47,34,12,1,0,2,10,0,52
86,197,363,63,300,8,292,3,57,102,26,7,4,2,30,3,58
86,198,463,54,409,8,401,7,90,84,47,4,2,2,41,10,114
86,200,449,78,371,12,359,1,47,132,30,6,3,1,30,3,106
86,201,179,25,154,3,151,1,37,46,8,6,1,0,18,3,31
86,202,416,59,357,8,349,7,64,116,35,3,3,3,22,6,90
86,203,447,84,363,12,351,6,58,69,68,10,4,1,32,9,94
86,204,1579,170,1409,22,1387,57,203,261,178,19,8,2,149,23,487
86,205,150,25,125,0,125,5,31,27,9,1,5,1,5,1,40
86,206,100,15,85,0,85,0,31,26,8,2,1,0,8,2,7
86,207,1258,182,1076,16,1060,25,203,343,99,9,6,3,101,17,254
86,208,543,93,450,7,443,6,82,128,41,4,8,1,34,15,124
86,209,1392,148,1244,20,1224,24,160,292,146,8,17,3,131,30,413
86,210,486,76,410,8,402,0,112,91,45,10,7,1,37,10,89
86,211,676,126,550,18,532,15,99,140,49,11,3,0,50,16,149
86,213,1785,237,1548,38,1510,18,265,383,137,20,12,3,159,27,486
86,214,5477,986,4491,61,4430,129,434,1237,429,38,18,15,514,87,1529
86,217,252,37,215,4,211,4,44,58,25,2,0,0,19,7,52
86,218,162,27,135,2,133,1,37,33,21,1,0,0,6,3,31
86,219,744,123,621,9,612,14,112,127,75,6,11,0,84,15,168
86,220,245,42,203,3,200,3,32,61,20,1,0,1,12,3,67
86,221,906,134,772,15,757,19,213,151,82,8,8,4,60,19,193
86,222,2986,420,2566,55,2511,43,389,634,277,35,13,8,280,54,778
86,223,791,104,687,15,672,6,163,160,59,6,11,0,55,22,190
86,224,932,159,773,19,754,11,187,204,58,12,9,1,66,14,192
86,225,1023,163,860,11,849,7,190,232,62,15,6,3,95,17,222
86,226,1824,219,1605,34,1571,41,200,378,199,17,13,4,179,28,512
86,227,113,29,84,0,84,1,20,28,8,1,1,0,9,1,15
86,228,139,20,119,3,116,3,15,48,13,4,0,1,10,4,18
86,229,297,46,251,6,245,3,56,67,8,3,6,1,45,7,49
86,230,161,22,139,2,137,1,22,45,14,5,1,0,12,3,34
86,231,372,69,303,10,293,2,62,47,43,6,6,0,19,7,101
86,233,1941,243,1698,48,1650,40,319,369,193,26,7,3,140,25,528
86,234,321,65,256,3,253,4,37,88,22,9,1,1,21,2,68
86,235,930,126,804,13,791,25,136,158,103,11,8,1,74,21,254
86,236,746,117,629,23,606,8,98,224,53,7,3,1,48,20,144
86,237,658,101,557,6,551,5,107,117,73,12,3,1,53,10,170
86,239,130,20,110,5,105,5,21,26,14,2,0,1,9,2,25
86,241,352,45,307,4,303,1,88,80,35,4,6,2,28,7,52
86,242,276,45,231,13,218,1,40,59,19,4,0,0,26,5,64
86,244,1126,218,908,13,895,28,166,236,78,14,7,1,95,12,258
86,245,802,81,721,13,708,13,177,155,71,7,7,4,75,16,183
86,246,693,110,583,16,567,7,107,160,64,7,6,1,44,5,166
86,247,386,55,331,10,321,4,61,74,34,6,8,0,30,3,101
86,248,462,115,347,10,337,5,60,83,34,7,6,0,37,6,99
86,249,109,24,85,1,84,0,21,27,4,1,0,0,11,0,20
86,250,177,23,154,2,152,3,45,58,12,0,0,0,11,2,21
86,252,424,53,371,6,365,2,73,133,28,2,4,0,32,2,89
86,253,470,68,402,9,393,12,52,125,30,6,1,1,44,4,118
86,254,815,121,694,19,675,5,125,153,69,7,6,3,56,15,236
86,255,1018,164,854,30,824,12,125,193,75,16,10,4,74,17,298
86,256,823,85,738,10,728,16,83,159,82,13,8,1,79,23,264
86,257,240,39,201,4,197,5,40,68,8,2,3,1,24,8,38
86,258,1891,319,1572,39,1533,31,351,356,161,21,12,2,126,17,456
86,259,531,62,469,8,461,11,96,109,62,6,4,3,47,11,112
86,260,274,39,235,1,234,3,41,81,22,6,2,0,21,11,47
86,261,1507,184,1323,21,1302,34,187,322,133,8,10,1,127,33,447
86,262,528,96,432,15,417,7,101,127,30,6,7,0,37,4,98
86,263,1995,232,1763,37,1726,61,184,359,232,24,13,1,165,35,652
86,264,605,95,510,10,500,5,96,119,40,9,6,0,61,9,155
86,265,371,64,307,5,302,7,75,75,35,5,2,0,34,8,61
86,266,96,18,78,4,74,2,12,21,8,0,0,1,10,3,17
86,268,835,109,726,11,715,19,101,117,79,10,3,1,66,19,300
86,269,156,22,134,7,127,3,22,43,9,2,0,0,12,1,35
86,270,158,22,136,2,134,3,32,40,10,3,1,0,7,6,32
86,271,595,78,517,11,506,12,113,131,33,10,5,3,64,7,128
86,272,2171,341,1830,49,1781,42,394,370,212,20,15,2,171,36,519
86,273,727,124,603,17,586,5,91,220,46,6,10,1,42,12,153
86,274,744,117,627,16,611,3,146,213,55,6,5,4,53,12,114
86,275,482,53,429,8,421,5,113,104,30,3,1,0,31,7,127
86,276,1027,192,835,22,813,14,137,298,49,12,5,3,80,15,200
86,277,271,35,236,8,228,1,43,66,18,2,1,0,22,6,69
86,278,609,89,520,13,507,3,81,140,51,10,1,2,43,11,165
86,279,485,62,423,9,414,8,87,81,48,6,2,2,51,9,120
86,280,320,47,273,9,264,2,77,81,24,5,0,1,13,2,59
86,281,2369,411,1958,47,1911,30,377,475,212,38,14,4,173,41,547
86,284,489,58,431,8,423,11,66,103,68,9,3,0,47,8,108
86,285,751,106,645,22,623,17,108,150,83,12,4,0,54,18,177
86,286,337,60,277,7,270,9,63,79,32,8,0,0,13,6,60
86,287,284,36,248,5,243,5,54,75,27,0,4,0,19,8,51
86,288,588,106,482,8,474,12,74,136,43,8,2,4,48,14,133
86,289,509,72,437,6,431,9,82,113,45,8,4,0,44,15,111
86,290,1206,215,991,26,965,21,151,223,139,14,7,2,74,20,314
86,291,95,15,80,1,79,2,14,20,7,3,0,0,4,1,28
86,292,581,67,514,9,505,7,72,135,41,5,6,3,44,18,174
86,293,2399,347,2052,51,2001,35,291,506,194,32,17,1,200,60,665
86,294,2539,367,2172,50,2122,44,344,568,195,24,16,0,239,53,639
86,295,289,52,237,8,229,6,49,53,26,5,0,1,16,2,71
86,296,303,43,260,7,253,3,58,55,22,4,0,0,32,5,74
86,297,3879,511,3368,59,3309,59,448,831,277,50,18,14,409,69,1134
86,298,1521,229,1292,24,1268,27,305,284,140,23,2,4,120,34,329
86,299,424,60,364,6,358,7,64,100,39,1,0,0,27,10,110
86,300,237,24,213,8,205,5,35,38,13,8,3,0,28,6,69
87,1,4493,679,3814,93,3721,78,580,832,441,41,20,8,297,74,1350
87,2,4277,632,3645,75,3570,44,789,601,628,63,35,4,219,60,1127
87,3,740,111,629,16,613,1,113,119,100,10,6,3,46,10,205
87,4,90,18,72,1,71,3,5,16,11,0,0,0,11,0,25
87,5,769,73,696,10,686,7,105,132,109,10,3,0,49,13,258
87,6,196,18,178,7,171,1,40,47,15,1,1,1,12,2,51
87,7,163,29,134,4,130,3,29,23,26,0,1,0,6,2,40
87,8,120,31,89,4,85,2,14,28,8,0,0,0,9,3,21
87,9,145,20,125,1,124,9,17,25,25,1,0,0,3,4,40
87,11,2939,483,2456,67,2389,35,392,554,307,46,18,10,183,43,801
87,12,315,41,274,6,268,3,68,64,30,9,3,1,16,3,71
87,13,566,93,473,9,464,6,63,127,62,9,2,2,44,11,138
87,14,2261,351,1910,48,1862,19,362,400,265,29,14,6,147,29,591
87,15,509,44,465,10,455,12,80,89,56,12,4,1,40,12,149
87,16,264,41,223,1,222,6,32,30,66,5,1,0,16,2,64
87,17,370,34,336,9,327,1,76,74,43,5,2,1,23,9,93
87,18,597,119,478,12,466,22,92,73,72,9,8,3,33,10,144
87,19,2199,232,1967,48,1919,27,305,419,221,15,6,6,198,37,685
87,20,1191,138,1053,24,1029,22,225,162,164,11,7,2,53,24,359
87,21,1911,179,1732,42,1690,24,280,277,246,16,3,4,148,35,657
87,22,115,9,106,4,102,2,16,16,17,3,0,0,6,0,42
87,23,146,21,125,2,123,4,19,17,16,3,4,1,8,1,50
87,24,710,93,617,6,611,14,83,97,138,6,4,2,35,3,229
87,25,602,48,554,16,538,7,100,90,93,9,8,2,50,9,170
87,26,256,48,208,3,205,14,43,49,27,6,0,0,10,5,51
87,27,1138,211,927,22,905,19,168,213,162,17,8,4,46,17,251
87,28,714,153,561,31,530,9,110,124,51,7,6,0,45,12,166
87,29,398,31,367,6,361,10,86,56,51,4,6,1,31,3,113
87,30,930,102,828,17,811,4,165,128,147,14,12,0,64,11,266
87,31,235,32,203,5,198,1,33,52,18,1,3,1,14,5,70
87,32,1348,224,1124,27,1097,12,167,236,149,12,10,3,80,26,402
87,33,573,62,511,11,500,9,102,68,92,4,5,4,43,2,171
87,34,436,63,373,8,365,9,63,60,82,6,2,0,24,4,115
87,35,454,74,380,12,368,5,79,61,48,5,5,0,32,8,125
87,36,498,77,421,10,411,9,109,59,66,4,3,1,34,10,116
87,37,198,28,170,2,168,2,13,43,39,3,4,0,13,3,48
87,38,1567,183,1384,32,1352,14,272,217,207,15,7,2,123,26,469
87,39,670,89,581,9,572,22,85,116,120,5,2,0,47,9,166
87,40,1180,194,986,24,962,12,148,187,139,11,12,4,63,20,366
87,41,1743,289,1454,42,1412,15,278,271,206,28,17,2,111,31,453
87,42,326,44,282,8,274,6,60,48,45,2,8,0,25,3,77
87,43,164,21,143,4,139,7,27,16,31,3,1,0,8,1,45
87,44,239,45,194,4,190,2,31,37,27,1,4,0,18,1,69
87,45,809,120,689,15,674,21,115,148,119,13,3,1,45,12,197
87,46,868,99,769,18,751,14,172,114,121,11,5,1,61,10,242
87,47,1352,189,1163,25,1138,30,240,171,176,13,9,4,95,26,374
87,48,3994,552,3442,58,3384,57,516,654,445,44,20,12,333,69,1234
87,49,1078,162,916,17,899,8,186,202,92,15,9,1,43,20,323
87,50,6795,950,5845,133,5712,85,861,1307,684,68,24,12,564,93,2014
87,51,515,73,442,17,425,7,73,82,64,5,4,0,40,15,135
87,52,156,26,130,6,124,0,20,33,18,3,3,1,11,4,31
87,53,217,43,174,4,170,1,37,43,22,0,1,1,13,6,46
87,54,926,176,750,25,725,11,136,177,111,7,0,2,48,18,215
87,55,312,49,263,6,257,0,77,81,15,3,1,0,23,10,47
87,56,222,28,194,8,186,1,37,36,21,7,1,0,13,2,68
87,57,297,53,244,4,240,5,34,76,20,3,5,2,18,2,75
87,58,126,14,112,11,101,1,13,25,26,0,0,0,5,1,30
87,59,1439,306,1133,26,1107,9,211,336,91,16,10,3,83,19,329
87,60,560,102,458,19,439,14,79,92,70,5,5,2,35,4,133
87,61,322,58,264,8,256,2,52,51,36,2,4,0,27,7,75
87,62,295,35,260,5,255,3,49,37,43,0,3,0,16,4,100
87,63,863,85,778,14,764,18,131,152,103,6,3,3,48,23,277
87,64,1544,220,1324,31,1293,22,111,231,258,23,9,0,91,24,524
87,65,4762,661,4101,89,4012,76,596,857,426,37,18,7,345,58,1592
87,66,867,118,749,13,736,19,156,134,72,11,6,0,51,8,279
87,67,455,86,369,9,360,6,54,79,57,5,4,0,18,8,129
87,68,403,77,326,7,319,8,82,55,42,9,3,0,22,7,91
87,69,131,27,104,2,102,4,22,28,13,1,1,1,4,5,23
87,70,701,76,625,9,616,12,101,114,89,10,3,0,43,5,239
87,71,624,84,540,16,524,9,69,91,63,4,4,1,45,7,231
87,72,406,52,354,3,351,15,65,61,48,6,2,1,29,5,119
87,73,318,34,284,10,274,10,52,48,35,3,1,1,15,4,105
87,74,232,27,205,5,200,3,51,31,16,2,5,0,10,4,78
87,75,6323,894,5429,95,5334,100,673,1047,654,51,25,7,516,97,2164
87,76,226,38,188,2,186,8,36,21,40,1,1,0,16,2,61
87,77,388,49,339,4,335,4,73,59,39,8,3,2,26,10,111
87,78,518,55,463,16,447,8,79,82,66,6,3,0,52,2,149
87,79,609,92,517,11,506,5,78,64,109,5,6,0,37,10,192
87,80,156,31,125,3,122,2,40,20,21,1,1,0,11,1,25
87,81,788,55,733,17,716,7,135,102,125,8,5,0,53,11,270
87,82,864,115,749,15,734,16,129,168,115,12,6,1,35,13,239
87,83,461,86,375,11,364,8,76,65,71,6,2,0,23,5,108
87,84,145,26,119,3,116,2,20,33,12,1,2,0,13,0,33
87,85,78145,14822,63323,2251,61072,1302,9030,12652,8073,656,347,147,4727,869,23269
87,86,894,147,747,23,724,16,142,119,109,12,4,1,60,16,245
87,87,428,119,309,12,297,3,64,74,14,4,4,0,32,5,97
87,88,836,88,748,16,732,10,139,148,76,10,1,2,59,22,265
87,89,1294,233,1061,23,1038,7,191,268,106,16,13,2,72,24,339
87,90,257,47,210,7,203,2,32,49,31,4,0,1,20,7,57
87,91,343,56,287,12,275,4,60,57,40,2,0,1,19,2,90
87,92,382,77,305,9,296,7,35,62,66,2,2,0,19,4,99
87,93,252,39,213,4,209,1,31,28,50,0,1,0,14,1,83
87,94,370,47,323,10,313,17,61,44,52,3,1,0,34,3,98
87,95,659,116,543,9,534,16,91,119,48,4,3,1,43,5,204
87,96,717,144,573,8,565,7,99,122,69,7,2,2,39,12,206
87,97,662,99,563,5,558,7,103,151,59,8,6,1,49,14,160
87,99,267,23,244,4,240,1,46,48,46,4,3,1,18,2,71
87,100,219,32,187,9,178,9,29,44,30,3,5,1,16,4,37
87,101,88,9,79,0,79,0,9,30,13,1,0,0,7,1,18
87,103,1195,159,1036,24,1012,15,187,183,126,13,12,3,80,15,378
87,104,459,46,413,8,405,8,40,56,126,5,1,0,17,5,147
87,105,749,126,623,17,606,14,103,71,106,8,6,5,33,11,249
87,106,1899,263,1636,29,1607,28,292,297,227,23,11,6,130,41,552
87,107,1212,160,1052,31,1021,16,200,197,129,17,7,4,88,22,341
87,108,406,63,343,7,336,1,59,87,44,10,6,1,26,7,95
87,109,288,51,237,6,231,4,52,71,23,1,2,1,19,2,56
87,110,1782,211,1571,37,1534,23,247,329,222,12,10,4,142,24,521
87,111,1211,178,1033,24,1009,18,144,185,159,14,5,2,96,20,366
87,112,486,85,401,7,394,7,75,73,48,4,1,0,30,6,150
87,113,4661,609,4052,84,3968,59,662,559,664,47,22,9,279,61,1606
87,114,7758,930,6828,137,6691,98,946,1478,789,66,35,18,626,103,2532
87,115,145,14,131,2,129,2,30,31,10,0,2,0,4,1,49
87,116,898,113,785,17,768,11,124,158,142,11,3,1,58,15,245
87,117,809,114,695,15,680,11,105,138,120,8,4,1,32,12,249
87,118,976,135,841,15,826,12,192,110,157,11,5,3,75,21,240
87,119,900,113,787,16,771,13,97,174,120,11,1,7,62,11,275
87,120,449,65,384,7,377,15,95,64,28,6,3,1,31,8,126
87,121,409,85,324,7,317,7,56,68,52,6,3,1,26,6,92
87,122,887,111,776,9,767,15,137,120,155,10,9,1,51,12,257
87,123,120,13,107,3,104,4,9,21,25,0,0,0,7,3,35
87,124,320,31,289,4,285,11,29,44,52,6,1,0,24,7,111
87,125,3401,370,3031,69,2962,42,496,522,482,27,16,4,242,53,1078
87,126,2862,431,2431,67,2364,17,371,460,445,31,19,3,185,40,793
87,127,503,73,430,6,424,7,58,61,78,9,4,1,33,6,167
87,128,371,60,311,10,301,6,51,72,44,7,2,1,23,4,91
87,129,686,63,623,18,605,4,105,145,86,4,1,1,39,12,208
87,130,146,26,120,2,118,3,24,10,23,1,2,1,2,4,48
87,131,698,113,585,14,571,5,114,82,107,11,8,3,36,7,198
87,132,92,17,75,1,74,2,5,6,19,2,0,0,6,1,33
87,133,432,60,372,8,364,5,66,77,56,7,2,0,24,5,122
87,134,121,19,102,1,101,4,15,6,36,0,1,0,10,2,27
87,135,694,86,608,16,592,9,122,126,84,17,7,1,53,6,167
87,136,241,47,194,4,190,3,33,44,23,4,1,2,11,6,63
87,137,112,19,93,1,92,2,19,15,18,0,0,0,7,2,29
87,138,435,74,361,4,357,12,67,52,61,3,3,2,24,6,127
87,139,349,62,287,7,280,3,56,77,35,2,2,1,18,2,84
87,140,1254,161,1093,26,1067,9,204,154,206,6,5,7,68,19,389
87,141,608,81,527,13,514,6,127,106,72,5,2,1,42,15,138
87,142,429,46,383,7,376,7,82,55,75,2,2,2,18,3,130
87,143,1543,165,1378,42,1336,25,228,203,254,17,10,3,95,22,479
87,144,356,40,316,7,309,4,49,45,66,8,6,0,29,5,97
87,145,187,31,156,6,150,2,23,29,31,0,0,2,9,2,52
87,146,896,128,768,16,752,16,136,163,84,10,3,0,56,12,272
87,147,54,7,47,3,44,1,8,10,9,1,1,0,1,0,13
87,148,713,67,646,17,629,13,121,132,74,8,4,0,52,18,207
87,149,294,43,251,5,246,1,49,39,28,3,2,0,25,3,96
87,150,684,68,616,18,598,15,112,123,87,11,3,2,34,9,202
87,151,387,60,327,11,316,8,58,57,43,2,1,1,26,4,116
87,152,1253,165,1088,24,1064,18,249,175,180,13,5,1,73,15,335
87,153,301,68,233,3,230,4,31,27,66,8,2,0,12,6,74
87,154,8351,1390,6961,153,6808,116,992,1254,1261,71,56,10,451,105,2492
87,155,160,10,150,1,149,3,22,34,14,3,1,0,17,4,51
87,156,1834,192,1642,27,1615,34,297,339,204,18,7,10,147,21,538
87,157,676,86,590,7,583,13,108,65,111,16,2,0,46,11,211
87,158,1072,169,903,30,873,12,164,179,124,12,6,3,76,14,283
87,159,299,54,245,6,239,15,34,29,51,5,1,1,9,10,84
87,160,372,70,302,4,298,5,58,75,38,4,2,0,35,5,76
87,161,3533,552,2981,62,2919,51,461,513,489,40,27,4,184,55,1095
87,162,155,18,137,0,137,4,33,18,18,3,1,0,10,0,50
87,163,85,17,68,3,65,0,7,14,13,0,2,0,6,4,19
87,164,437,39,398,10,388,8,95,54,82,6,3,0,28,7,105
87,165,95,14,81,2,79,0,24,19,9,0,0,0,9,2,16
87,166,703,63,640,11,629,8,103,110,111,15,6,0,49,10,217
87,167,445,47,398,7,391,6,78,49,83,7,4,1,27,5,131
87,168,856,126,730,21,709,9,120,160,95,11,4,2,57,14,237
87,169,655,65,590,16,574,10,129,84,97,13,8,0,44,13,176
87,170,313,63,250,7,243,5,31,44,49,4,1,1,14,5,89
87,172,178,23,155,5,150,1,30,32,27,0,2,1,14,3,40
87,173,434,71,363,10,353,2,80,57,39,6,3,2,34,7,123
87,174,1039,121,918,24,894,22,136,189,155,13,1,2,79,12,285
87,176,513,63,450,11,439,22,63,93,64,9,3,2,28,12,143
87,177,1299,128,1171,29,1142,14,231,214,144,13,7,3,113,24,379
87,178,2271,312,1959,33,1926,25,376,308,337,24,11,2,139,37,667
87,179,208,38,170,3,167,7,29,56,24,2,3,2,18,1,25
87,180,476,88,388,9,379,3,89,81,34,6,3,3,29,8,123
87,181,708,134,574,18,556,14,80,84,126,8,4,0,37,5,198
87,182,1028,159,869,36,833,5,131,208,124,12,9,1,66,13,264
87,183,657,69,588,9,579,13,115,99,104,5,4,2,38,6,193
87,184,226,33,193,6,187,0,44,40,20,2,2,1,15,2,61
87,185,1322,147,1175,22,1153,18,197,209,156,8,11,5,87,26,436
87,186,257,43,214,9,205,3,21,37,31,3,5,1,23,7,74
87,187,5610,883,4727,145,4582,47,708,1003,493,40,29,14,364,84,1800
87,188,315,25,290,7,283,15,31,34,68,2,2,2,20,2,107
87,189,107,24,83,3,80,0,9,39,2,0,0,0,8,0,22
87,190,791,145,646,16,630,11,115,107,91,5,3,0,60,9,229
87,191,1411,214,1197,28,1169,16,269,242,140,6,7,3,99,20,367
87,192,1259,185,1074,23,1051,38,152,242,140,8,1,3,111,16,340
87,193,28,7,21,2,19,1,5,0,3,0,0,0,2,0,8
87,194,289,46,243,10,233,1,27,23,47,1,2,2,26,3,101
87,195,122,21,101,3,98,0,19,31,4,0,0,0,3,3,38
87,196,132,17,115,4,111,3,12,33,9,1,0,0,7,2,44
87,197,423,60,363,10,353,3,72,55,62,7,3,0,29,5,117
87,198,333,52,281,5,276,4,71,36,40,4,3,3,10,6,99
87,199,627,101,526,16,510,3,91,98,112,9,1,3,30,9,154
87,200,107,8,99,2,97,0,36,26,6,3,0,0,2,5,19
87,201,3304,298,3006,65,2941,55,395,566,393,31,19,8,272,42,1160
87,202,1515,160,1355,29,1326,26,212,213,258,18,13,2,112,25,447
87,203,1094,162,932,31,901,4,177,177,151,9,4,0,72,18,289
87,204,176,17,159,5,154,1,29,36,18,2,0,1,9,4,54
87,205,1712,218,1494,32,1462,30,206,320,226,18,5,4,145,14,494
87,206,146,25,121,7,114,1,24,35,15,2,4,0,3,2,28
88,1,55,8,47,1,46,0,16,10,3,1,0,0,5,2,9
88,2,54,5,49,1,48,1,11,13,9,0,0,1,1,3,9
88,3,68,16,52,2,50,0,15,14,0,1,1,0,6,0,13
88,4,128,22,106,2,104,1,27,39,6,4,0,0,11,5,11
88,5,190,28,162,4,158,2,47,47,9,3,0,0,14,3,33
88,6,245,30,215,7,208,4,61,66,15,6,0,0,19,6,31
88,7,63,25,38,0,38,0,7,23,1,1,0,0,4,0,2
88,8,100,13,87,0,87,6,30,17,8,0,0,0,10,2,14
88,9,2698,500,2198,46,2152,22,691,410,237,32,25,5,186,53,491
88,10,168,29,139,4,135,1,41,49,7,0,1,0,16,1,19
88,11,1219,156,1063,26,1037,14,257,230,97,18,3,3,104,22,289
88,12,854,121,733,20,713,8,176,157,84,12,2,2,80,24,168
88,13,74,15,59,0,59,4,21,18,2,0,0,0,5,2,7
88,14,164,23,141,3,138,0,37,27,23,3,2,0,11,4,31
88,15,191,21,170,0,170,3,36,56,21,4,0,1,20,5,24
88,16,237,33,204,3,201,1,56,45,12,0,1,1,16,5,64
88,17,126,14,112,5,107,1,25,34,11,2,3,0,6,1,24
88,18,400,74,326,8,318,6,110,45,30,2,5,2,24,11,83
88,19,155,23,132,0,132,6,37,32,9,1,0,0,9,5,33
88,20,137,26,111,6,105,0,26,37,9,1,1,0,9,3,19
88,21,205,18,187,2,185,4,41,69,8,2,0,1,17,1,42
88,22,185,22,163,0,163,0,51,38,25,5,1,0,10,5,28
88,23,73,1,72,1,71,1,21,19,12,3,3,1,2,2,7
88,24,83,10,73,0,73,1,18,25,4,0,0,0,11,2,12
88,25,62,10,52,2,50,1,10,16,2,2,0,0,8,3,8
88,26,882,119,763,13,750,7,157,203,57,7,1,0,92,13,213
88,27,106,10,96,2,94,0,45,19,5,0,0,0,5,1,19
88,28,532,63,469,6,463,7,96,128,28,7,2,2,60,14,119
88,29,945,184,761,22,739,16,188,200,70,13,4,0,70,17,161
88,30,120,12,108,1,107,3,36,33,7,0,1,0,11,0,16
88,31,96,6,90,3,87,4,21,13,11,1,0,1,13,0,23
88,32,1012,167,845,32,813,26,236,180,65,10,7,1,79,26,183
88,33,294,56,238,9,229,11,59,49,18,4,0,1,40,7,40
88,35,127,23,104,4,100,1,50,24,4,1,0,1,6,7,6
88,36,74,12,62,5,57,2,16,15,6,1,1,0,6,3,7
88,37,731,115,616,15,601,25,88,171,47,9,3,2,101,16,139
88,38,28,6,22,2,20,1,5,5,2,0,0,0,4,0,3
88,39,252,30,222,8,214,4,44,35,27,8,7,4,14,11,60
88,40,234,20,214,5,209,5,55,56,18,2,0,0,32,9,32
88,41,86,2,84,2,82,8,16,27,7,0,0,0,12,0,12
88,42,68,14,54,2,52,3,23,14,0,0,0,1,0,1,10
88,43,106,18,88,1,87,2,27,25,4,2,1,1,2,2,21
88,44,479,64,415,8,407,1,109,118,21,4,2,0,45,10,97
88,45,77,3,74,2,72,1,12,33,9,1,0,0,4,2,10
88,46,114,18,96,1,95,0,34,19,9,1,0,0,8,4,20
88,47,135,24,111,1,110,1,24,23,9,3,1,0,12,7,30
88,48,825,136,689,14,675,14,199,188,59,12,4,1,53,20,125
88,49,97,9,88,1,87,1,18,23,4,3,1,0,6,5,26
88,50,221,26,195,5,190,4,44,38,19,0,1,0,14,5,65
88,51,103,10,93,2,91,4,13,13,14,2,2,0,3,3,37
88,52,95,23,72,4,68,2,25,14,6,1,1,0,5,1,13
88,53,135,27,108,3,105,3,29,29,7,2,1,0,12,4,18
88,54,307,61,246,1,245,2,50,70,26,4,2,1,35,7,48
88,55,102,7,95,1,94,1,29,27,9,6,1,0,6,2,13
88,56,88,13,75,1,74,0,23,18,7,1,0,0,6,2,17
88,57,93,16,77,2,75,2,12,10,3,2,1,0,7,1,37
88,58,82,14,68,0,68,2,13,19,3,0,0,0,8,0,23
88,59,337,60,277,4,273,6,95,42,24,9,2,0,19,8,68
88,60,24,6,18,0,18,2,7,1,2,0,0,0,0,0,6
88,61,282,58,224,5,219,0,61,59,24,0,3,0,19,10,43
88,62,103,30,73,2,71,0,7,22,8,0,0,0,9,2,23
88,63,113,12,101,3,98,1,22,33,11,2,0,0,6,2,21
88,64,95,19,76,3,73,1,34,12,5,0,1,1,3,5,11
88,65,321,59,262,4,258,3,66,71,25,2,5,0,22,8,56
88,66,43,1,42,0,42,1,10,15,1,3,1,0,8,1,2
88,68,675,109,566,17,549,7,173,111,37,8,8,4,47,20,134
88,69,111,11,100,3,97,2,25,30,6,3,0,0,8,0,23
88,70,133,21,112,1,111,10,31,17,15,1,1,0,9,4,23
88,71,53,7,46,1,45,1,6,11,10,0,2,0,9,2,4
88,73,150,18,132,4,128,7,35,32,9,2,1,0,6,4,32
88,74,47,7,40,0,40,0,17,11,3,0,0,0,2,0,7
88,75,3875,605,3270,97,3173,56,560,976,273,57,32,7,448,86,678
88,76,368,61,307,10,297,6,77,62,28,7,1,0,22,6,88
88,77,414,47,367,6,361,5,100,95,29,4,2,2,40,14,70
88,78,2053,368,1685,34,1651,27,373,399,153,31,8,2,139,34,485
88,79,1135,163,972,30,942,12,208,222,80,8,3,4,61,26,318
88,80,232,40,192,4,188,7,54,43,11,3,4,0,25,8,33
88,81,1124,211,913,26,887,12,211,211,117,15,12,0,71,31,207
88,82,626,128,498,4,494,6,171,120,56,4,2,1,20,6,108
88,83,192,23,169,4,165,1,27,44,25,4,4,0,13,6,41
88,84,329,44,285,4,281,7,59,48,19,4,1,0,30,11,102
88,85,167,29,138,3,135,6,26,37,19,3,0,0,18,1,25
88,86,480,79,401,9,392,5,102,99,39,3,3,0,42,7,92
88,87,2658,549,2109,29,2080,59,324,581,197,19,9,6,229,57,599
88,88,537,77,460,16,444,10,94,145,44,6,3,2,43,20,77
88,89,503,96,407,3,404,3,126,94,47,9,1,0,35,7,82
88,90,2928,599,2329,52,2277,37,601,517,228,23,18,7,170,48,628
88,91,351,48,303,10,293,4,69,54,37,4,4,4,42,12,63
88,92,515,107,408,4,404,4,107,117,25,8,6,0,38,17,82
88,93,56,17,39,4,35,0,7,9,2,4,0,0,5,2,6
88,94,1074,190,884,24,860,12,162,187,112,11,6,3,74,20,273
88,95,1165,198,967,13,954,15,204,228,104,16,3,3,72,22,287
88,96,129,28,101,6,95,0,24,20,6,1,0,0,6,2,36
88,97,32,3,29,1,28,0,5,9,5,0,0,0,6,0,3
88,98,708,107,601,9,592,11,140,175,43,2,3,2,52,14,150
88,99,1273,215,1058,23,1035,13,250,237,96,18,4,3,102,13,299
88,100,41,3,38,1,37,0,10,5,6,1,0,0,3,0,12
88,101,905,149,756,13,743,13,164,165,87,11,9,1,85,25,183
88,102,84,13,71,1,70,0,22,28,2,1,0,1,1,7,8
88,103,69,4,65,2,63,1,8,23,7,3,0,0,7,2,12
88,104,175,31,144,3,141,3,27,31,20,1,1,0,17,4,37
88,105,215,37,178,6,172,0,48,38,20,2,4,0,16,6,38
88,106,827,142,685,17,668,16,188,160,72,6,7,4,73,12,130
88,107,46,17,29,1,28,2,7,9,1,0,1,0,3,0,5
88,108,440,74,366,3,363,3,102,105,29,8,2,1,29,10,74
88,109,564,56,508,12,496,10,92,141,54,10,10,1,53,22,103
88,110,148,18,130,4,126,0,39,44,8,0,1,0,16,2,16
88,111,292,41,251,2,249,6,77,56,15,4,1,2,26,11,51
88,112,400,54,346,7,339,3,114,57,38,8,6,0,23,12,78
88,113,123,11,112,3,109,2,29,19,11,3,1,0,8,3,33
88,114,2391,477,1914,40,1874,33,377,394,250,40,9,4,151,45,571
88,115,1103,224,879,21,858,7,248,228,68,13,9,1,64,18,202
88,116,2762,516,2246,54,2192,43,469,470,236,58,17,8,256,61,574
88,117,57,11,46,0,46,0,15,18,4,0,1,0,5,0,3
88,118,591,105,486,5,481,10,144,118,44,8,2,0,43,11,101
88,119,158,43,115,4,111,1,29,31,15,1,2,0,4,1,27
88,120,456,92,364,11,353,1,129,65,39,3,1,1,29,10,75
88,121,216,31,185,4,181,2,42,60,16,3,0,0,19,8,31
88,122,283,25,258,4,254,8,60,77,15,2,1,3,30,11,47
88,123,236,46,190,2,188,2,54,56,11,8,0,1,8,5,43
88,124,771,166,605,13,592,9,158,138,54,9,5,1,59,18,141
88,125,42,5,37,1,36,1,7,12,8,0,0,0,1,1,6
88,126,1181,174,1007,26,981,21,255,212,112,20,8,1,76,12,264
88,127,51,5,46,1,45,0,8,17,7,0,2,0,7,0,4
88,128,208,38,170,4,166,7,30,43,17,7,1,2,11,2,46
88,129,100,11,89,0,89,1,14,38,13,1,1,1,10,1,9
88,130,166,20,146,5,141,2,48,44,7,0,0,0,9,5,26
88,131,230,38,192,7,185,4,44,57,9,3,1,0,24,8,35
88,132,1139,149,990,26,964,16,194,261,75,7,2,2,118,24,265
88,133,167,15,152,6,146,0,29,62,8,2,0,0,16,5,24
88,134,404,53,351,7,344,7,66,109,22,3,5,1,33,4,94
88,135,672,104,568,13,555,4,128,131,76,13,3,2,42,15,141
88,136,1206,164,1042,20,1022,13,175,286,80,11,5,3,115,34,300
88,137,76,8,68,1,67,2,14,16,13,0,0,0,0,1,21
88,138,84,7,77,2,75,0,24,19,3,2,1,0,7,2,17
88,139,104,19,85,3,82,1,15,19,12,0,2,0,8,2,23
88,140,323,67,256,5,251,2,72,51,28,3,5,0,23,10,57
88,141,201,24,177,2,175,2,40,36,22,6,1,1,23,7,37
88,142,335,36,299,5,294,6,66,62,21,4,5,1,38,3,88
88,143,245,32,213,4,209,2,53,70,16,6,1,0,21,3,37
88,144,57,5,52,2,50,0,9,24,9,1,0,0,3,0,4
88,145,196,26,170,3,167,11,48,35,17,4,2,1,8,3,38
88,146,158,23,135,2,133,2,57,31,14,1,0,0,15,2,11
88,147,297,43,254,3,251,4,68,75,15,6,3,1,31,3,45
88,148,1583,234,1349,21,1328,26,343,330,131,20,7,3,167,27,274
88,149,38,5,33,0,33,1,6,5,8,3,0,1,4,1,4
88,150,211,42,169,4,165,1,48,45,16,6,1,1,11,8,28
88,151,809,135,674,12,662,8,159,197,54,11,3,1,69,21,139
88,152,219,29,190,2,188,3,40,50,21,3,2,0,38,3,28
88,153,241,29,212,4,208,0,59,51,16,1,3,0,29,10,39
88,154,121,29,92,3,89,2,5,40,12,0,0,0,14,1,15
88,155,104,12,92,2,90,0,20,18,18,1,2,0,8,1,22
88,156,108,10,98,3,95,0,34,23,7,0,1,2,5,1,22
88,157,699,115,584,7,577,17,117,185,32,14,2,0,60,16,134
88,158,2248,352,1896,48,1848,39,439,468,148,11,15,3,189,56,480
88,159,387,37,350,8,342,4,114,70,31,2,1,1,40,9,70
88,160,21229,4813,16416,340,16076,356,2588,4208,1661,186,102,52,1538,289,5096
88,161,343,41,302,2,300,10,67,83,23,4,1,3,28,1,80
88,162,160,22,138,2,136,1,36,37,9,1,5,0,11,2,34
88,163,545,93,452,12,440,11,102,102,35,8,3,0,32,10,137
88,164,92,10,82,2,80,3,17,16,6,3,0,0,13,0,22
88,165,2022,333,1689,38,1651,34,551,394,125,25,16,3,126,50,327
88,166,207,25,182,3,179,0,59,39,9,2,3,2,21,2,42
88,167,200,27,173,5,168,6,37,41,13,5,0,0,23,4,39
88,168,96,13,83,5,78,1,17,31,2,0,0,0,6,5,16
88,169,217,39,178,0,178,8,52,25,12,4,0,0,21,3,53
88,170,652,125,527,20,507,8,156,106,52,8,3,2,39,17,116
88,171,51,3,48,0,48,0,11,18,3,2,0,0,8,2,4
88,172,201,31,170,3,167,2,61,27,17,0,1,2,17,3,37
88,173,359,43,316,7,309,10,54,76,33,3,2,0,36,5,90
88,174,118,9,109,2,107,10,19,33,7,2,1,0,17,1,17
88,175,369,44,325,3,322,6,58,88,31,9,1,0,48,8,73
88,176,436,92,344,5,339,6,86,105,24,1,3,0,21,3,90
88,177,448,57,391,6,385,9,98,101,40,5,5,1,39,10,77
88,178,1584,153,1431,29,1402,33,312,364,115,11,5,1,190,23,348
88,179,51,4,47,0,47,0,5,9,8,2,0,0,4,1,18
88,180,132,21,111,2,109,1,27,29,6,0,2,2,17,6,19
88,181,2254,480,1774,41,1733,27,580,346,200,37,20,8,101,27,387
88,182,176,31,145,6,139,2,40,27,24,1,1,1,13,0,30
88,183,263,40,223,3,220,4,52,58,31,4,5,0,15,4,47
88,184,369,45,324,7,317,2,124,68,28,5,1,0,23,9,57
88,185,118,15,103,3,100,2,33,21,11,1,0,0,14,1,17
88,186,44,7,37,1,36,1,8,16,4,0,0,0,2,3,2
88,187,45,9,36,1,35,0,11,13,4,1,0,1,2,1,2
88,188,1519,268,1251,38,1213,25,324,254,147,31,10,2,107,36,277
88,189,124,23,101,0,101,0,23,46,6,1,0,0,10,4,11
88,190,350,47,303,5,298,4,71,81,19,8,0,0,35,6,74
88,192,86,16,70,3,67,1,18,18,4,1,0,0,6,2,17
88,193,122,28,94,2,92,2,32,21,5,1,1,0,6,3,21
88,194,130,13,117,2,115,2,33,29,13,0,1,1,10,3,23
88,195,105,20,85,1,84,0,34,24,5,2,1,0,8,2,8
88,196,6661,1075,5586,116,5470,115,870,1460,845,118,43,18,515,111,1375
88,197,302,46,256,10,246,9,55,88,15,4,0,0,32,9,34
88,198,422,60,362,11,351,8,64,95,41,9,3,2,40,12,77
88,199,61,10,51,2,49,1,16,7,2,2,1,1,6,2,11
88,200,51,9,42,0,42,1,13,18,2,0,0,0,1,0,7
88,201,648,57,591,10,581,13,139,145,52,8,3,1,47,13,160
88,202,157,30,127,2,125,1,38,24,16,2,1,0,17,6,20
88,203,271,37,234,4,230,7,60,62,14,3,4,3,25,5,47
88,204,775,99,676,11,665,19,159,201,58,1,2,0,71,12,142
88,205,217,26,191,4,187,6,37,74,9,2,2,1,24,16,16
88,206,667,94,573,7,566,3,143,91,82,8,3,4,59,12,161
88,208,114,19,95,4,91,5,23,26,6,2,1,0,9,4,15
88,209,5912,1344,4568,107,4461,75,1061,977,424,56,25,14,387,92,1350
88,210,130,20,110,3,107,0,30,29,15,3,1,0,8,3,18
88,212,353,60,293,8,285,1,95,79,22,1,1,0,16,12,58
88,213,111,18,93,1,92,3,18,25,8,1,1,0,8,1,27
88,214,58,10,48,1,47,0,13,18,3,2,0,0,2,1,8
88,215,69,11,58,0,58,2,18,19,4,1,1,2,1,0,10
88,216,569,79,490,12,478,5,127,104,41,17,3,1,55,15,110
88,218,1778,391,1387,32,1355,30,330,311,170,25,16,6,138,33,296
88,219,117,15,102,1,101,2,27,40,4,0,0,0,10,2,16
88,220,39,7,32,0,32,2,11,6,3,1,0,0,3,0,6
88,221,202,48,154,3,151,0,47,35,10,2,1,0,19,5,32
88,222,148,19,129,1,128,5,19,50,10,1,2,1,11,6,23
88,223,129,29,100,1,99,0,27,24,7,7,0,0,15,1,18
88,224,300,53,247,10,237,5,85,65,16,0,1,2,17,3,43
88,225,1866,244,1622,38,1584,22,451,425,97,16,7,2,182,44,338
88,226,95,8,87,1,86,2,17,20,13,0,0,1,10,1,22
88,227,83,14,69,1,68,0,25,20,2,1,0,0,11,0,9
88,228,132,11,121,1,120,3,25,48,11,0,1,1,14,3,14
88,229,67,6,61,2,59,2,16,20,3,0,0,0,8,1,9
88,230,28,0,28,2,26,2,2,16,0,0,0,0,6,0,0
88,231,389,67,322,4,318,3,78,90,40,4,0,4,32,13,54
88,232,163,27,136,5,131,2,34,52,12,2,4,0,6,1,18
88,233,456,55,401,15,386,4,111,119,18,4,3,0,39,14,74
88,234,327,60,267,8,259,3,78,64,24,4,0,0,20,6,60
88,235,126,15,111,2,109,4,13,39,21,2,0,0,7,0,23
88,236,119,26,93,3,90,2,32,30,6,1,0,0,7,3,9
88,237,287,32,255,6,249,0,53,64,18,6,3,1,26,9,69
88,238,312,58,254,8,246,3,71,48,36,6,0,1,15,8,58
88,239,115,16,99,2,97,0,30,23,11,0,0,2,4,1,26
88,240,209,27,182,9,173,2,71,21,19,3,3,1,14,6,33
88,241,317,47,270,15,255,3,67,55,25,2,3,0,16,5,79
88,242,34,2,32,1,31,1,7,8,4,0,1,0,3,1,6
88,243,415,69,346,6,340,8,81,93,8,9,0,0,29,9,103
88,244,418,90,328,4,324,6,97,81,24,5,6,0,27,6,72
88,245,234,49,185,2,183,6,46,45,17,4,0,0,31,8,26
88,246,372,40,332,6,326,3,70,55,40,3,1,0,25,6,123
88,247,936,134,802,24,778,10,286,157,76,6,6,2,42,14,179
88,248,167,34,133,0,133,2,42,35,12,2,2,1,17,0,20
88,249,80,16,64,1,63,0,9,14,6,2,0,1,8,1,22
88,250,300,35,265,7,258,5,77,50,32,8,1,1,29,6,49
88,251,850,129,721,20,701,13,160,215,51,13,7,1,51,27,163
88,252,118,13,105,4,101,0,11,29,13,1,0,0,11,0,36
88,253,554,69,485,10,475,12,70,169,36,8,1,2,56,10,111
88,254,79,9,70,2,68,0,30,10,4,4,0,2,3,1,14
88,255,72,3,69,1,68,0,12,37,5,1,0,1,1,2,9
88,256,222,42,180,3,177,1,46,57,21,2,1,1,17,3,28
88,257,133,12,121,3,118,1,38,35,9,1,5,1,10,2,16
88,258,756,158,598,13,585,4,177,125,55,13,4,0,46,5,156
88,259,271,38,233,4,229,5,64,61,24,8,0,1,26,4,36
88,260,148,28,120,3,117,0,27,25,17,2,0,2,11,2,31
88,261,497,70,427,8,419,6,133,88,42,10,1,0,33,9,97
88,262,468,84,384,13,371,2,112,79,34,8,0,0,19,9,108
88,263,194,31,163,6,157,2,56,27,9,3,0,0,23,2,35
88,264,50,5,45,1,44,0,18,10,5,2,2,0,2,4,1
88,265,25,2,23,0,23,1,10,8,1,1,0,0,0,0,2
88,266,657,111,546,20,526,2,137,130,30,15,5,0,44,15,148
88,267,392,54,338,7,331,8,92,96,36,10,2,1,25,4,57
88,268,124,20,104,3,101,2,29,26,6,3,0,0,6,0,29
88,269,258,33,225,6,219,8,25,41,28,12,1,0,21,10,73
88,270,1675,279,1396,19,1377,18,314,403,102,13,11,4,97,36,379
88,271,249,63,186,2,184,1,56,37,26,3,1,3,11,7,39
88,272,74,18,56,0,56,1,14,16,1,0,0,0,0,1,23
88,273,369,31,338,4,334,9,78,89,29,3,4,0,29,5,88
88,274,75,9,66,1,65,0,21,24,4,1,0,0,4,0,11
88,275,184,33,151,2,149,5,44,49,9,1,3,1,11,2,24
88,276,358,64,294,5,289,5,65,64,44,4,3,0,38,7,59
88,277,97,22,75,1,74,2,20,29,5,2,0,0,3,3,10
88,278,81,13,68,2,66,0,21,17,10,0,0,0,6,4,8
88,279,62,4,58,0,58,0,13,13,7,0,0,0,5,3,17
88,280,85,7,78,0,78,1,27,5,7,0,0,1,15,4,18
88,281,295,48,247,4,243,2,70,64,17,5,1,1,18,6,59
88,282,28,9,19,0,19,0,5,8,0,2,0,0,1,0,3
88,283,77,17,60,3,57,2,16,13,4,1,4,1,9,0,7
88,284,518,87,431,11,420,9,134,72,67,8,1,2,34,13,80
88,285,255,22,233,3,230,1,54,61,15,9,2,1,23,4,60
88,286,66,15,51,0,51,3,8,20,6,0,0,0,9,1,4
88,287,84,13,71,2,69,0,21,13,5,1,1,0,17,0,11
88,288,14,2,12,0,12,0,2,5,1,0,0,0,2,1,1
88,289,673,123,550,16,534,2,139,146,44,9,7,2,44,21,120
88,290,104,32,72,1,71,3,25,20,4,0,0,0,5,1,13
88,291,115,19,96,1,95,1,21,46,2,1,0,0,8,1,15
88,292,526,85,441,7,434,6,98,84,46,4,4,0,35,12,145
88,293,200,26,174,3,171,1,35,47,12,4,0,0,17,0,55
88,294,211,29,182,4,178,1,51,52,7,1,3,0,8,5,50
88,295,188,19,169,5,164,9,35,38,17,2,1,0,7,2,53
88,296,91,19,72,0,72,0,15,32,6,0,0,1,2,2,14
88,297,116,10,106,2,104,0,28,29,14,0,1,0,3,5,24
88,298,49,6,43,1,42,0,19,14,0,2,0,0,4,0,3
88,299,132,16,116,1,115,1,31,36,6,1,0,0,21,4,15
88,300,119,8,111,1,110,5,23,36,15,0,2,0,9,2,18
88,301,239,31,208,3,205,3,62,58,15,0,1,0,22,5,39
88,302,944,146,798,14,784,18,215,192,73,9,10,0,86,19,162
88,303,178,21,157,2,155,3,55,27,7,4,1,0,10,1,47
88,304,3753,942,2811,45,2766,53,506,649,403,43,19,9,201,62,821
88,305,178,18,160,6,154,4,42,37,6,3,0,0,13,4,45
88,306,60,11,49,0,49,0,14,21,2,1,0,0,2,1,8
88,307,99,16,83,2,81,2,37,9,8,3,0,0,10,2,10
88,308,198,31,167,9,158,4,37,61,17,0,0,0,13,4,22
88,309,133,21,112,1,111,4,29,35,13,0,1,0,8,6,15
88,310,640,89,551,15,536,6,103,166,47,5,4,2,56,15,132
88,311,44,4,40,1,39,0,3,13,6,1,1,0,6,2,7
88,312,165,32,133,1,132,1,30,18,22,1,1,0,11,1,47
88,313,361,82,279,8,271,1,81,77,15,9,5,1,23,8,51
88,314,130,33,97,0,97,1,27,20,15,5,0,0,9,1,19
88,315,136,25,111,2,109,0,47,35,2,2,0,0,3,1,19
88,316,33,2,31,0,31,0,11,14,0,0,0,0,2,0,4
88,317,537,101,436,8,428,13,136,82,43,6,7,1,34,10,96
88,318,171,30,141,2,139,5,43,26,18,1,1,0,10,7,28
88,319,2495,556,1939,42,1897,26,669,397,169,31,15,5,133,32,420
88,320,714,72,642,10,632,11,148,182,63,7,3,0,59,11,148
88,321,4755,980,3775,55,3720,50,709,1059,341,45,23,13,338,93,1049
88,322,362,52,310,9,301,6,96,80,31,6,2,0,17,11,52
88,324,264,36,228,4,224,1,52,33,37,4,4,0,23,3,67
88,325,134,19,115,5,110,3,37,24,7,2,0,0,10,7,20
88,326,256,36,220,4,216,4,68,59,10,5,0,1,24,6,39
88,327,1631,314,1317,36,1281,22,372,231,118,26,18,0,87,23,384
88,328,465,73,392,7,385,3,96,111,43,8,1,1,31,14,77
88,330,139,19,120,5,115,0,24,37,10,5,0,0,11,3,25
88,331,41,4,37,3,34,0,8,13,3,0,0,0,4,1,5
88,332,205,34,171,4,167,4,26,45,12,4,2,2,14,17,41
88,333,89,16,73,1,72,1,19,19,5,2,2,0,14,2,8
88,334,231,30,201,6,195,5,41,60,15,2,5,1,26,6,34
88,335,119,13,106,4,102,2,20,24,2,1,2,0,10,2,39
88,336,73,15,58,1,57,0,13,33,5,0,0,0,1,0,5
88,337,166,18,148,3,145,2,29,36,18,5,1,2,15,4,33
88,338,75,13,62,2,60,0,17,13,8,2,0,0,10,0,10
88,340,394,64,330,4,326,5,116,94,16,4,0,0,33,6,52
88,341,395,46,349,3,346,9,97,70,36,4,3,0,26,13,88
88,342,127,16,111,3,108,2,35,25,11,0,0,1,12,5,17
88,343,116,13,103,5,98,1,31,25,6,1,1,1,15,4,13
88,344,158,29,129,2,127,1,28,43,3,1,3,0,21,1,26
88,345,68,8,60,2,58,0,15,9,9,0,0,1,3,2,19
88,346,619,136,483,10,473,2,162,87,48,7,3,2,29,7,126
88,347,86,10,76,0,76,1,21,16,5,1,1,0,11,0,20
88,348,116,13,103,3,100,0,31,31,12,2,0,0,8,4,12
88,349,1392,255,1137,30,1107,12,390,180,183,27,15,1,66,20,213
88,350,69,20,49,3,46,1,14,15,4,2,0,0,4,3,3
88,351,1290,197,1093,25,1068,24,237,317,89,18,12,2,123,22,224
88,352,211,31,180,0,180,0,27,78,14,1,2,1,22,2,33
88,353,71,6,65,0,65,2,14,18,3,1,0,0,14,0,13
88,354,103,6,97,4,93,2,27,27,8,1,0,1,3,1,23
88,355,876,204,672,13,659,12,130,207,74,14,1,0,63,9,149
88,356,193,37,156,4,152,0,67,34,8,5,0,1,7,2,28
88,357,614,89,525,10,515,7,134,115,72,9,3,2,43,13,117
88,358,1388,229,1159,37,1122,17,329,245,140,10,14,2,95,32,238
88,359,72,5,67,2,65,0,17,14,7,1,0,0,4,0,22
88,360,145,21,124,1,123,1,35,19,16,4,1,1,15,7,24
88,361,647,106,541,15,526,11,171,124,54,8,3,2,55,9,89
88,362,110,19,91,2,89,3,18,31,8,2,0,2,13,0,12
88,363,142,34,108,2,106,1,33,30,18,0,2,0,6,1,15
88,364,131,11,120,2,118,0,27,56,10,0,1,1,8,1,14
88,365,121,13,108,0,108,1,27,28,11,1,2,1,6,2,29
88,366,234,28,206,8,198,1,43,61,24,3,1,0,23,2,40
88,367,3887,883,3004,71,2933,43,789,764,261,56,24,9,202,47,738
88,368,149,25,124,1,123,2,27,30,14,4,1,0,7,3,35
88,369,1475,265,1210,41,1169,15,382,250,88,28,16,3,100,39,248
88,370,57,4,53,1,52,1,13,23,6,0,0,0,3,0,6
88,371,996,142,854,26,828,23,216,226,60,15,3,3,71,12,199
88,372,4865,1217,3648,70,3578,44,976,836,387,53,18,13,224,74,953
88,373,147,16,131,2,129,1,23,19,22,4,2,1,11,4,42
88,374,19,2,17,0,17,0,1,11,0,0,1,0,2,0,2
88,375,366,58,308,5,303,3,104,81,26,4,1,0,23,7,54
88,376,233,27,206,3,203,2,38,46,18,4,1,4,32,5,53
88,377,122,22,100,1,99,4,16,31,2,4,0,0,10,7,25
88,378,70,7,63,0,63,0,23,8,5,3,0,0,7,0,17
88,379,280,38,242,6,236,1,64,65,19,5,0,0,22,5,55
88,380,173,30,143,6,137,3,26,24,19,2,3,0,22,3,35
88,381,178,23,155,3,152,5,34,32,22,6,1,1,22,5,24
88,382,47,4,43,1,42,0,10,12,1,1,0,0,10,3,5
88,383,5853,1547,4306,92,4214,91,711,1297,338,55,26,18,469,99,1110
88,385,410,58,352,10,342,9,76,87,48,8,2,0,21,9,82
88,386,375,62,313,10,303,4,95,89,28,5,0,1,23,4,54
88,387,161,19,142,3,139,0,38,40,16,3,1,0,19,1,21
88,388,103,14,89,5,84,4,13,24,5,1,1,0,18,2,16
88,389,61,3,58,3,55,0,18,16,2,1,1,1,6,6,4
88,390,111,32,79,0,79,3,12,30,15,1,0,0,8,0,10
88,391,542,70,472,10,462,11,72,129,56,10,6,0,56,7,115
88,392,27,3,24,0,24,1,2,9,3,0,0,0,3,1,5
88,393,248,20,228,2,226,0,40,64,20,3,4,0,29,7,59
88,394,44,6,38,0,38,0,9,13,1,1,0,0,7,2,5
88,395,270,32,238,1,237,3,61,50,10,5,1,0,23,6,78
88,398,76,9,67,0,67,1,19,21,6,1,0,0,5,1,13
88,399,150,15,135,3,132,0,42,40,8,0,0,0,8,5,29
88,400,265,43,222,3,219,2,55,49,25,3,1,3,24,4,53
88,401,392,73,319,9,310,10,61,78,23,7,0,2,37,11,81
88,402,181,35,146,7,139,3,38,47,3,0,1,0,14,5,28
88,403,154,26,128,1,127,1,28,41,11,2,5,1,11,3,24
88,404,69,14,55,0,55,0,10,16,6,0,1,0,1,0,21
88,406,84,9,75,1,74,1,24,18,6,1,1,0,8,2,13
88,407,140,27,113,2,111,5,22,29,8,0,0,0,16,4,27
88,408,2680,446,2234,48,2186,38,668,467,200,43,9,9,202,64,486
88,409,1713,248,1465,46,1419,20,324,338,143,38,16,3,152,41,344
88,410,239,46,193,8,185,3,55,52,19,4,1,0,17,4,30
88,411,76,19,57,0,57,3,14,11,7,1,1,0,5,0,15
88,412,372,48,324,6,318,6,93,87,29,6,2,0,20,5,70
88,413,13977,2956,11021,225,10796,209,2399,2737,1036,142,65,28,874,179,3127
88,415,2689,480,2209,44,2165,34,484,548,208,28,10,9,226,49,569
88,416,77,17,60,3,57,1,9,29,0,2,0,0,7,2,7
88,417,284,39,245,10,235,3,60,46,33,2,4,0,23,3,61
88,418,372,77,295,5,290,3,91,64,20,4,4,1,33,7,63
88,419,123,26,97,1,96,0,32,28,17,1,0,0,4,2,12
88,421,112,18,94,0,94,0,32,34,6,1,0,0,6,5,10
88,423,992,144,848,22,826,9,286,170,63,12,5,4,58,18,201
88,424,1897,261,1636,54,1582,20,407,454,143,17,11,3,144,29,354
88,425,124,12,112,9,103,1,34,16,9,2,3,1,13,1,23
88,426,1122,187,935,39,896,14,240,198,92,24,12,5,93,31,187
88,427,105,12,93,3,90,0,23,22,9,1,3,0,5,1,26
88,428,1698,315,1383,34,1349,16,395,358,99,12,10,1,126,34,298
88,429,3146,417,2729,45,2684,64,598,774,217,30,11,10,278,78,624
88,430,407,86,321,9,312,7,71,86,25,2,5,1,25,11,79
88,431,97,12,85,0,85,2,22,21,10,1,0,0,11,1,17
88,432,143,28,115,2,113,1,44,33,5,3,1,2,11,4,9
88,433,65,13,52,3,49,0,16,10,6,0,4,0,6,0,7
88,434,182,29,153,6,147,1,32,35,16,2,1,1,12,5,42
88,435,402,50,352,9,343,3,91,96,21,4,4,0,48,6,70
88,436,78,12,66,2,64,2,18,6,7,1,1,0,5,0,24
88,437,81,12,69,2,67,1,24,17,4,1,0,0,5,4,11
88,438,306,47,259,4,255,4,74,59,23,5,1,1,20,3,65
88,439,686,81,605,14,591,14,120,128,48,3,2,1,77,15,183
88,440,168,20,148,4,144,6,24,50,11,1,2,0,20,3,27
88,441,88,17,71,5,66,0,17,25,6,2,1,0,9,2,4
88,442,506,67,439,10,429,15,84,102,41,10,1,0,59,17,100
88,443,90,11,79,0,79,0,12,37,6,2,1,0,10,3,8
88,444,276,45,231,0,231,7,58,59,31,6,3,2,18,6,41
88,445,1730,247,1483,47,1436,21,437,324,120,19,12,6,95,37,365
88,446,190,31,159,2,157,1,52,26,8,4,0,2,8,3,53
88,447,2226,442,1784,59,1725,30,381,372,210,38,15,8,199,43,429
88,448,146,20,126,2,124,0,27,50,8,0,3,0,8,3,25
88,449,175,35,140,2,138,0,39,30,7,2,1,0,13,5,41
88,450,188,44,144,0,144,0,38,39,9,2,3,0,12,2,39
88,451,1752,365,1387,28,1359,23,337,293,152,37,13,5,105,29,365
88,452,114,24,90,4,86,2,20,21,13,1,1,1,0,0,27
88,453,33,3,30,2,28,0,10,4,1,0,1,0,2,1,9
88,454,215,30,185,1,184,3,45,61,9,1,1,1,11,8,44
88,455,108,15,93,1,92,0,23,27,10,1,1,2,13,3,12
88,456,96,20,76,3,73,1,18,22,6,1,1,0,4,0,20
88,457,119,17,102,1,101,5,30,28,7,0,3,0,8,3,17
88,458,194,20,174,5,169,0,34,36,10,6,4,0,20,6,53
88,459,55,6,49,0,49,1,9,23,2,0,0,0,3,1,10
88,460,471,87,384,10,374,6,89,121,26,7,2,3,38,10,72
88,461,171,34,137,3,134,2,43,40,7,1,0,1,12,3,25
88,462,1562,233,1329,46,1283,26,294,308,122,28,16,2,161,35,291
88,463,1385,327,1058,18,1040,39,288,224,88,11,4,2,94,30,260
88,464,410,49,361,10,351,10,99,93,25,2,1,1,37,7,76
88,465,5835,1344,4491,96,4395,66,1207,941,453,61,36,8,327,108,1188
88,466,144,28,116,4,112,3,34,27,7,1,1,0,12,0,27
88,467,512,100,412,10,402,7,114,88,50,9,3,1,33,9,88
88,468,2500,543,1957,46,1911,32,515,443,185,35,15,8,176,42,460
88,469,80,10,70,0,70,1,18,14,9,1,1,0,8,4,14
88,470,1253,177,1076,20,1056,22,209,250,115,18,9,3,140,27,263
88,471,125,32,93,0,93,2,25,19,13,0,2,0,9,5,18
88,472,122,17,105,2,103,2,27,18,10,2,0,0,11,4,29
88,473,105,12,93,6,87,1,15,24,6,4,1,0,12,5,19
88,474,50,4,46,0,46,0,8,16,2,0,1,0,17,1,1
88,475,94,20,74,4,70,2,15,16,3,1,1,0,20,4,8
88,476,96,12,84,1,83,2,17,10,10,3,1,0,5,1,34
88,477,99,17,82,1,81,3,18,30,4,2,0,0,11,2,11
88,478,56,5,51,1,50,2,17,11,5,0,2,0,3,0,10
88,479,186,36,150,1,149,4,45,42,17,0,1,0,5,6,29
88,480,173,38,135,4,131,4,28,32,11,0,1,1,14,3,37
88,481,1069,147,922,21,901,19,280,189,73,15,5,5,85,17,213
88,482,53,8,45,1,44,1,11,15,3,1,0,0,7,1,5
88,483,1769,244,1525,22,1503,27,386,333,138,31,11,4,158,39,376
88,484,929,167,762,17,745,18,195,185,68,16,11,6,69,24,153
88,485,109,12,97,5,92,1,15,21,9,2,3,2,5,2,32
88,486,3186,502,2684,61,2623,43,578,657,265,51,18,3,283,96,629
88,487,3469,647,2822,87,2735,45,669,861,231,54,31,6,260,64,514
88,488,203,26,177,3,174,1,31,58,13,2,1,0,21,2,45
88,489,224,33,191,2,189,1,32,40,20,4,2,0,16,5,69
88,490,142,23,119,3,116,2,44,22,10,3,3,0,6,7,19
88,491,79,10,69,6,63,1,22,14,3,0,0,0,8,4,11
88,492,106,21,85,2,83,7,11,42,9,1,0,0,7,0,6
88,493,22,0,22,0,22,0,2,10,0,0,0,5,2,0,3
88,494,101,20,81,1,80,1,17,20,9,1,0,0,7,3,22
88,495,149,15,134,1,133,2,28,40,15,5,0,0,17,2,24
88,496,115,8,107,1,106,2,15,44,6,4,0,0,9,4,22
88,497,385,52,333,6,327,2,96,87,18,4,2,1,31,6,80
88,498,821,112,709,19,690,17,174,169,64,14,2,2,89,24,135
88,499,130,17,113,3,110,1,17,29,15,1,2,0,16,2,27
88,500,764,106,658,26,632,13,148,171,75,14,4,4,56,14,133
88,501,77,20,57,1,56,0,14,23,3,0,2,0,9,1,4
88,502,123,8,115,6,109,1,24,27,15,1,0,0,9,2,30
88,503,141,22,119,1,118,0,31,39,14,3,1,0,6,2,22
88,504,150,33,117,4,113,4,31,34,4,1,0,1,10,3,25
88,505,105,8,97,1,96,1,39,22,5,0,1,0,7,1,20
88,506,277,31,246,8,238,4,72,56,23,4,2,0,17,4,56
88,507,195,21,174,3,171,3,29,48,19,3,3,2,24,0,40
88,508,364,53,311,6,305,1,82,75,36,0,4,0,37,8,62
88,509,98,13,85,1,84,0,27,21,7,2,2,0,11,2,12
88,510,166,30,136,2,134,0,41,33,15,0,2,0,9,2,32
88,511,82,20,62,1,61,1,16,9,4,0,2,0,5,2,22
88,512,175,15,160,1,159,4,51,38,20,2,4,2,16,3,19
88,513,1670,279,1391,26,1365,10,394,233,168,13,6,5,115,37,384
88,514,127,22,105,1,104,3,15,41,5,0,3,0,12,5,20
88,515,148,25,123,3,120,7,29,35,8,0,1,1,9,3,27
88,516,4422,934,3488,53,3435,51,656,1073,321,54,22,12,346,60,840
88,517,140,14,126,4,122,1,25,32,14,1,3,1,10,4,31
88,518,24,2,22,0,22,1,5,10,0,1,0,0,2,0,3
88,519,523,72,451,6,445,10,114,125,27,5,7,0,43,11,103
88,520,233,38,195,2,193,5,66,39,8,6,2,0,27,1,39
88,521,247,41,206,3,203,5,56,54,22,1,2,1,7,2,53
88,522,52,4,48,2,46,0,11,17,9,0,0,0,2,0,7
88,523,134,20,114,3,111,3,32,18,13,1,0,2,11,4,27
88,524,263,42,221,3,218,5,75,52,6,5,4,0,29,3,39
88,525,106,14,92,0,92,1,23,25,6,1,2,0,9,0,25
88,526,325,60,265,3,262,3,97,57,14,4,6,0,14,9,58
88,527,125,31,94,0,94,1,32,30,9,4,0,0,7,1,10
88,528,137,19,118,4,114,1,33,32,9,0,0,1,13,2,23
88,529,75,7,68,2,66,1,11,28,9,0,0,0,8,0,9
88,530,2081,396,1685,35,1650,21,459,455,164,20,13,6,160,49,303
88,531,1376,229,1147,30,1117,22,207,322,135,23,9,6,139,22,232
88,532,83,9,74,2,72,1,15,26,6,0,1,1,8,3,11
89,1,338,45,293,4,289,11,72,62,42,7,3,0,16,0,76
89,2,67,2,65,2,63,2,15,22,4,0,0,0,4,4,12
89,3,1100,237,863,13,850,12,179,286,68,10,6,1,71,16,201
89,4,210,29,181,2,179,7,37,44,24,1,1,0,11,7,47
89,5,721,149,572,8,564,9,132,128,85,4,4,2,47,19,134
89,6,169,36,133,0,133,5,39,27,16,0,1,1,9,5,30
89,7,393,66,327,5,322,3,62,61,53,5,4,3,28,11,92
89,8,141,31,110,2,108,1,24,32,4,4,0,0,11,2,30
89,9,266,31,235,5,230,6,54,62,25,0,0,0,33,3,47
89,10,230,42,188,1,187,4,38,85,9,2,2,0,16,3,28
89,11,109,11,98,3,95,0,19,48,7,0,0,1,3,1,16
89,12,103,16,87,1,86,0,20,29,5,2,1,2,5,0,22
89,13,2405,385,2020,39,1981,22,478,583,186,21,12,2,158,42,477
89,14,452,70,382,4,378,4,130,87,32,9,1,0,25,6,84
89,15,389,74,315,5,310,12,61,74,48,4,0,1,30,6,74
89,16,85,22,63,0,63,0,21,13,10,1,0,1,1,0,16
89,17,211,43,168,0,168,0,35,67,20,1,2,1,6,3,33
89,18,530,91,439,7,432,14,119,134,33,3,1,0,33,7,88
89,19,159,29,130,1,129,1,26,46,13,1,0,1,8,4,29
89,20,139,21,118,6,112,3,25,20,25,1,0,0,12,1,25
89,21,276,30,246,4,242,4,24,59,55,2,1,0,31,2,64
89,22,116,14,102,1,101,0,20,28,11,4,1,0,13,4,20
89,23,822,134,688,16,672,18,130,178,67,9,6,3,70,19,172
89,24,22070,5221,16849,300,16549,393,2855,4306,1781,145,112,28,1422,320,5187
89,25,4956,1237,3719,72,3647,42,739,899,350,47,20,9,325,58,1158
89,27,169,18,151,1,150,2,36,50,17,2,1,0,5,3,34
89,28,63,8,55,4,51,1,21,10,6,1,0,0,3,0,9
89,29,559,98,461,7,454,5,111,123,45,7,6,0,45,6,106
89,30,330,74,256,7,249,7,67,68,29,3,0,0,19,2,54
89,31,455,88,367,8,359,6,98,81,34,4,3,1,40,4,88
89,32,85,12,73,0,73,1,15,28,5,0,0,1,10,0,13
89,33,273,35,238,4,234,2,34,71,36,4,0,1,32,8,46
89,34,347,48,299,4,295,4,87,99,11,2,2,0,27,8,55
89,35,338,51,287,3,284,8,67,63,24,6,4,1,36,8,67
89,36,207,24,183,3,180,3,63,39,15,1,2,0,14,2,41
89,37,415,68,347,11,336,11,103,88,38,4,2,0,37,11,42
89,38,89,12,77,0,77,0,24,20,10,0,0,0,3,3,17
89,39,72,10,62,1,61,0,12,22,4,1,0,0,5,2,15
89,40,167,18,149,3,146,1,31,55,7,0,1,1,8,0,42
89,41,259,37,222,3,219,3,77,55,16,2,0,0,27,11,28
89,42,192,50,142,0,142,3,32,44,13,1,0,0,12,2,35
89,43,95,6,89,0,89,0,24,22,13,0,0,0,6,3,21
89,44,114,31,83,4,79,4,19,22,7,4,0,1,12,2,8
89,45,239,31,208,4,204,2,43,68,21,2,1,0,21,5,41
89,46,1119,197,922,22,900,11,221,275,79,8,5,1,78,22,200
89,48,243,47,196,3,193,3,58,70,14,1,0,0,7,6,34
89,49,30,4,26,0,26,1,2,1,10,0,0,1,0,0,11
89,50,659,111,548,12,536,9,152,118,54,6,3,0,34,7,153
89,51,407,66,341,1,340,5,106,100,26,5,3,3,32,9,51
89,53,347,70,277,5,272,3,69,73,21,4,1,3,25,6,67
89,54,564,99,465,6,459,6,136,137,38,3,6,3,31,5,94
89,55,1968,480,1488,21,1467,17,517,288,147,32,14,3,91,31,327
89,56,465,55,410,4,406,10,101,128,35,8,3,1,35,6,79
89,57,249,29,220,4,216,5,50,54,36,3,0,0,23,4,41
89,58,126,17,109,0,109,0,27,21,10,2,0,0,13,0,36
89,59,607,93,514,4,510,6,152,131,52,2,2,1,40,13,111
89,60,281,63,218,4,214,9,42,96,14,3,0,0,19,4,27
89,61,226,32,194,1,193,5,58,73,14,5,0,0,9,4,25
89,62,248,38,210,7,203,8,55,46,22,1,0,0,14,2,55
89,63,561,100,461,8,453,10,115,129,44,4,5,0,53,14,79
89,64,37,5,32,1,31,3,6,6,2,0,1,0,4,1,8
89,65,44,8,36,0,36,0,12,12,0,0,0,0,6,1,5
89,66,723,114,609,9,600,12,161,190,43,8,10,0,57,17,102
89,67,892,185,707,17,690,15,226,173,47,8,6,0,60,20,135
89,68,1575,280,1295,31,1264,19,260,431,83,16,15,4,124,34,278
89,69,415,88,327,6,321,4,93,96,24,7,3,2,15,7,70
89,70,52,8,44,0,44,0,14,10,5,0,2,0,8,0,5
89,71,97,15,82,5,77,1,23,21,9,2,0,1,10,0,10
89,72,230,50,180,1,179,1,45,73,9,2,3,0,16,3,27
89,73,851,142,709,11,698,8,193,237,47,5,4,0,45,22,137
89,74,1602,312,1290,31,1259,16,363,297,132,21,6,3,88,25,308
89,75,531,65,466,8,458,7,144,107,53,7,3,0,34,10,93
89,76,597,90,507,13,494,5,143,173,30,5,5,3,32,10,88
89,77,1144,181,963,16,947,16,216,291,86,7,8,3,95,22,203
89,78,494,67,427,8,419,3,120,124,45,4,1,2,33,9,78
89,79,566,95,471,10,461,6,131,137,39,10,3,3,30,10,92
89,80,441,59,382,7,375,8,78,131,34,9,4,1,32,4,74
89,81,90,11,79,1,78,2,11,32,4,2,0,1,4,0,22
89,83,1352,159,1193,16,1177,26,252,333,100,17,6,3,120,26,294
89,84,226,33,193,3,190,4,40,55,26,5,0,0,22,0,38
89,85,892,156,736,11,725,12,206,143,100,13,3,3,50,15,180
89,86,1270,263,1007,17,990,6,282,359,54,9,7,1,87,15,170
89,87,241,39,202,6,196,7,22,69,28,3,2,0,16,7,42
89,88,351,55,296,5,291,9,75,96,22,2,0,0,24,10,53
89,89,141,17,124,1,123,0,37,24,8,2,1,0,18,3,30
89,91,484,69,415,10,405,1,88,135,39,3,3,0,30,2,104
89,92,211,41,170,6,164,3,22,67,11,2,3,0,15,0,41
89,93,426,64,362,6,356,11,108,81,45,7,3,1,23,8,69
89,94,456,90,366,2,364,5,103,141,36,2,1,1,24,6,45
89,95,131,23,108,3,105,0,22,53,1,1,1,0,5,5,17
89,96,659,81,578,6,572,3,160,140,34,6,5,4,47,10,163
89,97,119,19,100,0,100,1,21,43,6,4,1,0,9,1,14
89,98,152,20,132,1,131,1,29,35,16,2,3,1,8,1,35
89,99,1720,433,1287,18,1269,18,359,241,157,18,14,0,104,33,325
89,100,1120,227,893,30,863,11,257,262,67,12,4,2,51,19,178
89,101,347,46,301,8,293,3,92,76,24,7,2,1,24,8,56
89,102,1642,214,1428,30,1398,37,279,345,148,14,6,2,170,24,373
89,103,259,55,204,3,201,4,46,60,15,3,1,1,17,3,51
89,104,269,40,229,4,225,1,83,62,8,3,4,0,19,6,39
89,105,325,43,282,4,278,4,53,59,25,3,2,4,31,13,84
89,107,223,28,195,6,189,2,55,50,15,0,2,0,21,13,31
89,108,259,40,219,6,213,3,44,85,15,1,4,2,27,4,28
89,109,48,8,40,0,40,0,8,14,4,0,0,0,11,1,2
89,111,226,30,196,8,188,1,53,54,14,2,4,0,20,0,40
89,112,150,30,120,1,119,1,36,33,8,6,0,0,7,5,23
89,113,447,80,367,7,360,10,92,119,37,9,1,0,35,3,54
89,115,124,31,93,1,92,3,41,25,7,0,1,0,2,1,12
89,116,266,24,242,3,239,7,68,53,28,3,1,2,20,4,53
89,117,124,12,112,1,111,5,21,44,8,3,0,2,11,2,15
89,118,544,82,462,3,459,15,92,111,75,9,2,1,30,10,114
89,119,367,57,310,3,307,6,78,100,26,2,2,1,25,6,61
89,120,139,34,105,0,105,1,36,40,5,0,0,0,12,2,9
89,122,412,65,347,3,344,3,113,103,27,3,1,0,15,10,69
89,123,194,29,165,1,164,2,23,73,8,0,0,1,26,3,28
89,124,879,144,735,5,730,8,230,198,81,4,8,1,41,22,137
89,125,579,87,492,15,477,9,117,104,60,11,3,0,46,12,115
89,126,45,2,43,1,42,1,2,25,2,1,0,0,4,3,4
89,127,482,71,411,7,404,5,109,129,38,3,2,0,34,9,75
89,128,91,21,70,1,69,3,15,15,8,0,0,0,8,5,15
89,129,341,56,285,4,281,3,67,67,29,5,2,2,16,5,85
89,130,555,86,469,7,462,10,88,109,62,5,3,2,34,12,137
89,131,215,28,187,2,185,3,51,66,15,0,1,0,11,8,30
89,132,146,21,125,0,125,0,22,47,13,3,2,0,3,2,33
89,133,261,58,203,3,200,3,57,63,12,5,2,0,14,7,37
89,134,263,40,223,2,221,2,48,66,18,5,0,0,30,6,46
89,136,543,83,460,4,456,4,128,128,45,6,1,1,35,20,88
89,137,335,39,296,4,292,9,60,56,40,11,4,1,26,4,81
89,138,263,32,231,2,229,6,56,87,22,1,1,0,14,6,36
89,139,867,152,715,11,704,15,199,192,69,11,9,0,60,15,134
89,141,106,10,96,1,95,0,19,21,20,3,0,1,10,2,19
89,142,727,127,600,11,589,11,163,173,51,7,2,2,60,11,109
89,143,247,30,217,8,209,7,59,59,20,4,2,0,9,3,46
89,144,589,85,504,3,501,9,139,183,29,8,2,0,32,7,92
89,145,361,40,321,12,309,3,57,87,35,7,1,0,26,7,86
89,146,78,11,67,2,65,2,16,12,7,2,2,1,4,0,19
89,147,213,31,182,7,175,3,47,64,17,0,1,1,5,3,34
89,148,265,48,217,5,212,9,51,61,18,1,1,1,28,2,40
89,149,162,24,138,6,132,1,35,32,9,4,2,0,15,5,29
89,150,304,58,246,7,239,4,60,60,31,4,2,0,24,8,46
89,151,905,131,774,15,759,14,221,225,73,11,6,0,53,29,127
89,152,502,101,401,7,394,3,123,86,48,4,2,0,34,9,85
89,153,515,89,426,11,415,14,69,116,64,7,6,0,27,8,104
89,154,672,94,578,13,565,4,158,127,48,12,2,1,47,16,150
89,155,578,90,488,5,483,13,102,118,45,5,6,3,55,12,124
89,156,280,41,239,4,235,2,94,51,26,4,5,0,10,7,36
89,158,507,116,391,7,384,6,107,107,22,4,2,0,42,8,86
89,159,358,39,319,3,316,0,56,103,45,5,3,1,31,5,67
89,160,515,83,432,12,420,14,124,94,40,7,0,0,25,15,101
89,161,185,27,158,2,156,7,26,30,33,2,0,0,16,5,37
89,162,277,35,242,8,234,2,80,64,19,1,2,0,21,4,41
89,163,456,81,375,2,373,6,81,139,28,3,4,2,31,8,71
89,164,89,14,75,2,73,1,16,24,4,0,0,0,9,1,18
89,165,89,17,72,1,71,0,22,27,7,1,0,0,4,2,8
89,167,832,133,699,21,678,13,141,144,89,8,6,3,55,21,198
89,168,128,20,108,1,107,1,34,25,8,1,0,1,13,3,21
89,169,811,186,625,11,614,10,157,139,67,12,9,2,43,15,160
89,170,132,29,103,1,102,0,19,32,8,2,1,0,11,0,29
89,171,211,44,167,2,165,1,49,45,21,3,2,0,13,6,25
89,172,386,51,335,10,325,4,69,110,24,3,0,0,28,10,77
89,173,398,91,307,7,300,9,90,73,46,3,2,0,20,6,51
89,174,79,16,63,1,62,0,20,9,6,1,0,0,8,3,15
89,175,117,17,100,0,100,3,24,49,7,0,0,0,3,2,12
89,176,126,28,98,0,98,0,25,17,19,2,2,1,5,3,24
89,177,66,19,47,0,47,1,10,14,3,0,0,0,3,2,14
89,178,198,45,153,2,151,2,36,59,10,0,0,0,23,4,17
89,179,279,49,230,3,227,2,61,70,18,5,1,0,17,5,48
89,180,355,48,307,9,298,6,71,89,19,7,4,1,26,10,65
89,181,117,19,98,1,97,2,25,32,7,2,0,0,6,3,20
89,182,123,25,98,1,97,2,17,29,14,3,1,0,10,0,21
89,183,65,5,60,2,58,1,8,28,4,3,1,0,4,3,6
89,184,110,16,94,1,93,0,15,16,29,2,0,0,6,0,25
89,186,461,72,389,18,371,1,86,119,34,12,2,0,26,5,86
89,187,94,8,86,3,83,0,17,33,12,0,1,0,6,1,13
89,188,156,26,130,3,127,3,24,22,16,5,1,0,14,6,36
89,189,455,91,364,5,359,4,96,93,46,4,4,1,44,10,57
89,190,146,19,127,3,124,6,39,37,8,0,2,0,12,1,19
89,191,55,8,47,0,47,3,9,13,1,1,0,0,5,1,14
89,192,353,78,275,3,272,6,84,71,28,5,1,1,15,13,48
89,194,107,13,94,2,92,1,23,37,4,1,0,0,2,3,21
89,195,894,151,743,22,721,18,172,149,108,6,4,1,72,17,174
89,196,467,85,382,8,374,9,101,91,51,2,3,3,33,13,68
89,197,345,71,274,2,272,4,55,96,25,2,0,1,32,2,55
89,198,1298,245,1053,17,1036,14,243,260,116,9,3,2,91,22,276
89,199,355,48,307,4,303,7,89,55,37,14,2,1,30,9,59
89,200,311,36,275,5,270,4,76,72,21,2,2,2,22,13,56
89,201,1453,249,1204,24,1180,22,294,289,105,27,6,4,108,34,291
89,202,250,47,203,6,197,6,22,49,40,2,0,1,18,1,58
89,203,154,13,141,0,141,4,26,39,20,2,1,0,14,2,33
89,204,481,98,383,7,376,4,86,128,39,4,2,1,22,7,83
89,205,328,64,264,3,261,0,84,60,18,7,5,0,16,3,68
89,206,6205,1746,4459,77,4382,82,943,1254,443,47,24,9,326,59,1195
89,207,31,5,26,0,26,3,5,7,1,1,0,0,6,1,2
89,208,481,79,402,4,398,7,91,134,40,12,2,2,33,12,65
89,209,343,65,278,5,273,1,91,92,23,7,0,0,20,4,35
89,210,119,17,102,4,98,1,12,42,7,0,3,0,11,3,19
89,211,92,15,77,1,76,0,10,15,11,0,2,0,7,2,29
89,212,360,53,307,5,302,9,72,74,36,8,1,1,28,5,68
89,213,236,30,206,3,203,8,56,48,21,3,2,0,15,7,43
89,214,154,34,120,3,117,1,22,48,9,1,0,0,4,2,30
89,215,153,17,136,2,134,1,32,37,14,3,0,0,17,7,23
89,216,247,58,189,2,187,3,61,54,18,2,0,1,17,4,27
89,217,95,8,87,4,83,2,14,46,5,0,0,0,5,3,8
89,218,941,153,788,17,771,15,195,163,110,12,8,2,52,25,189
89,219,116,21,95,4,91,2,27,33,3,0,0,0,13,4,9
89,220,321,46,275,1,274,3,62,90,16,0,0,1,22,8,72
89,221,296,56,240,1,239,6,79,73,18,1,0,1,8,6,47
89,222,209,33,176,1,175,5,63,38,7,3,2,2,14,1,40
89,223,571,63,508,10,498,1,116,132,66,7,1,0,35,11,129
89,224,134,22,112,2,110,3,20,26,12,3,1,1,9,2,33
89,225,64,10,54,1,53,5,9,13,6,1,0,0,9,5,5
89,226,155,22,133,0,133,1,28,55,10,1,1,0,13,0,24
89,227,885,151,734,15,719,6,184,191,77,9,5,1,56,13,177
89,228,931,145,786,17,769,18,148,227,104,8,4,1,61,20,178
89,229,323,42,281,3,278,7,79,67,18,3,3,0,25,16,60
89,230,346,54,292,5,287,3,65,96,21,1,0,0,19,15,67
89,232,272,43,229,5,224,5,62,59,21,1,3,0,22,4,47
89,233,176,20,156,2,154,6,22,22,25,3,2,2,21,2,49
89,234,110,19,91,1,90,5,19,24,14,0,1,0,2,2,23
89,235,698,113,585,15,570,6,125,182,42,4,5,3,65,16,122
89,236,851,115,736,17,719,14,142,223,65,10,6,2,75,18,164
89,237,411,96,315,5,310,15,64,82,35,5,4,0,25,6,74
89,238,404,70,334,6,328,9,54,67,41,5,1,0,31,11,109
89,239,1246,226,1020,14,1006,17,289,271,98,9,8,2,80,27,205
89,240,263,51,212,2,210,1,61,61,12,6,5,0,15,7,42
89,241,157,28,129,0,129,2,34,40,6,0,0,1,17,6,23
89,242,529,78,451,3,448,11,117,135,28,4,2,2,38,11,100
89,243,117,21,96,2,94,2,13,33,11,0,0,0,8,3,24
89,244,80,8,72,1,71,0,16,11,14,3,0,0,4,2,21
89,245,540,75,465,13,452,6,116,126,32,4,1,1,50,12,104
89,246,321,60,261,9,252,2,45,81,21,2,1,1,22,3,74
89,247,254,67,187,2,185,0,40,64,22,0,2,0,14,5,38
89,248,55,8,47,1,46,1,15,9,1,1,0,0,10,0,9
89,249,73,17,56,2,54,0,22,16,1,0,1,0,3,2,9
89,250,146,44,102,2,100,2,25,25,4,2,1,0,13,1,27
89,251,365,70,295,2,293,10,61,52,53,5,0,0,31,2,79
89,252,146,18,128,1,127,0,50,30,5,1,1,0,18,2,20
89,253,178,32,146,1,145,6,27,33,20,5,0,1,16,6,31
89,254,444,62,382,4,378,4,92,144,27,3,2,1,26,10,69
89,255,822,141,681,8,673,5,202,176,73,6,4,2,39,13,153
89,256,319,34,285,7,278,6,64,79,35,5,3,1,26,7,52
89,257,4553,1125,3428,60,3368,46,823,608,562,34,18,11,202,57,1007
89,259,103,14,89,1,88,1,15,26,9,2,0,0,5,2,28
89,260,144,17,127,1,126,0,27,25,41,1,2,0,8,6,16
89,261,200,30,170,3,167,3,51,64,9,1,2,2,13,6,16
89,262,173,31,142,4,138,8,34,38,10,1,1,0,12,1,33
89,263,2937,444,2493,57,2436,35,527,696,188,34,15,4,229,51,657
89,264,551,75,476,9,467,8,111,175,29,8,1,1,28,14,92
89,265,457,79,378,10,368,10,91,92,25,5,1,3,56,5,80
89,266,271,45,226,1,225,2,49,55,21,6,2,3,18,16,53
89,267,147,29,118,2,116,3,23,22,20,2,0,0,11,1,34
89,268,673,133,540,9,531,7,138,163,47,6,3,3,41,8,115
89,270,89,13,76,2,74,3,13,25,1,0,1,0,8,2,21
89,271,99,20,79,1,78,1,12,36,8,0,0,0,10,1,10
89,272,241,39,202,5,197,2,53,43,37,4,0,0,15,10,33
89,273,267,39,228,2,226,3,48,77,22,2,1,1,19,3,50
89,274,978,184,794,13,781,14,178,207,67,15,2,2,72,16,208
89,275,319,69,250,8,242,7,82,50,25,3,3,1,29,2,40
89,276,693,128,565,7,558,3,189,147,53,5,2,1,50,11,97
89,277,265,54,211,3,208,3,59,65,19,2,0,0,20,4,36
89,278,337,52,285,5,280,6,94,60,29,3,3,1,21,5,58
89,279,480,69,411,8,403,6,65,135,49,7,2,1,43,10,85
89,280,314,60,254,8,246,3,69,40,31,4,1,2,17,8,71
89,281,239,45,194,5,189,7,40,64,26,2,0,0,20,4,26
89,282,540,76,464,7,457,1,118,113,51,6,6,1,48,7,106
89,283,522,116,406,9,397,6,80,139,41,5,0,1,24,14,87
89,284,180,25,155,4,151,2,48,44,20,2,1,0,7,4,23
89,285,176,31,145,2,143,2,36,45,15,3,1,3,16,1,21
89,286,607,109,498,8,490,11,114,111,58,8,1,3,50,13,121
89,287,3294,762,2532,51,2481,30,519,660,273,29,17,3,227,49,674
89,288,150,14,136,0,136,0,47,31,14,3,0,0,12,3,26
89,289,222,31,191,1,190,1,56,46,23,1,0,0,12,13,38
89,290,43,6,37,0,37,1,12,8,4,0,0,0,4,0,8
89,291,250,35,215,1,214,7,52,51,24,1,2,0,9,7,61
89,292,183,43,140,2,138,2,50,46,14,2,0,1,7,1,15
89,294,267,41,226,4,222,5,57,65,27,7,4,1,12,2,42
89,295,958,132,826,16,810,4,173,241,66,8,6,4,89,25,194
89,296,111,16,95,1,94,4,9,19,23,0,0,0,3,1,35
89,297,95,15,80,1,79,1,16,28,6,4,0,0,6,2,16
89,298,446,90,356,10,346,4,95,117,22,6,0,2,40,11,49
89,299,48,2,46,2,44,0,11,11,6,1,0,0,1,1,13
89,300,74,13,61,2,59,0,16,16,3,0,1,0,8,2,13
89,302,179,26,153,4,149,5,40,43,11,1,0,1,9,3,36
89,303,245,36,209,3,206,0,47,81,15,4,1,0,17,4,37
89,304,502,63,439,8,431,12,86,110,57,2,0,0,47,4,113
89,306,290,29,261,2,259,3,54,69,23,3,3,4,16,7,77
89,307,576,120,456,9,447,9,120,102,42,8,3,2,37,9,115
89,308,157,25,132,4,128,1,38,33,21,1,1,0,12,2,19
89,309,2230,439,1791,35,1756,23,456,425,215,18,20,4,117,48,430
89,310,124,12,112,1,111,2,31,38,10,1,1,0,5,2,21
89,311,1057,156,901,21,880,27,199,225,117,12,3,1,85,13,198
89,312,185,28,157,2,155,3,28,42,15,2,0,0,25,1,39
89,313,408,87,321,4,317,10,96,94,24,3,1,1,34,7,47
89,314,150,9,141,1,140,3,37,35,11,8,1,0,6,3,36
89,315,131,24,107,1,106,1,23,30,14,0,0,2,13,2,21
89,316,194,42,152,1,151,2,38,50,14,1,0,0,8,3,35
89,317,228,46,182,3,179,1,63,44,17,1,1,1,21,3,27
89,318,610,124,486,11,475,9,76,154,52,4,2,2,43,12,121
89,319,388,53,335,6,329,13,79,73,32,4,4,2,34,4,84
89,320,65,10,55,1,54,0,5,26,6,1,1,0,5,2,8
89,321,594,95,499,8,491,7,92,137,53,2,6,1,41,4,148
89,323,133,48,85,1,84,0,33,22,6,0,1,0,7,1,14
89,324,595,99,496,4,492,3,103,182,42,8,2,3,50,18,81
89,325,76,13,63,0,63,0,15,25,6,2,0,0,3,1,11
89,326,740,121,619,5,614,4,155,177,37,6,4,0,75,15,141
89,327,285,36,249,3,246,1,56,70,26,6,0,2,29,13,43
89,328,330,39,291,4,287,6,69,80,28,5,2,1,28,13,55
89,329,90,10,80,3,77,1,24,25,4,0,0,0,9,1,13
89,330,157,23,134,4,130,5,29,22,21,3,0,2,22,2,24
89,331,302,70,232,5,227,8,31,68,27,3,2,0,31,11,46
89,332,618,92,526,11,515,8,166,106,46,4,8,1,27,20,129
89,333,156,30,126,1,125,1,25,45,13,1,1,0,19,1,19
89,334,398,67,331,3,328,11,69,107,28,4,1,3,36,7,62
89,335,290,46,244,4,240,5,76,61,20,2,3,0,19,6,48
89,336,265,38,227,5,222,2,70,40,17,0,3,0,19,3,68
89,337,854,161,693,15,678,14,156,231,39,3,11,6,75,20,123
89,338,2011,421,1590,27,1563,23,332,437,142,14,9,3,167,26,410
89,339,133,20,113,3,110,5,20,26,16,1,0,0,12,3,27
89,340,175,20,155,6,149,3,30,41,15,3,0,1,15,4,37
89,341,300,58,242,5,237,4,69,79,20,1,2,1,17,6,38
89,342,455,85,370,8,362,4,87,111,30,5,0,1,32,11,81
89,343,132,26,106,4,102,2,26,31,7,3,0,0,8,0,25
89,344,1178,177,1001,20,981,16,210,337,72,17,13,0,69,25,222
89,345,2863,719,2144,25,2119,17,445,532,193,18,10,7,124,42,731
89,346,2564,310,2254,31,2223,48,306,821,148,17,9,6,229,45,594
89,347,326,53,273,5,268,4,43,119,20,1,1,0,23,10,47
89,348,1614,316,1298,22,1276,31,346,331,132,14,14,1,78,28,301
89,349,334,47,287,2,285,15,48,75,25,1,0,1,36,19,65
89,350,218,46,172,1,171,3,62,36,18,1,0,1,14,4,32
89,351,340,43,297,3,294,1,86,68,21,6,2,0,28,1,81
89,352,242,34,208,8,200,5,69,42,10,6,1,0,14,4,49
89,353,297,55,242,6,236,0,74,70,14,5,1,1,30,8,33
89,354,1141,193,948,18,930,14,229,219,103,15,5,2,67,20,256
89,355,118,14,104,0,104,2,33,25,5,1,1,1,8,1,27
89,356,43,7,36,1,35,1,7,6,6,0,0,0,2,0,13
89,358,334,60,274,5,269,5,69,91,23,3,0,2,20,10,46
89,359,333,55,278,1,277,4,74,94,15,5,1,1,19,9,55
89,360,253,40,213,6,207,7,36,63,25,2,1,0,19,5,49
89,361,184,35,149,2,147,3,36,37,10,2,0,0,14,5,40
89,362,147,33,114,2,112,1,29,35,14,0,0,0,8,4,21
89,363,98,15,83,1,82,1,21,27,5,0,0,0,6,1,21
89,364,315,40,275,8,267,9,42,33,48,5,1,0,19,8,102
89,365,418,56,362,5,357,10,97,102,30,8,0,2,35,11,62
89,366,157,27,130,1,129,3,31,45,14,2,1,0,8,7,18
89,367,485,64,421,9,412,10,86,79,68,4,7,0,40,5,113
89,368,711,136,575,9,566,17,139,139,51,11,2,4,57,13,133
89,369,365,58,307,4,303,7,94,80,30,2,2,0,17,9,62
89,370,1023,172,851,17,834,18,173,260,89,16,3,1,63,16,195
89,371,88,16,72,1,71,2,20,25,6,1,1,0,4,2,10
89,373,505,82,423,9,414,10,117,133,33,5,0,1,33,10,72
89,374,72,13,59,2,57,1,4,24,11,0,1,0,7,2,7
89,375,86,10,76,2,74,0,13,18,6,0,2,0,5,2,28
89,376,141,22,119,1,118,0,33,37,8,0,0,0,6,8,26
89,377,63,14,49,1,48,1,23,13,3,0,0,0,0,3,5
89,378,562,80,482,9,473,12,107,117,40,8,4,1,40,4,140
89,379,129,24,105,2,103,0,10,38,9,0,0,0,14,1,31
89,380,360,38,322,0,322,4,74,154,11,4,0,0,23,6,46
89,381,115,13,102,2,100,2,28,27,5,0,1,0,18,2,17
89,382,1165,204,961,13,948,16,241,214,86,20,11,1,79,30,250
89,383,107,13,94,1,93,5,12,31,7,4,1,0,4,0,29
89,384,595,108,487,9,478,9,137,121,43,10,7,1,46,16,88
89,385,96,22,74,1,73,2,11,16,15,0,4,0,10,1,14
89,386,77,11,66,1,65,1,15,16,7,0,0,0,8,2,16
89,387,16058,4816,11242,211,11031,223,2065,3212,1155,137,73,35,900,185,3046
89,388,322,45,277,4,273,6,75,77,29,5,3,0,23,9,46
89,390,368,48,320,3,317,6,85,84,36,7,3,2,26,7,61
89,391,892,138,754,13,741,11,211,204,71,20,8,0,62,16,138
89,392,214,22,192,3,189,2,57,49,23,1,0,0,13,2,42
89,393,101,27,74,2,72,1,14,31,10,0,1,0,0,2,13
89,394,89,14,75,1,74,3,28,13,7,0,1,0,2,2,18
89,395,348,76,272,7,265,4,76,78,12,6,1,0,25,4,59
89,397,291,58,233,0,233,9,68,65,12,4,3,0,17,2,53
89,398,335,64,271,6,265,3,92,85,21,2,3,0,18,5,36
89,399,1252,236,1016,19,997,8,239,306,91,15,6,3,86,27,216
89,400,303,48,255,5,250,2,77,68,24,4,0,0,18,2,55
89,402,173,31,142,0,142,0,57,36,9,2,1,0,12,4,21
89,403,100,17,83,3,80,5,16,17,10,1,1,0,8,0,22
89,404,371,63,308,5,303,8,79,71,19,2,5,1,30,4,84
89,405,255,33,222,7,215,5,47,59,26,0,1,0,16,2,59
89,406,67,12,55,0,55,2,12,15,6,1,0,0,5,2,12
89,407,894,124,770,19,751,12,213,203,72,7,2,4,66,16,156
89,408,258,44,214,4,210,2,51,64,24,0,2,0,22,5,40
89,409,68,5,63,1,62,1,10,18,4,1,0,0,10,1,17
89,410,90,11,79,0,79,0,13,33,5,0,0,0,9,2,17
89,411,415,96,319,8,311,5,107,74,23,7,1,0,23,10,61
89,412,100,14,86,1,85,4,17,22,9,3,2,1,7,0,20
89,413,47,6,41,0,41,1,5,21,3,0,0,0,6,0,5
89,414,1120,176,944,20,924,19,264,266,66,13,8,3,77,29,179
89,415,147,16,131,0,131,1,25,48,2,3,1,0,14,3,34
89,416,428,103,325,6,319,4,67,98,31,6,2,2,30,9,70
89,417,102,17,85,2,83,0,22,29,6,1,1,0,6,5,13
89,418,3070,720,2350,44,2306,32,488,560,324,26,21,4,147,53,651
89,419,1985,363,1622,30,1592,37,355,413,160,15,8,1,171,27,405
89,420,789,153,636,12,624,16,137,166,79,14,8,1,47,12,144
89,421,66,9,57,1,56,2,8,21,6,0,0,1,6,0,12
89,422,40,8,32,1,31,1,6,12,2,0,0,0,2,0,8
89,423,152,23,129,2,127,3,44,36,8,1,3,1,6,0,25
89,424,108,13,95,0,95,1,10,24,18,4,0,1,9,1,27
89,425,541,92,449,7,442,1,102,154,46,6,3,1,36,11,82
89,426,266,33,233,4,229,3,59,40,20,3,7,0,25,11,61
89,427,503,70,433,11,422,5,104,109,34,6,3,0,49,4,108
89,428,418,74,344,8,336,5,80,113,22,4,4,2,24,5,77
89,429,200,21,179,3,176,3,38,62,14,2,1,0,10,4,42
89,430,213,53,160,5,155,5,37,57,11,2,0,0,11,4,28
89,431,69,10,59,1,58,2,18,15,3,0,0,0,6,1,13
89,432,411,69,342,3,339,1,97,71,52,4,4,0,23,13,74
89,433,272,21,251,4,247,5,60,85,15,3,4,0,23,8,44
89,434,238,41,197,5,192,2,73,40,19,2,1,1,12,7,35
89,436,593,95,498,8,490,9,141,119,50,13,4,1,54,8,91
89,437,261,51,210,2,208,3,46,60,25,5,1,1,20,2,45
89,438,1352,222,1130,23,1107,15,253,303,117,17,5,2,102,32,261
89,439,980,158,822,14,808,8,260,202,86,14,9,0,49,17,163
89,440,333,56,277,3,274,2,78,92,28,2,1,0,20,1,50
89,441,891,164,727,8,719,11,163,208,72,6,7,4,58,20,170
89,442,165,25,140,1,139,4,45,26,16,2,2,0,7,2,35
89,443,1490,310,1180,32,1148,19,347,309,101,15,6,4,92,32,223
89,445,47,5,42,0,42,2,12,14,3,1,2,0,0,1,7
89,446,346,62,284,1,283,3,31,93,36,3,2,2,38,4,71
89,447,146,28,118,0,118,2,34,22,21,1,1,1,5,0,31
89,448,90,20,70,2,68,1,25,25,1,1,2,0,3,1,9
89,449,1198,227,971,18,953,12,287,219,101,13,10,3,76,23,209
89,450,509,99,410,11,399,11,82,138,38,8,2,3,31,15,71
89,451,187,18,169,2,167,2,63,43,7,2,1,2,19,3,25
89,452,314,54,260,5,255,10,83,58,27,3,0,1,23,7,43
89,453,717,69,648,12,636,16,116,177,47,8,5,3,71,22,171
89,454,471,95,376,3,373,5,94,129,36,4,3,2,32,7,61
89,456,446,74,372,9,363,10,96,79,42,12,2,2,26,6,88
89,457,215,36,179,0,179,3,23,41,19,6,0,0,25,1,61
89,458,177,20,157,3,154,3,47,42,7,1,2,0,11,4,37
89,459,213,38,175,5,170,1,52,57,19,3,1,2,12,7,16
89,460,1941,299,1642,41,1601,19,412,366,160,22,22,5,123,39,433
89,461,856,206,650,8,642,7,172,171,62,7,4,2,50,16,151
89,462,237,42,195,9,186,6,36,60,18,4,3,1,17,3,38
89,463,203,30,173,5,168,1,47,40,23,5,1,0,15,2,34
89,464,3612,797,2815,49,2766,43,708,775,276,40,11,6,270,51,586
89,465,237,45,192,4,188,3,64,33,22,2,1,0,9,8,46
89,466,249,19,230,3,227,3,53,56,15,4,1,1,24,8,62
89,467,552,92,460,6,454,9,148,109,40,10,3,0,24,16,95
89,468,338,67,271,10,261,1,85,71,20,0,1,2,22,7,52
89,469,748,135,613,14,599,8,166,192,67,5,7,1,36,23,94
89,470,120,15,105,0,105,0,18,31,11,0,1,0,16,1,27
89,471,344,43,301,3,298,6,77,88,40,2,3,2,20,2,58
89,472,362,66,296,8,288,8,87,67,42,0,0,2,19,5,58
89,473,413,57,356,9,347,11,73,104,32,7,8,3,31,11,67
89,474,234,64,170,1,169,0,41,66,16,0,1,0,13,4,28
89,475,91,17,74,1,73,4,18,32,1,2,0,0,9,0,7
89,477,71,10,61,0,61,0,18,14,8,0,0,1,7,3,10
89,478,747,149,598,13,585,9,132,147,60,6,4,1,49,7,170
89,479,278,51,227,5,222,4,47,56,27,4,0,0,28,4,52
89,480,978,152,826,9,817,14,227,217,83,5,2,2,75,17,175
89,481,106,31,75,2,73,1,18,12,7,2,3,0,8,3,19
89,482,128,19,109,2,107,3,25,52,7,0,1,0,6,1,12
89,483,347,48,299,8,291,2,60,102,23,2,3,2,25,9,63
89,484,245,32,213,3,210,5,52,69,24,5,0,0,9,7,39
89,485,163,27,136,2,134,1,36,35,7,5,0,0,8,3,39
89,486,154,26,128,2,126,2,26,43,13,2,0,1,17,1,21
90,1,1001,160,841,12,829,20,213,188,95,11,4,4,77,12,205
90,2,259,32,227,4,223,3,50,47,14,2,2,2,19,4,80
90,3,497,66,431,8,423,4,122,104,58,8,3,4,27,5,88
90,4,314,42,272,5,267,5,80,74,17,5,1,1,31,10,43
90,5,376,51,325,8,317,10,75,76,48,5,0,1,31,4,67
90,6,260,41,219,3,216,17,33,36,53,6,3,0,23,3,42
90,7,234,21,213,5,208,7,37,55,21,2,3,0,23,5,55
90,8,2928,432,2496,44,2452,64,488,515,344,22,15,2,245,46,711
90,9,3763,849,2914,70,2844,29,726,588,351,35,22,9,170,64,850
90,10,26678,6626,20052,408,19644,459,3738,4531,2676,247,143,68,1720,267,5795
90,11,271,24,247,5,242,4,42,72,31,4,4,0,33,5,47
90,12,811,104,707,19,688,25,132,182,60,9,3,3,83,15,176
90,13,177,23,154,4,150,1,63,27,22,2,2,0,4,7,22
90,14,285,41,244,4,240,3,97,45,20,3,1,0,13,1,57
90,15,226,32,194,4,190,5,47,49,20,2,0,0,24,4,39
90,16,109,11,98,5,93,5,19,27,6,0,3,0,5,3,25
90,17,1093,207,886,20,866,8,246,190,122,21,5,1,71,18,184
90,18,264,51,213,6,207,1,42,63,18,1,5,0,26,5,46
90,19,188,28,160,1,159,1,48,50,10,0,1,1,12,4,32
90,20,272,35,237,6,231,6,63,74,23,1,1,0,14,4,45
90,21,239,30,209,3,206,2,54,58,21,3,1,1,23,4,39
90,22,2066,293,1773,37,1736,33,477,421,178,21,14,6,136,35,415
90,23,794,153,641,9,632,12,188,108,74,10,10,2,70,14,144
90,24,135,20,115,3,112,3,45,20,9,1,0,0,6,2,26
90,25,272,57,215,2,213,2,80,36,29,8,2,2,19,2,33
90,26,1121,146,975,18,957,17,192,295,79,9,0,0,108,24,233
90,27,108,19,89,3,86,0,23,24,10,1,1,0,7,2,18
90,28,294,28,266,5,261,1,75,71,22,4,3,0,18,7,60
90,29,1467,280,1187,18,1169,33,252,301,113,10,4,4,118,21,313
90,30,156,25,131,2,129,2,40,41,12,1,0,1,9,0,23
90,31,237,26,211,1,210,9,55,51,18,4,0,1,24,4,44
90,32,2311,429,1882,29,1853,47,450,476,189,14,9,3,145,34,486
90,33,3941,891,3050,71,2979,46,711,598,407,36,21,10,188,41,921
90,34,587,74,513,8,505,8,98,150,64,4,2,1,46,7,125
90,35,475,84,391,10,381,3,96,95,35,6,2,1,32,8,103
90,36,241,36,205,1,204,2,43,74,11,0,0,1,20,5,48
90,37,773,112,661,14,647,12,167,142,62,10,6,0,66,14,168
90,39,2603,573,2030,38,1992,43,352,562,214,20,9,4,219,35,534
90,41,1182,211,971,17,954,11,236,180,139,12,11,2,80,17,266
90,42,1838,252,1586,30,1556,46,275,384,154,19,5,7,209,42,415
90,43,420,88,332,2,330,8,110,84,39,3,1,0,24,12,49
90,44,187,27,160,1,159,9,55,24,14,0,0,0,18,4,35
90,45,557,83,474,12,462,3,136,97,49,8,5,3,42,9,110
90,46,312,57,255,9,246,1,89,63,23,8,0,0,18,2,42
90,47,453,79,374,12,362,8,100,82,34,2,2,3,29,7,95
90,48,107,8,99,2,97,4,29,19,8,1,2,1,11,2,20
90,49,664,111,553,15,538,9,187,110,58,6,1,1,48,11,107
90,50,171,20,151,6,145,2,37,34,17,1,1,0,10,2,41
90,51,357,66,291,1,290,5,71,87,26,3,2,1,30,6,59
90,52,2316,573,1743,51,1692,21,474,335,201,30,18,4,146,29,434
90,53,1946,352,1594,21,1573,18,502,393,130,20,13,5,123,22,347
90,54,408,34,374,11,363,15,72,95,42,5,1,0,45,6,82
90,55,255,35,220,6,214,2,74,50,24,6,0,3,17,1,37
90,56,952,144,808,20,788,6,233,249,46,13,6,2,51,13,169
90,57,604,103,501,6,495,19,125,122,56,7,6,1,44,12,103
90,58,339,52,287,10,277,0,90,57,21,4,1,2,30,4,68
90,59,212,30,182,1,181,3,52,36,21,2,1,0,18,8,40
90,60,101,17,84,1,83,1,24,21,9,0,0,1,6,1,20
90,61,45,3,42,0,42,0,14,8,6,0,0,0,2,0,12
90,62,219,39,180,2,178,6,49,29,22,2,2,0,11,10,47
90,63,370,67,303,3,300,1,100,67,26,4,1,2,26,4,69
90,64,208,47,161,4,157,1,47,40,13,1,1,1,8,3,42
90,65,926,132,794,19,775,16,261,146,107,17,11,1,63,23,130
90,66,193,43,150,5,145,3,45,47,8,0,3,0,12,0,27
90,67,341,53,288,10,278,4,92,83,16,2,0,1,21,11,48
90,68,641,113,528,7,521,12,128,119,53,3,4,2,51,10,139
90,69,1008,191,817,19,798,6,236,202,69,19,7,1,53,17,188
90,70,313,37,276,8,268,6,49,78,31,8,0,0,24,4,68
90,71,745,96,649,15,634,7,175,169,49,15,6,1,50,9,153
90,72,761,151,610,11,599,7,192,142,71,10,5,0,23,13,136
90,73,263,25,238,4,234,10,74,48,22,4,1,0,15,3,57
90,74,191,33,158,7,151,2,33,45,12,1,2,0,27,4,25
90,75,2654,703,1951,33,1918,41,394,438,208,19,10,4,183,24,597
90,76,807,117,690,21,669,7,129,199,65,10,2,2,88,12,155
90,77,234,26,208,6,202,4,66,50,11,1,0,0,12,2,56
90,78,137,10,127,8,119,5,45,20,5,5,0,0,12,0,27
90,79,234,29,205,10,195,6,42,44,25,8,2,0,21,7,40
90,80,297,33,264,5,259,2,79,73,20,3,7,0,14,8,53
90,81,603,116,487,12,475,8,156,157,30,11,2,0,35,9,67
90,82,229,24,205,2,203,3,57,50,24,1,1,2,22,6,37
90,83,75,6,69,0,69,0,18,29,4,0,3,0,3,1,11
90,84,283,42,241,5,236,7,59,48,24,3,0,2,40,10,43
90,85,82,15,67,2,65,2,36,9,4,4,0,0,3,1,6
90,86,171,17,154,4,150,0,41,52,9,2,2,0,10,7,27
90,87,637,94,543,13,530,13,149,167,31,5,1,2,43,9,110
90,88,805,117,688,18,670,19,180,138,67,12,5,1,57,19,172
90,89,935,120,815,19,796,21,197,202,101,5,7,5,63,20,175
90,90,298,30,268,9,259,6,74,52,23,8,2,3,25,7,59
90,91,443,57,386,8,378,9,89,98,32,7,2,0,43,16,82
90,93,682,106,576,6,570,8,139,158,57,10,2,1,51,13,131
90,94,380,43,337,2,335,8,70,93,32,6,1,0,42,4,79
90,95,340,63,277,9,268,0,109,61,19,3,3,0,26,6,41
90,96,217,33,184,1,183,3,44,57,19,4,0,0,12,2,42
90,97,917,149,768,14,754,9,234,171,75,9,6,2,76,15,157
90,98,190,21,169,2,167,7,29,47,5,5,0,0,29,1,44
90,99,3537,591,2946,68,2878,66,606,711,321,39,28,7,249,38,813
90,100,185,25,160,3,157,3,26,52,21,4,0,1,11,2,37
90,101,172,27,145,2,143,0,70,24,15,1,1,0,5,4,23
90,102,575,69,506,15,491,10,123,124,42,4,5,0,34,13,136
90,103,480,68,412,19,393,10,97,109,25,5,4,1,44,5,93
90,104,741,85,656,5,651,14,176,165,56,8,2,4,81,14,131
90,105,118,22,96,2,94,1,27,32,5,2,1,0,6,2,18
91,1,230,31,199,3,196,0,50,73,21,2,0,0,12,5,33
91,16,2401,449,1952,28,1924,20,510,488,182,19,13,5,146,65,476
91,17,1029,186,843,18,825,20,151,223,99,18,2,2,88,16,206
91,21,5931,1432,4499,77,4422,93,839,1183,498,32,15,11,442,82,1227
91,22,99,7,92,3,89,1,22,26,15,1,0,0,12,1,11
91,27,16808,3716,13092,238,12854,264,2037,2856,1707,134,60,31,1038,246,4481
91,35,271,46,225,4,221,3,46,52,45,6,2,1,17,3,46
91,37,239,35,204,4,200,6,71,64,16,2,0,0,17,5,19
91,38,915,164,751,18,733,15,153,198,80,8,1,2,76,15,185
91,41,569,80,489,6,483,6,81,149,60,1,3,2,47,10,124
91,44,2366,413,1953,35,1918,27,344,639,144,12,5,6,214,46,481
91,45,5001,1062,3939,84,3855,80,792,1029,462,46,23,13,348,106,956
91,47,887,163,724,14,710,11,170,183,78,7,4,4,74,22,157
91,64,3066,549,2517,42,2475,78,241,968,233,19,6,4,294,39,593
91,67,91,6,85,0,85,2,29,26,8,0,0,0,7,0,13
91,69,353,65,288,10,278,7,55,97,21,2,1,0,31,10,54
91,75,54,3,51,1,50,1,14,13,6,0,0,0,8,1,7
91,79,420,53,367,9,358,9,85,124,33,2,0,0,25,5,75
91,80,817,183,634,8,626,11,138,178,77,5,2,0,56,17,142
91,81,523,102,421,9,412,17,75,145,33,4,3,1,32,13,89
91,85,2818,577,2241,51,2190,40,492,544,232,16,5,8,218,60,575
91,86,6681,1336,5345,135,5210,102,922,1433,511,72,29,15,529,124,1473
91,93,485,69,416,8,408,24,49,121,33,5,0,0,63,14,99
91,95,1402,210,1192,18,1174,34,211,313,155,19,1,4,108,22,307
91,97,4385,951,3434,47,3387,84,486,802,405,38,7,14,286,188,1077
91,98,281,45,236,4,232,2,46,76,24,2,2,0,28,8,44
91,99,2370,424,1946,25,1921,44,423,502,246,18,13,6,191,49,429
91,100,492,79,413,7,406,4,109,115,42,1,1,2,33,13,86
91,103,14644,3461,11183,177,11006,278,1669,2536,1466,133,49,36,1094,243,3502
91,105,5438,961,4477,87,4390,102,820,1249,442,35,17,15,448,91,1171
91,106,906,180,726,19,707,14,162,207,72,7,5,2,58,20,160
91,109,721,109,612,8,604,7,166,180,52,5,4,0,41,19,130
91,111,2292,389,1903,15,1888,44,215,510,266,28,7,6,244,47,521
91,112,108,3,105,3,102,1,24,32,7,2,0,0,13,5,18
91,114,17157,3889,13268,143,13125,323,1530,3410,1314,108,32,21,1172,1551,3664
91,115,2169,397,1772,23,1749,40,301,536,177,12,6,7,198,33,439
91,121,382,51,331,3,328,3,103,84,21,2,1,2,31,11,70
91,122,6660,1198,5462,79,5383,228,344,1444,633,50,26,22,737,92,1807
91,129,2471,467,2004,26,1978,46,440,515,231,25,9,4,212,51,445
91,130,915,158,757,9,748,33,136,243,101,10,6,1,53,10,155
91,131,304,35,269,1,268,6,66,65,34,4,3,0,21,4,65
91,132,808,151,657,11,646,22,85,183,94,8,5,1,53,13,182
91,135,1749,360,1389,25,1364,26,279,354,161,24,5,1,110,41,363
91,136,1602,318,1284,14,1270,18,257,337,127,15,5,1,111,36,363
91,137,236,38,198,2,196,2,36,64,22,3,1,0,11,7,50
91,145,67,9,58,2,56,1,7,25,1,1,0,1,4,0,16
91,148,101,15,86,0,86,2,6,29,7,1,1,0,12,3,25
91,156,1243,200,1043,21,1022,20,192,255,133,8,1,1,109,34,269
91,159,1122,174,948,29,919,16,174,225,125,12,2,2,93,23,247
91,161,10923,2321,8602,167,8435,154,1465,2264,907,71,35,24,757,162,2596
91,174,22078,6220,15858,262,15596,357,2625,2967,2459,149,106,38,1042,292,5561
91,175,1111,165,946,22,924,21,151,233,123,11,8,4,101,39,233
91,179,2935,612,2323,36,2287,46,441,695,236,24,9,2,199,56,579
91,180,291,28,263,8,255,4,53,84,18,3,0,1,32,8,52
91,182,7620,1789,5831,105,5726,110,630,1167,681,34,22,8,440,126,2508
91,184,223,31,192,6,186,1,43,67,15,3,1,0,16,3,37
91,186,472,92,380,7,373,10,64,97,40,10,1,0,42,10,99
91,191,5922,1172,4750,50,4700,90,694,980,595,37,16,6,277,612,1393
91,195,607,86,521,14,507,12,86,195,43,7,0,3,45,7,109
91,198,1050,156,894,21,873,19,190,236,92,9,6,4,71,18,228
91,200,6580,1336,5244,83,5161,116,830,1329,698,40,18,10,465,105,1550
91,201,18544,3832,14712,244,14468,392,2237,3776,1811,145,59,32,1378,445,4193
91,204,616,119,497,4,493,8,96,153,48,7,2,2,47,10,120
91,207,3037,607,2430,34,2396,34,381,613,287,30,18,7,201,64,761
91,215,6679,1796,4883,94,4789,82,627,818,692,45,24,11,291,271,1928
91,216,6798,1390,5408,95,5313,125,813,1536,545,48,21,11,569,116,1529
91,222,154,30,124,4,120,1,34,31,13,1,1,1,9,4,25
91,223,12776,2778,9998,228,9770,168,1809,2189,1370,108,52,22,767,204,3081
91,225,2315,460,1855,21,1834,64,225,749,132,10,5,6,206,36,401
91,226,4754,876,3878,72,3806,75,693,1139,415,46,20,6,380,92,940
91,228,25443,6889,18554,379,18175,416,2018,2793,2714,188,97,37,1187,276,8449
91,232,2560,544,2016,29,1987,50,415,493,247,16,12,7,182,61,504
91,235,2905,700,2205,74,2131,19,438,343,420,17,8,1,88,36,761
91,240,167,30,137,1,136,3,31,49,10,0,1,2,13,6,21
91,243,1284,235,1049,18,1031,19,176,300,99,3,3,2,122,33,274
91,244,816,108,708,13,695,14,131,213,89,8,3,5,57,23,152
91,247,366,64,302,9,293,4,58,71,41,4,3,0,48,9,55
91,248,115,13,102,3,99,3,20,29,13,1,0,0,10,5,18
91,249,2498,403,2095,38,2057,61,248,632,257,23,8,6,247,51,524
91,272,15699,2676,13023,156,12867,478,835,4325,1248,69,29,31,1709,191,3952
91,273,531,86,445,11,434,10,95,103,56,5,1,2,34,17,111
91,274,864,153,711,8,703,16,47,263,61,5,1,1,107,11,191
91,275,1608,269,1339,15,1324,47,125,409,150,17,2,3,119,30,422
91,284,794,99,695,14,681,22,122,192,83,9,5,2,74,20,152
91,286,10808,3376,7432,197,7235,105,832,975,1536,72,41,16,331,100,3227
91,292,513,81,432,13,419,8,95,119,35,12,4,2,41,8,95
91,293,672,130,542,6,536,10,139,146,65,3,2,1,53,14,103
91,294,607,160,447,10,437,19,105,125,35,3,1,0,52,11,86
91,312,7208,1424,5784,107,5677,190,681,1696,564,44,21,21,683,131,1646
91,315,4377,776,3601,73,3528,65,804,819,430,28,18,12,310,100,942
91,318,1359,191,1168,11,1157,48,189,286,169,6,6,5,128,20,300
91,319,446,48,398,10,388,15,55,142,36,5,0,0,43,10,82
91,326,8708,1759,6949,114,6835,194,887,1613,919,65,27,23,628,165,2314
91,330,4012,756,3256,74,3182,99,502,729,460,34,14,7,351,77,909
91,332,978,158,820,8,812,24,148,232,76,6,12,1,86,24,203
91,333,2748,505,2243,31,2212,52,369,574,241,40,14,5,241,51,625
91,338,4829,798,4031,51,3980,89,443,1122,427,35,12,16,479,89,1268
91,339,4025,810,3215,47,3168,56,630,924,327,38,11,10,339,83,750
91,340,5273,939,4334,95,4239,90,801,922,571,51,19,5,356,95,1329
91,345,13078,2850,10228,202,10026,196,1538,2576,1244,101,54,19,860,179,3259
91,347,4323,878,3445,54,3391,62,653,980,381,29,10,5,410,83,778
91,359,1950,421,1529,38,1491,21,404,445,170,15,5,7,105,60,259
91,363,5591,1055,4536,78,4458,92,694,1283,551,38,19,12,436,86,1247
91,374,160,23,137,3,134,3,43,33,17,0,0,0,14,4,20
91,376,3660,713,2947,29,2918,54,454,762,365,43,14,8,329,84,805
91,377,25358,5399,19959,339,19620,558,2115,3902,2954,178,79,65,2057,310,7402
91,378,205,27,178,3,175,0,38,59,18,3,0,0,16,3,38
91,386,9975,2203,7772,100,7672,178,1242,2587,773,68,22,15,818,193,1776
91,390,2357,496,1861,30,1831,35,417,535,224,21,6,7,164,48,374
91,393,423,62,361,7,354,5,107,121,36,3,2,0,21,9,50
91,399,152,26,126,3,123,1,33,42,12,1,0,1,17,5,11
91,405,3436,554,2882,45,2837,65,549,991,248,40,14,8,258,73,591
91,408,1016,151,865,17,848,21,164,262,71,8,2,1,84,27,208
91,411,1349,209,1140,11,1129,37,83,335,93,19,8,0,160,28,366
91,412,537,118,419,8,411,7,59,127,55,7,5,0,40,10,101
91,414,274,55,219,7,212,1,54,49,23,5,0,0,25,5,50
91,421,15267,3240,12027,193,11834,281,1579,2895,1262,76,51,25,1030,1145,3490
91,425,4377,972,3405,64,3341,64,624,1111,315,32,15,12,336,92,740
91,432,7829,1491,6338,83,6255,104,1256,1911,623,49,21,16,539,132,1604
91,433,3461,755,2706,49,2657,38,556,843,263,27,8,6,244,63,609
91,434,13661,3133,10528,181,10347,201,1812,2503,1750,92,41,35,834,224,2855
91,435,457,65,392,1,391,22,65,174,27,2,0,2,32,14,53
91,441,351,54,297,6,291,3,60,79,32,2,0,2,31,11,71
91,457,3158,559,2599,42,2557,79,376,655,344,31,13,8,224,46,781
91,458,3013,521,2492,36,2456,65,362,691,262,18,9,8,326,58,657
91,461,2889,486,2403,43,2360,48,414,737,238,16,16,8,236,58,589
91,463,716,78,638,12,626,11,124,227,47,9,4,1,68,13,122
91,468,1129,209,920,13,907,13,209,269,89,6,1,3,89,17,211
91,469,629,18,611,9,602,9,120,162,58,4,2,6,99,10,132
91,471,10831,1954,8877,114,8763,365,699,2266,999,59,27,34,1173,166,2975
91,473,177,38,139,4,135,3,34,40,19,4,1,0,7,2,25
91,477,19958,3999,15959,217,15742,630,1561,3702,2085,150,69,37,1776,278,5454
91,479,5075,1186,3889,75,3814,55,881,1099,410,37,21,5,265,100,941
91,482,409,46,363,5,358,9,68,111,23,4,1,1,42,9,90
91,494,2711,471,2240,31,2209,50,364,649,259,15,3,6,226,56,581
91,495,240,46,194,4,190,7,42,64,14,1,0,2,21,4,35
91,507,258,43,215,6,209,5,44,83,16,3,0,0,13,4,41
91,508,221,29,192,2,190,3,34,63,22,1,0,0,18,9,40
91,511,1418,294,1124,22,1102,11,275,276,152,16,10,1,88,34,239
91,514,4992,1020,3972,63,3909,59,650,873,472,29,17,9,293,209,1298
91,519,322,48,274,1,273,7,70,82,30,2,0,0,34,9,39
91,521,15205,3624,11581,231,11350,228,1902,2549,1547,98,48,33,822,234,3889
91,525,851,106,745,15,730,11,139,229,78,9,4,2,73,18,167
91,526,73,6,67,0,67,0,14,29,4,0,0,0,5,0,15
91,533,1155,180,975,20,955,17,221,256,127,15,5,2,99,21,192
91,534,2406,399,2007,27,1980,50,232,643,213,12,4,2,240,36,548
91,538,598,103,495,1,494,11,28,154,46,1,0,0,85,9,160
91,540,3406,610,2796,40,2756,56,495,849,333,17,12,9,255,58,672
91,544,372,51,321,7,314,5,97,95,31,7,0,0,19,7,53
91,546,825,179,646,12,634,19,104,220,50,5,1,0,75,20,140
91,547,322,60,262,8,254,6,50,74,43,2,4,0,18,8,49
91,549,20583,4262,16321,322,15999,332,2459,3939,2036,132,53,30,1419,326,5273
91,552,5152,1040,4112,76,4036,75,836,1053,485,39,21,10,329,98,1090
91,553,5291,917,4374,76,4298,82,678,1594,376,25,9,7,399,122,1006
91,556,294,31,263,2,261,9,38,84,23,4,1,0,24,5,73
91,560,203,32,171,1,170,5,24,60,10,1,1,0,17,4,48
91,568,1257,241,1016,12,1004,13,179,370,93,11,1,4,93,22,218
91,570,12626,2658,9968,185,9783,272,1536,2242,1366,90,49,16,883,226,3103
91,573,5403,1034,4369,71,4298,88,704,1080,557,31,11,7,410,113,1297
91,577,3825,701,3124,55,3069,68,560,826,376,33,11,7,264,96,828
91,578,297,35,262,4,258,7,29,106,28,2,2,1,29,5,49
91,579,2170,457,1713,32,1681,41,288,492,191,13,2,1,189,62,402
91,581,683,106,577,11,566,16,83,163,68,11,5,2,77,16,125
91,587,3549,559,2990,40,2950,66,492,813,453,38,8,12,265,74,729
91,589,22514,4640,17874,286,17588,381,2772,4734,1982,157,69,42,1637,368,5446
91,593,1332,269,1063,11,1052,20,230,289,107,16,5,2,106,25,252
91,599,929,162,767,8,759,21,120,261,104,10,3,3,54,19,164
91,600,5368,1041,4327,62,4265,106,528,1567,329,27,7,16,487,100,1098
91,602,220,23,197,3,194,4,37,39,30,4,0,0,22,4,54
91,613,169,20,149,3,146,8,27,41,15,2,0,1,16,1,35
91,617,1871,340,1531,33,1498,24,276,403,139,19,7,6,174,59,391
91,619,190,27,163,1,162,4,13,63,23,4,1,1,9,4,40
91,629,481,59,422,6,416,13,87,146,38,5,0,0,35,10,82
91,630,1087,192,895,12,883,22,94,291,107,8,5,1,109,18,228
91,631,1607,263,1344,12,1332,35,233,468,106,6,2,2,144,69,267
91,634,849,158,691,11,680,18,99,168,92,8,4,2,79,24,186
91,635,1519,228,1291,18,1273,41,125,469,131,4,4,7,158,28,306
91,639,638,100,538,7,531,10,126,138,66,7,2,0,43,17,122
91,645,12063,2240,9823,141,9682,353,770,3520,774,66,26,30,1341,145,2657
91,648,1569,313,1256,31,1225,24,220,407,121,16,5,3,128,37,264
91,649,1901,327,1574,30,1544,33,315,366,203,19,8,1,173,40,386
91,654,508,72,436,5,431,9,113,148,42,3,4,2,23,8,79
91,657,16555,3911,12644,221,12423,189,2004,2145,1878,117,55,22,692,925,4396
91,659,3221,560,2661,33,2628,35,496,574,407,34,8,4,222,44,804
91,661,7030,1281,5749,103,5646,180,632,1507,614,60,27,24,694,123,1785
91,662,576,93,483,5,478,19,106,140,59,7,0,1,31,7,108
91,665,4435,1005,3430,65,3365,58,648,997,373,36,21,8,323,83,818
91,666,1360,221,1139,11,1128,14,233,336,103,10,12,3,94,35,288
91,667,5025,959,4066,82,3984,115,535,1088,392,51,14,2,469,87,1231
91,671,476,73,403,8,395,16,99,102,40,1,3,0,37,8,89
91,679,851,111,740,11,729,17,85,200,105,3,0,1,70,15,233
91,685,2825,579,2246,28,2218,57,341,597,258,18,9,5,273,40,620
91,687,18492,4261,14231,300,13931,227,2553,3489,1879,135,51,27,1117,294,4159
91,689,4759,1018,3741,68,3673,90,527,1200,388,23,9,10,410,69,947
91,691,20313,3871,16442,169,16273,339,1890,3178,1558,100,33,13,1129,4049,3984
91,692,12843,2886,9957,200,9757,238,1033,1374,1646,126,64,22,774,141,4339
92,2,40169,7755,32414,674,31740,981,2586,9985,3356,221,108,101,4082,443,9877
92,4,45042,9279,35763,516,35247,1054,2884,11477,3350,244,112,91,3742,476,11817
92,7,20608,4687,15921,281,15640,382,1682,2513,3298,175,77,56,1069,197,6191
92,9,16746,3612,13134,231,12903,422,1056,4717,1176,76,34,45,1478,160,3739
92,12,67579,13310,54269,818,53451,1290,3469,25891,3319,226,88,99,5727,643,12699
92,14,13300,2381,10919,132,10787,367,775,3452,1010,48,24,43,1424,169,3475
92,19,17914,3466,14448,325,14123,386,1304,3845,1723,101,50,40,1422,213,5039
92,20,21656,4298,17358,265,17093,456,1562,4884,1890,138,54,43,1997,264,5805
92,22,12768,2527,10241,147,10094,326,881,3308,891,69,28,30,1368,169,3024
92,23,34131,6740,27391,417,26974,842,2665,8153,2965,229,78,68,2881,421,8672
92,24,29226,6786,22440,374,22066,751,1993,4422,3219,184,108,57,1860,289,9183
92,25,44741,10181,34560,526,34034,922,3435,8890,4505,289,139,104,3224,474,12052
92,26,50576,11277,39299,681,38618,978,3216,15158,2895,194,90,116,4571,488,10912
92,32,15217,3289,11928,161,11767,379,1029,3000,1420,113,48,40,1376,210,4152
92,33,12388,2501,9887,167,9720,204,791,4800,531,30,13,37,1111,112,2091
92,35,17300,3509,13791,212,13579,353,1218,5412,1129,88,32,27,1636,192,3492
92,36,20990,5264,15726,342,15384,307,1647,1845,4314,163,95,40,619,155,6199
92,40,41994,9488,32506,521,31985,970,2487,10391,2990,209,84,105,4090,452,10207
92,44,39497,7296,32201,438,31763,709,2445,15112,2134,193,58,58,3283,400,7371
92,46,18852,4162,14690,207,14483,485,1412,2367,3340,158,78,42,1141,168,5292
92,47,1082,163,919,8,911,18,55,566,26,6,2,1,113,8,116
92,48,30572,6341,24231,318,23913,755,1974,8217,2268,163,71,57,2763,326,7319
92,49,27851,5527,22324,289,22035,825,1763,6023,2556,171,86,51,2416,304,7840
92,50,44307,10435,33872,654,33218,847,3546,5772,6168,334,180,95,2509,427,13340
92,51,37003,5964,31039,257,30782,409,1539,22360,649,67,22,57,2292,255,3132
92,60,18767,3621,15146,260,14886,346,1752,4893,1624,124,50,35,1648,273,4141
92,62,28189,5597,22592,470,22122,629,2306,7869,1997,182,54,58,2492,331,6204
92,63,52385,10540,41845,580,41265,1038,3549,15865,3217,280,109,113,5312,652,11130
92,64,18973,3529,15444,153,15291,381,1279,7934,667,66,20,30,1843,208,2863
92,71,14355,2941,11414,118,11296,349,697,4152,929,66,11,26,1584,143,3339
92,72,14837,2876,11961,219,11742,424,830,4206,1033,59,27,46,1369,166,3582
92,73,26458,5110,21348,425,20923,538,1823,7547,1898,137,59,57,2430,260,6174
92,75,17512,3079,14433,161,14272,507,1088,4118,1588,95,41,38,1624,176,4997
92,76,6089,1241,4848,74,4774,134,318,2768,179,15,4,6,558,39,753
92,77,7132,1060,6072,80,5992,196,318,2910,301,28,11,7,841,77,1303
92,78,12332,3328,9004,225,8779,126,1073,1748,1356,90,42,20,502,111,3711
93,1,26215,7914,18301,356,17945,337,2309,2672,3673,165,155,42,759,172,7661
93,5,43171,11934,31237,550,30687,572,4356,6615,4491,232,127,58,1916,389,11931
93,6,17296,4656,12640,257,12383,402,1358,1918,3081,115,57,30,682,135,4605
93,7,24508,6785,17723,363,17360,205,2895,3117,3403,145,95,27,800,236,6437
93,8,21088,6472,14616,315,14301,214,1555,1856,2783,130,83,36,649,151,6844
93,10,24577,6473,18104,376,17728,323,2305,3034,2699,172,73,56,989,240,7837
93,13,6411,1521,4890,71,4819,65,804,1165,607,44,26,16,284,69,1739
93,14,10173,3173,7000,143,6857,99,880,1082,997,57,30,15,335,54,3308
93,15,3446,694,2752,36,2716,46,632,831,301,24,8,5,195,64,610
93,27,14431,3869,10562,252,10310,130,1169,1376,2105,86,62,13,421,107,4841
93,29,34679,10064,24615,463,24152,313,4478,4737,3911,269,146,52,1405,327,8514
93,30,5294,1617,3677,85,3592,41,671,513,639,40,16,5,163,44,1460
93,31,23893,6821,17072,299,16773,250,1827,3024,2548,132,74,36,1188,203,7491
93,32,22176,5290,16886,336,16550,316,2720,4461,2013,155,60,32,1375,273,5145
93,33,4461,764,3697,61,3636,72,514,1333,349,26,10,7,358,73,894
93,39,3448,813,2635,56,2579,75,287,323,553,34,23,9,102,20,1153
93,45,13344,2766,10578,154,10424,394,917,2632,1688,70,50,17,702,137,3817
93,46,23530,5426,18104,311,17793,252,3575,4584,2102,144,59,42,1216,284,5535
93,47,13098,3536,9562,146,9416,142,1799,2179,1320,75,31,21,586,161,3102
93,48,53900,14367,39533,543,38990,1720,3640,5272,9392,439,183,75,2198,406,15665
93,49,13021,3164,9857,124,9733,278,1296,2757,1136,90,29,33,854,197,3063
93,50,18288,4075,14213,344,13869,287,2068,2551,1884,153,61,34,946,195,5690
93,51,34852,8068,26784,465,26319,668,3271,6351,3405,232,102,69,2287,435,9499
93,53,19551,5329,14222,222,14000,353,1866,2605,2620,109,83,40,844,165,5315
93,55,23681,5833,17848,325,17523,566,1672,3027,3298,161,132,38,943,196,7490
93,57,11404,2693,8711,146,8565,139,1364,2511,1008,74,39,23,638,154,2615
93,59,11498,3372,8126,168,7958,148,879,1172,1418,68,29,17,376,103,3748
93,61,8338,1779,6559,97,6462,276,669,1145,1044,74,44,16,391,65,2738
93,62,10172,2371,7801,100,7701,175,993,3237,671,46,19,18,739,111,1692
93,63,13014,3394,9620,170,9450,228,1370,1638,1874,106,73,20,490,120,3531
93,64,22645,5788,16857,389,16468,315,2528,4154,2205,126,76,32,1256,251,5525
93,66,40836,12384,28452,530,27922,708,2764,3402,6064,335,187,75,1307,295,12785
93,70,21542,6089,15453,264,15189,491,1599,2258,3186,169,96,49,849,163,6329
93,71,22470,5973,16497,326,16171,305,2292,2675,2721,121,75,46,865,189,6882
93,72,15830,4902,10928,350,10578,134,1404,1535,2055,97,52,29,439,108,4725
93,73,20550,5347,15203,306,14897,238,2701,2702,2956,152,82,37,916,213,4900
93,74,3927,925,3002,42,2960,42,645,748,370,31,10,4,241,65,804
93,77,15258,2991,12267,193,12074,261,1901,3758,1309,91,48,33,1021,207,3445
93,78,18946,5479,13467,282,13185,169,1942,2594,2043,115,76,41,796,156,5253
93,79,5574,1606,3968,88,3880,32,420,466,788,32,27,11,140,45,1919
94,1,3038,599,2439,35,2404,41,455,653,299,17,7,5,206,59,662
94,2,23499,5073,18426,351,18075,509,2223,3916,2572,184,94,36,1334,321,6886
94,3,11778,3078,8700,212,8488,312,1023,1395,1806,100,40,25,659,117,3011
94,4,8478,1856,6622,132,6490,112,897,1431,933,50,26,14,471,164,2392
94,11,8981,2378,6603,161,6442,109,900,1231,1280,57,35,16,324,88,2402
94,15,10931,2282,8649,147,8502,198,946,3172,748,47,19,18,972,155,2227
94,16,16174,3583,12591,197,12394,415,1225,2602,1664,116,46,32,1171,160,4963
94,17,41110,10073,31037,493,30544,663,3896,6269,6183,272,110,72,2190,429,10460
94,18,19274,4083,15191,184,15007,434,1298,5404,1409,111,29,33,1510,215,4564
94,19,10297,2212,8085,135,7950,140,1134,2464,855,72,17,18,661,148,2441
94,21,9932,1991,7941,133,7808,151,1046,1668,1252,77,31,17,628,132,2806
94,22,19459,3901,15558,224,15334,375,1986,2873,2876,148,62,37,1165,221,5591
94,28,48414,11251,37163,691,36472,829,3840,8977,4959,300,164,115,2516,517,14255
94,33,31679,7090,24589,316,24273,834,2413,5613,4205,207,112,68,2219,323,8279
94,34,15002,3960,11042,163,10879,306,1268,2317,1534,106,40,28,977,173,4130
94,37,9648,2196,7452,131,7321,248,779,1127,1664,70,32,18,494,85,2804
94,38,18828,4173,14655,266,14389,376,1594,3472,1784,121,42,36,1367,242,5355
94,41,27911,6501,21410,323,21087,729,2033,3140,5367,248,108,47,1232,257,7926
94,42,11996,2710,9286,143,9143,309,968,2796,1007,68,28,22,974,140,2831
94,43,14267,3595,10672,162,10510,305,1091,2224,1500,105,53,24,971,159,4078
94,44,11180,2446,8734,157,8577,155,1392,1937,1204,79,40,17,615,214,2924
94,46,33907,6717,27190,471,26719,734,3665,7990,2773,219,119,70,2592,549,8008
94,47,3103,681,2422,31,2391,49,393,725,224,18,7,4,233,115,623
94,48,3862,742,3120,51,3069,58,392,1146,235,13,6,8,363,110,738
94,52,22178,5426,16752,169,16583,491,1438,6576,1286,84,27,49,1982,252,4398
94,53,3154,561,2593,33,2560,60,425,711,274,16,6,10,276,51,731
94,54,11014,2671,8343,173,8170,126,1193,1292,1662,78,30,24,450,128,3187
94,55,6362,1268,5094,76,5018,83,759,2084,366,44,11,11,515,100,1045
94,56,1762,386,1376,28,1348,24,225,410,115,9,1,1,123,61,379
94,58,22010,5032,16978,242,16736,550,1873,6117,1415,140,47,40,1774,254,4526
94,59,11344,2334,9010,139,8871,178,1228,2691,954,68,33,27,1227,147,2318
94,60,7305,1634,5671,94,5577,98,860,1475,821,48,31,16,488,107,1633
94,65,3956,619,3337,47,3290,72,409,1042,352,27,27,14,357,60,930
94,67,14668,3333,11335,137,11198,324,762,5193,706,54,33,25,1156,146,2799
94,68,49295,9313,39982,514,39468,1180,4174,15774,2949,240,95,116,4673,726,9541
94,69,8529,1970,6559,78,6481,189,665,2241,610,45,31,22,675,118,1885
94,70,2508,469,2039,31,2008,47,275,916,150,18,9,7,170,46,370
94,71,17032,3485,13547,232,13315,355,1727,4249,1320,82,47,31,1427,292,3785
94,73,15955,3371,12584,233,12351,206,1701,3587,1529,108,59,34,1093,204,3830
94,74,5936,1537,4399,90,4309,53,618,542,1055,37,25,12,192,87,1688
94,75,6429,1144,5285,84,5201,102,874,1635,489,54,15,17,461,253,1301
94,76,28268,7098,21170,334,20836,601,2636,3574,4385,219,83,42,1506,263,7527
94,77,10260,2383,7877,163,7714,136,1454,1626,1252,71,30,16,495,117,2517
94,78,14136,4071,10065,148,9917,129,1787,1582,1592,104,46,27,593,258,3799
94,79,16276,3760,12516,226,12290,288,1674,3150,1467,98,51,28,1095,222,4217
94,80,31518,5834,25684,304,25380,1020,1754,8658,2155,155,55,71,3312,338,7862
94,81,44928,11838,33090,617,32473,689,4031,5885,6713,342,158,78,2008,412,12157
95,2,675,100,575,9,566,16,110,168,58,6,1,3,58,12,134
95,8,567,91,476,9,467,16,115,132,44,3,7,1,27,11,111
95,11,305,66,239,1,238,0,50,79,27,3,2,0,19,4,54
95,12,157,22,135,7,128,2,36,50,6,4,1,0,8,4,17
95,14,1508,282,1226,17,1209,20,157,473,103,11,1,3,139,21,281
95,18,53833,14498,39335,725,38610,697,5718,7313,6355,394,226,93,2478,544,14792
95,19,7623,1716,5907,93,5814,85,1059,1722,618,51,24,6,337,76,1836
95,23,495,77,418,10,408,11,95,148,32,6,0,2,34,13,67
95,24,214,33,181,4,177,1,37,55,26,3,0,0,18,5,32
95,26,1957,387,1570,33,1537,46,350,461,175,19,9,2,139,31,305
95,28,1217,277,940,14,926,16,198,256,109,11,0,2,58,19,257
95,39,5119,885,4234,62,4172,88,597,1201,531,39,17,9,390,77,1223
95,40,631,90,541,8,533,16,98,207,57,4,3,3,40,14,91
95,42,1511,289,1222,29,1193,33,244,357,121,7,2,3,109,24,293
95,46,97,10,87,0,87,1,17,35,4,2,0,0,9,6,13
95,51,6436,1429,5007,83,4924,113,774,1703,481,41,24,16,514,96,1162
95,52,5263,1022,4241,80,4161,72,862,927,491,46,23,11,316,82,1331
95,54,162,24,138,1,137,0,29,31,18,1,2,0,24,4,28
95,55,298,56,242,2,240,7,57,84,20,4,2,1,13,8,44
95,56,1282,272,1010,15,995,11,284,297,78,10,2,1,89,20,203
95,58,1421,261,1160,24,1136,17,280,218,156,20,4,4,73,31,333
95,59,252,45,207,5,202,6,36,55,15,1,0,0,23,9,57
95,60,4568,993,3575,74,3501,82,587,947,403,37,15,9,335,64,1022
95,61,325,46,279,5,274,7,53,99,23,1,1,0,27,4,59
95,63,14165,3430,10735,191,10544,156,1664,1854,1938,105,61,24,658,139,3945
95,74,554,106,448,9,439,14,67,179,34,3,0,0,52,9,81
95,78,1178,221,957,10,947,29,173,262,92,15,7,1,78,29,261
95,88,423,107,316,7,309,4,84,89,18,3,2,0,26,2,81
95,91,4047,881,3166,58,3108,68,442,755,431,26,13,11,256,63,1043
95,94,179,29,150,1,149,1,43,53,12,0,0,0,10,2,28
95,101,608,122,486,5,481,12,143,89,25,4,3,1,59,15,130
95,102,291,59,232,3,229,3,40,99,17,1,1,0,17,5,46
95,110,167,18,149,2,147,5,29,50,10,1,2,0,12,4,34
95,116,2308,425,1883,38,1845,26,464,344,257,25,12,1,108,37,571
95,119,227,38,189,1,188,2,57,51,15,0,0,0,16,7,40
95,120,1467,242,1225,18,1207,27,254,312,117,15,4,7,130,23,318
95,127,29730,7410,22320,443,21877,591,2139,4027,2889,237,100,71,1834,310,9679
95,134,3421,792,2629,48,2581,50,553,732,265,38,27,7,220,46,643
95,139,224,35,189,0,189,6,45,53,16,1,1,2,14,2,49
95,141,15,1,14,1,13,0,1,3,2,1,0,0,3,0,3
95,142,1186,199,987,18,969,26,237,218,107,5,4,4,73,20,275
95,144,56,7,49,0,49,1,7,29,0,0,0,0,6,0,6
95,149,2679,553,2126,35,2091,51,512,619,200,15,12,6,197,49,430
95,150,435,83,352,3,349,19,68,104,48,7,2,1,35,13,52
95,151,229,55,174,3,171,5,41,46,10,0,0,2,21,1,45
95,154,189,33,156,4,152,3,37,42,20,4,1,0,14,2,29
95,157,156,8,148,1,147,4,23,69,14,3,0,0,5,3,26
95,166,302,41,261,3,258,9,45,76,31,3,1,0,29,12,52
95,169,301,37,264,9,255,8,33,86,37,4,0,0,23,6,58
95,170,378,52,326,4,322,11,52,123,29,8,1,2,20,7,69
95,176,14784,3349,11435,172,11263,302,1675,3316,1196,82,30,24,1279,234,3125
95,177,745,125,620,7,613,11,154,214,76,6,1,2,39,14,96
95,181,217,31,186,3,183,6,32,73,8,2,1,0,14,5,42
95,183,4197,765,3432,61,3371,73,417,865,347,39,14,9,387,53,1167
95,197,14429,3588,10841,171,10670,260,1373,3125,1276,88,41,17,1001,209,3280
95,199,9685,2057,7628,131,7497,129,1347,2322,760,61,37,18,645,109,2069
95,203,16161,3730,12431,204,12227,297,1657,3657,1206,111,51,42,1321,220,3665
95,205,4765,1034,3731,69,3662,78,594,892,508,48,18,10,320,63,1131
95,210,7731,1769,5962,94,5868,154,567,2670,405,31,16,15,600,75,1335
95,211,1515,226,1289,25,1264,25,211,441,123,12,3,4,133,30,282
95,212,68,14,54,0,54,0,19,15,6,0,1,0,3,1,9
95,213,524,85,439,6,433,6,88,147,39,4,1,0,51,10,87
95,214,47,6,41,0,41,1,13,14,3,0,0,0,4,1,5
95,218,10782,2495,8287,188,8099,178,1316,2036,937,81,37,20,755,134,2605
95,219,17872,4210,13662,221,13441,322,1836,3347,1564,144,75,36,1328,263,4526
95,229,6077,1273,4804,90,4714,97,777,1274,557,39,18,15,399,85,1453
95,241,1157,202,955,20,935,13,231,230,111,9,5,6,65,13,252
95,250,6169,1381,4788,116,4672,91,940,939,626,53,23,15,348,77,1560
95,252,20799,4812,15987,273,15714,296,2588,4232,1728,154,87,45,1439,261,4884
95,253,357,56,301,9,292,7,47,102,23,5,0,1,32,3,72
95,254,398,59,339,11,328,0,81,101,32,2,2,2,24,7,77
95,256,1985,409,1576,26,1550,29,284,502,160,20,4,3,139,26,383
95,257,3207,625,2582,39,2543,86,348,784,279,14,2,11,310,47,662
95,258,305,38,267,2,265,4,42,95,19,2,1,1,22,6,73
95,259,70,5,65,1,64,5,6,28,8,0,0,0,6,2,9
95,268,15749,4123,11626,307,11319,137,1207,1944,1771,87,48,17,496,103,5509
95,270,444,79,365,7,358,12,78,111,33,5,3,1,34,9,72
95,271,390,60,330,4,326,11,48,117,31,4,2,1,37,7,68
95,277,14127,4005,10122,258,9864,131,1628,2336,1140,66,42,10,477,121,3913
95,280,15360,3967,11393,245,11148,104,2134,1823,1585,117,42,26,472,122,4723
95,282,130,15,115,0,115,2,25,29,14,1,2,0,15,8,19
95,287,453,57,396,6,390,4,68,140,26,1,4,3,46,9,89
95,288,5084,1078,4006,72,3934,97,650,1203,432,29,8,7,349,51,1108
95,295,157,14,143,1,142,5,20,54,13,2,0,0,17,3,28
95,298,401,62,339,7,332,7,50,149,25,0,1,1,27,7,65
95,301,223,38,185,0,185,7,50,61,18,6,1,0,8,5,29
95,303,152,24,128,2,126,5,32,40,8,3,0,1,14,2,21
95,304,231,29,202,4,198,7,25,83,8,3,0,1,21,8,42
95,306,17610,3908,13702,201,13501,300,2160,3715,1498,111,63,29,1427,267,3931
95,308,423,59,364,3,361,10,71,123,38,2,4,0,31,3,79
95,309,175,34,141,3,138,3,26,47,14,1,1,1,12,1,32
95,313,7617,1177,6440,96,6344,119,887,2587,455,48,16,13,607,91,1521
95,316,212,33,179,2,177,2,46,42,15,2,1,0,17,3,49
95,323,11075,2520,8555,179,8376,176,1185,1740,1145,110,41,22,841,150,2966
95,328,448,81,367,8,359,5,60,134,21,5,0,1,45,5,83
95,331,131,21,110,1,109,6,31,26,9,3,0,0,2,2,30
95,341,298,40,258,7,251,8,56,83,15,2,2,2,28,5,50
95,348,413,64,349,5,344,8,58,128,24,1,1,0,31,10,83
95,351,6203,1667,4536,87,4449,51,939,913,519,42,35,5,374,96,1475
95,352,2954,555,2399,48,2351,38,406,760,248,20,10,3,227,39,600
95,353,1098,223,875,15,860,16,186,253,92,8,1,2,92,22,188
95,355,3704,740,2964,66,2898,49,546,806,290,40,16,12,252,56,831
95,365,435,57,378,1,377,6,105,127,31,0,0,1,34,8,65
95,369,2011,324,1687,21,1666,51,192,666,116,8,2,1,241,22,367
95,370,2147,340,1807,40,1767,36,385,549,134,21,6,0,155,33,448
95,371,4072,816,3256,63,3193,46,722,681,440,34,21,8,293,65,883
95,379,161,20,141,0,141,4,34,56,6,1,0,0,12,4,24
95,387,59,9,50,3,47,3,8,19,2,0,0,0,7,0,8
95,388,3753,800,2953,55,2898,115,529,632,390,36,16,1,287,44,848
95,392,3395,738,2657,49,2608,65,514,697,311,29,13,11,263,63,642
95,394,6099,1292,4807,84,4723,121,838,1157,623,58,13,11,452,90,1360
95,395,631,103,528,5,523,8,130,151,70,6,2,0,41,7,108
95,409,730,146,584,10,574,7,127,199,50,4,1,0,52,8,126
95,422,324,59,265,7,258,5,43,78,36,3,3,0,37,4,49
95,424,10865,2732,8133,150,7983,109,1242,1687,1207,68,33,23,577,109,2928
95,426,1904,331,1573,23,1550,36,202,633,119,8,0,5,218,30,299
95,427,7509,1883,5626,84,5542,93,797,1224,773,55,19,18,366,84,2113
95,428,12915,2353,10562,126,10436,251,1237,4107,908,68,30,37,993,139,2666
95,429,334,41,293,3,290,8,61,83,33,6,0,0,30,8,61
95,430,2497,406,2091,37,2054,48,350,588,233,17,6,10,190,55,557
95,436,970,163,807,16,791,14,131,247,95,9,3,1,65,16,210
95,438,89,20,69,2,67,1,17,20,4,0,0,0,6,1,18
95,445,453,76,377,7,370,6,64,126,34,3,1,0,35,5,96
95,446,1460,238,1222,15,1207,21,173,410,106,17,5,1,139,17,318
95,447,157,22,135,3,132,3,26,38,13,5,1,0,15,4,27
95,450,1167,176,991,20,971,29,133,343,73,7,3,2,129,8,244
95,452,684,133,551,8,543,11,90,168,89,7,4,1,50,10,113
95,456,456,62,394,2,392,8,84,118,34,8,1,0,40,12,87
95,459,547,94,453,5,448,11,91,139,38,8,6,1,40,9,105
95,462,237,33,204,4,200,7,40,68,12,3,5,0,18,8,39
95,476,10035,2111,7924,125,7799,150,1377,2194,820,73,37,29,770,151,2198
95,480,4019,781,3238,41,3197,69,532,1008,286,33,10,9,318,83,849
95,483,389,59,330,8,322,13,53,100,48,4,2,0,30,6,66
95,487,5476,1327,4149,75,4074,44,942,661,628,59,36,14,205,76,1409
95,488,4674,1023,3651,70,3581,61,778,820,556,34,17,10,260,82,963
95,489,493,73,420,8,412,10,88,160,36,2,1,0,36,4,75
95,491,5332,1073,4259,63,4196,85,702,1395,379,38,17,8,448,99,1025
95,492,40,3,37,0,37,0,11,21,1,1,0,0,1,1,1
95,493,117,11,106,2,104,2,23,36,11,2,0,2,4,4,20
95,500,16699,4289,12410,201,12209,363,1578,3068,1486,129,61,37,1153,206,4128
95,504,2658,436,2222,22,2200,56,356,694,274,18,8,7,224,45,518
95,509,2431,563,1868,33,1835,33,348,476,180,22,14,7,166,38,551
95,510,330,58,272,4,268,3,34,79,21,2,3,0,32,8,86
95,523,309,49,260,5,255,13,45,87,28,4,1,1,19,1,56
95,527,1706,419,1287,27,1260,15,338,342,127,12,5,5,94,16,306
95,529,607,76,531,7,524,12,110,164,45,4,4,0,57,15,113
95,535,912,193,719,12,707,20,140,205,90,6,2,2,66,15,161
95,539,8754,2087,6667,116,6551,120,876,2395,737,63,27,11,480,104,1738
95,541,550,130,420,9,411,6,141,91,54,3,4,0,24,5,83
95,543,165,31,134,1,133,3,27,57,10,1,2,2,10,0,21
95,554,754,116,638,9,629,16,111,206,75,11,2,2,66,3,137
95,555,13184,3118,10066,159,9907,184,1332,3010,1107,68,29,27,896,144,3110
95,563,10390,1908,8482,127,8355,226,1166,2497,948,66,27,19,867,152,2387
95,566,1696,368,1328,12,1316,40,242,291,193,19,9,3,109,30,380
95,572,12229,2866,9363,177,9186,181,1474,1785,1210,119,45,12,710,143,3507
95,574,5345,1098,4247,59,4188,93,580,1497,389,37,13,10,444,196,929
95,580,1890,343,1547,20,1527,23,192,768,79,5,2,3,156,21,278
95,582,16421,3750,12671,216,12455,273,1906,3204,1504,122,53,37,1119,205,4032
95,584,486,63,423,9,414,16,74,83,47,6,1,2,40,14,131
95,585,28210,8236,19974,385,19589,214,1964,5247,2236,176,71,33,838,200,8610
95,592,941,160,781,17,764,20,155,244,59,4,2,2,75,24,179
95,594,738,122,616,10,606,10,106,191,69,7,2,0,60,22,139
95,598,11752,2887,8865,147,8718,173,1165,2931,865,76,25,24,797,134,2528
95,604,2460,468,1992,36,1956,41,509,476,203,29,13,3,121,45,516
95,607,17912,4449,13463,265,13198,325,2088,3415,1600,132,70,38,1206,261,4063
95,610,210,26,184,3,181,6,33,69,9,1,0,0,10,4,49
95,611,22,4,18,0,18,2,6,8,0,0,0,0,1,0,1
95,612,2369,475,1894,35,1859,19,491,449,198,19,10,3,113,25,532
95,625,936,178,758,13,745,19,134,225,68,15,4,7,64,17,192
95,627,491,67,424,1,423,12,68,154,20,2,0,0,47,18,102
95,628,1001,171,830,11,819,29,145,246,69,6,3,1,76,11,233
95,633,48,11,37,1,36,0,19,6,2,0,0,0,2,0,7
95,637,10783,2469,8314,236,8078,208,996,1611,976,81,26,27,769,129,3255
95,641,1613,434,1179,18,1161,24,292,252,121,11,5,1,74,35,346
95,651,622,89,533,10,523,33,76,190,31,8,1,2,60,12,110
95,652,3663,664,2999,49,2950,67,661,838,343,23,14,10,246,58,690
95,656,349,43,306,1,305,7,57,137,23,1,1,1,18,7,53
95,658,823,135,688,9,679,15,106,265,54,4,1,1,71,19,143
95,660,470,62,408,5,403,9,80,139,32,5,0,2,37,8,91
95,675,486,73,413,8,405,4,101,99,36,1,3,0,39,16,106
95,676,382,64,318,5,313,9,69,129,28,2,1,0,22,6,47
95,678,595,71,524,4,520,14,86,177,47,3,2,3,48,15,125
95,680,13269,4083,9186,224,8962,104,1292,1588,1146,73,28,13,411,112,4195
95,682,95,11,84,0,84,0,14,25,8,1,0,0,5,0,31
95,690,279,30,249,1,248,6,37,97,18,3,0,0,28,3,56
ZA,101,34547,15393,19154,1603,17551,228,898,3593,811,139,205,61,756,143,10717
ZA,102,4832,2890,1942,93,1849,16,62,492,64,14,7,4,56,10,1124
ZA,103,19599,7881,11718,825,10893,146,584,2645,646,107,111,37,665,113,5839
ZA,104,4733,1977,2756,224,2532,23,126,772,83,20,12,14,94,13,1375
ZA,105,9142,3937,5205,456,4749,66,217,1443,229,46,39,11,194,37,2467
ZA,106,6257,3330,2927,228,2699,63,110,474,125,22,29,7,119,23,1727
ZA,107,14879,7005,7874,589,7285,71,451,1889,333,55,87,17,263,39,4080
ZA,108,3368,2099,1269,129,1140,19,43,351,56,6,9,7,24,14,611
ZA,109,5404,2383,3021,299,2722,63,137,785,169,28,23,14,173,30,1300
ZA,110,1586,938,648,19,629,9,55,143,25,9,6,0,32,6,344
ZA,111,3747,1751,1996,107,1889,24,74,335,114,21,10,4,91,17,1199
ZA,112,5111,3145,1966,164,1802,27,88,414,136,9,13,9,63,13,1030
ZA,113,19104,8754,10350,710,9640,196,541,2632,589,88,86,35,581,95,4797
ZA,114,4709,2356,2353,178,2175,40,146,458,127,20,21,8,94,14,1247
ZA,115,11632,5828,5804,365,5439,73,263,937,557,46,44,17,272,40,3190
ZA,116,13064,6623,6441,401,6040,57,222,989,240,39,62,18,244,53,4116
ZA,117,16746,7705,9041,764,8277,114,475,1617,385,53,68,26,376,85,5078
ZA,118,16041,8094,7947,455,7492,155,400,1834,483,67,55,19,427,81,3971
ZA,119,5937,2999,2938,216,2722,20,127,582,109,16,21,7,130,23,1687
ZA,120,13672,6109,7563,532,7031,114,349,1811,393,50,90,19,318,52,3835
ZA,121,6950,3722,3228,256,2972,45,133,553,122,20,24,10,101,26,1938
ZA,122,4938,2848,2090,125,1965,16,81,250,109,12,19,8,80,17,1373
ZA,124,7958,3157,4801,269,4532,102,247,1280,273,32,27,16,285,36,2234
ZA,125,10336,4021,6315,406,5909,101,446,1732,345,44,48,13,282,60,2838
ZA,126,2923,1859,1064,86,978,15,25,187,26,6,6,5,28,9,671
ZA,128,17917,9077,8840,637,8203,108,423,2100,490,73,77,14,378,71,4469
ZA,129,14156,6992,7164,490,6674,90,371,1245,371,45,61,16,382,57,4036
ZA,130,1652,1181,471,6,465,4,20,66,8,3,1,0,19,6,338
ZA,131,1690,894,796,23,773,15,41,355,27,8,4,2,21,10,290
ZA,132,7083,2914,4169,330,3839,54,219,1024,189,27,40,15,161,26,2084
ZA,133,1514,644,870,44,826,17,20,136,44,7,10,1,43,5,543
ZA,134,6881,3079,3802,335,3467,43,92,849,128,19,20,7,109,13,2187
ZB,201,1513,735,778,61,717,4,38,175,17,16,8,1,46,4,408
ZB,202,3499,1879,1620,72,1548,37,50,310,103,17,12,6,83,18,912
ZB,203,3561,1680,1881,157,1724,15,81,486,59,20,17,4,64,14,964
ZB,204,3083,1343,1740,71,1669,21,72,449,146,22,13,6,94,22,824
ZB,205,3162,1263,1899,96,1803,36,84,566,137,17,14,8,164,26,751
ZB,206,4685,2266,2419,116,2303,48,108,631,178,20,19,5,156,26,1112
ZB,207,11772,5158,6614,484,6130,70,287,1480,391,80,53,28,358,66,3317
ZB,208,813,388,425,21,404,6,15,159,20,11,2,3,15,0,173
ZB,209,65906,32780,33126,2679,30447,492,1451,7600,1923,361,342,129,1843,342,15964
ZB,210,15899,7180,8719,715,8004,73,330,2254,392,73,79,31,378,69,4325
ZB,211,839,456,383,22,361,4,5,72,10,0,1,0,8,1,260
ZB,212,8289,4038,4251,385,3866,54,248,1047,200,62,56,18,227,48,1906
ZB,213,24946,10738,14208,1155,13053,210,722,3480,840,146,141,48,814,153,6499
ZB,214,6719,2605,4114,416,3698,45,196,966,114,35,37,15,192,23,2075
ZB,215,1174,641,533,17,516,1,18,240,16,4,5,0,12,1,219
ZB,216,3230,1460,1770,136,1634,18,53,411,59,20,11,2,86,9,965
ZB,217,6586,3407,3179,220,2959,55,121,641,168,34,33,12,155,29,1711
ZB,218,4580,2058,2522,251,2271,32,109,791,125,20,23,9,145,24,993
ZB,219,1501,797,704,33,671,16,47,202,29,6,11,2,24,3,331
ZB,220,10827,6579,4248,492,3756,32,150,726,224,50,31,9,245,38,2251
ZB,221,9337,4442,4895,436,4459,64,230,1172,273,69,40,15,276,40,2280
ZB,222,17408,7833,9575,911,8664,135,419,2476,435,104,94,40,506,90,4365
ZB,223,7454,3914,3540,232,3308,40,157,872,208,45,28,6,195,27,1730
ZB,224,11689,5503,6186,469,5717,101,339,1735,331,64,58,20,378,75,2616
ZB,225,4018,2123,1895,114,1781,28,102,506,103,29,20,10,113,23,847
ZB,226,4024,2277,1747,101,1646,48,97,363,125,25,18,7,86,16,861
ZB,227,7124,3343,3781,227,3554,82,157,824,256,39,28,13,223,29,1903
ZB,228,16909,8347,8562,828,7734,93,318,1850,244,62,82,21,353,84,4627
ZB,229,15721,6731,8990,605,8385,168,357,2525,618,98,57,43,653,113,3753
ZB,230,9865,4162,5703,413,5290,90,215,1137,316,63,42,15,302,50,3060
ZB,231,5500,2418,3082,150,2932,77,175,825,272,39,25,16,231,45,1227
ZB,232,8126,4315,3811,297,3514,46,142,933,154,37,27,14,159,40,1962
ZB,233,1639,686,953,50,903,25,40,351,65,8,6,2,52,6,348
ZB,234,1505,581,924,75,849,9,27,188,49,16,9,2,45,9,495
ZC,301,627,375,252,3,249,13,38,69,15,2,3,0,11,3,95
ZC,302,22223,11148,11075,537,10538,214,1181,2741,732,150,62,31,654,105,4668
ZC,303,958,445,513,130,383,1,36,137,23,7,2,1,29,1,146
ZC,304,8235,3382,4853,202,4651,127,638,1142,379,61,24,15,374,61,1830
ZC,305,4508,2068,2440,114,2326,30,300,508,224,39,18,13,142,26,1026
ZC,306,1661,924,737,25,712,10,29,139,76,10,6,5,31,7,399
ZC,307,9655,4385,5270,287,4983,87,539,1193,388,68,30,26,319,64,2269
ZC,308,1181,594,587,17,570,16,45,156,13,1,7,3,16,12,301
ZC,309,10050,4186,5864,209,5655,176,579,1500,541,79,24,30,465,68,2193
ZC,310,1499,572,927,36,891,24,95,282,83,10,4,3,51,7,332
ZC,311,7695,4071,3624,104,3520,72,214,1333,307,26,16,7,126,26,1393
ZC,312,1844,1137,707,41,666,7,85,144,36,7,6,1,27,6,347
ZC,313,1040,577,463,12,451,21,68,121,54,4,2,1,25,11,144
ZC,314,59,41,18,0,18,0,2,2,0,1,0,0,2,0,11
ZC,352,128,83,45,3,42,4,7,7,3,1,0,0,2,0,18
ZC,353,1500,1044,456,21,435,11,15,114,22,3,1,5,20,7,237
ZC,356,790,371,419,3,416,11,21,248,8,2,2,5,10,7,102
ZC,357,584,443,141,2,139,4,5,53,7,0,1,0,3,2,64
ZC,358,38,28,10,1,9,0,2,0,0,0,0,0,0,0,7
ZC,360,1108,766,342,4,338,9,7,91,15,7,0,1,7,0,201
ZC,361,528,281,247,2,245,5,14,66,20,1,0,0,9,1,129
ZC,362,963,785,178,3,175,1,0,128,6,0,0,1,6,2,31
ZD,401,7804,2103,5701,180,5521,143,534,961,455,59,21,12,571,58,2707
ZD,402,8840,3220,5620,203,5417,74,544,971,357,42,38,9,351,55,2976
ZD,403,5014,1428,3586,119,3467,80,380,475,252,38,18,9,387,50,1778
ZD,404,10505,2515,7990,354,7636,212,784,1601,679,64,35,17,566,98,3580
ZD,405,9568,3003,6565,242,6323,125,722,1054,453,50,47,19,392,57,3404
ZD,406,3877,1253,2624,106,2518,48,350,549,171,23,14,5,159,30,1169
ZD,407,23512,8182,15330,729,14601,248,1249,1705,1321,149,108,47,571,137,9066
ZD,408,19146,5862,13284,458,12826,306,1252,2193,1140,123,72,43,826,154,6717
ZD,409,32261,12918,19343,759,18584,299,2278,3038,1258,162,112,42,1016,150,10229
ZD,410,25568,9683,15885,587,15298,204,1580,2144,856,123,147,50,618,117,9459
ZD,411,92985,31891,61094,2013,59081,1307,6160,12625,3698,461,327,188,4833,581,28901
ZD,412,27381,6319,21062,716,20346,315,2140,2536,1009,154,95,54,711,152,13180
ZD,413,22993,7297,15696,592,15104,413,1155,2053,1165,133,71,40,2316,127,7631
ZD,414,37895,15805,22090,958,21132,306,2931,3291,1226,152,95,49,1083,205,11794
ZD,415,73179,25970,47209,2219,44990,1291,3684,8516,3309,420,266,143,3841,497,23023
ZD,416,57859,19815,38044,1729,36315,904,3310,8325,2574,358,230,145,1978,347,18144
ZD,417,4479,1659,2820,119,2701,26,313,382,113,17,11,5,80,18,1736
ZD,418,21311,7723,13588,465,13123,266,1492,2520,762,123,75,30,791,117,6947
ZD,419,5845,2302,3543,115,3428,42,341,469,192,28,26,6,129,32,2163
ZD,420,16302,6575,9727,322,9405,168,1031,1295,688,73,64,28,517,75,5466
ZD,421,5653,1991,3662,119,3543,46,335,575,128,23,44,13,140,29,2210
ZD,422,55976,17188,38788,1960,36828,809,4487,7087,2329,355,233,105,2542,486,18395
ZD,423,5594,2179,3415,141,3274,55,276,520,196,24,26,3,287,37,1850
ZD,424,4862,2140,2722,98,2624,50,221,492,172,16,15,4,148,22,1484
ZM,501,2399,1010,1389,124,1265,37,41,504,22,12,15,12,59,26,537
ZM,502,3854,2032,1822,74,1748,26,27,765,29,10,10,9,48,22,802
ZM,503,3624,1653,1971,65,1906,26,32,1235,38,9,12,9,108,19,418
ZM,504,3738,1851,1887,125,1762,20,30,1185,32,10,4,1,53,10,417
ZM,505,4081,1665,2416,152,2264,68,52,1456,42,24,21,10,89,38,464
ZM,506,3910,1835,2075,88,1987,39,16,1099,37,11,5,8,38,16,718
ZM,507,2798,1210,1588,74,1514,30,40,656,45,21,7,9,44,11,651
ZM,508,5962,3503,2459,129,2330,46,110,713,62,25,17,19,159,30,1149
ZM,509,3698,1824,1874,90,1784,31,39,1196,22,14,4,8,39,24,407
ZM,510,5063,2666,2397,86,2311,63,114,882,79,21,14,13,136,38,951
ZM,511,13586,7509,6077,283,5794,168,168,2257,233,52,29,32,343,65,2447
ZM,512,5083,2795,2288,71,2217,24,79,1293,40,19,12,4,72,16,658
ZM,513,4172,2422,1750,95,1655,84,39,667,46,21,17,7,52,34,688
ZM,514,3366,1900,1466,61,1405,23,17,755,31,4,3,4,44,10,514
ZM,515,3753,1820,1933,81,1852,40,102,743,80,12,7,8,121,11,728
ZM,516,4938,2424,2514,58,2456,25,25,1256,56,22,6,13,51,13,989
ZM,517,3388,1612,1776,43,1733,39,65,874,50,12,9,9,49,12,614
ZN,801,832,514,318,3,315,4,3,10,0,0,0,1,11,0,286
ZN,802,2348,865,1483,29,1454,23,283,861,31,13,3,4,43,8,185
ZN,803,3753,1499,2254,65,2189,50,371,1191,96,21,11,4,116,21,308
ZN,804,3025,2017,1008,38,970,32,19,140,32,24,14,3,35,9,662
ZN,805,13336,4706,8630,263,8367,186,1168,5051,240,80,46,30,397,71,1098
ZN,806,497,109,388,16,372,3,97,204,5,2,2,1,20,6,32
ZN,807,2054,1007,1047,10,1037,11,6,63,15,6,2,5,25,7,897
ZN,808,3188,1932,1256,50,1206,33,52,242,28,19,13,3,53,7,756
ZN,809,1499,785,714,14,700,22,20,303,11,5,9,0,33,3,294
ZN,810,1373,946,427,7,420,1,19,134,3,5,2,0,7,3,246
ZN,811,3482,1664,1818,33,1785,50,121,518,66,16,12,2,54,14,932
ZN,812,2454,1034,1420,43,1377,30,216,759,46,16,8,7,54,17,224
ZN,813,2800,893,1907,68,1839,50,363,832,49,24,9,6,95,19,392
ZN,814,10233,7613,2620,27,2593,49,44,448,113,47,23,5,76,12,1776
ZN,815,6246,5240,1006,8,998,16,19,235,24,14,7,6,14,6,657
ZN,816,629,222,407,11,396,7,83,155,19,8,0,2,12,1,109
ZN,817,16552,5878,10674,406,10268,281,1307,5988,316,108,57,25,518,89,1579
ZN,818,54048,16986,37062,813,36249,1095,4831,20820,1308,281,146,111,2348,414,4895
ZN,819,1881,1096,785,13,772,5,131,181,8,7,1,8,22,3,406
ZN,820,4297,3469,828,19,809,29,23,150,21,13,6,2,16,9,540
ZN,821,9613,3327,6286,177,6109,125,764,3653,176,57,40,22,293,64,915
ZN,822,3811,2163,1648,42,1606,43,57,325,85,30,13,4,72,10,967
ZN,823,2295,1260,1035,32,1003,27,23,159,39,13,9,4,37,5,687
ZN,824,2056,1418,638,12,626,8,13,52,26,4,4,3,17,2,497
ZN,825,1127,452,675,18,657,19,74,267,33,2,3,1,28,4,226
ZN,826,1201,772,429,3,426,22,30,119,19,2,5,5,18,5,201
ZN,827,2049,878,1171,26,1145,24,72,467,16,15,8,4,43,5,491
ZN,828,460,249,211,12,199,9,13,53,6,0,2,0,8,1,107
ZN,829,1968,1251,717,38,679,27,41,223,15,10,13,4,31,7,308
ZN,830,1790,1016,774,17,757,10,24,140,23,8,3,1,20,3,525
ZN,831,1991,1079,912,22,890,22,88,259,31,9,2,4,26,2,447
ZN,832,1546,984,562,17,545,21,16,122,10,6,8,1,19,4,338
ZN,833,1033,515,518,17,501,2,18,178,17,9,4,1,18,2,252
ZP,11,562,289,273,12,261,19,6,81,2,1,3,1,4,4,140
ZP,12,7222,3624,3598,73,3525,182,293,1693,105,25,16,18,273,45,875
ZP,13,1404,826,578,24,554,28,20,248,5,0,2,4,54,5,188
ZP,14,6542,3813,2729,66,2663,132,116,1278,61,18,20,9,144,26,859
ZP,15,17270,9114,8156,263,7893,265,498,2598,215,47,52,31,412,137,3638
ZP,16,1238,568,670,10,660,30,21,272,9,6,2,3,111,20,186
ZP,17,264,104,160,0,160,2,16,57,1,1,0,0,10,2,71
ZP,18,513,207,306,2,304,8,3,71,1,1,1,0,33,8,178
ZP,19,698,322,376,9,367,25,12,227,7,2,3,1,12,1,77
ZP,20,1150,577,573,6,567,23,25,169,17,9,9,1,59,9,246
ZP,21,195,81,114,4,110,0,3,45,0,0,0,0,2,2,58
ZP,22,6934,3780,3154,101,3053,95,131,1451,70,21,20,4,88,156,1017
ZP,23,1721,742,979,17,962,28,24,325,18,2,1,2,72,7,483
ZP,24,4847,2648,2199,35,2164,65,54,1039,52,9,10,4,59,33,839
ZP,25,11184,6124,5060,111,4949,225,387,2253,206,30,41,26,287,268,1226
ZP,26,1066,509,557,17,540,18,33,255,11,4,6,0,24,4,185
ZP,27,878,400,478,3,475,2,11,178,5,5,2,1,64,3,204
ZP,28,999,393,606,21,585,12,15,323,10,3,2,1,23,5,191
ZP,29,11956,7103,4853,125,4728,204,283,2144,173,34,26,21,220,72,1551
ZP,30,266,143,123,4,119,0,6,48,0,0,0,0,16,8,41
ZP,31,2041,790,1251,22,1229,33,38,405,24,8,7,3,171,20,520
ZP,32,264,136,128,2,126,6,3,67,0,1,1,0,2,2,44
ZP,33,8161,3570,4591,125,4466,163,270,2061,99,23,26,17,217,159,1431
ZP,34,7378,4072,3306,101,3205,141,173,1446,84,20,32,34,125,73,1077
ZP,35,17946,8838,9108,236,8872,306,585,4181,247,40,51,39,638,211,2574
ZP,36,10456,4800,5656,149,5507,207,364,3064,201,36,29,34,321,153,1098
ZP,37,118,49,69,0,69,2,1,45,0,0,0,0,1,4,16
ZP,38,16788,7427,9361,224,9137,392,756,4330,361,60,35,55,680,161,2307
ZP,39,871,390,481,28,453,35,27,115,7,5,2,2,16,9,235
ZP,40,2484,1267,1217,30,1187,64,79,555,21,9,9,4,55,31,360
ZP,41,386,155,231,1,230,11,4,144,1,0,1,0,2,1,66
ZP,42,437,162,275,13,262,3,9,149,1,1,0,0,4,7,88
ZP,43,708,238,470,7,463,11,14,224,2,1,3,1,10,4,193
ZP,44,1786,597,1189,12,1177,27,24,665,8,1,3,6,21,15,407
ZP,45,4173,2008,2165,49,2116,55,57,843,26,8,13,9,35,22,1048
ZP,46,584,244,340,2,338,3,3,181,4,1,2,0,58,1,85
ZP,47,8913,5193,3720,91,3629,128,241,1545,121,35,16,12,162,292,1077
ZP,48,5227,2932,2295,68,2227,83,103,948,60,13,10,11,120,191,688
ZP,49,1257,630,627,14,613,13,13,289,14,1,1,0,51,3,228
ZP,50,3368,1572,1796,41,1755,59,63,837,63,10,2,1,63,27,630
ZP,51,172,44,128,3,125,1,10,84,0,1,0,1,2,0,26
ZP,52,6371,3362,3009,62,2947,86,146,1411,63,11,16,4,102,230,878
ZP,53,1478,751,727,15,712,25,40,312,21,4,6,1,20,6,277
ZP,54,2992,1630,1362,28,1334,56,48,652,27,9,9,8,48,19,458
ZP,55,236,130,106,1,105,10,4,45,0,5,2,1,0,6,32
ZP,56,479,151,328,1,327,15,3,99,7,1,0,2,59,2,139
ZP,57,1559,671,888,9,879,20,36,382,19,4,12,3,114,4,285
ZP,58,3100,1366,1734,44,1690,74,80,777,43,6,6,3,75,16,610
ZS,501,486,215,271,7,264,1,60,61,41,6,4,0,16,9,66
ZS,502,4437,1978,2459,92,2367,42,356,427,358,97,19,13,178,55,822
ZW,1,8940,2494,6446,39,6407,100,152,2414,76,42,48,29,410,43,3093
ZX,701,4871,2114,2757,39,2718,91,310,1697,135,29,6,5,136,35,274
ZX,801,17814,12294,5520,205,5315,117,665,1807,338,56,38,23,337,57,1877
ZZ,1,157767,104831,52936,542,52394,3231,2998,19755,3729,321,94,171,6574,694,14827
ZZ,2,73912,52648,21264,363,20901,1058,1180,8367,2104,152,74,88,1591,219,6068
ZZ,3,88133,59723,28410,269,28141,1948,927,9443,2117,204,61,88,3904,365,9084
ZZ,4,95182,46980,48202,432,47770,2915,3270,16690,4679,370,166,218,6639,679,12144
ZZ,5,80761,53215,27546,305,27241,1462,2028,10651,2979,253,93,113,2269,324,7069
ZZ,6,79508,29458,50050,514,49536,2441,3982,20335,4187,488,155,200,7168,880,9700
ZZ,7,89643,54981,34662,318,34344,3473,1446,10363,2592,248,97,138,4911,431,10645
ZZ,8,109763,84466,25297,292,25005,1011,1321,12256,1926,203,112,92,1722,315,6047
ZZ,9,98997,59887,39110,321,38789,1010,1395,12307,4378,209,78,87,2615,269,16441
ZZ,10,89859,46782,43077,566,42511,1320,3254,17882,2484,206,101,147,3779,441,12897
ZZ,11,80061,42911,37150,488,36662,2078,2194,15252,2328,189,106,115,4695,431,9274
