Code du département,Code du canton,Inscrits,Abstentions,Votants,Blancs et nuls,Exprimés,JOLY,LE PEN,SARKOZY,MÉLENCHON,POUTOU,ARTHAUD,CHEMINADE,BAYROU,DUPONT-AIGNAN,HOLLANDE
1,1,14828,2631,12197,246,11951,244,2758,2972,1423,142,81,35,1059,286,2951
1,2,11210,1657,9553,265,9288,158,1927,2952,759,83,50,18,1013,211,2117
1,3,10971,2195,8776,165,8611,209,1699,2063,1081,107,56,34,809,159,2394
1,4,12764,1952,10812,254,10558,263,2272,2809,1313,122,52,24,959,224,2520
1,5,8730,2104,6626,112,6514,132,1004,1723,731,60,44,9,593,102,2116
1,6,2854,435,2419,55,2364,73,555,717,267,28,17,5,231,66,405
1,7,6853,905,5948,114,5834,160,1184,1583,611,58,30,13,652,127,1416
1,8,4756,691,4065,61,4004,67,1017,1284,361,39,14,9,359,90,764
1,9,3845,606,3239,60,3179,92,663,860,367,29,26,9,317,74,742
1,10,12910,2041,10869,252,10617,186,2318,3678,822,97,58,36,996,239,2187
1,11,5119,690,4429,98,4331,101,1016,1271,366,40,26,11,418,109,973
1,12,6495,1247,5248,97,5151,176,977,1602,526,77,30,19,590,140,1014
1,13,17720,3647,14073,211,13862,618,1573,4765,1227,136,61,36,1877,263,3306
1,14,17643,3709,13934,235,13699,582,1804,5441,1015,115,48,50,1811,310,2523
1,15,3618,645,2973,74,2899,75,622,814,423,32,28,7,264,53,581
1,16,4049,592,3457,73,3384,81,919,981,347,41,20,10,332,110,543
1,17,14199,2275,11924,259,11665,198,2827,3111,1362,147,67,38,1093,263,2559
1,18,4228,693,3535,77,3458,61,830,1015,333,59,34,13,341,81,691
1,19,14797,2270,12527,216,12311,254,2907,3791,1094,97,50,31,1244,294,2549
1,20,14620,2252,12368,241,12127,218,2801,3588,1115,92,65,25,1177,282,2764
1,21,11821,1665,10156,238,9918,171,2321,2990,781,118,69,25,1104,277,2062
1,22,7809,1354,6455,115,6340,120,1361,1974,713,63,43,11,632,161,1262
1,23,10066,2139,7927,117,7810,149,1590,2324,868,87,34,30,665,157,1906
1,24,5039,736,4303,76,4227,112,978,1161,448,55,18,11,440,95,909
1,25,9589,1260,8329,162,8167,146,1947,2346,811,105,51,18,784,177,1782
1,26,6931,1261,5670,145,5525,95,1355,1549,518,52,47,15,539,161,1194
1,27,9262,1332,7930,187,7743,122,1697,2382,629,95,58,22,794,213,1731
1,28,3715,698,3017,66,2951,55,737,699,384,51,30,8,228,64,695
1,29,4473,790,3683,80,3603,52,905,1070,268,52,28,8,366,92,762
1,30,10485,1550,8935,144,8791,148,2224,3059,612,74,56,15,885,198,1520
1,31,4239,772,3467,68,3399,64,747,792,410,47,20,15,298,81,925
1,32,10724,1750,8974,184,8790,186,2136,3051,651,99,48,23,835,227,1534
1,33,6082,884,5198,114,5084,143,1020,1416,568,58,29,25,582,101,1142
1,34,12396,1866,10530,178,10352,243,2040,3237,971,95,55,21,1087,219,2384
1,35,7040,1013,6027,111,5916,119,1400,1952,492,58,37,16,506,151,1185
1,36,3311,451,2860,61,2799,82,617,645,303,44,18,12,276,61,741
1,37,6808,1591,5217,95,5122,108,689,1524,557,49,31,12,466,75,1611
1,38,7789,1693,6096,109,5987,166,810,1629,695,52,38,17,606,91,1883
1,39,10315,1433,8882,171,8711,188,1657,2679,727,83,45,27,926,216,2163
1,40,14581,2464,12117,213,11904,275,2221,3862,1117,76,45,26,1182,217,2883
1,41,10284,2336,7948,147,7801,117,1560,2255,886,77,40,15,610,138,2103
1,42,16230,1999,14231,273,13958,281,2814,4733,1119,127,48,36,1504,309,2987
1,43,12610,1722,10888,234,10654,178,2041,3373,827,105,49,20,1200,244,2617
2,1,7641,1224,6417,93,6324,96,1557,1383,710,105,55,9,427,134,1848
2,2,2489,430,2059,32,2027,15,614,603,174,27,13,2,147,44,388
2,3,9778,1988,7790,164,7626,64,2126,1620,806,108,76,13,436,139,2238
2,4,8284,1390,6894,123,6771,81,2102,1673,578,91,53,19,456,150,1568
2,5,6065,992,5073,119,4954,51,1494,1410,339,55,42,19,314,104,1126
2,6,6172,955,5217,94,5123,38,1611,1246,632,53,42,16,294,93,1098
2,7,9860,1827,8033,149,7884,130,2250,2142,725,106,51,20,637,181,1642
2,8,20332,4251,16081,297,15784,262,3573,3821,1869,229,134,51,1285,357,4203
2,9,17276,3535,13741,253,13488,139,3690,2958,1605,180,96,34,935,288,3563
2,10,6413,1107,5306,111,5195,81,1427,1443,551,60,40,20,415,133,1025
2,11,8579,1470,7109,141,6968,89,1991,1607,796,99,69,12,400,148,1757
2,12,4241,536,3705,62,3643,50,952,850,403,41,27,12,226,92,990
2,13,5618,822,4796,82,4714,57,1342,941,432,52,53,9,250,80,1498
2,14,8524,1768,6756,109,6647,67,1766,1478,740,93,63,14,379,137,1910
2,15,6578,1042,5536,101,5435,80,1623,1389,482,70,50,17,409,112,1203
2,16,7578,1316,6262,95,6167,43,1615,1419,541,73,52,16,340,127,1941
2,17,13850,3768,10082,150,9932,90,2699,2164,1141,135,80,28,548,165,2882
2,18,10474,2296,8178,133,8045,111,1868,1828,827,99,64,16,584,126,2522
2,19,5283,836,4447,76,4371,44,1111,1021,396,78,47,6,237,78,1353
2,20,6077,836,5241,74,5167,47,1404,1359,432,48,43,20,396,131,1287
2,21,7243,1175,6068,119,5949,59,1555,1631,491,102,61,15,474,134,1427
2,22,7358,1417,5941,81,5860,107,1792,1485,616,79,57,8,400,111,1205
2,23,4789,869,3920,93,3827,28,1121,1086,276,49,31,7,230,54,945
2,24,4199,640,3559,53,3506,46,1090,911,323,62,31,14,211,56,762
2,25,6418,1088,5330,76,5254,51,1476,1212,510,74,56,16,262,89,1508
2,26,5676,1034,4642,68,4574,50,1249,1188,327,76,51,10,327,89,1207
2,27,3351,468,2883,67,2816,21,767,753,188,39,26,4,188,47,783
2,28,11840,2640,9200,149,9051,108,1834,2722,798,74,54,23,729,147,2562
2,29,8562,1419,7143,106,7037,46,1986,1538,784,82,56,20,366,167,1992
2,30,7369,1294,6075,104,5971,69,1662,1418,516,97,51,8,398,149,1603
2,31,15217,3469,11748,208,11540,127,2934,2923,1173,127,76,23,823,190,3144
2,32,7518,1161,6357,113,6244,68,1821,1444,585,88,56,15,458,142,1567
2,33,7477,1000,6477,107,6370,71,1579,1800,588,54,32,15,502,120,1609
2,34,5969,996,4973,91,4882,46,1264,1337,456,64,53,11,285,100,1266
2,35,7889,1307,6582,86,6496,82,1842,1677,640,66,49,16,470,122,1532
2,36,10453,2119,8334,168,8166,119,2120,2124,839,125,76,24,531,155,2053
2,37,4769,918,3851,64,3787,19,1213,797,311,66,38,12,195,85,1051
2,38,15823,3465,12358,198,12160,183,2568,2909,1321,171,101,24,948,223,3712
2,39,15585,3153,12432,216,12216,160,2818,3314,1056,122,76,25,807,222,3616
2,40,17487,3679,13808,211,13597,155,3353,2787,1637,160,119,28,797,241,4320
2,41,17105,4068,13037,195,12842,134,3106,3230,1343,146,94,41,921,245,3582
2,42,12859,3160,9699,165,9534,71,2487,1449,1403,135,96,26,458,146,3263
3,1,4823,688,4135,119,4016,146,596,801,948,49,26,6,304,89,1051
3,2,4865,748,4117,91,4026,76,787,1050,643,51,28,9,323,92,967
3,3,4190,633,3557,107,3450,62,629,961,435,50,40,10,315,82,866
3,4,5616,894,4722,131,4591,57,850,1113,555,64,33,8,409,85,1417
3,5,6002,1097,4905,112,4793,54,770,817,827,64,51,10,333,79,1788
3,6,9468,1482,7986,184,7802,131,1562,1898,943,84,48,21,705,148,2262
3,7,6735,1250,5485,150,5335,60,1020,1240,603,63,52,12,440,100,1745
3,8,3897,621,3276,85,3191,14,679,700,358,42,38,6,288,82,984
3,9,3623,610,3013,74,2939,60,523,757,416,42,28,9,247,52,805
3,10,15563,2186,13377,324,13053,224,2687,3718,1232,147,74,25,1176,263,3507
3,11,7486,1358,6128,134,5994,92,1163,1484,702,83,49,11,566,113,1731
3,12,6870,938,5932,160,5772,100,1056,1251,934,86,33,12,536,113,1651
3,13,6064,1015,5049,125,4924,75,1022,883,778,70,48,10,434,95,1509
3,14,3458,572,2886,93,2793,34,598,696,343,35,21,5,235,67,759
3,15,7012,1158,5854,162,5692,77,1269,1342,618,77,56,8,530,140,1575
3,16,3643,631,3012,66,2946,31,627,719,491,42,21,3,204,66,742
3,17,4766,682,4084,120,3964,66,735,967,516,60,31,13,438,82,1056
3,18,3762,656,3106,80,3026,84,660,709,333,62,20,6,337,72,743
3,19,3815,540,3275,86,3189,50,543,717,695,45,28,7,284,63,757
3,20,10917,2312,8605,218,8387,121,1261,2060,1258,103,63,13,759,134,2615
3,21,9181,2092,7089,151,6938,98,1135,1475,1070,79,56,15,506,106,2398
3,22,5956,934,5022,110,4912,53,971,1032,935,73,41,14,462,101,1230
3,23,9745,2338,7407,150,7257,112,1109,1882,837,59,39,23,633,133,2430
3,24,11043,2149,8894,181,8713,126,1482,2048,1112,106,47,8,780,174,2830
3,25,3964,603,3361,92,3269,33,631,759,434,37,28,11,252,92,992
3,26,8445,1338,7107,175,6932,111,1431,1739,866,119,61,21,570,145,1869
3,27,5038,724,4314,91,4223,148,706,892,746,51,25,11,407,87,1150
3,28,10642,1596,9046,217,8829,103,1977,1880,1105,136,83,25,675,196,2649
3,29,9038,2101,6937,128,6809,119,1243,2445,513,58,33,15,608,131,1644
3,30,8562,2089,6473,113,6360,117,1012,2114,582,66,27,14,629,131,1668
3,31,7435,1721,5714,138,5576,55,966,1199,934,81,39,11,366,83,1842
3,32,12202,2373,9829,236,9593,165,1354,2405,1421,110,52,24,853,198,3011
3,33,12670,1912,10758,232,10526,190,1565,2250,1447,117,63,24,878,185,3807
3,34,8932,1675,7257,184,7073,59,1252,1323,1200,75,42,15,493,120,2494
3,35,10847,1550,9297,240,9057,129,1865,2151,1139,98,58,22,839,169,2587
4,2,1893,304,1589,31,1558,47,382,414,216,26,11,2,128,25,307
4,3,2463,339,2124,31,2093,76,396,533,332,25,13,4,146,40,528
4,4,5436,998,4438,110,4328,151,750,1446,566,69,25,14,423,90,794
4,5,1228,199,1029,16,1013,39,256,246,156,14,7,1,59,17,218
4,6,2040,300,1740,32,1708,52,349,452,214,31,10,4,126,32,438
4,7,2023,337,1686,29,1657,50,342,535,245,27,7,2,106,23,320
4,8,6910,1482,5428,117,5311,189,1055,1283,695,75,27,20,394,81,1492
4,9,1228,174,1054,17,1037,28,253,294,137,14,5,1,66,15,224
4,10,10741,1793,8948,144,8804,325,1695,2124,1514,130,41,28,647,144,2156
4,11,1624,207,1417,34,1383,55,278,291,220,21,6,7,96,23,386
4,12,1216,223,993,13,980,36,185,239,136,22,3,3,85,25,246
4,13,8903,1641,7262,151,7111,203,1400,1895,952,67,29,20,561,117,1867
4,14,8321,1379,6942,148,6794,125,1641,1641,1014,95,45,18,471,143,1601
4,15,1784,237,1547,38,1509,48,319,329,268,21,5,2,74,24,419
4,16,2141,289,1852,39,1813,67,422,447,240,22,7,1,129,50,428
4,17,1029,166,863,9,854,39,117,236,163,28,7,1,56,14,193
4,18,1182,171,1011,29,982,62,214,240,145,14,3,4,58,15,227
4,19,3066,513,2553,63,2490,65,615,565,356,29,11,4,171,47,627
4,20,2939,494,2445,35,2410,99,453,605,485,36,12,2,173,40,505
4,21,4294,659,3635,84,3551,88,763,985,518,57,15,12,207,65,841
4,22,1432,196,1236,21,1215,24,272,337,165,23,11,2,92,27,262
4,23,2548,328,2220,35,2185,76,461,530,427,25,10,10,144,40,462
4,26,2545,446,2099,45,2054,57,382,552,306,43,13,6,171,48,476
4,27,6763,1128,5635,137,5498,128,1096,1436,752,77,23,17,469,111,1389
4,28,995,138,857,16,841,33,167,191,148,12,6,2,73,21,188
4,29,5226,872,4354,88,4266,115,1016,1205,555,54,15,9,302,88,907
4,30,8814,1273,7541,175,7366,155,1554,1554,1272,97,42,23,513,137,2019
4,31,9701,1637,8064,185,7879,229,1573,1757,1260,110,35,20,639,125,2131
4,32,6219,1188,5031,103,4928,104,1140,1172,907,48,9,17,297,76,1158
4,33,9229,1923,7306,136,7170,168,1329,2134,905,82,34,27,607,142,1742
5,1,1858,279,1579,35,1544,62,127,519,269,27,12,3,166,28,331
5,2,5354,969,4385,87,4298,230,604,926,762,92,31,10,385,80,1178
5,3,1825,290,1535,38,1497,49,317,309,248,21,15,1,131,20,386
5,4,329,35,294,4,290,10,52,61,62,4,3,0,16,6,76
5,5,3778,438,3340,77,3263,102,750,762,421,29,11,3,338,93,754
5,6,3734,740,2994,67,2927,161,445,661,498,44,8,10,283,53,764
5,7,3839,531,3308,57,3251,89,697,859,409,46,13,7,329,65,737
5,8,8446,1605,6841,141,6700,289,1063,1948,915,96,42,19,610,141,1577
5,9,4048,562,3486,62,3424,105,683,874,424,36,14,5,387,82,814
5,10,719,132,587,10,577,42,73,203,67,9,6,3,56,8,110
5,11,4967,809,4158,95,4063,150,728,1272,521,65,22,11,375,87,832
5,12,4642,700,3942,96,3846,67,848,898,579,53,23,10,343,93,932
5,13,3165,504,2661,63,2598,122,424,876,294,36,12,4,223,64,543
5,14,1574,219,1355,26,1329,34,250,407,162,23,5,3,149,52,244
5,15,1001,117,884,8,876,31,144,158,165,15,8,1,88,23,243
5,16,1404,193,1211,22,1189,69,237,241,236,11,5,5,103,16,266
5,17,1029,131,898,12,886,29,175,202,145,10,7,3,82,23,210
5,18,6245,874,5371,111,5260,162,965,1621,571,77,28,19,484,103,1230
5,19,892,159,733,11,722,18,143,207,84,11,2,0,104,10,143
5,20,1615,236,1379,29,1350,34,276,351,191,8,9,5,111,21,344
5,21,1642,247,1395,26,1369,64,228,357,199,26,9,1,157,34,294
5,22,2175,343,1832,44,1788,79,320,434,315,22,14,5,134,40,425
5,23,4779,602,4177,92,4085,157,842,1131,458,50,24,8,452,105,858
5,24,3454,484,2970,56,2914,103,448,515,652,33,39,6,276,67,775
5,25,7590,1555,6035,149,5886,265,934,1420,954,105,41,16,491,109,1551
5,26,5773,1227,4546,84,4462,175,662,1288,562,47,17,13,545,62,1091
5,27,4666,930,3736,69,3667,117,622,824,507,31,18,10,421,61,1056
5,28,2843,539,2304,39,2265,77,335,617,270,21,9,10,255,54,617
5,29,6231,1376,4855,113,4742,102,872,1250,550,51,22,7,491,72,1325
5,30,7248,1420,5828,119,5709,153,1095,1464,685,53,19,14,574,110,1542
6,1,26000,5182,20818,307,20511,525,3954,8492,1551,145,57,45,1572,329,3841
6,2,25212,4292,20920,335,20585,769,3585,7971,1688,154,58,58,1935,360,4007
6,3,7994,2734,5260,73,5187,83,1293,2054,396,36,21,13,285,84,922
6,4,2831,584,2247,40,2207,61,528,466,387,28,13,4,124,49,547
6,5,28021,5432,22589,433,22156,423,5965,8492,1429,128,66,33,1430,330,3860
6,6,18784,4256,14528,143,14385,228,2469,7886,668,44,19,20,769,180,2102
6,7,12847,2350,10497,185,10312,164,3330,2566,1708,75,26,25,509,159,1750
6,8,2155,340,1815,26,1789,59,505,557,181,18,14,5,109,32,309
6,9,7405,1227,6178,100,6078,116,2050,1633,831,44,23,11,321,84,965
6,10,22707,4265,18442,292,18150,425,4491,6167,1603,159,53,38,1390,314,3510
6,11,2978,572,2406,32,2374,57,578,773,238,23,5,6,175,43,476
6,12,16195,2479,13716,203,13513,265,4138,4324,1292,100,44,32,853,228,2237
6,13,17604,3633,13971,222,13749,275,3496,5073,1071,121,55,33,816,288,2521
6,14,11293,2618,8675,126,8549,271,1708,2840,1012,58,27,19,526,122,1966
6,15,12538,2840,9698,129,9569,246,1639,3638,873,56,26,30,734,170,2157
6,16,21702,4627,17075,287,16788,300,4756,4829,1965,130,42,27,894,232,3613
6,17,11176,2843,8333,114,8219,202,1334,3630,602,25,24,20,516,84,1782
6,18,2608,412,2196,43,2153,55,560,570,345,24,7,9,124,42,417
6,19,2891,457,2434,44,2390,51,609,714,311,21,6,2,154,48,474
6,20,3603,661,2942,56,2886,62,852,759,344,27,16,8,171,52,595
6,21,2679,438,2241,30,2211,79,627,636,214,22,8,7,157,47,414
6,22,2403,459,1944,29,1915,43,398,798,169,22,9,3,139,40,294
6,23,1700,224,1476,19,1457,22,312,632,116,8,1,0,84,27,255
6,24,2815,475,2340,25,2315,70,578,724,236,23,8,5,150,45,476
6,25,16423,2647,13776,219,13557,348,3406,4853,1090,98,37,26,1095,262,2342
6,26,3442,653,2789,54,2735,72,735,776,312,27,13,4,195,62,539
6,27,2247,383,1864,22,1842,29,563,524,191,13,9,4,102,28,379
6,28,21158,3755,17403,283,17120,502,3508,6390,1433,124,42,34,1462,327,3298
6,29,2717,459,2258,38,2220,57,678,618,286,22,9,1,106,47,396
6,30,16080,3350,12730,186,12544,244,3050,5642,739,81,25,26,790,201,1746
6,31,2300,492,1808,34,1774,78,417,583,178,22,7,3,105,50,331
6,32,18532,4063,14469,219,14250,311,3122,4736,1411,105,49,27,949,184,3356
6,33,17179,3874,13305,209,13096,262,2858,4634,1201,81,44,33,853,166,2964
6,34,20770,4726,16044,208,15836,283,3301,7058,991,92,45,29,1060,204,2773
6,35,30295,6598,23697,401,23296,466,5040,9243,1885,171,55,37,1550,355,4494
6,36,29464,5738,23726,399,23327,371,5916,9154,1673,174,51,38,1333,349,4268
6,37,14911,2884,12027,157,11870,249,2630,4642,830,65,19,27,840,181,2387
6,38,12851,3131,9720,160,9560,198,1831,3865,802,49,25,17,645,133,1995
6,39,21884,4230,17654,262,17392,335,4307,6301,1474,106,36,40,1163,276,3354
6,40,21284,4307,16977,199,16778,295,3760,6927,1067,88,26,38,1164,253,3160
6,41,19467,3899,15568,226,15342,281,4022,4842,1376,94,46,32,1086,220,3343
6,42,12674,2995,9679,145,9534,141,2401,3005,982,71,23,27,432,98,2354
6,43,17230,3842,13388,192,13196,192,3974,3291,1697,88,43,23,666,160,3062
6,44,13883,3602,10281,204,10077,115,2731,2565,1027,77,34,17,419,128,2964
6,45,29319,5970,23349,386,22963,510,5166,9494,1518,151,38,45,1703,435,3903
6,46,33707,6516,27191,402,26789,661,5667,10890,1892,208,62,70,1993,455,4891
6,47,20005,4201,15804,233,15571,320,3127,6586,1097,94,37,37,1189,250,2834
6,48,18711,4010,14701,165,14536,262,3659,5937,936,79,27,27,912,226,2471
6,49,20364,4444,15920,234,15686,316,3380,6865,1019,93,40,31,1026,215,2701
6,50,12334,2561,9773,180,9593,222,2591,2755,1149,106,37,24,594,164,1951
6,51,15644,3766,11878,160,11718,331,2679,3681,1254,97,29,35,895,182,2535
6,52,14272,2887,11385,193,11192,254,2708,4657,753,81,40,33,716,241,1709
7,1,13757,2668,11089,238,10851,226,2126,2795,1360,156,80,27,1082,227,2772
7,2,2508,385,2123,41,2082,99,404,314,490,31,17,3,164,29,531
7,3,14754,2787,11967,231,11736,323,2093,2955,1672,138,57,31,1050,198,3219
7,4,12083,1878,10205,173,10032,204,2726,2378,1228,100,52,29,761,205,2349
7,5,1249,226,1023,47,976,29,230,264,105,6,4,3,99,22,214
7,6,5269,861,4408,120,4288,96,728,1171,509,70,37,20,503,99,1055
7,7,7620,1112,6508,132,6376,130,1496,1288,948,112,35,15,517,142,1693
7,8,1939,311,1628,34,1594,17,405,488,129,11,5,6,189,22,322
7,9,8075,1244,6831,134,6697,278,1061,1661,1104,101,37,15,541,99,1800
7,10,5254,702,4552,84,4468,138,777,1205,567,63,39,12,465,95,1107
7,11,6087,993,5094,84,5010,208,870,1106,878,102,33,10,400,86,1317
7,12,1812,303,1509,25,1484,47,357,405,166,14,5,4,148,36,302
7,13,14422,2551,11871,245,11626,385,1978,2414,1746,145,61,28,1035,228,3606
7,14,6025,1006,5019,107,4912,85,1169,877,932,59,24,15,330,101,1320
7,15,3353,575,2778,77,2701,50,424,685,308,53,27,14,281,50,809
7,16,865,132,733,12,721,17,141,227,60,10,1,2,113,5,145
7,17,3154,429,2725,57,2668,86,543,754,307,42,17,4,310,64,541
7,18,2877,438,2439,57,2382,61,374,610,334,35,16,4,278,39,631
7,19,20543,2688,17855,341,17514,481,3161,5122,1695,182,88,54,1897,357,4477
7,20,2691,419,2272,50,2222,85,366,515,342,31,17,5,165,48,648
7,21,6339,791,5548,126,5422,131,1310,1229,704,87,52,17,610,116,1166
7,22,8855,1239,7616,170,7446,154,1651,1900,833,85,67,18,781,181,1776
7,23,6286,972,5314,98,5216,187,1047,1121,956,81,22,14,366,75,1347
7,24,18005,2730,15275,272,15003,360,3049,3819,1796,195,75,36,1522,307,3844
7,25,930,144,786,7,779,53,99,121,196,13,4,0,63,11,219
7,26,7046,1142,5904,111,5793,183,1135,1354,1008,81,43,8,405,100,1476
7,27,7282,1089,6193,111,6082,283,906,1309,1235,82,44,20,435,87,1681
7,28,3313,456,2857,57,2800,102,404,683,450,56,25,6,214,62,798
7,29,7896,990,6906,140,6766,200,1351,1394,1174,99,36,5,589,133,1785
7,30,10802,1920,8882,148,8734,191,2198,1688,1304,98,39,22,647,162,2385
7,31,11366,1880,9486,198,9288,233,1964,1928,1345,142,71,22,842,187,2554
7,32,11603,1993,9610,192,9418,284,2075,2052,1191,180,79,33,1010,202,2312
7,33,9291,1506,7785,154,7631,215,1598,1855,1175,90,48,19,561,115,1955
8,1,4138,650,3488,58,3430,36,923,1092,244,52,30,9,297,68,679
8,2,2379,380,1999,28,1971,26,541,557,146,28,25,9,179,38,422
8,3,1624,288,1336,25,1311,21,300,480,68,25,9,2,139,24,243
8,4,6965,1522,5443,86,5357,58,1398,1328,473,72,42,16,459,95,1416
8,5,8524,1769,6755,91,6664,132,1117,1930,583,73,39,15,667,97,2011
8,6,2971,506,2465,41,2424,23,586,791,182,33,19,3,220,53,514
8,7,2060,375,1685,19,1666,18,481,536,91,12,12,4,99,36,377
8,8,2077,368,1709,34,1675,25,401,514,149,23,19,5,162,43,334
8,9,8041,1278,6763,91,6672,78,1709,1560,694,84,56,10,509,128,1844
8,10,4825,1182,3643,56,3587,22,799,808,382,52,20,15,151,43,1295
8,11,9799,2166,7633,107,7526,68,1580,1536,830,94,47,18,511,151,2691
8,12,1735,277,1458,23,1435,29,348,451,80,24,11,6,137,36,313
8,13,3777,520,3257,48,3209,41,725,1122,180,26,21,5,384,62,643
8,14,1711,225,1486,22,1464,6,346,601,63,18,15,4,163,33,215
8,15,9020,2159,6861,110,6751,116,1515,1636,685,67,52,16,478,144,2042
8,16,8768,1915,6853,119,6734,84,1907,1193,877,87,62,22,302,80,2120
8,17,2084,306,1778,27,1751,14,524,541,125,16,11,4,159,49,308
8,18,4452,777,3675,61,3614,29,889,861,331,63,46,4,299,88,1004
8,19,3735,623,3112,52,3060,48,928,839,215,53,35,11,290,68,573
8,20,2008,304,1704,25,1679,24,484,454,112,19,5,9,165,46,361
8,21,2943,492,2451,37,2414,27,612,563,244,29,20,3,244,60,612
8,22,6009,879,5130,88,5042,48,1513,1318,386,49,37,15,363,89,1224
8,23,9558,1980,7578,138,7440,84,1766,2103,592,101,48,21,663,164,1898
8,24,5709,1224,4485,70,4415,35,1269,1129,322,58,32,10,271,100,1189
8,25,3182,535,2647,44,2603,35,780,735,171,31,23,6,213,62,547
8,26,7268,1586,5682,88,5594,78,1205,1445,505,55,38,19,411,101,1737
8,27,9027,2043,6984,113,6871,71,1616,1585,654,88,59,16,455,118,2209
8,28,3136,505,2631,55,2576,35,719,650,208,35,23,7,236,44,619
8,29,2792,590,2202,38,2164,33,685,480,200,24,18,4,129,37,554
8,30,1095,142,953,13,940,23,247,267,57,7,10,4,101,24,200
8,31,4529,838,3691,58,3633,50,924,933,265,58,33,4,291,72,1003
8,32,8865,2116,6749,115,6634,103,1303,1650,641,63,45,11,500,93,2225
8,33,9294,2809,6485,92,6393,77,1464,1046,707,110,41,12,373,89,2474
8,34,6652,1454,5198,89,5109,57,1309,783,630,75,32,13,274,69,1867
8,35,5290,1557,3733,74,3659,37,783,590,480,50,20,2,158,59,1480
8,36,10650,2219,8431,135,8296,97,2030,1703,873,124,66,13,532,118,2740
8,37,9887,1949,7938,110,7828,80,1902,1714,815,103,64,19,567,106,2458
9,1,2487,398,2089,33,2056,48,341,405,322,31,11,2,124,38,734
9,2,1853,291,1562,39,1523,120,139,257,331,32,7,6,130,14,487
9,3,2446,381,2065,34,2031,27,347,306,325,32,17,7,124,35,811
9,4,2985,517,2468,38,2430,94,333,397,496,30,24,8,164,27,857
9,5,6616,1130,5486,79,5407,164,646,1002,907,64,28,10,379,74,2133
9,6,4804,615,4189,90,4099,174,698,794,739,38,30,8,273,52,1293
9,7,10245,1877,8368,188,8180,161,1822,1623,1232,89,48,19,423,113,2650
9,8,3445,561,2884,59,2825,133,374,445,573,39,9,6,185,52,1009
9,9,1926,432,1494,21,1473,101,178,226,380,43,16,2,81,20,426
9,10,10249,1568,8681,176,8505,211,1478,1704,1536,150,46,17,590,137,2636
9,11,2747,461,2286,23,2263,106,340,383,422,32,2,9,120,32,817
9,12,7637,1469,6168,132,6036,123,1151,1312,897,74,20,20,387,89,1963
9,13,492,80,412,7,405,8,53,67,65,5,0,2,15,5,185
9,14,1821,257,1564,40,1524,74,235,280,292,20,13,4,127,22,457
9,15,7752,1398,6354,135,6219,218,814,1156,1064,104,31,16,434,106,2276
9,16,5909,894,5015,79,4936,147,806,963,770,81,32,13,381,82,1661
9,17,8105,1248,6857,128,6729,129,1407,1487,888,89,39,7,485,115,2083
9,18,6727,1027,5700,87,5613,142,832,921,980,90,37,11,321,70,2209
9,19,7810,1121,6689,118,6571,137,1148,1129,1248,96,45,15,463,106,2184
9,20,1423,206,1217,12,1205,27,148,150,249,12,6,3,72,16,522
9,21,8870,1175,7695,148,7547,248,1050,1242,1311,133,39,19,532,90,2883
9,22,10021,1396,8625,154,8471,150,1785,1730,1170,112,28,17,601,151,2727
10,1,3980,635,3345,55,3290,46,848,918,316,32,17,8,267,77,761
10,2,7106,1195,5911,106,5805,59,1758,1804,329,70,37,9,504,158,1077
10,3,8340,1771,6569,142,6427,74,1750,2013,568,72,37,17,439,145,1312
10,4,7300,1406,5894,108,5786,74,1561,1973,410,54,35,10,418,126,1125
10,5,8090,1067,7023,110,6913,112,1787,2111,516,85,54,15,612,153,1468
10,6,5703,955,4748,95,4653,59,1331,1418,341,47,42,11,381,95,928
10,7,3709,603,3106,54,3052,36,886,1030,233,41,13,7,243,62,501
10,8,1766,326,1440,23,1417,13,432,462,83,13,13,2,130,37,232
10,9,4289,687,3602,54,3548,58,1009,1027,285,41,29,15,268,85,731
10,10,3489,600,2889,66,2823,42,636,1197,156,21,11,4,232,68,456
10,11,4535,727,3808,54,3754,69,943,1077,305,36,27,12,334,79,872
10,12,7289,985,6304,124,6180,82,1823,1848,432,61,38,15,544,124,1213
10,13,5219,842,4377,77,4300,48,1157,1433,330,48,28,16,365,126,749
10,14,7237,1049,6188,119,6069,59,1924,1753,400,68,50,15,479,138,1183
10,15,2540,393,2147,36,2111,26,589,801,107,16,12,13,147,56,344
10,16,7857,1533,6324,653,5671,63,1588,1701,468,52,26,13,464,138,1158
10,17,3781,581,3200,65,3135,45,904,981,195,27,24,7,299,67,586
10,18,2901,509,2392,43,2349,20,720,896,104,34,10,11,200,60,294
10,19,1862,317,1545,35,1510,11,388,701,56,6,5,5,117,40,181
10,20,6756,1310,5446,93,5353,63,1519,1452,538,53,29,14,371,119,1195
10,21,2229,343,1886,39,1847,13,547,672,97,17,16,7,175,50,253
10,22,8033,1727,6306,101,6205,107,1374,1714,499,61,34,15,542,109,1750
10,23,10130,1796,8334,141,8193,125,1951,2364,632,67,54,13,771,189,2027
10,24,7187,1572,5615,84,5531,125,966,1757,443,45,30,14,510,121,1520
10,25,3935,644,3291,73,3218,31,928,1031,215,47,30,11,253,61,611
10,26,2892,488,2404,40,2364,40,702,710,196,25,11,6,168,60,446
10,27,6905,1785,5120,85,5035,71,1218,948,801,46,30,14,326,84,1497
10,28,11671,2323,9348,181,9167,169,1825,2743,739,86,46,26,892,210,2431
10,29,10151,1940,8211,149,8062,82,2027,2154,650,74,47,22,661,178,2167
10,30,5496,1144,4352,60,4292,108,620,1657,344,32,22,10,426,69,1004
10,31,13548,2975,10573,149,10424,178,2101,3146,845,115,43,16,948,203,2829
10,32,11740,2315,9425,163,9262,140,2066,2842,761,87,58,21,809,181,2297
10,33,5924,1396,4528,89,4439,46,862,862,466,53,32,13,280,56,1769
11,1,3946,540,3406,73,3333,72,679,640,428,49,10,10,217,59,1169
11,2,6576,813,5763,116,5647,123,1428,1210,633,82,20,11,327,77,1736
11,3,1555,293,1262,20,1242,26,222,206,197,19,8,2,65,16,481
11,4,1790,331,1459,29,1430,63,289,331,184,12,8,5,79,22,437
11,5,1722,244,1478,42,1436,50,293,344,185,20,7,3,121,26,387
11,6,10047,1454,8593,162,8431,115,2160,1563,1116,103,37,10,427,96,2804
11,7,14255,2381,11874,221,11653,225,2755,2453,1368,116,45,14,714,169,3794
11,8,10158,1875,8283,161,8122,145,1935,1696,1017,96,25,18,458,122,2610
11,9,7310,1059,6251,115,6136,148,1318,1370,778,84,35,21,514,106,1762
11,10,11297,1763,9534,205,9329,150,1999,2261,979,121,55,16,669,187,2892
11,11,2543,420,2123,50,2073,80,330,415,329,30,19,6,118,27,719
11,12,8301,983,7318,141,7177,132,1806,1522,833,78,46,12,451,84,2213
11,13,3226,538,2688,60,2628,123,481,440,453,35,10,5,161,51,869
11,14,20694,3152,17542,323,17219,278,4456,3722,2529,209,90,47,952,231,4705
11,15,3189,479,2710,48,2662,64,540,488,411,28,12,8,122,39,950
11,16,5097,664,4433,104,4329,87,971,971,479,64,35,11,252,75,1384
11,17,12137,1621,10516,184,10332,189,2498,2008,1467,157,71,28,692,174,3048
11,18,2664,391,2273,48,2225,85,343,343,450,21,11,3,139,23,807
11,19,16024,2582,13442,291,13151,191,3402,2447,1842,148,69,20,659,192,4181
11,20,12029,1912,10117,197,9920,229,2022,2235,1298,135,46,28,569,142,3216
11,21,1893,269,1624,30,1594,57,315,277,241,27,7,3,87,22,558
11,22,5410,656,4754,74,4680,103,1149,978,559,71,28,13,304,71,1404
11,23,1313,216,1097,28,1069,55,151,167,251,24,7,5,50,25,334
11,24,14409,2938,11471,230,11241,198,2371,2889,1453,116,42,18,654,165,3335
11,25,9669,1548,8121,174,7947,178,1761,1636,1061,82,48,16,446,111,2608
11,26,6409,1227,5182,105,5077,140,1067,1075,854,118,27,8,299,77,1412
11,27,2501,325,2176,27,2149,74,426,447,257,34,13,7,156,28,707
11,28,2503,368,2135,45,2090,76,480,438,258,24,9,5,163,36,601
11,29,1737,191,1546,27,1519,45,256,357,206,21,3,6,131,34,460
11,30,18228,3023,15205,267,14938,280,4286,3613,1591,207,70,36,867,239,3749
11,31,1608,250,1358,28,1330,40,184,237,299,24,13,7,78,15,433
11,32,7241,1789,5452,97,5355,135,1088,1580,582,54,20,6,355,52,1483
11,33,19169,3245,15924,322,15602,260,3869,3132,2197,177,85,26,947,205,4704
11,34,11207,2836,8371,171,8200,210,1709,2190,1055,93,54,15,569,113,2192
11,35,6431,1265,5166,84,5082,90,1195,1120,616,45,31,9,264,73,1639
12,1,7577,1254,6323,106,6217,78,752,805,1504,81,33,14,421,77,2452
12,2,2223,352,1871,52,1819,65,246,435,251,24,14,4,303,32,445
12,3,5728,619,5109,102,5007,121,694,1405,589,49,23,10,676,103,1337
12,4,2139,339,1800,44,1756,46,292,483,212,26,17,5,228,16,431
12,5,1500,205,1295,33,1262,31,178,395,154,15,7,2,157,16,307
12,6,6664,927,5737,157,5580,118,725,1094,848,75,33,18,563,119,1987
12,7,4630,525,4105,121,3984,87,550,1134,415,55,14,4,577,68,1080
12,8,2322,336,1986,53,1933,49,273,580,161,20,15,5,318,40,472
12,9,1709,261,1448,30,1418,51,243,337,212,17,7,0,181,29,341
12,10,7633,1330,6303,126,6177,104,807,1178,1087,80,32,13,499,81,2296
12,11,2093,324,1769,37,1732,40,242,571,177,24,10,5,212,35,416
12,12,5768,878,4890,110,4780,94,706,1696,400,53,22,7,652,100,1050
12,13,2530,380,2150,50,2100,43,318,766,162,23,11,5,357,31,384
12,14,2002,246,1756,39,1717,23,280,764,87,15,14,4,252,33,245
12,15,3727,451,3276,76,3200,55,546,1013,310,46,18,3,393,58,758
12,16,7915,978,6937,173,6764,199,768,1573,936,114,35,17,899,93,2130
12,17,6691,1391,5300,135,5165,223,920,1014,802,104,39,19,462,69,1513
12,18,5606,731,4875,157,4718,87,635,1075,535,55,36,11,715,87,1482
12,19,2554,392,2162,52,2110,23,258,960,178,19,9,1,220,36,406
12,20,3417,466,2951,89,2862,101,343,641,360,42,20,8,457,57,833
12,21,2772,381,2391,52,2339,94,484,592,337,35,15,4,211,38,529
12,22,4256,619,3637,104,3533,57,429,844,356,49,13,5,532,36,1212
12,23,2056,284,1772,33,1739,54,284,397,257,26,6,5,186,38,486
12,24,5602,651,4951,135,4816,88,819,1347,452,54,32,15,707,91,1211
12,25,4313,626,3687,103,3584,65,545,1083,311,53,17,11,548,72,879
12,26,3705,518,3187,74,3113,71,412,730,315,52,16,12,495,63,947
12,27,4223,482,3741,94,3647,86,406,901,404,40,17,15,559,67,1152
12,28,9394,1533,7861,162,7699,215,800,2248,837,75,27,19,1035,135,2308
12,29,9686,1359,8327,230,8097,225,1266,1819,1190,148,49,23,855,139,2383
12,30,2000,343,1657,49,1608,14,253,651,124,17,6,1,216,31,295
12,31,1891,247,1644,50,1594,60,277,339,252,24,15,1,167,27,432
12,32,698,101,597,14,583,13,89,208,42,9,2,3,108,11,98
12,33,1858,298,1560,31,1529,13,288,619,82,10,14,5,217,35,246
12,34,2789,441,2348,64,2284,32,391,814,194,31,4,7,308,38,465
12,35,2665,409,2256,74,2182,62,370,561,285,37,9,5,313,45,495
12,36,3000,460,2540,61,2479,71,374,654,266,51,12,6,338,46,661
12,37,2196,308,1888,49,1839,25,279,683,125,30,9,3,283,36,366
12,38,1748,266,1482,32,1450,32,198,347,156,21,8,1,209,25,453
12,39,7097,907,6190,177,6013,125,781,1607,650,65,30,20,890,115,1730
12,40,3394,452,2942,65,2877,65,495,686,329,46,19,10,347,38,842
12,41,1448,178,1270,31,1239,38,214,385,105,12,11,2,220,37,215
12,42,12716,2469,10247,283,9964,225,1240,2191,1209,145,53,28,1007,155,3711
12,43,3820,517,3303,84,3219,87,432,738,343,52,14,6,380,48,1119
12,44,14093,2205,11888,258,11630,303,1912,2606,1659,171,70,23,1175,207,3504
12,45,14739,2112,12627,276,12351,269,1572,3004,1369,108,51,25,1725,198,4030
12,46,11760,1544,10216,212,10004,216,1233,2378,1253,119,41,25,1236,144,3359
13,1,40057,7289,32768,429,32339,1129,4139,11968,3105,157,59,88,3290,464,7940
13,2,47722,9309,38413,554,37859,1058,6554,12077,4233,249,128,96,3328,485,9651
13,3,31120,5305,25815,449,25366,461,6462,6364,3379,236,122,59,1615,348,6320
13,4,17941,3572,14369,254,14115,305,3460,3057,2298,168,61,19,686,160,3901
13,5,29776,5662,24114,422,23692,461,5833,5747,4557,199,89,37,1319,334,5116
13,6,24034,4697,19337,315,19022,248,5682,4156,2774,182,90,40,1018,310,4522
13,7,27352,4632,22720,402,22318,399,6658,6808,2140,184,92,44,1447,392,4154
13,8,30883,5826,25057,406,24651,565,5790,7409,3138,221,78,51,1522,359,5518
13,9,18426,3193,15233,273,14960,322,4163,4127,1659,173,45,40,1183,338,2910
13,10,35121,6648,28473,454,28019,615,6446,7489,4128,224,113,59,2033,428,6484
13,11,23675,4838,18837,382,18455,280,5748,3693,2692,204,83,47,1061,257,4390
13,12,20733,3439,17294,305,16989,460,3425,5104,1896,157,59,45,1510,291,4042
13,13,14582,3423,11159,137,11022,465,1525,2536,2016,101,39,18,581,107,3634
13,14,17441,3764,13677,169,13508,521,1919,3552,2252,126,45,27,918,163,3985
13,16,13875,3604,10271,137,10134,292,1501,1794,1874,83,36,19,395,68,4072
13,17,12888,3625,9263,120,9143,154,1823,1484,1597,61,57,21,275,83,3588
13,18,18994,3994,15000,172,14828,635,2301,3405,2595,119,43,29,898,140,4663
13,19,16853,3269,13584,184,13400,436,2372,3227,2303,94,41,35,776,155,3961
13,21,17755,4688,13067,185,12882,141,2957,2529,1971,70,50,16,485,115,4548
13,22,22140,4128,18012,267,17745,339,3847,6375,1779,111,39,18,1244,236,3757
13,23,20425,4682,15743,251,15492,248,4174,3993,2018,145,52,34,798,177,3853
13,24,22396,4189,18207,178,18029,376,2447,8789,1449,98,25,32,1265,186,3362
13,25,26297,4488,21809,390,21419,406,5133,4700,4541,208,121,54,1167,285,4804
13,26,18396,3128,15268,297,14971,301,4537,4359,1446,129,65,35,885,277,2937
13,27,14454,2620,11834,207,11627,269,2741,3128,1357,96,57,44,876,206,2853
13,28,6309,1032,5277,110,5167,44,1521,680,1640,59,34,15,150,55,969
13,29,35192,5337,29855,517,29338,670,7476,7757,4196,250,116,78,2153,462,6180
13,30,2676,374,2302,34,2268,53,621,998,132,22,10,5,90,31,306
13,31,13354,2142,11212,188,11024,266,2505,3973,1136,98,29,33,753,149,2082
13,32,32595,6075,26520,474,26046,533,6336,7791,2508,231,106,68,2081,462,5930
13,33,13092,2686,10406,188,10218,192,3275,2755,1021,104,32,29,651,181,1978
13,34,24322,3790,20532,357,20175,628,4197,5615,2617,180,75,61,1669,352,4781
13,35,25670,4200,21470,388,21082,372,5826,6692,2236,132,62,43,1409,262,4048
13,36,26839,5338,21501,491,21010,230,7369,5375,2125,165,63,43,1043,267,4330
13,37,18041,3418,14623,172,14451,529,2587,5207,1624,90,37,30,955,155,3237
13,38,17733,5483,12250,185,12065,135,2642,1524,2216,79,43,21,318,88,4999
13,39,19694,4867,14827,205,14622,255,3483,1886,3013,99,65,26,469,109,5217
13,40,19178,4555,14623,221,14402,190,3767,2882,2020,95,47,29,573,153,4646
13,41,20564,3733,16831,278,16553,252,4756,4406,1915,92,50,28,888,214,3952
13,42,18137,3922,14215,215,14000,172,4029,2898,2228,108,50,24,633,211,3647
13,43,25174,5239,19935,315,19620,255,5398,4757,2691,165,75,39,975,247,5018
13,44,23517,4250,19267,268,18999,528,3674,6263,2265,142,53,41,1428,208,4397
13,45,19274,4860,14414,192,14222,186,3255,2238,2259,88,54,20,516,117,5489
13,46,24531,4726,19805,238,19567,402,4143,6054,2304,137,44,39,1296,250,4898
13,47,23587,5585,18002,256,17746,573,2599,5128,2311,132,44,52,1414,243,5250
13,48,37496,6451,31045,529,30516,481,8531,9197,3772,231,94,47,1723,452,5988
13,49,39182,7513,31669,607,31062,526,8385,6514,4766,446,163,77,1789,424,7972
13,50,18700,3807,14893,238,14655,160,3456,2174,4620,135,77,35,528,142,3328
13,51,36215,6147,30068,465,29603,664,6687,9580,2754,219,94,69,2657,500,6379
13,52,33099,6689,26410,411,25999,406,7341,7461,3431,150,69,46,1524,349,5222
13,53,24337,5068,19269,317,18952,266,5170,4219,2553,177,87,48,1068,291,5073
13,54,31908,5251,26657,401,26256,608,5990,9443,2858,169,57,63,1821,371,4876
13,55,19816,4283,15533,237,15296,335,3682,3982,2119,112,44,26,876,190,3930
13,56,21410,3539,17871,240,17631,319,4069,6291,1789,93,55,34,1290,247,3444
13,57,17938,4913,13025,182,12843,136,3097,1972,2135,90,64,19,405,118,4807
13,58,22221,4299,17922,259,17663,307,3709,6383,1682,107,37,35,1127,251,4025
13,59,19629,3848,15781,194,15587,418,2135,6210,1586,101,22,19,1235,172,3689
14,1,6406,1114,5292,97,5195,124,1244,1254,472,81,36,16,502,135,1331
14,2,8016,1375,6641,117,6524,112,1413,1655,642,98,62,15,673,177,1677
14,3,14722,2535,12187,186,12001,263,1664,3388,1224,192,85,25,1419,265,3476
14,4,6373,1075,5298,93,5205,98,1080,1449,452,83,37,12,558,131,1305
14,5,5777,770,5007,74,4933,77,960,1892,335,59,26,13,508,117,946
14,6,17655,2169,15486,242,15244,255,2586,3317,1769,229,128,34,1489,335,5102
14,7,10832,1359,9473,171,9302,160,1851,1958,1095,160,91,19,854,177,2937
14,8,11258,1709,9549,135,9414,329,732,3026,901,97,21,19,1184,165,2940
14,9,15616,2803,12813,193,12620,339,1558,2719,1497,175,93,28,1466,228,4517
14,10,3934,627,3307,51,3256,87,680,1126,311,46,16,6,309,85,590
14,11,4574,763,3811,61,3750,62,841,992,344,62,27,13,404,105,900
14,12,5876,913,4963,75,4888,89,984,1246,419,54,47,20,471,126,1432
14,13,16267,2127,14140,214,13926,368,1717,4103,1381,142,70,36,1606,254,4249
14,14,19196,3161,16035,226,15809,428,2066,4503,1667,185,76,38,1723,316,4807
14,15,11734,1960,9774,146,9628,155,1722,3036,1405,112,61,24,798,193,2122
14,16,16314,1927,14387,291,14096,341,1872,3603,1471,169,72,40,1753,302,4473
14,17,8346,1231,7115,114,7001,106,1356,1542,804,116,59,23,683,148,2164
14,18,6529,1334,5195,93,5102,96,888,1246,450,63,50,13,507,77,1712
14,19,12510,2444,10066,151,9915,161,1774,3219,906,117,62,30,910,250,2486
14,20,7996,1632,6364,94,6270,68,1570,2061,505,74,54,14,496,150,1278
14,21,9788,1558,8230,127,8103,154,1553,2679,682,110,44,12,884,167,1818
14,22,7620,1873,5747,98,5649,77,1082,1378,578,79,50,10,451,131,1813
14,23,5041,861,4180,80,4100,77,901,1418,341,46,33,9,355,97,823
14,24,7661,1290,6371,83,6288,109,1439,1504,638,118,52,13,513,128,1774
14,25,3915,638,3277,46,3231,43,746,902,316,46,29,13,294,85,757
14,26,7094,1323,5771,101,5670,96,1453,1720,498,100,47,16,460,144,1136
14,27,7904,1313,6591,109,6482,97,1150,2585,525,65,39,10,641,145,1225
14,28,9599,1382,8217,122,8095,158,1378,2554,710,104,41,26,797,171,2156
14,29,5755,1304,4451,71,4380,60,950,1372,381,66,46,11,349,64,1081
14,30,5456,944,4512,90,4422,70,786,1369,405,63,35,12,528,120,1034
14,31,7392,1101,6291,103,6188,103,1288,1558,691,91,47,17,562,139,1692
14,32,12194,1619,10575,188,10387,218,1660,2693,1033,128,85,38,1139,230,3163
14,33,5955,878,5077,79,4998,96,1089,1552,432,73,27,12,460,158,1099
14,34,17621,2572,15049,253,14796,208,2629,3198,1898,186,108,38,1392,264,4875
14,35,17069,3627,13442,191,13251,233,2054,6149,807,126,45,32,964,225,2616
14,36,4407,675,3732,93,3639,74,822,946,347,64,35,9,421,122,799
14,37,7758,1062,6696,117,6579,108,1430,1596,657,96,58,15,686,178,1755
14,38,13335,2321,11014,271,10743,182,1585,3027,1005,156,83,30,1127,233,3315
14,39,11393,1985,9408,131,9277,349,688,2770,1020,109,37,21,1114,118,3051
14,40,6751,1331,5420,73,5347,180,459,1231,650,71,20,19,568,86,2063
14,41,10152,2181,7971,110,7861,217,834,1078,1275,117,34,16,920,96,3274
14,42,8343,1514,6829,91,6738,267,599,1506,857,99,37,14,876,96,2387
14,43,9614,1732,7882,144,7738,165,1126,1365,1152,131,78,16,662,116,2927
14,44,11677,2047,9630,146,9484,359,815,2418,1379,120,31,16,1000,192,3154
14,45,7989,1788,6201,80,6121,199,735,1172,825,98,40,15,601,89,2347
14,46,14518,2594,11924,193,11731,252,1706,2447,1435,150,69,44,1114,215,4299
14,47,16530,2817,13713,218,13495,224,2173,3654,1588,185,94,42,1112,255,4168
14,48,18421,3160,15261,232,15029,331,2056,4200,1589,182,76,29,1528,254,4784
14,49,9664,1980,7684,153,7531,145,1382,2369,632,92,48,15,731,173,1944
15,1,2236,505,1731,27,1704,29,287,532,131,20,10,6,229,20,440
15,2,5842,1064,4778,84,4694,93,460,1128,536,59,17,7,495,64,1835
15,3,8287,1296,6991,165,6826,78,992,1546,734,78,32,17,658,123,2568
15,4,2459,427,2032,45,1987,43,261,494,220,34,14,0,197,30,694
15,5,2028,320,1708,26,1682,22,278,778,85,20,7,3,217,21,251
15,6,2447,518,1929,45,1884,26,318,568,134,25,12,8,259,34,500
15,7,3675,565,3110,49,3061,47,488,847,317,26,16,8,310,65,937
15,8,3444,568,2876,63,2813,39,506,908,243,26,16,6,362,52,655
15,9,6018,1067,4951,114,4837,59,810,1284,482,75,37,6,492,88,1504
15,10,5071,771,4300,111,4189,84,534,1167,425,53,21,10,548,62,1285
15,11,3921,591,3330,85,3245,51,516,1112,238,28,29,8,395,71,797
15,12,5154,798,4356,80,4276,71,649,1512,291,46,36,11,477,50,1133
15,13,2197,391,1806,44,1762,28,291,775,83,21,8,4,227,24,301
15,14,2958,546,2412,69,2343,31,402,617,209,21,14,1,224,31,793
15,15,4159,848,3311,55,3256,55,504,910,296,43,22,9,354,59,1004
15,16,2655,508,2147,35,2112,17,368,650,140,43,9,7,316,37,525
15,17,5108,897,4211,103,4108,69,599,900,381,57,27,13,390,101,1571
15,18,2188,427,1761,30,1731,9,313,561,135,12,9,3,186,25,478
15,19,6012,921,5091,118,4973,73,896,1493,364,56,24,7,711,70,1279
15,20,6565,1001,5564,118,5446,68,869,1744,414,79,34,18,812,97,1311
15,21,4954,675,4279,125,4154,70,635,1173,326,59,28,14,456,97,1296
15,22,3046,531,2515,65,2450,33,342,844,184,33,17,8,278,42,669
15,23,4630,690,3940,75,3865,71,670,1248,317,45,29,14,394,68,1009
15,24,6228,1365,4863,120,4743,96,579,1104,486,63,29,14,370,57,1945
15,25,7565,1332,6233,115,6118,138,810,1630,666,66,36,15,671,82,2004
15,26,7250,1071,6179,134,6045,86,913,1562,605,71,24,13,611,91,2069
15,27,4865,673,4192,90,4102,48,587,1064,394,59,30,10,341,69,1500
16,1,3816,588,3228,82,3146,46,572,843,295,44,20,3,238,53,1032
16,2,8223,1969,6254,97,6157,171,819,1566,723,83,29,9,574,86,2097
16,3,8618,2146,6472,120,6352,177,857,1540,732,76,25,19,554,94,2278
16,4,2388,397,1991,46,1945,39,385,461,193,33,17,4,179,46,588
16,5,3260,542,2718,61,2657,41,543,623,283,53,24,6,266,50,768
16,6,7541,1357,6184,135,6049,100,1092,1584,582,90,52,17,596,145,1791
16,7,6480,1075,5405,139,5266,118,1002,1217,547,87,35,13,487,128,1632
16,8,1772,325,1447,32,1415,43,287,282,182,31,16,4,134,32,404
16,9,6063,985,5078,124,4954,49,764,872,837,89,36,16,439,116,1736
16,10,3552,768,2784,60,2724,50,559,668,242,35,18,11,226,57,858
16,11,2069,393,1676,41,1635,19,291,306,196,32,17,5,143,45,581
16,12,6157,1058,5099,113,4986,77,1095,1316,430,68,36,14,475,106,1369
16,13,11963,2326,9637,176,9461,200,1550,2604,929,129,63,25,892,207,2862
16,14,3469,488,2981,78,2903,49,518,544,419,65,18,8,241,78,963
16,15,4774,775,3999,90,3909,60,663,800,611,72,36,9,321,90,1247
16,16,9612,1447,8165,130,8035,130,1602,1864,756,106,50,18,772,137,2600
16,17,9759,1715,8044,162,7882,144,1416,2046,695,118,47,19,682,161,2554
16,18,6698,1079,5619,148,5471,65,1115,1235,615,85,38,10,475,96,1737
16,19,5592,814,4778,136,4642,89,857,1101,497,62,40,10,362,113,1511
16,20,3076,564,2512,78,2434,46,416,563,340,41,19,14,174,60,761
16,21,3709,683,3026,68,2958,69,514,737,300,50,30,7,276,68,907
16,22,14452,2202,12250,283,11967,196,2177,2486,1458,196,110,26,943,258,4117
16,23,5841,964,4877,88,4789,85,1016,1028,496,69,35,19,360,115,1566
16,24,6423,1155,5268,126,5142,69,886,1145,682,72,28,28,453,115,1664
16,25,7159,1125,6034,132,5902,118,1314,1280,694,95,51,9,445,144,1752
16,26,8431,1532,6899,164,6735,68,1164,1302,869,114,75,22,552,131,2438
16,27,9465,1654,7811,137,7674,127,1476,2148,683,145,66,18,804,184,2023
16,28,5905,863,5042,106,4936,97,1007,1209,593,58,30,10,414,101,1417
16,29,4433,704,3729,112,3617,69,679,815,388,46,35,13,342,72,1158
16,30,18516,3355,15161,304,14857,251,2657,3108,1617,205,89,38,1358,248,5286
16,31,14665,2586,12079,240,11839,224,1801,2326,1594,154,75,29,1038,240,4358
16,32,10232,1990,8242,162,8080,158,1487,1705,924,98,33,18,672,160,2825
16,33,12815,2407,10408,367,10041,169,1685,2577,1128,163,76,23,902,212,3106
16,34,9371,2507,6864,103,6761,206,844,1707,809,70,25,16,503,101,2480
16,35,14466,2103,12363,225,12138,224,2011,2683,1368,150,66,13,1169,229,4225
17,1,9725,1537,8188,164,8024,162,1616,1797,998,141,56,11,731,170,2342
17,2,5304,949,4355,108,4247,67,919,1222,371,93,25,12,430,100,1008
17,3,4405,641,3764,64,3700,93,403,1773,270,35,18,7,304,58,739
17,4,5149,1008,4141,100,4041,52,780,1115,344,79,41,19,322,110,1179
17,5,5308,831,4477,84,4393,77,795,1093,488,68,29,5,418,88,1332
17,6,8055,1520,6535,114,6421,145,1128,2243,698,87,30,12,486,104,1488
17,7,9566,1433,8133,183,7950,197,1540,1944,862,109,40,15,797,187,2259
17,8,10002,1685,8317,215,8102,169,1796,2635,612,113,60,15,696,201,1805
17,9,9795,1641,8154,202,7952,141,1772,2310,727,129,53,21,682,208,1909
17,10,17750,2733,15017,309,14708,334,2151,3700,1718,214,89,19,1414,336,4733
17,11,8005,1493,6512,169,6343,111,1118,1722,621,86,30,19,677,128,1831
17,12,3909,685,3224,68,3156,51,601,781,355,47,30,12,242,78,959
17,13,8909,1541,7368,154,7214,126,1427,1753,765,112,40,18,690,182,2101
17,14,11317,2175,9142,184,8958,151,2036,2640,881,139,75,29,704,202,2101
17,15,7292,1260,6032,127,5905,88,1174,1491,588,91,48,8,541,145,1731
17,16,6016,1073,4943,112,4831,76,1202,1292,449,82,32,12,458,112,1116
17,17,5107,854,4253,77,4176,65,822,1024,401,69,26,9,365,90,1305
17,18,7675,1409,6266,152,6114,102,1544,1396,632,98,52,16,458,140,1676
17,19,4966,824,4142,86,4056,70,892,910,413,77,33,5,371,89,1196
17,20,9476,1669,7807,197,7610,114,1622,2018,761,137,46,16,744,205,1947
17,21,10903,1749,9154,156,8998,179,1529,2659,846,96,28,24,813,178,2646
17,22,7154,1878,5276,103,5173,133,911,1189,684,80,30,14,394,102,1636
17,23,6473,1495,4978,78,4900,167,628,1107,633,57,17,12,388,57,1834
17,24,4996,1287,3709,74,3635,84,583,625,508,47,27,12,245,50,1454
17,25,14945,2989,11956,223,11733,216,1946,4368,851,113,41,31,981,243,2943
17,26,10583,1619,8964,194,8770,187,1975,2459,858,148,49,30,798,223,2043
17,27,5947,1006,4941,109,4832,69,1099,1391,437,71,33,20,457,107,1148
17,28,3637,657,2980,65,2915,59,646,681,274,41,11,8,274,49,872
17,29,12777,2534,10243,218,10025,214,1892,2589,990,164,84,22,821,232,3017
17,30,11171,1658,9513,172,9341,266,1190,3822,734,86,40,23,845,156,2179
17,31,11045,2070,8975,174,8801,202,1661,2951,899,137,51,20,677,167,2036
17,32,10233,1632,8601,212,8389,177,1916,2335,771,160,57,36,765,203,1969
17,33,5539,973,4566,82,4484,97,956,1136,485,85,41,20,426,92,1146
17,34,12709,2621,10088,200,9888,271,1364,2543,1280,144,46,13,1015,194,3018
17,35,12548,2330,10218,218,10000,203,1748,2409,1213,139,52,24,951,233,3028
17,36,14568,2503,12065,244,11821,189,2479,3444,977,184,71,25,1048,307,3097
17,37,11302,1922,9380,203,9177,153,1547,2251,1112,153,67,33,876,178,2807
17,38,2655,440,2215,56,2159,33,402,602,228,45,18,7,203,55,566
17,39,10550,2007,8543,194,8349,147,1910,1943,942,142,71,23,720,203,2248
17,40,11901,2155,9746,165,9581,177,2022,3162,820,115,51,36,811,218,2169
17,41,5423,1464,3959,57,3902,109,515,831,465,63,17,5,319,61,1517
17,42,8981,1781,7200,82,7118,353,397,2485,680,56,23,9,820,83,2212
17,43,17736,3086,14650,259,14391,269,2221,5867,966,143,48,27,1294,265,3291
17,44,14122,2231,11891,225,11666,313,1565,3004,1299,154,43,16,1120,249,3903
17,45,10326,2318,8008,121,7887,344,761,1774,1156,107,35,14,705,101,2890
17,46,14174,2535,11639,191,11448,283,1419,3190,1351,121,58,29,1062,214,3721
17,47,7995,1896,6099,106,5993,155,944,1620,690,88,30,8,553,108,1797
17,48,7165,1276,5889,89,5800,193,596,1412,707,71,30,9,554,96,2132
17,49,11624,2053,9571,186,9385,241,1097,2374,1132,120,43,17,941,150,3270
17,50,14091,2300,11791,188,11603,319,1383,3239,1247,128,48,21,1135,205,3878
17,51,10943,2052,8891,215,8676,185,1436,2110,1124,128,48,20,840,188,2597
18,1,9622,1584,8038,180,7858,102,1576,1778,1189,94,64,28,685,168,2174
18,2,4190,766,3424,76,3348,35,802,1130,270,56,17,3,304,87,644
18,3,5314,1033,4281,70,4211,53,915,1274,354,61,22,7,349,109,1067
18,4,7383,1042,6341,138,6203,82,1485,1680,714,69,57,19,640,157,1300
18,5,6188,1811,4377,113,4264,97,524,1043,665,35,28,8,380,60,1424
18,6,2023,328,1695,41,1654,21,372,453,199,25,18,0,138,41,387
18,7,3151,528,2623,69,2554,29,645,651,269,38,33,10,223,59,597
18,8,10579,1887,8692,176,8516,92,1637,1870,1366,126,63,26,696,188,2452
18,9,4289,787,3502,81,3421,34,750,887,404,42,30,8,303,89,874
18,10,3599,631,2968,52,2916,56,665,614,429,43,27,3,258,49,772
18,11,2150,325,1825,44,1781,29,419,412,223,25,22,2,155,42,452
18,12,4922,948,3974,104,3870,44,884,1014,408,63,33,16,368,77,963
18,13,2738,421,2317,39,2278,22,527,556,380,36,22,9,160,41,525
18,14,6981,1318,5663,92,5571,76,1349,1125,748,76,44,16,443,134,1560
18,15,2800,499,2301,46,2255,53,456,553,339,42,17,1,200,62,532
18,16,4868,841,4027,78,3949,59,896,1021,420,35,41,15,341,111,1010
18,17,8425,1205,7220,142,7078,103,1359,1678,937,74,42,12,701,156,2016
18,18,3148,491,2657,50,2607,48,631,563,368,31,13,9,223,66,655
18,19,4798,750,4048,75,3973,60,940,972,688,42,31,12,339,64,825
18,20,8493,1512,6981,163,6818,88,1314,1675,1020,102,45,9,582,142,1841
18,21,3492,625,2867,96,2771,36,714,753,271,27,22,4,214,63,667
18,22,12450,2665,9785,203,9582,136,1859,2421,1104,146,81,26,763,223,2823
18,23,10020,1448,8572,178,8394,155,1673,2270,939,101,57,24,829,174,2172
18,24,5915,954,4961,98,4863,53,1114,1185,619,59,33,12,350,133,1305
18,25,7563,1236,6327,113,6214,96,1356,2062,601,68,55,17,552,132,1275
18,26,4185,751,3434,70,3364,40,835,849,371,41,29,10,269,81,839
18,27,2716,404,2312,43,2269,49,543,546,236,31,24,3,249,42,546
18,28,2857,467,2390,55,2335,31,557,728,228,25,13,4,212,45,492
18,29,10913,2763,8150,126,8024,104,1458,1387,1886,79,73,15,511,128,2383
18,30,14793,3057,11736,184,11552,209,2344,2394,2442,162,109,20,825,202,2845
18,31,7754,2059,5695,166,5529,125,700,1565,790,61,35,15,511,114,1613
18,32,13036,3507,9529,231,9298,240,1202,2368,1247,83,47,20,985,172,2934
18,33,10260,2522,7738,229,7509,150,1068,1965,1013,60,34,20,816,139,2244
18,34,7611,2055,5556,175,5381,104,743,1357,792,53,42,11,485,70,1724
18,35,11691,2075,9616,211,9405,150,1513,2532,1150,107,64,19,989,205,2676
19,1,5115,740,4375,87,4288,81,459,872,517,42,22,6,260,57,1972
19,2,7094,870,6224,133,6091,72,914,1399,596,58,25,8,421,103,2495
19,3,3311,377,2934,48,2886,57,340,661,312,36,9,8,185,64,1214
19,4,2997,350,2647,52,2595,41,350,534,246,24,8,5,191,48,1148
19,5,3853,643,3210,70,3140,34,461,744,245,43,18,7,226,53,1309
19,6,7249,1524,5725,116,5609,85,681,1679,400,32,24,7,461,99,2141
19,7,1918,266,1652,39,1613,13,190,325,387,28,11,2,109,34,514
19,8,2957,333,2624,62,2562,57,318,590,277,33,5,8,191,38,1045
19,9,8881,1082,7799,144,7655,95,1183,1628,758,70,25,14,557,130,3195
19,10,4935,662,4273,94,4179,51,530,928,493,66,22,10,272,63,1744
19,11,2053,250,1803,38,1765,13,267,315,164,31,8,3,170,41,753
19,12,4421,515,3906,84,3822,47,580,725,417,37,17,6,232,59,1702
19,13,1543,183,1360,25,1335,33,164,283,155,22,7,1,100,23,547
19,14,9300,1177,8123,172,7951,89,1316,1646,832,71,28,12,584,123,3250
19,15,5865,811,5054,116,4938,58,630,1220,328,47,29,12,380,99,2135
19,16,2305,367,1938,34,1904,21,264,437,193,27,18,2,151,29,762
19,17,3766,550,3216,55,3161,53,420,685,472,29,14,3,223,53,1209
19,18,4488,502,3986,70,3916,83,545,902,395,52,15,6,334,61,1523
19,19,3100,425,2675,76,2599,52,376,546,340,30,11,2,171,39,1032
19,20,2880,302,2578,48,2530,34,280,481,364,24,6,8,161,41,1131
19,21,3011,404,2607,58,2549,25,286,654,235,30,14,6,191,25,1083
19,22,5834,683,5151,111,5040,62,548,907,743,38,18,7,331,95,2291
19,23,1912,256,1656,24,1632,25,177,346,267,21,9,2,97,18,670
19,24,4161,532,3629,102,3527,41,375,830,473,37,20,9,258,88,1396
19,25,5604,961,4643,75,4568,83,372,731,438,52,10,9,268,61,2544
19,26,4255,785,3470,54,3416,33,357,521,311,29,10,4,152,40,1959
19,27,4998,847,4151,97,4054,38,608,949,385,50,22,7,262,77,1656
19,28,5427,785,4642,94,4548,65,690,1023,526,43,17,14,306,91,1773
19,29,3152,342,2810,66,2744,36,352,558,313,13,6,3,191,37,1235
19,30,9394,1681,7713,167,7546,96,1138,1606,673,66,31,16,531,138,3251
19,31,5693,1489,4204,75,4129,69,474,1447,324,42,20,10,346,65,1332
19,32,7033,1594,5439,108,5331,69,798,1088,545,47,27,5,300,70,2382
19,33,7971,1497,6474,132,6342,87,995,1417,701,55,25,13,430,89,2530
19,34,11859,1390,10469,225,10244,112,1531,2384,860,102,37,24,782,172,4240
19,35,6645,667,5978,101,5877,92,610,901,742,54,21,6,308,82,3061
19,36,7275,800,6475,138,6337,94,693,960,702,60,22,7,406,92,3301
19,37,4446,690,3756,84,3672,59,512,784,333,40,28,5,286,80,1545
2A,1,6691,1495,5196,79,5117,129,939,2051,415,39,10,14,332,59,1129
2A,2,2910,699,2211,34,2177,70,495,615,300,28,7,9,142,28,483
2A,6,7351,2012,5339,77,5262,131,1527,1434,511,81,19,10,283,42,1224
2A,7,2432,549,1883,34,1849,49,458,654,194,13,0,3,86,18,374
2A,22,3352,797,2555,50,2505,55,609,913,244,42,8,1,171,33,429
2A,30,4212,1115,3097,60,3037,76,849,867,267,43,13,7,147,27,741
2A,34,1822,506,1316,25,1291,20,278,424,198,11,4,2,78,13,263
2A,35,2726,732,1994,36,1958,81,411,636,152,18,7,4,75,19,555
2A,40,11208,2913,8295,151,8144,194,1935,2942,673,93,13,16,588,108,1582
2A,48,7827,1843,5984,110,5874,116,1424,2283,461,55,15,11,319,67,1123
2A,51,2413,694,1719,31,1688,30,456,573,110,44,7,5,100,25,338
2A,53,3081,732,2349,59,2290,37,475,619,465,27,5,3,123,30,506
2A,55,1787,491,1296,19,1277,27,248,488,145,15,5,5,66,17,261
2A,61,3227,938,2289,38,2251,45,507,814,135,38,10,8,97,22,575
2A,62,1872,621,1251,22,1229,15,212,655,72,8,4,1,54,8,200
2A,63,2270,603,1667,27,1640,47,307,639,137,21,2,2,95,13,377
2A,64,4375,1095,3280,65,3215,92,641,1006,351,48,10,12,165,42,848
2A,65,3276,918,2358,29,2329,44,712,638,204,24,8,7,126,19,547
2A,66,4482,1138,3344,45,3299,50,1061,870,300,34,10,4,141,26,803
2A,70,3055,773,2282,28,2254,52,557,769,202,22,14,2,124,46,466
2A,72,10217,2986,7231,127,7104,91,2429,1666,750,75,30,15,334,61,1653
2A,73,11096,2523,8573,148,8425,207,2551,2067,905,94,19,22,423,74,2063
2B,3,3207,711,2496,45,2451,75,416,778,296,30,4,9,147,17,679
2B,4,5442,1298,4144,78,4066,87,830,1145,480,55,15,12,224,47,1171
2B,5,3558,896,2662,47,2615,108,533,829,236,43,3,2,83,24,754
2B,8,11801,2736,9065,188,8877,169,2597,3395,637,81,24,19,393,98,1464
2B,9,3631,758,2873,58,2815,78,595,893,355,44,19,6,135,33,657
2B,10,2892,931,1961,40,1921,49,393,592,164,20,8,2,97,19,577
2B,11,2983,747,2236,35,2201,62,577,642,170,29,5,3,108,37,568
2B,12,4619,1152,3467,58,3409,84,845,1492,240,30,7,7,156,35,513
2B,14,2756,674,2082,45,2037,48,473,503,213,15,4,5,58,17,701
2B,16,5392,1492,3900,66,3834,80,941,1188,283,31,10,7,147,35,1112
2B,17,3760,1088,2672,68,2604,61,516,773,212,40,9,6,140,27,820
2B,19,3086,942,2144,34,2110,34,415,894,152,25,4,4,97,22,463
2B,20,5116,1206,3910,63,3847,94,715,1184,334,38,6,6,185,43,1242
2B,24,3555,1059,2496,39,2457,45,603,807,162,18,5,5,85,24,703
2B,25,3083,865,2218,39,2179,50,528,518,233,22,6,7,116,26,673
2B,26,2670,693,1977,34,1943,49,359,632,250,30,9,5,128,24,457
2B,29,4215,904,3311,70,3241,97,675,1172,301,31,17,4,191,41,712
2B,37,1713,438,1275,21,1254,32,173,414,71,6,6,1,64,13,474
2B,39,3420,924,2496,55,2441,52,578,900,207,41,11,3,113,20,516
2B,41,6036,1748,4288,76,4212,81,1206,1346,359,57,18,7,185,44,909
2B,42,2848,670,2178,43,2135,53,418,674,320,36,14,7,89,27,497
2B,45,5938,1224,4714,79,4635,110,846,1431,668,58,18,6,254,60,1184
2B,54,2302,679,1623,19,1604,55,214,577,138,19,7,0,71,15,508
2B,58,1951,485,1466,24,1442,53,189,283,186,15,6,2,51,14,643
2B,59,6019,1714,4305,86,4219,79,1077,1075,558,37,10,12,187,35,1149
2B,60,1742,513,1229,10,1219,21,157,347,125,12,3,2,42,16,494
2B,67,1468,354,1114,18,1096,38,157,290,164,18,3,2,69,13,342
2B,68,1052,259,793,12,781,25,176,185,118,14,1,2,43,13,204
2B,69,4387,1309,3078,66,3012,44,1033,582,370,33,17,6,97,26,804
2B,71,8025,2054,5971,111,5860,107,1893,1328,641,73,13,15,226,65,1499
21,1,1322,216,1106,17,1089,14,220,442,75,14,6,5,101,28,184
21,2,4071,747,3324,65,3259,45,815,940,289,44,22,10,292,74,728
21,3,10112,2108,8004,159,7845,114,1972,2268,663,89,51,12,650,177,1849
21,4,1283,197,1086,26,1060,23,179,380,75,11,10,4,119,33,226
21,5,11367,2213,9154,181,8973,149,1507,3336,629,96,51,22,968,172,2043
21,6,15670,2928,12742,242,12500,199,2459,4165,1025,131,75,31,1185,242,2988
21,7,2430,379,2051,51,2000,45,475,479,167,33,7,3,208,49,534
21,8,7823,1610,6213,132,6081,92,1495,1740,529,60,48,19,502,107,1489
21,9,18803,2914,15889,248,15641,372,2204,5078,1373,120,54,50,1671,305,4414
21,10,24720,4146,20574,380,20194,435,3596,4866,2038,225,100,50,1916,393,6575
21,11,11410,2004,9406,177,9229,298,1214,2164,1099,102,53,26,864,118,3291
21,12,10350,2285,8065,152,7913,160,1323,1637,967,78,52,9,610,103,2974
21,13,2300,407,1893,40,1853,25,550,510,168,20,16,4,146,44,370
21,14,16359,2524,13835,269,13566,181,3273,3531,1345,131,77,23,1089,321,3595
21,15,11686,1582,10104,195,9909,200,1894,2939,942,95,45,18,1015,207,2554
21,16,961,144,817,22,795,11,165,258,70,10,10,0,71,21,179
21,17,9603,1598,8005,148,7857,144,1691,2205,668,91,35,12,777,154,2080
21,18,2651,430,2221,41,2180,43,485,677,190,45,25,9,185,68,453
21,19,2161,403,1758,42,1716,44,376,419,163,26,18,3,179,42,446
21,20,6574,901,5673,103,5570,97,1195,1678,487,60,17,13,490,138,1395
21,21,8139,1508,6631,124,6507,109,1333,1547,723,86,62,16,581,159,1891
21,22,2071,343,1728,33,1695,16,463,574,120,25,9,4,128,35,321
21,23,4936,886,4050,81,3969,76,805,1243,366,52,21,10,367,83,946
21,24,11250,1773,9477,191,9286,198,1909,2669,875,119,76,24,846,202,2368
21,25,5882,995,4887,91,4796,63,1294,1277,381,55,46,9,369,92,1210
21,26,4293,680,3613,83,3530,76,769,1071,315,44,22,8,361,86,778
21,27,2354,336,2018,39,1979,46,408,517,191,31,13,5,232,42,494
21,28,1741,334,1407,29,1378,27,263,499,117,15,9,4,137,31,276
21,29,8078,1504,6574,118,6456,79,1970,1659,583,94,32,14,464,115,1446
21,30,2509,373,2136,33,2103,48,378,709,229,24,7,2,254,49,403
21,31,4611,817,3794,58,3736,61,919,1041,327,42,36,4,301,60,945
21,32,2930,507,2423,63,2360,36,544,574,234,32,15,11,190,57,667
21,33,7053,1093,5960,133,5827,128,1036,1551,650,94,45,13,567,138,1605
21,34,6958,1204,5754,113,5641,71,1479,1562,496,51,41,16,441,126,1358
21,35,5294,715,4579,86,4493,154,989,1051,531,76,32,8,433,106,1113
21,36,5889,1013,4876,96,4780,85,954,1067,587,72,24,16,429,87,1459
21,37,2792,466,2326,49,2277,38,441,709,222,28,16,4,234,56,529
21,38,17700,3203,14497,275,14222,263,2699,3443,1594,135,73,39,1177,280,4519
21,39,16435,2733,13702,198,13504,363,2077,3493,1417,116,58,29,1228,217,4506
21,40,14000,2186,11814,165,11649,405,1126,4080,1033,83,49,41,1231,193,3408
21,41,13376,2252,11124,188,10936,362,1413,3122,1185,100,47,34,1070,155,3448
21,42,11035,2096,8939,154,8785,197,1527,2212,830,84,44,14,806,145,2926
21,43,23807,3531,20276,344,19932,481,2588,7206,1528,131,82,46,2202,330,5338
22,1,6840,1030,5810,119,5691,170,852,850,926,93,55,20,579,92,2054
22,2,4592,635,3957,71,3886,94,517,585,774,71,32,13,381,46,1373
22,3,3527,534,2993,49,2944,68,447,600,390,57,24,9,303,41,1005
22,4,6645,892,5753,96,5657,79,928,1499,581,77,44,10,629,98,1712
22,5,4710,690,4020,57,3963,109,485,759,706,66,30,9,390,77,1332
22,6,4864,671,4193,76,4117,114,655,1077,385,63,24,9,513,89,1188
22,7,6633,739,5894,101,5793,147,905,1349,619,108,39,13,702,114,1797
22,8,6308,801,5507,111,5396,83,957,1449,512,75,50,13,555,101,1601
22,9,3264,485,2779,59,2720,45,453,621,347,48,34,7,254,47,864
22,10,2292,246,2046,44,2002,40,276,529,250,21,15,3,255,28,585
22,11,12316,1734,10582,210,10372,294,1188,2962,1047,137,55,24,1311,155,3199
22,12,19694,2931,16763,357,16406,418,2272,3801,1930,242,100,37,1656,266,5684
22,13,11976,1665,10311,192,10119,279,1252,3208,1036,109,59,28,1084,181,2883
22,14,4832,648,4184,81,4103,119,686,952,441,53,45,6,467,69,1265
22,15,2633,355,2278,41,2237,91,271,485,328,41,13,4,200,38,766
22,16,16189,2570,13619,268,13351,359,1598,2524,1897,174,83,50,1379,195,5092
22,17,6160,771,5389,110,5279,133,733,1139,629,71,45,20,582,88,1839
22,18,16348,1905,14443,247,14196,267,1892,3508,1450,177,74,29,1770,266,4763
22,19,19597,2754,16843,313,16530,740,1711,2967,2380,208,115,35,1723,240,6411
22,20,6693,795,5898,99,5799,174,916,1252,656,83,52,7,638,86,1935
22,21,6954,1020,5934,93,5841,131,996,1501,538,84,30,14,521,114,1912
22,22,11655,1887,9768,196,9572,145,1526,2507,912,134,75,15,1055,163,3040
22,23,4080,522,3558,75,3483,101,510,606,510,49,18,11,355,72,1251
22,24,11577,1522,10055,157,9898,202,1504,2996,1004,110,45,21,963,178,2875
22,25,5883,855,5028,88,4940,83,982,1289,459,68,36,8,472,86,1457
22,26,9636,1168,8468,177,8291,165,1280,2090,971,95,57,22,913,172,2526
22,27,2639,297,2342,36,2306,45,328,647,198,28,17,5,243,41,754
22,28,15417,2702,12715,215,12500,430,1855,3431,1436,166,89,22,1145,192,3734
22,29,22754,3301,19453,305,19148,814,2017,4883,2325,231,87,46,1976,330,6439
22,30,9939,1416,8523,176,8347,169,1293,2145,773,135,60,20,775,193,2784
22,31,4219,455,3764,89,3675,74,521,816,392,41,29,10,375,77,1340
22,32,11284,1416,9868,155,9713,271,1274,3209,864,82,35,19,1102,209,2648
22,33,8211,1094,7117,103,7014,244,881,1438,1157,101,34,11,651,101,2396
22,34,7278,933,6345,120,6225,109,917,1501,776,80,36,11,669,122,2004
22,35,5272,632,4640,90,4550,93,704,919,612,83,40,13,531,103,1452
22,36,7615,1056,6559,88,6471,199,879,1181,1173,98,71,20,591,110,2149
22,37,8365,1017,7348,142,7206,203,983,2073,690,82,52,19,698,128,2278
22,38,5069,663,4406,91,4315,81,562,1461,398,57,18,16,447,71,1204
22,39,5836,903,4933,78,4855,152,798,1220,612,48,49,9,447,100,1420
22,40,5021,639,4382,67,4315,118,619,931,470,49,40,7,374,60,1647
22,41,6874,826,6048,132,5916,121,847,1449,696,93,55,12,698,152,1793
22,42,4890,686,4204,69,4135,121,550,844,601,58,29,12,457,51,1412
22,43,6277,902,5375,85,5290,231,698,962,835,97,46,19,528,81,1793
22,44,9375,2271,7104,99,7005,273,696,1692,928,67,45,20,762,80,2442
22,45,10319,2433,7886,110,7776,294,888,1675,1081,83,39,33,825,114,2744
22,46,2977,427,2550,44,2506,83,306,506,373,45,18,3,316,39,817
22,47,9892,1357,8535,152,8383,245,1141,2033,1103,135,74,16,789,146,2701
22,48,2818,325,2493,46,2447,40,371,724,222,27,19,9,288,56,691
22,49,18324,2460,15864,337,15527,341,2027,3560,1870,150,92,32,1801,251,5403
22,50,16245,1697,14548,264,14284,478,1757,3550,1799,178,67,40,1586,232,4597
22,51,16727,2258,14469,253,14216,332,1908,2766,2092,208,114,30,1497,227,5042
22,52,11426,2462,8964,138,8826,334,940,1834,1149,118,48,18,1019,126,3240
23,1,3520,572,2948,63,2885,49,522,726,350,49,25,7,230,44,883
23,2,5065,908,4157,111,4046,68,614,943,467,79,26,12,327,64,1446
23,3,2942,552,2390,71,2319,27,404,544,234,28,12,4,275,61,730
23,4,2263,416,1847,42,1805,54,279,370,218,30,11,2,175,31,635
23,5,2787,488,2299,48,2251,37,357,532,332,32,12,2,151,31,765
23,6,4233,793,3440,103,3337,63,628,691,375,50,45,6,283,80,1116
23,7,4350,774,3576,85,3491,44,660,659,492,51,28,8,241,59,1249
23,8,4369,843,3526,58,3468,47,645,713,462,59,29,5,302,62,1144
23,9,2977,439,2538,49,2489,38,442,669,274,24,15,4,219,49,755
23,10,3122,540,2582,54,2528,46,464,557,295,35,19,2,210,57,843
23,11,3317,629,2688,73,2615,37,481,713,249,46,22,8,234,80,745
23,12,1474,253,1221,25,1196,19,190,245,160,26,3,3,95,30,425
23,13,2739,568,2171,80,2091,34,331,549,235,26,15,6,220,35,640
23,14,5509,1133,4376,125,4251,70,651,1144,500,72,39,16,317,105,1337
23,15,2430,400,2030,51,1979,28,322,498,204,24,19,1,236,53,594
23,16,3300,545,2755,69,2686,62,469,709,315,33,14,6,217,57,804
23,17,1274,233,1041,23,1018,35,145,161,200,20,7,5,77,20,348
23,18,3211,584,2627,71,2556,44,407,512,418,35,11,6,216,47,860
23,19,6238,1126,5112,123,4989,70,793,960,656,61,32,18,402,91,1906
23,20,2860,421,2439,65,2374,18,425,616,281,38,9,6,225,51,705
23,21,2397,427,1970,54,1916,43,347,386,296,30,21,5,151,22,615
23,22,1581,267,1314,22,1292,27,196,282,200,26,12,3,98,19,429
23,23,1772,258,1514,38,1476,43,244,321,194,20,7,4,110,30,503
23,24,5582,908,4674,118,4556,74,680,879,624,86,41,8,339,88,1737
23,25,8544,1601,6943,140,6803,136,1032,1456,1051,83,41,20,528,123,2333
23,26,5556,860,4696,85,4611,91,573,924,641,59,28,17,393,71,1814
23,27,3463,680,2783,61,2722,65,350,521,394,34,14,11,205,42,1086
24,1,2764,383,2381,60,2321,53,384,585,286,35,12,12,267,45,642
24,2,3256,538,2718,39,2679,65,397,607,389,32,17,14,233,47,878
24,3,15361,3328,12033,213,11820,296,2180,3042,1358,118,58,19,1069,183,3497
24,4,5923,874,5049,120,4929,93,812,1160,611,84,32,10,446,102,1579
24,5,3774,525,3249,70,3179,72,539,831,369,41,12,14,259,78,964
24,6,2854,399,2455,60,2395,46,393,581,300,35,25,7,177,43,788
24,7,3013,455,2558,63,2495,69,365,626,325,49,15,10,238,53,745
24,8,4323,537,3786,80,3706,109,624,720,557,52,23,9,275,74,1263
24,9,2572,340,2232,52,2180,33,347,482,281,32,14,6,174,41,770
24,10,5232,685,4547,85,4462,111,639,1114,593,62,17,11,337,89,1489
24,11,4226,596,3630,84,3546,75,490,790,449,54,16,16,283,79,1294
24,12,3192,487,2705,49,2656,53,538,685,348,37,10,10,260,72,643
24,13,3290,452,2838,73,2765,55,360,692,331,30,18,12,229,42,996
24,14,3499,460,3039,65,2974,76,580,782,383,32,15,9,300,48,749
24,15,3840,551,3289,96,3193,66,559,722,549,40,17,10,214,56,960
24,16,9435,1451,7984,181,7803,157,1680,1691,1016,128,49,22,675,143,2242
24,17,6498,898,5600,116,5484,128,984,1158,780,74,28,14,451,90,1777
24,18,4356,545,3811,115,3696,53,601,861,507,31,23,6,273,84,1257
24,19,2642,396,2246,63,2183,48,365,563,289,28,8,5,169,51,657
24,20,1733,252,1481,29,1452,37,246,289,224,22,10,6,163,31,424
24,21,3874,502,3372,84,3288,72,523,697,450,42,20,9,240,63,1172
24,22,7186,1057,6129,116,6013,254,793,1336,959,70,36,14,379,109,2063
24,23,8311,1329,6982,178,6804,97,1444,1646,775,108,44,11,514,123,2042
24,24,7327,1082,6245,137,6108,91,1186,1260,984,81,49,11,397,110,1939
24,25,5901,776,5125,113,5012,118,913,974,831,73,37,9,306,107,1644
24,26,6878,1000,5878,180,5698,96,1007,1402,769,96,48,7,414,119,1740
24,27,10973,2133,8840,151,8689,233,982,2533,1157,88,41,18,761,138,2738
24,28,6441,1036,5405,157,5248,92,849,1273,660,70,33,7,407,80,1777
24,29,2016,251,1765,34,1731,47,292,442,228,28,6,2,169,35,482
24,30,14855,2190,12665,254,12411,218,2219,2350,2155,211,91,31,922,260,3954
24,31,5209,962,4247,91,4156,60,877,1042,397,66,28,9,296,63,1318
24,32,5716,838,4878,118,4760,158,653,1036,718,100,36,9,414,75,1561
24,33,3703,609,3094,99,2995,42,520,726,401,43,29,4,224,65,941
24,34,15390,2162,13228,282,12946,259,1970,2657,2039,173,49,25,1019,209,4546
24,35,3250,426,2824,74,2750,53,425,745,333,30,16,10,235,64,839
24,36,12423,1766,10657,218,10439,261,1372,2520,1466,122,52,33,927,206,3480
24,37,7337,865,6472,150,6322,120,926,1363,1039,93,36,14,456,132,2143
24,38,7323,1107,6216,125,6091,129,1332,1593,655,85,28,14,576,112,1567
24,39,10758,1477,9281,190,9091,124,1598,1694,1254,132,55,17,609,142,3466
24,40,3500,508,2992,71,2921,70,506,651,358,44,19,0,209,63,1001
24,41,5761,808,4953,124,4829,81,686,1184,666,50,34,8,369,100,1651
24,42,7706,1192,6514,119,6395,135,1639,1571,651,73,28,21,462,113,1702
24,43,4785,683,4102,100,4002,74,732,996,519,56,28,14,364,91,1128
24,44,3447,458,2989,82,2907,52,537,745,276,38,13,2,235,62,947
24,45,4365,588,3777,81,3696,116,658,876,553,56,10,9,326,63,1029
24,46,3733,586,3147,73,3074,57,733,713,332,37,24,7,252,60,859
24,47,1829,246,1583,50,1533,24,239,361,227,25,11,4,148,39,455
24,48,12496,2091,10405,211,10194,200,2207,2244,1243,132,53,26,920,195,2974
24,49,12555,1818,10737,199,10538,237,1396,2311,1575,131,57,19,956,183,3673
24,50,15102,2588,12514,259,12255,260,1738,2425,1874,164,50,24,900,215,4605
25,1,3086,361,2725,52,2673,83,435,952,328,34,14,12,294,56,465
25,2,20625,2657,17968,330,17638,422,3060,5124,1968,184,96,37,1772,315,4660
25,3,12595,2874,9721,185,9536,156,2365,1899,1121,110,87,24,616,135,3023
25,4,7005,1182,5823,120,5703,100,1138,1732,525,85,55,13,494,113,1448
25,5,14810,3280,11530,208,11322,319,1510,2881,1589,123,45,34,995,183,3643
25,6,14410,2315,12095,207,11888,515,1437,3316,1734,113,64,28,1155,187,3339
25,7,13498,1824,11674,236,11438,259,2130,3144,1320,120,75,29,1095,215,3051
25,8,4582,683,3899,75,3824,58,976,1203,308,62,35,18,322,87,755
25,9,12227,2085,10142,230,9912,152,2889,2279,946,132,68,20,731,209,2486
25,10,8618,1183,7435,132,7303,116,2136,1629,690,101,72,18,594,127,1820
25,11,6308,857,5451,132,5319,131,1007,1957,442,61,31,21,572,134,963
25,12,10433,1589,8844,218,8626,134,1536,3203,643,97,61,20,787,181,1964
25,13,15291,1974,13317,259,13058,307,2493,3608,1513,143,71,35,1172,246,3470
25,14,14929,3443,11486,211,11275,217,2231,2621,1288,113,82,19,820,144,3740
25,15,5125,627,4498,123,4375,103,781,1778,326,61,27,16,426,109,748
25,16,13514,2323,11191,253,10938,211,1575,4169,1028,153,56,24,1145,228,2349
25,17,6455,1026,5429,115,5314,187,833,2054,488,96,29,28,575,142,882
25,18,8566,1082,7484,145,7339,190,1208,2332,781,71,41,20,722,167,1807
25,19,5765,762,5003,129,4874,126,896,2153,318,58,32,11,482,98,700
25,20,23213,4160,19053,444,18609,558,2963,6344,1873,236,101,65,1808,386,4275
25,21,11133,1609,9524,205,9319,120,2662,2247,812,137,78,16,677,196,2374
25,22,6862,919,5943,118,5825,156,1137,1678,731,103,42,13,521,108,1336
25,23,3260,461,2799,62,2737,48,674,711,294,46,29,11,202,53,669
25,24,6593,817,5776,126,5650,129,1199,1563,628,75,28,14,487,117,1410
25,25,5093,581,4512,132,4380,97,714,1766,334,44,23,10,420,101,871
25,26,3539,551,2988,70,2918,53,769,902,225,36,23,8,248,45,609
25,27,8699,1137,7562,178,7384,149,1526,2788,470,75,52,22,807,167,1328
25,28,16564,3440,13124,220,12904,474,1355,3729,1869,116,47,23,1181,180,3930
25,29,13055,2863,10192,162,10030,394,1196,2390,1661,98,42,17,877,138,3217
25,30,13075,2196,10879,226,10653,165,2753,2517,1063,110,67,31,843,216,2888
25,31,8982,1845,7137,120,7017,95,1714,1490,751,83,61,20,463,103,2237
25,32,8707,1986,6721,98,6623,216,861,1733,931,57,35,9,607,108,2066
25,33,10166,3125,7041,113,6928,127,1062,1152,1088,74,72,11,425,69,2848
25,34,9750,1522,8228,184,8044,117,2143,1964,795,103,59,22,622,134,2085
25,35,12660,2438,10222,186,10036,163,2557,2028,1055,135,82,31,682,167,3136
26,1,1085,152,933,12,921,73,153,151,200,12,11,2,74,20,225
26,2,22683,3619,19064,342,18722,416,4466,5331,1803,205,151,48,1656,391,4255
26,3,4693,774,3919,68,3851,190,700,877,618,70,24,11,330,74,957
26,4,17113,2282,14831,237,14594,478,2709,4140,1516,135,69,45,1745,321,3436
26,5,1710,261,1449,38,1411,94,242,347,272,22,10,6,142,30,246
26,6,1867,277,1590,40,1550,89,177,348,327,19,10,2,148,33,397
26,7,13057,2000,11057,169,10888,523,1895,2555,1598,125,73,23,1117,240,2739
26,8,6800,991,5809,135,5674,269,1074,1252,895,64,33,18,578,102,1389
26,9,5051,876,4175,59,4116,251,502,826,942,74,29,4,367,60,1061
26,10,6325,931,5394,81,5313,336,783,1200,910,73,33,19,475,73,1411
26,11,7875,1294,6581,134,6447,104,1790,1563,785,70,49,15,521,149,1401
26,12,6360,837,5523,117,5406,175,1250,1451,665,58,25,10,480,91,1201
26,13,12964,2445,10519,198,10321,189,2687,2499,1205,121,71,21,826,181,2521
26,14,1595,231,1364,23,1341,95,117,274,255,27,7,5,127,18,416
26,15,9844,1337,8507,149,8358,216,2026,2142,986,92,49,29,811,182,1825
26,16,14522,3234,11288,178,11110,243,2344,2896,1170,127,61,34,935,218,3082
26,17,918,156,762,12,750,35,133,158,132,12,4,2,74,13,187
26,18,10424,1916,8508,152,8356,305,1668,2105,1274,98,55,16,688,149,1998
26,19,14268,2565,11703,196,11507,136,3335,3024,1164,116,44,37,816,187,2648
26,20,1251,188,1063,23,1040,44,208,221,181,14,12,3,82,21,254
26,21,20800,3897,16903,280,16623,506,3392,4415,1962,170,241,39,1361,306,4231
26,22,1927,257,1670,35,1635,116,205,290,341,37,14,6,136,26,464
26,23,6450,940,5510,127,5383,147,1201,1449,608,53,89,13,555,125,1143
26,24,5406,799,4607,87,4520,162,878,1278,581,78,48,8,385,85,1017
26,25,14915,2072,12843,234,12609,224,3230,3564,1389,129,65,34,1057,269,2648
26,26,18959,2937,16022,288,15734,260,3709,3668,1904,186,131,45,1332,380,4119
26,27,1949,299,1650,40,1610,83,339,359,302,23,7,4,108,27,358
26,28,16169,2235,13934,283,13651,280,2901,4045,1334,132,104,41,1376,282,3156
26,29,10271,2257,8014,126,7888,336,1015,2542,909,80,27,18,724,107,2130
26,30,9925,1829,8096,158,7938,270,1261,2359,817,76,43,14,733,142,2223
26,31,9751,2227,7524,170,7354,169,1354,1640,922,70,40,13,560,102,2484
26,32,17690,3166,14524,221,14303,315,2656,3962,1504,160,104,30,1188,261,4123
26,33,19867,3373,16494,319,16175,371,3784,4528,1716,145,82,50,1419,315,3765
26,34,16375,2527,13848,237,13611,344,2837,3441,1745,153,68,40,1126,270,3587
26,35,13203,2543,10660,181,10479,249,2238,2780,1086,108,149,30,922,209,2708
26,36,8994,1831,7163,99,7064,170,1165,1611,859,53,25,24,636,119,2402
27,1,11661,1589,10072,155,9917,119,2296,2578,1069,113,65,29,886,233,2529
27,2,13479,2471,11008,205,10803,159,2758,2961,1122,160,89,32,721,255,2546
27,3,3931,710,3221,68,3153,58,780,1104,223,35,13,7,278,61,594
27,4,9649,1518,8131,156,7975,86,1991,2202,783,110,43,18,597,185,1960
27,5,6615,1146,5469,100,5369,109,1082,1539,492,80,31,14,494,121,1407
27,6,8879,1528,7351,139,7212,110,1686,2140,671,116,48,19,623,163,1636
27,7,10531,1591,8940,150,8790,129,1887,2188,1069,119,56,32,788,215,2307
27,8,6747,1110,5637,91,5546,87,1516,1662,406,104,36,11,397,136,1191
27,9,8513,1513,7000,96,6904,108,1606,1828,822,105,59,10,485,155,1726
27,10,5016,882,4134,75,4059,59,944,1418,318,49,27,11,344,82,807
27,11,12347,2004,10343,194,10149,162,2512,2737,932,175,69,38,757,200,2567
27,12,4055,648,3407,66,3341,48,796,1103,267,45,24,9,358,78,613
27,13,5841,982,4859,83,4776,75,1193,1607,385,52,20,20,426,112,886
27,14,10871,1939,8932,150,8782,147,2404,2615,784,120,60,31,674,195,1752
27,15,8133,1506,6627,133,6494,69,1980,1651,616,96,63,10,413,122,1474
27,16,18267,2964,15303,363,14940,348,2959,4186,1542,204,94,55,1480,302,3770
27,17,11034,2740,8294,140,8154,184,1447,1875,949,114,59,17,686,143,2680
27,18,13209,2322,10887,191,10696,121,2694,2501,1338,157,93,32,749,221,2790
27,19,7361,1535,5826,99,5727,96,1370,1177,721,74,39,27,414,112,1697
27,20,13790,2976,10814,206,10608,150,2668,2814,1373,135,84,23,753,230,2378
27,21,9942,2264,7678,150,7528,158,1529,1951,847,126,58,18,585,135,2121
27,22,3651,548,3103,61,3042,49,812,949,275,34,18,7,240,50,608
27,23,5834,900,4934,86,4848,74,1134,1151,692,71,38,17,372,117,1182
27,24,9094,1607,7487,104,7383,96,1866,2204,620,90,57,19,681,151,1599
27,25,8570,1588,6982,117,6865,99,1652,2086,627,98,46,21,595,167,1474
27,26,12243,2159,10084,169,9915,160,2216,3455,774,122,58,18,878,231,2003
27,27,13916,2862,11054,187,10867,179,2223,2661,1220,184,71,25,965,217,3122
27,28,10934,1665,9269,167,9102,128,1961,2043,1399,156,58,19,700,174,2464
27,29,4684,713,3971,62,3909,58,999,1062,418,69,27,7,320,100,849
27,30,11716,1682,10034,181,9853,162,2290,2655,1066,97,44,16,876,215,2432
27,31,5865,1170,4695,74,4621,49,1183,1407,370,65,29,10,368,109,1031
27,32,19131,3736,15395,289,15106,178,3970,4410,1375,194,112,37,1187,374,3269
27,33,3781,564,3217,70,3147,44,782,895,294,37,29,12,294,63,697
27,34,5510,912,4598,78,4520,60,1170,1516,360,72,18,10,413,93,808
27,35,8718,1780,6938,118,6820,110,1499,2237,568,81,34,20,630,133,1508
27,36,12052,2428,9624,166,9458,222,1762,2903,917,98,50,25,918,194,2369
27,37,13028,2869,10159,164,9995,223,1865,2778,1083,138,61,24,963,171,2689
27,38,13245,2516,10729,219,10510,237,1783,2967,1187,105,61,26,1093,176,2875
27,39,12166,2478,9688,151,9537,190,2028,2629,1036,159,56,31,773,202,2433
27,40,11982,2584,9398,140,9258,191,1509,2754,909,76,38,23,927,158,2673
27,41,7767,1442,6325,112,6213,95,1175,1642,706,70,43,10,560,131,1781
27,42,11076,1722,9354,180,9174,153,2373,2822,776,120,43,24,809,210,1844
27,43,12996,3407,9589,180,9409,205,1754,1847,1171,159,68,26,674,182,3323
28,1,14188,2324,11864,183,11681,230,2810,3673,1010,135,63,38,1055,271,2396
28,2,10939,1920,9019,127,8892,118,2083,2554,858,135,74,30,759,222,2059
28,3,4688,794,3894,73,3821,53,927,1450,247,50,35,14,345,91,609
28,4,8321,1210,7111,155,6956,94,1502,2055,621,84,61,20,630,155,1734
28,5,9748,1904,7844,121,7723,119,2027,2150,648,110,82,20,605,168,1794
28,6,7288,1324,5964,141,5823,54,1454,1968,369,71,50,16,550,134,1157
28,7,14059,2461,11598,182,11416,282,1839,3344,1140,132,59,35,1224,252,3109
28,9,15682,2907,12775,269,12506,163,2621,3520,1055,167,106,33,1168,297,3376
28,10,7473,1252,6221,121,6100,111,1557,1944,425,62,34,10,545,152,1260
28,11,7462,1243,6219,112,6107,79,1517,1829,446,80,52,22,630,181,1271
28,12,10215,1633,8582,162,8420,120,1856,2410,746,133,57,24,761,205,2108
28,13,12744,3123,9621,164,9457,170,1520,2558,1033,104,37,22,793,206,3014
28,14,1804,288,1516,27,1489,21,338,572,100,16,13,5,141,50,233
28,15,7834,1362,6472,129,6343,89,1515,1792,601,94,49,15,555,140,1493
28,16,6693,1148,5545,101,5444,64,1391,1802,367,76,44,15,455,127,1103
28,17,7433,1304,6129,102,6027,72,1508,1844,482,75,46,16,459,136,1389
28,18,22695,4102,18593,341,18252,357,3463,5052,1807,228,104,66,1910,439,4826
28,19,12440,2197,10243,175,10068,199,1979,3305,910,106,57,21,971,217,2303
28,20,10605,1775,8830,201,8629,103,1617,2785,697,103,63,19,798,215,2229
28,21,3995,528,3467,62,3405,32,806,1251,243,35,26,4,287,82,639
28,22,4412,811,3601,54,3547,48,915,1144,265,46,31,5,287,72,734
28,23,4349,674,3675,64,3611,50,916,1153,300,45,26,5,306,58,752
28,24,6857,1046,5811,107,5704,75,1389,1706,457,78,47,16,478,143,1315
28,25,15701,3588,12113,232,11881,179,2138,3220,1235,153,73,38,1081,256,3508
28,26,22424,4282,18142,306,17836,402,2521,6069,1520,180,78,40,2069,335,4622
28,27,8767,2259,6508,104,6404,98,1288,1538,683,79,52,12,483,124,2047
28,28,12838,3002,9836,192,9644,120,1748,2174,1088,98,55,17,684,178,3482
28,29,12336,3097,9239,184,9055,95,1880,2126,896,108,58,18,801,183,2890
28,30,13794,3031,10763,189,10574,191,1942,2603,981,116,55,26,1012,218,3430
29,1,4523,503,4020,77,3943,132,600,885,509,61,14,13,459,85,1185
29,2,8051,1192,6859,148,6711,208,1019,1334,811,133,59,18,667,127,2335
29,3,12990,2005,10985,173,10812,298,1282,2550,1178,132,47,35,1188,204,3898
29,4,8975,2226,6749,158,6591,250,907,1302,874,80,39,11,597,105,2426
29,5,11269,2319,8950,135,8815,410,713,2547,1028,92,34,32,935,121,2903
29,6,7924,1023,6901,131,6770,201,910,1405,696,149,73,19,926,142,2249
29,7,12032,1861,10171,167,10004,272,1310,2042,1301,213,87,30,858,159,3732
29,8,14225,1967,12258,182,12076,319,1674,2980,1399,219,86,46,1503,288,3562
29,9,10206,1673,8533,108,8425,192,1288,1895,993,149,77,22,990,151,2668
29,10,22680,4553,18127,288,17839,566,2427,4645,2077,239,121,56,1689,276,5743
29,11,14121,2345,11776,202,11574,286,1779,3368,1190,206,70,43,1179,258,3195
29,12,21612,2778,18834,277,18557,725,1766,4472,2221,278,79,57,2212,299,6448
29,13,19046,3543,15503,258,15245,603,1742,3660,2128,257,103,34,1633,294,4791
29,14,5408,802,4606,62,4544,137,617,912,607,69,41,14,505,108,1534
29,15,22758,2982,19776,339,19437,541,2377,6086,1795,216,98,59,2354,383,5528
29,16,4139,668,3471,40,3431,129,374,525,717,68,18,6,283,50,1261
29,17,19930,2788,17142,259,16883,529,1683,3856,1722,236,91,50,2174,270,6272
29,18,13230,1932,11298,177,11121,191,1468,2892,979,166,70,32,1565,262,3496
29,19,10284,1427,8857,116,8741,276,838,1805,1321,108,63,27,820,121,3362
29,20,14123,2094,12029,181,11848,364,1524,3480,1156,158,88,25,1351,205,3497
29,21,18008,2554,15454,246,15208,338,1882,4475,1386,198,100,37,1969,252,4571
29,22,18427,3141,15286,210,15076,474,1331,3020,2188,179,62,29,1443,202,6148
29,23,926,181,745,6,739,27,82,174,104,18,14,4,70,7,239
29,24,15098,1613,13485,231,13254,277,1781,3513,1248,186,84,36,1769,299,4061
29,25,6649,1022,5627,101,5526,181,813,1354,641,96,38,16,667,97,1623
29,26,15430,2011,13419,238,13181,421,1589,2720,1528,224,82,42,1822,307,4446
29,27,14103,1758,12345,182,12163,313,1687,3597,1075,145,77,36,1532,221,3480
29,28,3553,441,3112,47,3065,86,341,726,342,59,23,11,351,56,1070
29,29,7109,1107,6002,86,5916,111,741,2062,459,91,30,8,772,114,1528
29,30,8472,1107,7365,109,7256,134,829,1327,1079,96,56,13,663,101,2958
29,31,7720,1093,6627,141,6486,129,821,2131,547,86,39,21,842,132,1738
29,32,14307,2412,11895,216,11679,396,1885,3069,1361,176,80,32,1121,219,3340
29,33,13996,2428,11568,166,11402,307,1580,2892,1206,170,63,23,1214,215,3732
29,34,15436,2371,13065,224,12841,464,1416,3227,1583,200,76,48,1370,246,4211
29,35,18654,3030,15624,287,15337,600,1287,3738,1890,215,74,35,1847,243,5408
29,36,17555,3025,14530,298,14232,458,1785,3103,1872,262,100,28,1405,251,4968
29,37,10943,1604,9339,207,9132,264,1260,1773,1304,153,74,22,926,156,3200
29,38,15770,2566,13204,233,12971,324,1355,3956,1288,188,55,38,1452,242,4073
29,39,25667,3487,22180,307,21873,597,2471,6041,2151,287,107,48,2858,407,6906
29,40,5900,805,5095,67,5028,158,578,1012,663,57,41,13,523,82,1901
29,41,6351,923,5428,97,5331,183,796,1020,747,109,46,20,542,108,1760
29,42,3355,470,2885,41,2844,129,413,628,348,56,17,4,315,46,888
29,43,8657,1159,7498,105,7393,187,706,2283,656,80,27,26,887,135,2406
29,44,14070,2042,12028,235,11793,279,1322,2708,1187,141,42,27,1386,165,4536
29,45,7977,1967,6010,126,5884,107,942,1037,785,90,45,18,431,88,2341
29,46,11681,1920,9761,166,9595,183,1128,2373,995,123,47,22,1053,152,3519
29,47,9328,2157,7171,143,7028,218,831,1325,955,107,35,23,752,101,2681
29,48,20134,2870,17264,305,16959,484,1695,3497,1973,310,103,49,2006,307,6535
29,49,15843,2508,13335,265,13070,364,1654,3288,1736,212,79,39,1316,242,4140
29,50,9585,2439,7146,147,6999,202,810,1358,928,113,49,14,591,84,2850
29,51,18766,2570,16196,221,15975,404,1500,3895,1768,179,70,41,1912,272,5934
29,52,16368,2643,13725,222,13503,502,1441,3017,1546,217,81,34,1536,224,4905
29,53,14080,2958,11122,217,10905,435,1033,2453,1450,120,41,24,1174,160,4015
29,54,9327,2113,7214,153,7061,171,1018,1561,814,101,32,21,716,103,2524
30,1,16810,2551,14259,234,14025,215,3930,4510,1396,117,72,29,761,176,2819
30,2,15504,2811,12693,213,12480,171,2887,2279,2486,116,61,25,748,150,3557
30,3,18924,3755,15169,278,14891,256,3365,3141,2683,138,77,29,917,187,4098
30,4,1040,151,889,22,867,42,147,161,158,12,8,2,71,11,255
30,5,9420,1348,8072,148,7924,259,1896,1907,1217,102,35,25,516,122,1845
30,6,11935,1874,10061,165,9896,164,3006,2378,1263,110,49,28,643,159,2096
30,7,25845,4864,20981,344,20637,271,5510,5039,2275,198,116,54,1520,349,5305
30,8,3274,413,2861,60,2801,68,559,670,507,33,20,1,237,44,662
30,9,20053,3504,16549,294,16255,232,5511,3719,1731,142,80,34,990,231,3585
30,10,4363,902,3461,74,3387,81,858,605,613,51,23,11,161,42,942
30,11,3390,533,2857,53,2804,139,526,467,696,52,13,8,177,35,691
30,12,7980,1559,6421,109,6312,90,1499,971,1498,49,28,14,310,77,1776
30,13,2632,366,2266,33,2233,158,311,388,544,29,14,10,128,29,622
30,14,5394,748,4646,87,4559,103,1265,987,761,55,22,3,323,67,973
30,15,3640,540,3100,49,3051,75,647,725,409,39,21,8,252,43,832
30,16,22946,3863,19083,338,18745,287,6014,4842,1883,183,86,35,1284,266,3865
30,17,21164,3867,17297,247,17050,501,3012,5560,2055,142,40,31,1479,195,4035
30,18,18487,3788,14699,179,14520,395,3077,3730,2142,131,36,41,1051,182,3735
30,19,14892,3363,11529,178,11351,188,2758,2424,1524,87,44,31,666,178,3451
30,20,14740,2271,12469,271,12198,219,3468,2775,1459,165,81,36,946,221,2828
30,21,4920,683,4237,55,4182,148,1031,875,679,48,23,11,277,64,1026
30,22,7273,969,6304,119,6185,153,1678,1594,728,70,33,14,444,113,1358
30,23,16895,2532,14363,252,14111,265,3816,3453,1844,159,80,43,1004,229,3218
30,24,11227,1957,9270,147,9123,178,2458,1670,1823,117,59,36,526,153,2103
30,25,1112,178,934,19,915,38,172,137,168,19,8,5,67,13,288
30,26,10911,1516,9395,175,9220,212,2734,2079,1179,105,54,13,672,121,2051
30,27,11633,2167,9466,142,9324,117,3172,2456,828,76,39,21,475,121,2019
30,28,3923,634,3289,63,3226,136,785,642,559,57,20,10,226,47,744
30,29,2875,473,2402,45,2357,89,357,511,456,27,12,3,170,31,701
30,30,12204,1575,10629,150,10479,236,2712,2614,1377,97,46,21,773,143,2460
30,31,2968,439,2529,38,2491,103,575,466,427,29,7,10,154,23,697
30,32,20944,2961,17983,290,17693,478,4120,4659,2181,161,82,39,1427,286,4260
30,33,2476,352,2124,40,2084,105,403,350,399,36,11,4,155,32,589
30,34,1101,175,926,12,914,12,206,226,113,14,8,2,99,11,223
30,35,15757,2790,12967,220,12747,379,2584,3515,1714,155,46,26,996,187,3145
30,36,1796,310,1486,19,1467,68,273,307,226,25,8,3,120,23,414
30,37,15083,2380,12703,189,12514,184,3953,3012,1430,103,59,37,727,190,2819
30,38,6876,906,5970,134,5836,156,1515,1404,768,76,34,14,459,89,1321
30,39,6880,1181,5699,134,5565,228,1074,1046,1056,88,27,15,352,69,1610
30,40,26824,4175,22649,353,22296,525,4904,7403,2017,191,74,41,1973,325,4843
30,41,21495,3786,17709,299,17410,284,4356,4568,2320,164,87,41,1243,301,4046
30,42,10329,2226,8103,105,7998,224,1634,2309,1051,75,16,10,545,99,2035
30,43,10117,2065,8052,138,7914,137,1818,2280,970,67,22,12,548,91,1969
30,44,9418,2798,6620,112,6508,94,1164,1184,1019,54,39,4,333,54,2563
30,45,17823,2816,15007,237,14770,164,4374,4339,1350,107,44,27,989,247,3129
30,46,17845,2875,14970,259,14711,228,4532,3550,1749,144,82,31,959,261,3175
31,1,4710,726,3984,68,3916,157,666,737,567,56,24,5,267,52,1385
31,2,3447,575,2872,61,2811,73,476,485,375,46,26,6,241,30,1053
31,3,14729,2134,12595,262,12333,271,2509,2670,1717,162,67,35,1015,234,3653
31,4,5358,1018,4340,113,4227,98,561,1176,488,44,19,19,392,57,1373
31,5,5562,973,4589,86,4503,100,836,867,620,53,15,14,350,70,1578
31,6,4106,628,3478,83,3395,71,630,711,399,42,12,4,301,53,1172
31,7,3807,493,3314,61,3253,81,711,653,356,43,11,6,318,79,995
31,8,5505,565,4940,102,4838,176,859,991,681,72,22,14,412,76,1535
31,9,12404,1727,10677,209,10468,227,2313,2184,1421,137,62,24,681,176,3243
31,10,30047,3613,26434,433,26001,890,2773,6613,3278,266,63,58,2993,353,8714
31,11,9320,1550,7770,144,7626,155,1656,1505,1066,107,36,14,574,133,2380
31,12,4451,579,3872,72,3800,101,848,742,550,62,7,15,269,54,1152
31,13,4694,618,4076,71,4005,81,857,747,529,57,16,7,369,74,1268
31,14,30263,3868,26395,468,25927,500,5334,6101,3255,303,108,68,2367,436,7455
31,15,23241,2931,20310,358,19952,472,3815,4592,2449,243,89,60,1959,348,5925
31,16,3809,530,3279,108,3171,69,601,655,349,42,16,11,268,65,1095
31,17,7328,701,6627,117,6510,219,963,1610,745,53,19,17,744,138,2002
31,18,34432,4723,29709,474,29235,853,4393,6388,3614,312,138,86,3178,520,9753
31,19,13662,1667,11995,207,11788,267,2052,3098,1337,121,63,20,1116,227,3487
31,20,3470,515,2955,56,2899,116,512,476,463,56,18,9,249,45,955
31,21,19534,2133,17401,300,17101,559,2272,3618,2228,209,60,46,1868,250,5991
31,22,6583,1227,5356,106,5250,57,1097,1012,710,59,23,3,381,88,1820
31,23,35587,5288,30299,526,29773,661,6055,6611,3616,344,123,70,2774,539,8980
31,24,5521,657,4864,72,4792,130,786,1018,651,71,25,17,453,81,1560
31,25,10288,1584,8704,201,8503,219,1609,2039,1020,130,50,27,736,160,2513
31,26,7162,947,6215,111,6104,179,1447,1257,780,85,40,14,534,109,1659
31,27,4042,588,3454,64,3390,96,732,665,528,52,16,14,243,56,988
31,28,3553,612,2941,48,2893,46,499,572,485,36,21,4,196,41,993
31,29,16476,3083,13393,272,13121,208,2659,3011,1455,141,50,28,1092,206,4271
31,30,21603,2792,18811,329,18482,403,3551,3769,2352,211,96,44,1838,359,5859
31,31,3032,452,2580,61,2519,61,556,379,380,44,24,9,180,36,850
31,32,7147,1258,5889,141,5748,131,1141,1099,777,72,25,10,493,98,1902
31,33,17298,3751,13547,147,13400,758,952,4071,1948,108,30,30,1235,144,4124
31,34,16245,3352,12893,139,12754,677,847,4117,1795,129,29,37,1315,138,3670
31,35,24512,5374,19138,268,18870,929,1901,3534,3435,236,72,50,1687,205,6821
31,36,20767,4446,16321,231,16090,760,1478,3506,2621,162,52,29,1539,204,5739
31,37,5496,577,4919,88,4831,131,788,1266,677,60,19,12,440,88,1350
31,38,10088,1169,8919,188,8731,224,1503,1778,1070,110,44,19,718,174,3091
31,39,7206,1168,6038,128,5910,102,1363,1432,685,72,38,17,449,112,1640
31,40,15209,3528,11681,100,11581,697,728,3104,1978,101,30,26,1051,111,3755
31,41,13165,3053,10112,143,9969,499,1031,2029,1839,107,38,25,859,131,3411
31,42,18804,4392,14412,199,14213,575,1690,3043,2323,162,48,31,1169,188,4984
31,43,37852,5474,32378,465,31913,997,3674,9787,3319,259,90,61,3555,471,9700
31,44,29309,5664,23645,348,23297,962,2455,5878,3072,218,85,71,2366,327,7863
31,45,18173,4406,13767,192,13575,632,1356,2520,2295,142,53,36,1246,173,5122
31,46,16183,4448,11735,159,11576,340,1417,2180,2053,119,55,22,726,120,4544
31,47,24255,5983,18272,298,17974,545,2177,3548,2917,166,62,43,1475,215,6826
31,48,29989,5366,24623,472,24151,728,3601,4663,3335,254,121,62,2198,339,8850
31,49,38121,6455,31666,506,31160,697,5561,7004,4168,348,134,71,2579,474,10124
31,50,45774,7430,38344,594,37750,1028,5439,9217,4776,370,143,90,3640,580,12467
31,51,25479,3657,21822,359,21463,632,3215,4668,2733,268,93,60,2242,343,7209
31,52,29134,3818,25316,444,24872,520,4770,5353,3045,273,121,48,2037,376,8329
31,53,37103,5416,31687,508,31179,909,4446,7658,3473,277,98,85,3271,445,10517
32,1,2199,290,1909,48,1861,29,247,476,215,24,8,7,209,41,605
32,2,5481,846,4635,96,4539,109,651,1025,580,51,15,13,376,59,1660
32,3,7379,1194,6185,131,6054,156,826,1349,795,74,35,11,556,71,2181
32,4,3748,552,3196,88,3108,55,535,784,329,52,18,8,312,56,959
32,5,2701,328,2373,46,2327,74,411,510,288,32,8,5,246,60,693
32,6,7732,1210,6522,132,6390,123,1130,1785,671,69,24,19,560,115,1894
32,7,4735,785,3950,92,3858,56,700,1151,358,40,23,7,353,84,1086
32,8,8140,1259,6881,164,6717,109,1201,1620,760,90,39,15,577,111,2195
32,9,5611,797,4814,106,4708,127,815,1204,509,69,27,9,486,92,1370
32,10,10135,1426,8709,172,8537,239,1460,2047,978,102,45,30,898,150,2588
32,11,2915,303,2612,55,2557,65,416,545,345,21,7,4,306,51,797
32,12,4858,724,4134,79,4055,100,623,1096,489,40,18,8,393,84,1204
32,13,4447,570,3877,101,3776,87,660,908,427,53,25,9,371,71,1165
32,14,2702,419,2283,56,2227,58,303,416,331,22,17,7,259,49,765
32,15,3558,514,3044,87,2957,61,412,713,401,28,20,8,337,53,924
32,16,3498,455,3043,66,2977,80,478,722,422,48,12,4,296,69,846
32,17,3781,573,3208,61,3147,55,500,674,397,27,20,12,330,57,1075
32,18,1631,197,1434,31,1403,21,276,397,186,18,10,2,134,36,323
32,19,5999,815,5184,121,5063,125,851,1115,588,74,24,16,554,92,1624
32,20,2344,359,1985,37,1948,47,300,510,253,20,11,8,226,44,529
32,21,3902,499,3403,83,3320,58,613,879,350,21,24,8,337,57,973
32,22,6398,911,5487,141,5346,77,827,1288,631,74,25,12,539,106,1767
32,23,3311,495,2816,54,2762,60,463,588,347,40,20,5,258,43,938
32,24,5478,697,4781,107,4674,66,658,1119,503,60,23,9,618,94,1524
32,25,2191,245,1946,36,1910,47,279,516,245,23,10,6,185,30,569
32,26,3902,440,3462,57,3405,79,507,785,464,36,22,8,350,64,1090
32,27,2465,321,2144,48,2096,93,358,471,304,26,16,4,197,39,588
32,28,3649,464,3185,81,3104,50,510,766,410,37,20,5,267,41,998
32,29,4704,578,4126,96,4030,96,663,1106,391,54,20,11,386,93,1210
32,30,7213,1055,6158,121,6037,156,756,1380,827,74,30,12,588,71,2143
32,31,6991,1087,5904,131,5773,157,761,1188,764,87,30,16,499,108,2163
33,1,10328,2049,8279,92,8187,188,908,4089,482,62,19,15,760,118,1546
33,2,48203,7907,40296,703,39593,852,6574,11963,4106,670,165,89,3911,741,10522
33,3,4316,485,3831,79,3752,85,665,936,498,62,29,7,322,64,1084
33,4,6981,985,5996,120,5876,112,945,1398,730,108,30,25,581,84,1863
33,5,11939,1801,10138,208,9930,216,1840,2344,1225,207,43,25,958,190,2882
33,6,39669,6096,33573,550,33023,699,5118,7391,3831,789,147,60,3383,551,11054
33,7,10560,1850,8710,190,8520,111,1748,2024,989,149,59,32,723,178,2507
33,8,15376,3419,11957,196,11761,403,1316,2290,1808,198,53,28,1016,152,4497
33,9,15776,3419,12357,144,12213,410,1014,3708,1277,186,31,23,1321,141,4102
33,10,21589,4305,17284,194,17090,804,1105,6059,1672,173,44,27,2122,198,4886
33,11,18704,4059,14645,183,14462,689,1041,3755,1885,196,36,37,1673,150,5000
33,12,13116,2822,10294,139,10155,570,586,2273,1627,135,33,24,1076,84,3747
33,13,14867,3433,11434,176,11258,553,976,1973,2018,194,44,25,1004,120,4351
33,14,8728,1773,6955,92,6863,257,761,1263,1062,102,31,20,587,75,2705
33,15,9737,1545,8192,150,8042,166,1800,1696,990,164,40,19,694,158,2315
33,16,10784,1552,9232,188,9044,197,1868,2151,1094,149,48,22,759,145,2611
33,17,9358,1339,8019,131,7888,191,1359,1739,1111,141,59,26,725,139,2398
33,18,1659,217,1442,37,1405,26,223,286,169,24,6,5,114,20,532
33,19,27638,4918,22720,370,22350,332,4140,4742,2716,387,126,58,1945,361,7543
33,20,24961,3803,21158,383,20775,408,4003,4872,2386,466,105,41,2063,393,6038
33,21,7417,1321,6096,112,5984,96,1589,1721,518,66,30,15,460,100,1389
33,22,16705,3112,13593,253,13340,182,3372,2890,1372,232,82,35,915,209,4051
33,23,32830,4625,28205,447,27758,706,4177,6807,3458,411,125,84,2904,508,8578
33,24,11534,1596,9938,187,9751,167,2061,2302,1062,166,59,13,889,197,2835
33,25,2323,326,1997,53,1944,32,379,536,284,27,16,5,158,25,482
33,26,11579,1986,9593,218,9375,156,2343,2117,926,181,62,18,765,164,2643
33,27,28608,4161,24447,410,24037,564,3437,5719,2926,419,93,56,2514,370,7939
33,28,12954,1899,11055,235,10820,215,1779,2343,1314,185,79,25,1008,211,3661
33,29,13419,2587,10832,173,10659,152,2802,2797,1016,179,55,22,773,153,2710
33,30,28533,5313,23220,404,22816,449,4259,5997,2371,373,112,60,1988,365,6842
33,31,5795,862,4933,84,4849,75,1084,1478,421,72,31,3,430,75,1180
33,32,3379,558,2821,60,2761,68,497,682,319,58,17,8,256,50,806
33,33,8509,1722,6787,118,6669,91,1849,1631,595,124,40,5,438,85,1811
33,34,2025,346,1679,47,1632,33,427,401,142,33,19,2,145,27,403
33,35,19256,3685,15571,244,15327,509,1572,3174,2039,253,55,37,1670,233,5785
33,36,13834,2143,11691,227,11464,219,2146,2457,1456,203,67,18,1135,216,3547
33,37,5784,881,4903,89,4814,81,1189,1196,475,62,33,11,371,64,1332
33,38,9587,1788,7799,210,7589,187,1587,1812,920,153,57,22,594,127,2130
33,39,15314,2529,12785,234,12551,201,2587,2451,1617,261,66,37,1112,216,4003
33,40,9293,1617,7676,172,7504,81,1919,1821,782,123,47,27,560,145,1999
33,41,8653,1512,7141,131,7010,140,1540,1878,702,101,29,17,520,129,1954
33,42,7631,1209,6422,87,6335,110,1355,1551,692,117,30,13,552,107,1808
33,43,6834,1074,5760,92,5668,109,1013,1214,935,89,37,13,517,83,1658
33,44,14905,2497,12408,219,12189,163,3286,2614,1370,258,93,35,943,238,3189
33,45,3609,562,3047,61,2986,86,590,596,397,72,24,5,221,73,922
33,46,8239,1432,6807,102,6705,110,1519,1903,703,103,27,9,458,98,1775
33,47,5042,796,4246,86,4160,71,899,1061,489,67,19,12,340,60,1142
33,48,5203,820,4383,57,4326,88,937,1010,520,86,21,5,375,91,1193
33,49,39283,6843,32440,623,31817,648,5197,10798,2952,478,118,82,3115,651,7778
33,50,3673,500,3173,41,3132,88,499,666,451,55,19,9,248,49,1048
33,51,24404,4599,19805,327,19478,510,2339,4504,2279,291,70,32,2144,285,7024
33,52,17002,3519,13483,222,13261,476,1610,1917,2710,207,54,25,990,167,5105
33,53,28021,5029,22992,295,22697,575,1958,9224,1606,209,51,41,2820,298,5915
33,54,26752,4592,22160,359,21801,575,2473,6914,2142,321,60,46,2405,340,6525
33,55,23576,4706,18870,319,18551,320,2904,3482,2290,299,81,36,1539,295,7305
33,56,21872,3863,18009,254,17755,729,1552,3810,2309,273,66,39,2166,221,6590
33,57,20437,3521,16916,302,16614,383,2051,3384,2399,299,73,49,1590,242,6144
33,58,16702,3824,12878,214,12664,252,1943,2396,1701,209,53,29,1058,191,4832
33,59,33383,4667,28716,491,28225,825,3047,6569,3353,398,113,68,3311,441,10100
33,60,18715,3946,14769,222,14547,218,2722,2213,2141,296,62,21,868,172,5834
33,61,30817,5253,25564,381,25183,704,3203,6142,2884,383,85,69,2676,421,8616
33,62,19981,3589,16392,290,16102,428,1805,3659,1815,290,67,34,1783,243,5978
33,63,39962,5530,34432,563,33869,799,4324,8607,3636,582,126,95,3816,585,11299
34,1,35350,6811,28539,482,28057,440,8015,8396,2807,253,100,47,1430,360,6209
34,2,7367,1143,6224,118,6106,232,1408,1248,1089,83,26,25,421,87,1487
34,3,7578,1641,5937,100,5837,135,1165,1077,1236,92,41,19,346,67,1659
34,4,12109,3027,9082,138,8944,181,2046,2830,937,76,27,20,533,113,2181
34,5,24347,4143,20204,301,19903,273,5569,5621,2124,172,81,30,1193,244,4596
34,6,14564,2358,12206,195,12011,194,3479,2666,1586,123,63,25,711,169,2995
34,7,35436,4678,30758,558,30200,817,5958,8312,3387,272,110,73,2638,469,8164
34,8,1107,139,968,28,940,33,126,275,153,14,6,2,43,20,268
34,9,3373,466,2907,37,2870,113,538,615,443,33,16,9,213,56,834
34,10,15929,2722,13207,193,13014,295,3115,2709,1901,168,69,22,901,193,3641
34,11,7129,1135,5994,112,5882,73,1636,1459,752,76,25,13,340,75,1433
34,12,36576,6492,30084,585,29499,520,8532,6940,4216,280,114,65,1596,454,6782
34,13,8182,1349,6833,130,6703,161,1672,1495,1088,81,29,18,439,107,1613
34,14,19304,3037,16267,280,15987,459,3611,3429,2652,204,72,35,1135,216,4174
34,15,9658,1863,7795,163,7632,266,1717,1687,1144,110,36,23,462,109,2078
34,16,3376,552,2824,60,2764,102,550,547,504,40,19,10,193,39,760
34,17,33685,5748,27937,521,27416,515,7350,6915,3182,289,141,64,1746,388,6826
34,18,25585,3312,22273,358,21915,753,3519,5869,2743,220,75,59,2113,392,6172
34,19,28837,4592,24245,412,23833,507,5530,7841,2291,214,62,56,1772,351,5209
34,20,24661,4555,20106,355,19751,419,5588,4840,2453,214,90,56,1154,302,4635
34,21,8522,1367,7155,134,7021,155,1685,1597,1078,95,29,10,431,122,1819
34,22,13567,3210,10357,109,10248,644,821,2289,2065,103,25,25,694,86,3496
34,23,16116,2851,13265,176,13089,602,1410,3319,1924,143,43,44,1271,162,4171
34,24,17155,3457,13698,180,13518,582,1427,3425,1959,116,37,33,1160,158,4621
34,25,9090,1298,7792,155,7637,104,2136,1867,1101,101,45,15,431,103,1734
34,26,3628,585,3043,71,2972,159,465,553,574,56,12,9,235,42,867
34,27,4229,793,3436,62,3374,95,741,693,512,60,20,7,258,60,928
34,28,11817,1863,9954,172,9782,203,2170,2587,1332,120,47,27,654,160,2482
34,29,6875,1128,5747,83,5664,105,1465,1320,807,59,30,9,332,95,1442
34,30,6134,928,5206,97,5109,89,1182,1101,720,90,21,12,352,64,1478
34,31,6323,1017,5306,107,5199,113,1120,1092,792,101,37,17,384,72,1471
34,32,4254,591,3663,69,3594,144,698,840,578,48,10,17,307,49,903
34,33,3186,594,2592,70,2522,97,466,473,403,54,20,6,162,35,806
34,34,1433,234,1199,37,1162,31,230,313,159,21,8,0,88,26,286
34,35,10510,1539,8971,162,8809,114,2506,2101,1121,93,48,22,510,134,2160
34,36,15196,2903,12293,186,12107,339,2574,3818,1726,118,40,21,646,175,2650
34,37,15922,2861,13061,222,12839,196,3423,3066,2162,108,62,26,555,138,3103
34,38,22454,3974,18480,310,18170,276,5264,4592,2020,183,74,29,1041,263,4428
34,39,27204,4947,22257,347,21910,286,6247,5753,2553,173,88,33,1126,279,5372
34,40,18845,3855,14990,217,14773,616,2112,3404,2208,148,58,34,1131,176,4886
34,41,10550,2405,8145,142,8003,265,1350,1736,1194,89,40,21,566,120,2622
34,42,13006,2740,10266,197,10069,246,2013,2093,1424,101,38,24,695,139,3296
34,43,14137,3395,10742,163,10579,410,1303,2150,1759,107,23,24,703,139,3961
34,44,23765,4539,19226,308,18918,530,3351,4768,2379,173,72,37,1530,261,5817
34,45,13392,3737,9655,197,9458,210,1523,1254,1594,79,36,23,380,98,4261
34,46,27207,5207,22000,357,21643,764,3284,5442,3093,195,74,43,1852,286,6610
34,47,19412,3408,16004,294,15710,485,2704,4760,1664,115,47,48,1475,223,4189
34,48,25256,4431,20825,350,20475,438,4804,6873,1817,150,48,46,1599,296,4404
34,49,23278,3574,19704,378,19326,437,4745,4564,2630,208,63,33,1404,290,4952
35,1,6743,977,5766,151,5615,110,1015,1643,492,87,63,13,564,116,1512
35,2,10414,1343,9071,217,8854,150,1307,3112,677,118,74,23,1415,229,1749
35,3,14790,2038,12752,248,12504,300,2263,3134,1268,197,115,35,1490,281,3421
35,4,8094,1010,7084,126,6958,222,986,1748,755,75,43,15,838,126,2150
35,5,13352,2250,11102,235,10867,257,1777,3434,925,116,71,22,1201,192,2872
35,6,10106,1292,8814,198,8616,245,1037,2458,812,108,80,21,1310,181,2364
35,7,19340,2351,16989,291,16698,532,1711,4199,1694,187,100,58,2488,368,5361
35,8,10035,1100,8935,490,8445,177,1477,2235,868,129,86,18,971,173,2311
35,9,10599,1523,9076,178,8898,225,1402,2323,857,118,54,17,1031,168,2703
35,10,20561,3328,17233,288,16945,443,2091,5878,1543,158,72,41,1793,300,4626
35,11,10649,1716,8933,185,8748,187,1455,2479,847,128,70,13,927,174,2468
35,12,16766,3023,13743,255,13488,300,1872,4145,1260,192,110,28,1748,257,3576
35,13,14290,2336,11954,284,11670,239,1576,3599,982,152,93,30,1603,254,3142
35,14,3698,478,3220,69,3151,64,608,840,321,41,27,4,404,78,764
35,15,8679,1312,7367,185,7182,142,1134,2782,465,82,58,23,975,171,1350
35,16,20064,2555,17509,323,17186,550,2393,3652,2021,222,134,39,2091,392,5692
35,17,10215,1183,9032,172,8860,304,1120,2043,924,124,62,24,1087,169,3003
35,18,11609,1488,10121,215,9906,245,1429,2742,950,123,85,25,1363,191,2753
35,19,18596,2142,16454,281,16173,534,1710,3559,1786,196,77,40,2125,282,5864
35,20,6493,1018,5475,149,5326,65,981,1913,352,73,40,17,750,118,1017
35,21,6077,903,5174,94,5080,128,983,1420,497,73,41,9,523,98,1308
35,22,8033,1111,6922,123,6799,187,997,1830,654,95,37,14,849,140,1996
35,23,20586,2558,18028,311,17717,526,2299,4042,1913,240,122,43,2150,362,6020
35,24,21130,2799,18331,324,18007,521,1936,4232,1842,175,122,50,2250,326,6553
35,25,10217,1481,8736,173,8563,156,1632,2271,818,126,79,21,908,165,2387
35,26,6144,892,5252,124,5128,100,1084,1401,478,75,54,13,463,112,1348
35,27,11913,1410,10503,195,10308,318,1605,2583,1086,138,79,26,1247,214,3012
35,28,13521,2525,10996,172,10824,440,1568,2615,1170,136,69,17,1174,197,3438
35,29,10755,2004,8751,103,8648,537,418,2559,1077,47,20,20,951,92,2927
35,30,12965,2435,10530,97,10433,565,609,2342,1423,108,43,21,1174,103,4045
35,31,18064,2981,15083,259,14824,553,1337,3573,1702,159,81,44,1786,218,5371
35,32,13988,2490,11498,140,11358,610,679,2442,1479,125,58,17,1287,139,4522
35,33,9433,1463,7970,165,7805,157,1299,2530,619,104,71,15,1111,170,1729
35,34,18341,2344,15997,318,15679,519,2114,3439,1778,206,110,36,1974,327,5176
35,35,7688,963,6725,156,6569,193,1119,1735,617,96,59,20,815,131,1784
35,36,8827,1066,7761,162,7599,133,1222,2137,639,104,79,21,981,202,2081
35,37,21829,4998,16831,283,16548,447,1791,5481,1519,222,92,39,1780,305,4872
35,38,7688,1214,6474,134,6340,118,1165,1775,593,86,42,22,764,103,1672
35,39,18784,3915,14869,267,14602,413,1852,4149,1448,203,96,25,1632,216,4568
35,40,4751,495,4256,84,4172,139,788,875,481,67,35,13,460,115,1199
35,41,8317,997,7320,146,7174,206,1032,1702,741,108,61,16,785,114,2409
35,42,17021,2895,14126,302,13824,321,1768,4767,1028,182,96,25,2150,281,3206
35,43,10794,1480,9314,240,9074,213,1268,2640,738,151,74,26,1530,249,2185
35,44,10310,2123,8187,130,8057,331,643,2000,895,68,43,18,885,100,3074
35,45,9887,1812,8075,107,7968,433,442,1760,1050,92,32,23,939,94,3103
35,46,25818,4068,21750,331,21419,928,1809,4143,2664,217,124,34,2511,330,8659
35,47,31743,4474,27269,492,26777,880,3066,6273,2719,344,148,71,3438,511,9327
35,48,9779,1777,8002,102,7900,524,491,1521,1097,59,42,16,906,92,3152
35,49,20014,3568,16446,274,16172,749,1400,3334,2057,163,122,37,1818,234,6258
35,50,11001,2613,8388,112,8276,268,857,1192,1266,103,76,26,680,104,3704
35,51,8707,1835,6872,103,6769,206,798,1237,868,87,52,22,687,104,2708
35,52,20524,2524,18000,281,17719,699,1241,4693,1733,148,57,36,2439,238,6435
35,53,17301,2296,15005,201,14804,558,1071,4074,1413,133,46,35,2270,195,5009
36,1,4960,957,4003,109,3894,37,673,942,437,53,37,14,444,88,1169
36,2,13148,1857,11291,295,10996,134,2068,2628,1195,167,84,36,1124,243,3317
36,3,9814,1617,8197,166,8031,128,1346,1804,952,122,63,18,621,168,2809
36,4,2718,467,2251,53,2198,30,460,593,219,25,12,9,194,44,612
36,5,8505,1568,6937,176,6761,112,1241,1792,700,94,60,18,593,148,2003
36,6,9210,1476,7734,192,7542,88,1851,1846,727,120,63,19,626,187,2015
36,7,12586,2748,9838,197,9641,200,1364,2690,1031,115,65,31,993,188,2964
36,8,4782,751,4031,99,3932,39,744,1168,354,49,34,12,327,91,1114
36,9,10369,1696,8673,267,8406,128,1505,2202,942,124,82,31,965,185,2242
36,10,2931,417,2514,77,2437,31,573,674,217,30,28,4,250,62,568
36,11,3608,506,3102,68,3034,50,529,619,422,43,18,9,259,57,1028
36,12,9479,1767,7712,190,7522,92,1380,1618,1078,114,71,25,624,159,2361
36,13,8707,1737,6970,133,6837,90,1405,1437,812,113,74,12,526,151,2217
36,14,5818,918,4900,141,4759,55,1188,1226,485,86,55,8,427,104,1125
36,15,2846,400,2446,60,2386,47,512,619,240,23,18,5,172,62,688
36,16,4796,807,3989,87,3902,78,822,895,407,76,36,10,374,101,1103
36,17,4208,751,3457,74,3383,48,642,736,453,55,34,10,262,76,1067
36,18,5119,816,4303,100,4203,58,1049,1006,555,52,36,12,339,120,976
36,19,3532,565,2967,66,2901,50,515,682,311,38,13,7,248,58,979
36,20,2760,579,2181,66,2115,27,439,463,237,37,23,5,213,30,641
36,21,3731,594,3137,92,3045,58,608,888,290,41,16,7,249,58,830
36,22,6508,1005,5503,161,5342,73,1281,1363,568,65,66,24,467,136,1299
36,23,3546,576,2970,67,2903,35,638,743,304,43,27,11,261,67,774
36,24,12254,2659,9595,230,9365,137,1755,2138,1109,113,64,23,859,183,2984
36,25,10887,2114,8773,218,8555,131,1693,1949,958,100,66,24,787,157,2690
36,26,6950,1988,4962,104,4858,59,883,843,642,87,45,9,269,91,1930
37,1,18119,3122,14997,259,14738,351,2701,4218,1482,204,85,35,1388,301,3973
37,2,10654,1552,9102,202,8900,188,1634,2518,1025,140,84,29,895,198,2189
37,3,17734,2731,15003,290,14713,284,2797,4245,1575,206,104,39,1448,320,3695
37,4,9064,1570,7494,141,7353,98,1423,2144,698,79,57,17,729,162,1946
37,5,7585,1259,6326,114,6212,109,1541,1829,558,74,60,17,539,138,1347
37,6,11598,1842,9756,221,9535,173,2116,2544,1031,135,88,24,935,221,2268
37,7,15064,2706,12358,249,12109,228,1935,2936,1640,171,110,36,1149,255,3649
37,8,3222,469,2753,54,2699,48,490,848,235,37,20,9,292,65,655
37,9,6673,985,5688,128,5560,66,1193,1496,483,76,42,16,511,139,1538
37,10,5923,853,5070,99,4971,89,978,1525,447,76,44,16,510,129,1157
37,11,8830,1269,7561,163,7398,123,1523,1923,768,130,59,23,624,192,2033
37,12,5833,737,5096,127,4969,93,978,1343,474,68,57,11,481,132,1332
37,13,14645,2482,12163,266,11897,249,2237,3415,1314,173,97,32,1135,240,3005
37,14,17955,2656,15299,255,15044,276,2449,4274,1460,218,89,45,1758,362,4113
37,15,4314,601,3713,77,3636,79,683,1148,360,46,26,9,303,91,891
37,16,10246,1580,8666,154,8512,155,1602,2425,872,95,74,16,920,204,2149
37,17,4653,749,3904,79,3825,72,825,1230,374,56,36,14,382,91,745
37,18,4098,510,3588,86,3502,64,652,963,329,46,32,5,323,90,998
37,19,6394,990,5404,112,5292,76,1065,1653,417,94,54,12,495,101,1325
37,20,8692,1392,7300,197,7103,112,1487,2067,647,126,64,14,684,167,1735
37,21,11672,2352,9320,102,9218,411,581,3206,1122,83,30,14,1043,125,2603
37,22,11796,2241,9555,164,9391,300,1137,2735,1113,124,45,31,1018,164,2724
37,23,9617,2082,7535,106,7429,249,711,2154,914,80,47,25,824,79,2346
37,24,20543,3080,17463,325,17138,390,2801,5278,1662,232,88,48,1951,363,4325
37,25,10996,2533,8463,117,8346,333,891,1912,1178,113,58,35,819,134,2873
37,26,11291,2514,8777,135,8642,291,1090,1847,1208,100,50,20,802,113,3121
37,27,10115,2460,7655,126,7529,147,990,2051,846,96,45,25,620,116,2593
37,28,12186,2355,9831,177,9654,196,1290,2682,1112,93,59,19,996,141,3066
37,29,12471,2034,10437,157,10280,264,943,3980,797,76,45,26,1303,195,2651
37,30,10598,2518,8080,131,7949,177,1141,1063,1909,118,69,17,477,112,2866
37,31,17184,2915,14269,243,14026,339,1989,3906,1546,164,68,41,1587,287,4099
37,32,11565,1681,9884,157,9727,220,1079,3122,847,94,48,33,1279,173,2832
37,33,10803,2228,8575,180,8395,180,1439,2023,881,132,90,21,755,165,2709
37,34,15597,2652,12945,227,12718,276,1918,3798,1277,137,54,29,1400,257,3572
37,35,12082,2565,9517,179,9338,153,1347,2327,1112,118,63,21,866,162,3169
37,36,16760,2554,14206,248,13958,329,1843,4532,1255,136,60,46,1766,290,3701
37,37,16332,2539,13793,244,13549,300,2087,3320,1689,157,71,31,1413,264,4217
38,1,5779,972,4807,75,4732,167,823,1018,718,64,31,12,404,118,1377
38,2,10762,1883,8879,188,8691,206,2332,2043,1019,104,58,28,671,217,2013
38,3,9271,1928,7343,139,7204,220,1233,2313,890,84,38,21,572,144,1689
38,4,17235,3060,14175,232,13943,328,2836,4023,1324,127,60,46,1461,288,3450
38,5,1792,216,1576,30,1546,73,266,440,248,17,10,2,107,21,362
38,6,1927,326,1601,29,1572,46,309,436,173,13,9,4,108,49,425
38,7,10717,1747,8970,167,8803,209,2177,2328,889,105,54,27,886,190,1938
38,8,22272,3274,18998,342,18656,374,4620,5465,1659,186,83,53,1670,396,4150
38,9,21303,3328,17975,323,17652,671,3059,3952,2437,148,99,58,1640,330,5258
38,10,16443,2656,13787,251,13536,440,2589,2918,1837,195,63,41,1197,291,3965
38,11,11030,1512,9518,169,9349,197,2092,2336,1060,111,53,22,919,197,2362
38,12,17598,3775,13823,175,13648,730,1494,2747,2073,121,74,26,1132,187,5064
38,13,14128,2840,11288,173,11115,619,886,3172,1532,89,28,29,1064,119,3577
38,14,13451,2803,10648,148,10500,452,1378,1845,1776,107,57,38,764,138,3945
38,15,15059,2343,12716,219,12497,224,3135,3813,1078,128,66,28,1076,281,2668
38,16,2778,409,2369,41,2328,155,334,565,351,33,11,4,173,51,651
38,18,3764,479,3285,43,3242,132,561,765,460,44,18,14,348,84,816
38,19,19950,3638,16312,334,15978,268,4485,4177,1724,193,111,50,1287,365,3318
38,20,10784,1880,8904,178,8726,264,1906,1665,1318,129,53,18,570,222,2581
38,21,16161,2884,13277,253,13024,235,3393,3385,1323,144,82,31,1177,292,2962
38,22,4886,778,4108,113,3995,120,885,947,559,56,32,10,357,75,954
38,23,22700,3882,18818,352,18466,429,3463,4423,2369,201,89,42,1828,378,5244
38,24,33904,6557,27347,562,26785,416,6503,5999,3779,312,146,66,2076,526,6962
38,25,5012,772,4240,104,4136,91,957,1022,500,58,31,7,405,89,976
38,26,9182,1502,7680,167,7513,150,1636,2010,812,95,54,17,698,155,1886
38,27,7138,1156,5982,103,5879,171,1318,1626,665,75,37,18,539,119,1311
38,28,11910,1718,10192,261,9931,171,2626,2855,886,105,66,20,919,239,2044
38,29,8625,1475,7150,142,7008,230,1450,1811,891,101,46,24,740,155,1560
38,30,16594,2741,13853,284,13569,349,3014,3615,1548,143,87,32,1356,301,3124
38,32,18389,3221,15168,243,14925,413,2784,3249,2128,152,89,30,1193,251,4636
38,33,20774,3556,17218,350,16868,347,4284,4356,1728,188,109,56,1431,427,3942
38,34,19169,2335,16834,256,16578,768,2369,3981,2236,182,46,54,1717,286,4939
38,35,9260,1550,7710,168,7542,210,1624,1678,923,76,42,28,711,165,2085
38,36,1879,314,1565,30,1535,56,298,311,194,20,13,6,118,43,476
38,37,12404,2022,10382,191,10191,197,2413,2699,1085,130,69,30,835,210,2523
38,38,24380,4459,19921,376,19545,442,3954,4987,2138,163,103,41,1684,323,5710
38,39,22197,3261,18936,361,18575,510,3669,5564,1831,183,84,44,1733,359,4598
38,40,26433,4528,21905,360,21545,560,4047,5481,2834,189,98,61,1910,360,6005
38,41,9757,1361,8396,112,8284,492,975,2391,1201,97,40,25,776,177,2110
38,42,6752,1162,5590,140,5450,154,1315,1313,695,62,44,17,480,101,1269
38,43,8346,1257,7089,137,6952,161,1560,1814,800,91,48,19,728,150,1581
38,44,22415,3579,18836,319,18517,531,3709,4250,2545,192,108,57,1585,340,5200
38,45,33027,5835,27192,534,26658,884,4216,6962,3056,286,96,83,2953,488,7634
38,46,16273,3725,12548,185,12363,160,3191,3384,1180,102,84,24,921,234,3083
38,47,8325,1642,6683,104,6579,183,1046,1105,1274,69,42,7,439,72,2342
38,48,11323,2164,9159,127,9032,465,850,2207,1245,66,29,17,859,120,3174
38,49,16615,3173,13442,172,13270,744,1418,2600,2173,125,86,29,1148,164,4783
38,50,21869,3368,18501,261,18240,869,1602,6511,1634,105,44,42,2102,253,5078
38,51,19011,3465,15546,235,15311,692,2132,3480,1989,150,51,39,1540,279,4959
38,52,11350,2197,9153,167,8986,317,1297,1529,1686,100,56,23,672,140,3166
38,53,18559,3563,14996,276,14720,312,3183,4030,1438,130,71,45,1410,327,3774
38,54,12843,2195,10648,179,10469,254,1885,2078,1808,91,55,18,795,150,3335
38,55,13574,1911,11663,201,11462,429,1595,2758,1422,93,34,20,1121,198,3792
38,56,19388,3297,16091,252,15839,532,2580,3618,2001,143,74,25,1426,284,5156
38,57,11421,2875,8546,149,8397,267,1144,1496,1362,71,37,23,499,99,3399
38,58,20991,5010,15981,288,15693,415,3302,2903,2279,173,96,31,1408,345,4741
38,59,6769,1440,5329,87,5242,155,882,884,933,60,25,7,374,61,1861
38,60,15631,1908,13723,176,13547,533,1293,4957,941,69,31,37,1896,235,3555
39,1,4819,721,4098,74,4024,131,584,1048,620,46,25,21,386,83,1080
39,2,3623,572,3051,66,2985,54,813,811,298,26,23,9,271,87,593
39,3,4838,749,4089,89,4000,86,905,950,528,42,37,10,401,93,948
39,4,5301,745,4556,104,4452,81,955,1130,550,61,31,15,454,104,1071
39,5,2051,307,1744,29,1715,69,351,509,212,21,9,3,176,68,297
39,6,12386,1939,10447,249,10198,191,1997,2942,1212,123,55,23,994,210,2451
39,7,2082,303,1779,38,1741,31,430,387,249,22,21,1,125,50,425
39,8,5216,699,4517,84,4433,70,1283,1085,481,52,30,9,358,91,974
39,9,7702,1211,6491,116,6375,64,1564,1676,620,72,44,10,522,139,1664
39,10,3953,529,3424,71,3353,87,664,986,409,42,27,19,334,82,703
39,11,4977,642,4335,86,4249,124,759,1102,574,63,32,9,419,89,1078
39,12,4841,688,4153,84,4069,68,1023,951,481,62,26,9,332,84,1033
39,13,13744,2194,11550,200,11350,266,2170,2628,1441,132,63,30,1019,205,3396
39,14,2235,285,1950,49,1901,55,456,448,244,41,13,6,144,44,450
39,15,10487,2013,8474,161,8313,216,1341,2194,1155,96,33,16,917,182,2163
39,16,4319,670,3649,63,3586,101,862,938,425,51,17,9,287,91,805
39,17,3615,470,3145,60,3085,57,646,812,389,57,33,15,261,73,742
39,18,2443,356,2087,40,2047,61,469,542,238,35,13,5,147,55,482
39,19,10041,2007,8034,203,7831,222,1478,2424,859,98,56,22,851,224,1597
39,20,2443,301,2142,45,2097,53,396,707,174,33,12,6,304,69,343
39,21,3423,474,2949,79,2870,56,619,808,311,35,34,11,282,75,639
39,22,1773,289,1484,14,1470,55,288,447,170,17,20,3,176,46,248
39,23,6926,1168,5758,160,5598,189,994,1470,773,73,49,11,608,123,1308
39,24,4856,584,4272,91,4181,82,1040,972,511,65,32,10,361,82,1026
39,25,3623,575,3048,54,2994,93,717,738,360,45,26,11,268,44,692
39,26,13773,2587,11186,202,10984,306,2234,2539,1463,139,74,46,1014,282,2887
39,27,1644,257,1387,27,1360,39,312,365,156,14,15,8,120,31,300
39,28,4200,643,3557,91,3466,88,640,1015,448,60,29,12,446,81,647
39,29,4332,758,3574,84,3490,103,612,966,428,52,23,5,366,72,863
39,30,2657,399,2258,68,2190,69,438,539,266,39,27,6,213,59,534
39,31,2984,444,2540,56,2484,71,432,706,388,36,17,3,223,49,559
39,32,5137,652,4485,85,4400,137,758,1240,518,56,21,14,537,116,1003
39,33,11489,2445,9044,172,8872,156,1865,1928,1181,117,75,25,733,181,2611
39,34,10319,2241,8078,148,7930,160,1363,1805,1206,105,42,13,770,168,2298
40,1,7613,1197,6416,133,6283,87,873,1657,597,98,35,17,759,99,2061
40,2,5867,736,5131,99,5032,70,602,1113,644,71,33,11,623,81,1784
40,3,8803,1158,7645,169,7476,138,955,1904,914,142,36,16,661,149,2561
40,4,16896,2587,14309,262,14047,227,1967,3267,1816,235,64,25,1330,246,4870
40,5,2939,384,2555,58,2497,36,424,619,274,31,31,9,230,63,780
40,6,3636,552,3084,76,3008,38,398,891,245,33,19,8,402,57,917
40,7,5988,906,5082,113,4969,69,813,1405,463,79,27,6,558,70,1479
40,8,7864,972,6892,145,6747,74,831,1561,620,95,36,12,823,118,2577
40,9,2581,349,2232,42,2190,33,355,514,296,43,9,11,220,44,665
40,10,9206,1442,7764,162,7602,141,1015,1780,932,99,42,16,669,117,2791
40,11,13010,3022,9988,215,9773,170,1606,2397,1038,127,54,22,1014,162,3183
40,12,8985,1218,7767,139,7628,122,1088,1546,1053,128,35,16,817,115,2708
40,13,7375,1109,6266,161,6105,64,786,1123,917,99,38,16,456,82,2524
40,14,4490,530,3960,81,3879,57,398,705,559,48,15,7,366,50,1674
40,15,20614,3781,16833,292,16541,316,3081,4671,1714,241,68,33,1734,361,4322
40,16,8819,1322,7497,128,7369,143,1067,1660,936,116,39,11,901,118,2378
40,17,2773,465,2308,45,2263,43,365,522,275,51,16,4,172,38,777
40,18,8439,1165,7274,146,7128,127,981,1536,1280,97,40,19,775,96,2177
40,19,6207,937,5270,97,5173,89,851,1218,648,69,28,12,486,78,1694
40,20,4645,752,3893,55,3838,61,595,780,562,69,23,6,291,68,1383
40,21,19480,3139,16341,289,16052,383,2198,3158,2936,252,75,26,1692,201,5131
40,22,8026,1147,6879,122,6757,88,899,1693,715,88,32,11,774,117,2340
40,23,23705,3953,19752,368,19384,454,2731,5083,2516,255,95,45,1981,306,5918
40,24,1469,191,1278,32,1246,18,160,286,177,25,11,2,126,20,421
40,25,22171,3579,18592,346,18246,568,2088,5595,2047,247,58,40,1869,325,5409
40,26,4480,645,3835,62,3773,41,538,779,632,62,14,4,332,84,1287
40,27,8281,1227,7054,163,6891,94,988,1300,1065,133,29,15,632,112,2523
40,28,4694,718,3976,93,3883,66,656,961,466,55,15,6,370,65,1223
40,29,22304,4056,18248,371,17877,307,2369,5160,1919,239,72,40,1929,232,5610
40,30,25380,4834,20546,373,20173,342,2703,5003,2252,278,72,50,2445,334,6694
41,1,11988,2410,9578,137,9441,249,1409,2767,865,96,56,18,1196,178,2607
41,2,10252,1752,8500,187,8313,213,1425,2140,924,112,48,25,960,163,2303
41,3,13176,1953,11223,194,11029,165,2395,2927,1279,147,71,38,1070,240,2697
41,4,14952,2248,12704,236,12468,214,2686,3598,1216,152,80,24,1256,270,2972
41,5,2570,357,2213,57,2156,32,547,728,157,19,20,3,199,59,392
41,6,11848,1669,10179,186,9993,191,2090,2721,1020,149,82,27,1003,226,2484
41,7,8276,1345,6931,161,6770,96,1329,2267,693,99,40,29,553,141,1523
41,8,4734,707,4027,67,3960,59,850,1210,326,51,23,9,457,88,887
41,9,5484,921,4563,90,4473,52,1244,1126,483,60,44,18,300,88,1058
41,10,8579,1270,7309,163,7146,115,1495,1935,674,93,50,26,754,155,1849
41,11,4681,676,4005,99,3906,47,847,1358,306,66,45,14,347,90,786
41,12,7259,1253,6006,125,5881,102,1402,1778,568,68,45,15,554,146,1203
41,13,11992,1921,10071,205,9866,160,2005,3036,1008,149,72,19,954,212,2251
41,14,6587,1023,5564,103,5461,81,1258,1554,515,85,58,24,493,115,1278
41,15,4669,686,3983,83,3900,50,996,1364,319,40,36,6,309,86,694
41,16,4081,591,3490,75,3415,31,852,1112,256,48,17,8,363,90,638
41,17,9577,1989,7588,163,7425,120,1644,2200,645,78,34,13,617,135,1939
41,18,13486,2341,11145,217,10928,175,2538,3040,1084,150,73,26,953,290,2599
41,19,3772,606,3166,84,3082,46,681,945,275,56,9,7,343,84,636
41,20,10794,1895,8899,152,8747,118,1972,2609,888,131,59,27,717,201,2025
41,21,4788,788,4000,110,3890,56,968,1027,380,58,49,10,388,96,858
41,22,8045,1393,6652,148,6504,102,1636,1896,580,61,48,19,577,136,1449
41,23,3019,414,2605,58,2547,48,541,756,241,45,15,7,302,62,530
41,24,9314,1627,7687,164,7523,144,1328,1954,840,111,75,10,797,135,2129
41,25,10125,2317,7808,104,7704,246,1166,2126,853,78,35,22,809,115,2254
41,26,5043,1769,3274,43,3231,51,520,511,398,27,21,4,217,44,1438
41,27,8154,1408,6746,96,6650,117,1264,1517,660,96,48,15,675,134,2124
41,28,11144,1897,9247,214,9033,156,1527,2580,906,128,69,20,974,192,2481
41,29,6768,1413,5355,133,5222,71,1252,1445,447,59,28,16,380,117,1407
41,30,7904,1146,6758,121,6637,111,1323,1717,631,82,34,19,739,125,1856
42,1,4331,686,3645,92,3553,58,820,1125,295,43,31,10,386,117,668
42,2,9933,1501,8432,216,8216,130,1944,1771,949,106,78,16,877,211,2134
42,3,5230,809,4421,77,4344,133,907,1021,591,91,44,9,507,112,929
42,4,13149,2973,10176,193,9983,110,2627,1593,1538,109,62,27,565,138,3214
42,5,11451,1935,9516,250,9266,159,1828,2533,1060,122,62,32,1022,252,2196
42,6,7773,1001,6772,152,6620,182,1430,1964,549,69,54,16,822,192,1342
42,7,19290,3126,16164,331,15833,295,3714,4736,1364,185,107,28,1749,381,3274
42,8,21485,3922,17563,323,17240,291,4283,3275,2533,184,100,32,1378,300,4864
42,9,22074,3608,18466,378,18088,403,3571,4782,1835,173,117,57,2087,451,4612
42,10,6279,1018,5261,132,5129,72,1249,1329,489,63,37,8,628,169,1085
42,11,3517,586,2931,65,2866,70,515,680,327,38,41,5,329,48,813
42,12,3382,568,2814,67,2747,42,668,715,357,21,19,2,198,58,667
42,13,11822,1786,10036,223,9813,321,2126,2361,1144,143,66,25,1086,304,2237
42,14,12009,1673,10336,225,10111,144,2292,2913,868,97,62,36,991,203,2505
42,15,18147,2935,15212,222,14990,276,3314,3208,1927,182,103,42,1334,357,4247
42,16,20602,3778,16824,309,16515,277,3154,4221,2036,188,94,43,1402,296,4804
42,17,6370,848,5522,96,5426,109,1416,1489,579,50,31,11,569,136,1036
42,18,13604,2967,10637,255,10382,203,2682,2126,1136,102,51,21,874,173,3014
42,19,12243,2946,9297,139,9158,218,1669,1704,1352,88,51,15,654,138,3269
42,20,18815,3801,15014,260,14754,211,2938,3157,1835,138,88,28,1281,234,4844
42,21,15192,3031,12161,163,11998,287,2058,3055,1367,127,67,35,1165,239,3598
42,22,21703,3796,17907,284,17623,347,3776,4226,2058,174,89,29,1602,288,5034
42,23,27037,4083,22954,443,22511,321,4922,6869,1776,227,108,51,2463,535,5239
42,24,6540,749,5791,110,5681,170,1152,1672,560,57,40,11,753,121,1145
42,25,3281,514,2767,60,2707,52,579,779,312,41,14,12,336,56,526
42,26,4678,793,3885,87,3798,76,948,1066,374,50,27,6,398,105,748
42,27,10308,1424,8884,185,8699,185,1872,2252,1020,102,61,29,851,219,2108
42,28,21519,2582,18937,324,18613,397,3759,6004,1550,162,80,46,2006,386,4223
42,29,5725,790,4935,113,4822,134,1191,947,659,65,35,10,445,98,1238
42,30,4000,754,3246,93,3153,65,723,914,303,31,27,8,337,78,667
42,31,28723,4494,24229,422,23807,424,5741,6255,2287,274,115,50,2521,563,5577
42,32,9668,1405,8263,221,8042,148,2034,2168,716,93,50,13,923,207,1690
42,33,16022,2493,13529,226,13303,223,3343,2847,1407,147,82,22,1246,310,3676
42,34,25429,4139,21290,504,20786,351,4285,5489,2335,237,132,38,1942,410,5567
42,35,15118,3257,11861,176,11685,259,2259,2651,1466,119,84,34,1017,201,3595
42,36,11816,2700,9116,129,8987,228,1533,2502,1039,70,39,15,776,131,2654
42,37,13134,2824,10310,146,10164,256,1728,2541,1331,109,48,26,907,159,3059
42,38,7142,1803,5339,67,5272,152,664,1097,808,54,30,9,451,95,1912
42,39,10077,2368,7709,120,7589,162,1401,1457,1124,65,39,15,633,112,2581
42,40,11083,2760,8323,174,8149,149,1762,1916,848,68,38,17,698,122,2531
43,1,2528,445,2083,58,2025,42,461,553,164,22,22,4,213,53,491
43,2,7252,1197,6055,144,5911,86,1068,1029,901,106,52,17,429,99,2124
43,3,5752,808,4944,107,4837,90,1306,1254,447,66,27,10,551,102,984
43,4,1839,272,1567,31,1536,37,285,358,227,29,12,3,143,24,418
43,5,5780,965,4815,130,4685,70,686,952,637,46,33,12,452,89,1708
43,6,2157,288,1869,52,1817,29,425,509,195,18,9,2,234,41,355
43,7,1992,373,1619,47,1572,39,357,426,150,26,16,4,193,40,321
43,8,3673,679,2994,80,2914,71,648,882,251,32,21,4,358,57,590
43,9,1640,297,1343,21,1322,34,238,394,146,16,14,3,208,27,242
43,10,6175,1040,5135,127,5008,86,909,1180,639,92,37,6,556,109,1394
43,11,2180,367,1813,37,1776,53,342,423,226,22,7,3,223,35,442
43,12,3871,509,3362,93,3269,64,677,814,323,41,34,7,375,98,836
43,13,3689,545,3144,75,3069,71,569,768,358,35,23,7,391,53,794
43,14,10684,1362,9322,218,9104,179,2299,2147,986,119,59,20,1011,196,2088
43,15,5588,679,4909,137,4772,65,1315,1490,358,55,40,9,562,119,759
43,16,3507,644,2863,68,2795,66,562,547,394,39,27,8,313,56,783
43,17,972,247,725,20,705,12,160,186,72,12,4,2,93,8,156
43,18,2631,417,2214,49,2165,31,483,629,218,27,14,1,212,39,511
43,19,7986,1200,6786,135,6651,161,1012,1703,732,98,44,20,708,165,2008
43,20,8676,1513,7163,155,7008,158,1056,1664,824,76,46,19,739,142,2284
43,21,2781,405,2376,55,2321,55,551,474,327,38,20,5,233,37,581
43,22,11164,1527,9637,219,9418,198,2523,2152,1018,128,65,25,998,217,2094
43,23,5781,767,5014,116,4898,150,816,974,623,53,37,13,631,91,1510
43,24,4209,514,3695,308,3387,51,730,849,349,43,20,5,398,73,869
43,25,3465,578,2887,82,2805,25,513,931,259,38,20,5,439,58,517
43,26,4534,540,3994,98,3896,75,887,863,413,49,26,3,436,82,1062
43,27,7062,1354,5708,149,5559,133,907,1405,655,55,33,9,620,119,1623
43,28,4467,639,3828,103,3725,87,820,913,416,49,41,11,418,70,900
43,29,9414,1346,8068,226,7842,158,1761,1966,724,135,55,20,994,188,1841
43,30,4144,564,3580,72,3508,70,903,813,394,46,30,6,348,67,831
43,31,8231,1314,6917,145,6772,149,1067,1490,807,97,49,14,736,120,2243
43,32,5017,970,4047,86,3961,115,557,1137,462,50,22,11,415,57,1135
43,33,5434,1052,4382,78,4304,110,611,1236,464,43,19,13,479,86,1243
43,34,5157,869,4288,106,4182,111,602,976,497,49,40,8,411,69,1419
43,35,6671,939,5732,152,5580,110,1494,1351,558,81,49,13,692,135,1097
44,1,17323,2185,15138,332,14806,340,1965,4214,1522,204,108,23,1893,357,4180
44,2,18230,2577,15653,350,15303,393,2227,3978,1563,197,116,43,2023,364,4399
44,3,13757,2101,11656,255,11401,468,1661,2737,1523,210,80,20,1270,263,3169
44,4,34035,4875,29160,526,28634,869,3109,6156,3813,324,163,61,2947,526,10666
44,5,9801,1346,8455,133,8322,189,1339,2596,834,125,66,24,858,222,2069
44,6,31681,4098,27583,463,27120,694,2661,7460,2765,283,113,56,3727,492,8869
44,7,28942,3893,25049,397,24652,1014,2424,6443,2502,251,71,54,3459,488,7946
44,8,11985,2217,9768,229,9539,203,1369,2726,858,131,61,21,1139,199,2832
44,9,17128,2220,14908,327,14581,431,1888,4247,1493,181,109,40,1899,330,3963
44,10,10884,1889,8995,136,8859,234,1155,3535,754,93,46,18,759,160,2105
44,11,6554,1009,5545,124,5421,134,898,1466,540,118,47,6,598,85,1529
44,12,6891,973,5918,93,5825,183,1028,1507,676,86,33,10,542,102,1658
44,13,26736,4095,22641,380,22261,654,2908,7519,2128,300,111,54,2422,443,5722
44,14,11509,1421,10088,235,9853,239,1526,2541,1162,167,68,16,1023,179,2932
44,15,5878,817,5061,122,4939,103,923,1510,471,66,45,8,539,93,1181
44,16,8845,1166,7679,152,7527,209,1145,1788,871,99,54,14,1078,194,2075
44,17,18376,2433,15943,355,15588,406,2258,4426,1638,209,97,54,2056,328,4116
44,18,10637,1578,9059,193,8866,179,1345,2811,825,154,73,27,1154,197,2101
44,19,5020,628,4392,105,4287,68,788,1389,352,58,31,15,416,89,1081
44,20,17363,3113,14250,164,14086,801,843,4392,1616,123,31,30,1689,164,4397
44,21,21259,4079,17180,235,16945,909,1217,4327,2208,161,69,34,1888,214,5918
44,22,17971,3560,14411,184,14227,872,926,3052,2135,155,56,34,1416,155,5426
44,23,21782,3639,18143,220,17923,736,979,7080,1582,109,37,36,2149,209,5006
44,24,15853,3391,12462,164,12298,584,1090,2194,1849,127,61,31,1097,150,5115
44,25,17207,3068,14139,177,13962,630,1106,4105,1296,123,54,31,1794,174,4649
44,26,13002,2869,10133,160,9973,370,995,1948,1344,107,48,24,992,140,4005
44,27,18481,2559,15922,291,15631,452,2511,3824,1673,233,108,33,1996,348,4453
44,28,11125,1461,9664,276,9388,304,1466,2331,1112,159,70,16,1052,176,2702
44,29,13610,2099,11511,206,11305,268,1682,2964,1315,170,85,27,1192,250,3352
44,30,21143,2731,18412,361,18051,518,2470,3820,2562,261,129,43,1952,374,5922
44,31,17787,2683,15104,273,14831,306,2440,2935,2139,270,140,25,1515,270,4791
44,32,23065,3377,19688,324,19364,532,2823,6722,1689,238,80,60,2105,458,4657
44,33,5741,739,5002,129,4873,189,863,1281,493,80,30,10,565,113,1249
44,34,3254,469,2785,68,2717,59,551,751,248,40,34,11,315,60,648
44,35,27370,3981,23389,498,22891,712,2932,4681,3285,283,135,59,2524,421,7859
44,36,10679,1453,9226,180,9046,211,1515,2129,1153,152,77,14,952,190,2653
44,37,4015,575,3440,86,3354,71,616,1010,290,62,22,11,363,75,834
44,38,4487,608,3879,97,3782,61,700,1343,297,42,37,12,438,121,731
44,39,13973,3060,10913,177,10736,339,1390,1744,1720,195,100,23,858,150,4217
44,40,9172,1271,7901,139,7762,233,1245,1774,1067,132,72,29,792,132,2286
44,41,8623,1291,7332,175,7157,158,1281,2140,736,96,58,25,828,196,1639
44,42,14849,1971,12878,252,12626,283,2145,3636,1187,202,119,18,1554,282,3200
44,43,16855,2236,14619,280,14339,463,2078,2960,1932,202,113,32,1604,338,4617
44,44,13303,1715,11588,290,11298,265,1527,3304,1200,174,69,25,1656,271,2807
44,45,6548,950,5598,134,5464,155,885,1596,480,86,41,14,628,127,1452
44,46,23272,2669,20603,357,20246,593,1993,5896,2134,195,83,47,2453,392,6460
44,47,17348,2833,14515,241,14274,199,2520,2179,2574,269,109,23,987,260,5154
44,48,17539,3214,14325,236,14089,544,1297,3072,1740,129,79,30,1636,177,5385
44,49,20523,3801,16722,245,16477,571,1544,3287,2213,174,83,31,1680,227,6667
44,50,26299,4190,22109,345,21764,769,1887,4933,2622,224,93,49,2555,318,8314
44,51,22386,3938,18448,339,18109,667,2101,3057,2851,252,112,38,1688,318,7025
44,52,16949,3810,13139,185,12954,490,1410,2691,1614,123,57,30,1277,175,5087
44,53,15185,2904,12281,163,12118,351,1220,2688,1732,137,83,21,1128,185,4573
44,54,25116,4021,21095,403,20692,654,1921,6229,1791,168,62,54,2688,312,6813
44,55,17439,3269,14170,223,13947,466,1453,2752,1900,148,81,25,1524,236,5362
44,56,17648,3448,14200,233,13967,429,1663,2803,2089,195,101,35,1241,227,5184
44,57,24307,4229,20078,352,19726,427,2148,8810,1326,162,52,31,1975,348,4447
44,58,11387,2584,8803,128,8675,349,792,1926,1125,85,36,28,834,110,3390
44,59,17127,1982,15145,274,14871,410,1407,4256,1531,136,60,47,2071,284,4669
45,1,6462,963,5499,116,5383,53,1440,1677,403,39,37,6,468,141,1119
45,2,12229,2318,9911,188,9723,180,1872,2839,975,102,63,25,900,204,2563
45,3,7562,1241,6321,105,6216,112,1830,1851,480,80,43,14,509,116,1181
45,4,5034,796,4238,79,4159,62,1025,1491,303,46,25,9,362,123,713
45,5,8571,1605,6966,124,6842,87,1673,1953,707,68,48,32,537,142,1595
45,6,14989,2363,12626,210,12416,240,2836,3712,1046,117,63,29,1168,263,2942
45,7,7757,1288,6469,114,6355,112,1760,2017,538,61,34,17,492,174,1150
45,8,7737,1397,6340,103,6237,111,1591,2043,480,65,47,16,501,190,1193
45,9,5669,968,4701,97,4604,72,1151,1214,472,55,29,13,383,110,1105
45,10,5938,772,5166,105,5061,121,982,1482,456,62,21,19,542,124,1252
45,11,7465,1287,6178,92,6086,77,1795,1947,489,55,29,13,460,165,1056
45,12,11723,2056,9667,208,9459,119,2570,2904,817,96,73,20,756,223,1881
45,13,10539,1461,9078,165,8913,172,1680,2868,774,91,55,32,809,182,2250
45,14,17231,3277,13954,254,13700,157,3435,4052,1153,116,71,26,1210,289,3191
45,15,13461,1964,11497,224,11273,239,2332,3205,1048,147,53,26,1064,264,2895
45,16,6881,1045,5836,127,5709,81,1585,1793,457,62,40,9,461,155,1066
45,17,7805,1595,6210,119,6091,87,1622,1678,568,78,40,8,467,171,1372
45,18,13974,2511,11463,194,11269,223,2360,3525,1041,110,75,30,1079,223,2603
45,19,8876,2614,6262,117,6145,122,1217,1830,687,46,38,6,517,98,1584
45,20,10984,1689,9295,177,9118,156,1994,2511,822,105,62,17,897,244,2310
45,21,9526,1830,7696,116,7580,294,787,2423,852,44,31,20,827,129,2173
45,22,10316,1903,8413,123,8290,292,926,2826,820,68,33,7,856,112,2350
45,23,10953,2165,8788,152,8636,226,1111,2634,839,85,49,14,949,151,2578
45,24,9255,2151,7104,133,6971,202,996,1515,794,82,41,28,586,104,2623
45,25,12611,2349,10262,193,10069,268,1335,3013,934,96,47,26,1056,187,3107
45,26,6281,940,5341,84,5257,68,1392,1635,407,71,40,21,474,125,1024
45,27,7209,1153,6056,119,5937,59,1537,1733,589,81,28,20,544,139,1207
45,28,4415,710,3705,74,3631,31,940,1210,269,51,41,12,322,94,661
45,29,15826,3124,12702,261,12441,175,3026,3641,1066,148,73,30,1086,225,2971
45,30,5106,916,4190,91,4099,69,1047,1220,348,43,26,14,401,99,832
45,31,8373,1515,6858,120,6738,78,1676,2175,487,77,47,15,550,152,1481
45,32,17160,3231,13929,272,13657,237,3288,4331,1093,118,70,51,1206,315,2948
45,33,14262,2976,11286,244,11042,147,2633,2500,1685,125,56,19,741,272,2864
45,34,14075,2945,11130,207,10923,205,2075,2369,1391,104,66,18,1024,176,3495
45,35,20278,3332,16946,259,16687,422,2122,5996,1283,119,61,43,2032,348,4261
45,36,14938,2716,12222,217,12005,270,2008,3163,1224,124,72,23,1189,228,3704
45,37,9750,2120,7630,144,7486,150,1355,1649,807,80,40,23,595,134,2653
45,38,13589,1940,11649,204,11445,230,2035,3479,1064,107,43,29,1272,209,2977
45,39,26013,4913,21100,409,20691,372,3942,5278,2333,230,130,58,1986,398,5964
45,40,13854,2088,11766,229,11537,259,1650,3864,993,98,41,29,1378,235,2990
45,41,8251,1970,6281,117,6164,107,633,1104,929,58,26,18,477,79,2733
46,1,6720,796,5924,143,5781,105,771,1136,710,76,36,16,498,112,2321
46,2,5429,919,4510,73,4437,131,601,850,623,73,16,6,374,74,1689
46,3,8059,1264,6795,121,6674,191,1013,1275,944,100,28,14,606,133,2370
46,4,2654,310,2344,46,2298,70,238,595,354,29,24,6,226,37,719
46,5,3322,444,2878,51,2827,79,438,682,403,37,14,3,329,63,779
46,6,4276,481,3795,82,3713,137,543,747,581,47,25,11,268,55,1299
46,7,2180,285,1895,40,1855,34,281,447,307,32,17,2,156,34,545
46,8,6734,1099,5635,134,5501,144,687,1197,844,74,28,12,574,97,1844
46,9,7861,1103,6758,140,6618,193,688,1337,1077,77,33,18,635,108,2452
46,10,6432,937,5495,128,5367,125,758,1190,783,69,31,18,413,103,1877
46,11,5886,773,5113,90,5023,106,666,1176,666,79,33,20,500,126,1651
46,12,1808,207,1601,34,1567,43,192,449,179,26,4,4,158,35,477
46,13,5223,681,4542,87,4455,131,524,864,696,80,25,8,436,73,1618
46,14,4675,490,4185,67,4118,134,623,908,651,48,14,10,388,87,1255
46,15,2200,340,1860,64,1796,39,213,363,217,29,14,6,233,42,640
46,16,1414,193,1221,24,1197,38,156,271,155,20,6,4,130,19,398
46,17,2818,343,2475,67,2408,129,283,529,397,41,4,4,233,49,739
46,18,3339,396,2943,71,2872,91,325,530,487,60,9,9,266,63,1032
46,19,5395,685,4710,88,4622,155,543,1034,714,70,25,11,444,78,1548
46,20,4480,560,3920,77,3843,94,515,915,469,57,20,11,368,102,1292
46,21,2981,440,2541,39,2502,107,376,616,305,36,13,9,304,54,682
46,22,2102,272,1830,36,1794,34,249,379,325,35,16,6,142,31,577
46,23,7197,1163,6034,132,5902,134,1021,1325,773,91,34,19,546,121,1838
46,24,6217,814,5403,91,5312,107,649,1153,643,67,34,15,576,99,1969
46,25,2069,275,1794,35,1759,45,253,346,259,22,12,3,177,27,615
46,26,1880,223,1657,37,1620,79,240,344,303,24,8,2,141,31,448
46,27,2156,359,1797,34,1763,47,274,370,305,19,16,10,135,37,550
46,28,5985,820,5165,118,5047,72,704,1135,648,79,26,18,429,113,1823
46,29,3675,462,3213,78,3135,62,471,663,391,42,19,8,276,64,1139
46,30,1235,192,1043,30,1013,23,111,191,108,16,4,0,110,19,431
46,31,8776,1412,7364,113,7251,167,970,1430,1083,95,35,16,577,126,2752
47,1,8637,1618,7019,148,6871,162,1209,1747,783,98,28,11,607,107,2119
47,2,7348,1260,6088,122,5966,117,1315,1253,708,67,19,9,493,91,1894
47,3,6555,1028,5527,130,5397,107,1245,1382,567,72,25,12,469,90,1428
47,4,2011,263,1748,28,1720,44,379,416,199,35,17,8,168,43,411
47,5,2356,304,2052,32,2020,48,444,461,346,37,12,6,200,44,422
47,6,4500,612,3888,68,3820,75,865,956,414,72,22,10,384,70,952
47,7,5195,909,4286,82,4204,71,814,1096,589,53,29,8,338,69,1137
47,8,2691,388,2303,29,2274,48,526,543,265,26,18,6,242,50,550
47,9,2573,394,2179,42,2137,39,455,588,211,27,13,9,218,53,524
47,10,3924,601,3323,57,3266,48,824,843,355,38,22,13,235,58,830
47,11,3575,542,3033,84,2949,80,626,909,291,34,18,9,318,47,617
47,12,2302,337,1965,47,1918,59,405,579,213,28,14,7,211,33,369
47,13,8084,1374,6710,164,6546,114,1221,1446,771,116,26,18,461,140,2233
47,14,1328,189,1139,22,1117,30,204,253,186,21,11,3,70,21,318
47,15,9190,1168,8022,153,7869,142,1775,2062,847,84,29,13,789,166,1962
47,16,3364,413,2951,45,2906,69,660,678,381,39,11,4,272,57,735
47,17,6977,1082,5895,110,5785,91,1257,1479,627,81,35,15,536,105,1559
47,18,6590,1023,5567,132,5435,78,1268,1354,654,73,29,13,460,104,1402
47,19,11461,2258,9203,201,9002,122,1997,2418,908,111,48,15,810,164,2409
47,20,4762,630,4132,90,4042,67,913,950,564,54,15,8,302,59,1110
47,21,3825,472,3353,79,3274,62,720,795,463,63,15,7,312,59,778
47,22,3060,410,2650,62,2588,61,498,715,333,33,6,4,241,52,645
47,23,3148,488,2660,56,2604,62,564,731,353,50,13,5,230,43,553
47,24,4731,622,4109,89,4020,86,801,904,504,68,19,8,443,93,1094
47,25,7595,1224,6371,152,6219,122,1169,1638,802,61,30,15,596,101,1685
47,26,6074,934,5140,97,5043,106,1159,1316,575,76,30,17,484,87,1193
47,27,6495,1168,5327,106,5221,106,1213,1342,686,65,21,15,416,77,1280
47,28,3485,456,3029,52,2977,84,625,823,296,37,13,6,309,59,725
47,29,5820,804,5016,103,4913,76,1275,1202,549,68,24,11,424,88,1196
47,30,6116,1162,4954,71,4883,75,1121,1288,522,89,25,13,327,80,1343
47,31,4746,604,4142,92,4050,82,969,1045,489,68,30,8,379,78,902
47,32,10022,1906,8116,170,7946,123,1889,1864,952,112,41,16,642,129,2178
47,33,5074,794,4280,96,4184,72,864,916,526,64,22,14,323,65,1318
47,34,12058,2625,9433,172,9261,170,1799,2507,1055,96,36,19,771,154,2654
47,35,2887,414,2473,52,2421,67,508,587,246,28,14,5,283,48,635
47,36,10767,1794,8973,181,8792,252,1691,2290,995,112,38,13,829,163,2409
47,37,8975,1823,7152,129,7023,142,1386,1832,795,111,29,18,652,133,1925
47,38,10354,2063,8291,169,8122,121,1647,2106,953,119,40,22,695,150,2269
47,39,12420,2551,9869,226,9643,163,2035,2476,1082,110,43,31,746,167,2790
47,40,9851,1599,8252,148,8104,132,1745,1978,911,103,44,17,709,125,2340
48,1,1994,258,1736,27,1709,24,376,678,103,14,9,7,170,43,285
48,2,1188,165,1023,18,1005,91,115,165,255,16,5,1,55,13,289
48,3,1719,287,1432,24,1408,37,265,372,195,18,10,1,193,19,298
48,4,2560,335,2225,54,2171,45,427,685,211,31,3,7,234,37,491
48,5,2055,257,1798,44,1754,55,291,437,274,32,12,3,193,31,426
48,6,1313,222,1091,16,1075,12,209,344,71,19,10,0,156,23,231
48,7,3047,447,2600,56,2544,119,286,504,499,40,15,7,183,36,855
48,8,1242,188,1054,24,1030,9,287,386,50,7,12,4,140,13,122
48,9,1490,254,1236,21,1215,20,223,345,158,15,12,3,147,23,269
48,10,3663,668,2995,54,2941,53,546,844,328,36,20,6,294,48,766
48,11,2098,294,1804,48,1756,17,378,581,137,25,9,5,220,30,354
48,12,5628,826,4802,115,4687,111,986,1219,463,50,24,17,531,103,1183
48,13,839,94,745,13,732,13,128,229,57,14,4,2,95,13,177
48,14,6709,961,5748,109,5639,127,788,1557,578,65,20,12,730,103,1659
48,15,1227,174,1053,14,1039,40,146,293,151,12,8,3,95,14,277
48,16,1031,149,882,16,866,13,168,421,38,3,2,1,107,10,103
48,17,1267,201,1066,18,1048,57,105,138,270,26,5,3,94,14,336
48,18,1819,314,1505,35,1470,17,224,532,149,16,4,3,159,20,346
48,19,1845,272,1573,27,1546,38,329,545,111,15,9,2,216,19,262
48,20,4954,679,4275,81,4194,63,756,1257,413,52,22,11,470,81,1069
48,21,1177,171,1006,18,988,47,149,244,150,10,6,1,115,24,242
48,22,2624,374,2250,47,2203,121,330,342,611,44,7,4,139,27,578
48,23,2486,298,2188,46,2142,45,412,591,234,23,14,4,245,36,538
48,24,1540,230,1310,18,1292,29,252,330,207,16,5,2,168,12,271
48,25,4375,739,3636,84,3552,104,474,846,495,48,16,10,356,51,1152
49,1,20909,3919,16990,395,16595,427,2028,4406,1756,223,107,53,1917,315,5363
49,2,19799,3478,16321,328,15993,416,1897,4191,1739,210,94,44,1858,301,5243
49,3,19948,3623,16325,222,16103,630,1061,5853,1395,121,31,41,2188,224,4559
49,4,8368,1254,7114,157,6957,165,1231,2102,662,105,43,23,725,186,1715
49,5,13750,1983,11767,332,11435,258,1908,3030,1192,175,89,23,1344,314,3102
49,6,21071,3079,17992,510,17482,343,2342,5774,1312,273,159,35,3014,488,3742
49,7,5400,715,4685,134,4551,85,766,1722,307,49,39,10,627,123,823
49,8,9191,1315,7876,201,7675,224,966,2247,825,91,56,26,994,151,2095
49,9,11354,1444,9910,308,9602,238,1571,2902,858,142,94,33,1310,222,2232
49,10,8834,1239,7595,185,7410,139,1390,2441,684,99,53,16,772,148,1668
49,11,12139,1775,10364,276,10088,231,1247,3581,766,167,82,30,1588,284,2112
49,12,18877,2844,16033,422,15611,292,1847,4846,1232,238,128,48,2302,344,4334
49,13,10664,1785,8879,192,8687,157,1750,2795,658,149,65,16,961,207,1929
49,14,7481,1113,6368,162,6206,110,1214,2000,571,84,56,19,633,167,1352
49,15,5574,719,4855,100,4755,175,692,1414,499,84,27,12,577,103,1172
49,16,9269,1335,7934,200,7734,159,1126,2383,747,118,71,14,952,188,1976
49,17,9450,1559,7891,244,7647,120,1634,2401,672,93,80,12,782,173,1680
49,18,7328,926,6402,156,6246,120,1068,1796,615,78,56,15,855,143,1500
49,19,18486,2623,15863,416,15447,305,2406,4827,1147,297,116,34,2228,367,3720
49,20,9301,1619,7682,185,7497,108,1714,2172,574,132,50,15,656,162,1914
49,21,11674,1623,10051,315,9736,147,1666,3257,677,134,97,18,1479,291,1970
49,22,4400,673,3727,76,3651,49,749,1140,320,48,34,14,378,72,847
49,23,30173,4139,26034,543,25491,718,3009,7171,2563,334,187,78,3261,495,7675
49,24,7595,1101,6494,146,6348,126,908,2106,575,105,64,17,792,151,1504
49,25,13393,1543,11850,376,11474,261,1557,3815,958,172,110,38,1800,306,2457
49,26,12514,1479,11035,278,10757,341,1390,3049,1122,138,100,26,1372,228,2991
49,27,8539,1316,7223,166,7057,104,1616,2211,573,98,42,14,703,208,1488
49,28,7809,1390,6419,120,6299,112,1054,1946,606,91,46,25,644,135,1640
49,29,21566,4000,17566,378,17188,282,2790,5781,1396,201,103,51,1889,392,4303
49,30,12555,2071,10484,242,10242,236,1432,3201,903,155,78,25,1299,237,2676
49,31,8610,1108,7502,200,7302,152,1198,2005,868,105,67,19,792,170,1926
49,32,15281,1987,13294,325,12969,359,1935,4010,1344,198,109,27,1727,341,2919
49,33,11239,1452,9787,193,9594,231,1359,2795,997,134,65,25,1223,233,2532
49,34,11216,1741,9475,225,9250,166,1346,3320,725,175,86,25,1359,282,1766
49,35,18213,3246,14967,311,14656,304,1519,4414,1240,189,111,37,2063,280,4499
49,36,21216,3534,17682,351,17331,432,2201,3870,2043,251,160,51,1904,336,6083
49,37,14617,3033,11584,231,11353,334,1304,2735,1354,131,63,20,1282,195,3935
49,38,22430,3804,18626,344,18282,590,1821,4502,2106,230,123,42,2259,288,6321
49,39,18038,2535,15503,318,15185,443,1633,4134,1519,205,99,42,2018,277,4815
49,40,19691,3561,16130,374,15756,301,1703,4583,1398,201,131,35,2079,331,4994
49,41,15052,2703,12349,218,12131,347,1204,3492,1103,115,55,34,1590,229,3962
50,1,14972,2523,12449,294,12155,267,1560,3604,1179,152,80,20,1648,295,3350
50,2,2329,369,1960,52,1908,31,370,626,110,33,20,9,294,46,369
50,3,6359,1036,5323,74,5249,70,877,1749,520,71,40,19,560,103,1240
50,4,9104,1140,7964,126,7838,156,1245,1819,963,111,56,33,824,194,2437
50,5,4669,727,3942,93,3849,61,633,1268,329,51,33,13,621,97,743
50,6,9243,1446,7797,181,7616,182,1297,2297,694,97,50,31,930,170,1868
50,7,8606,1498,7108,109,6999,99,1273,1818,772,98,57,14,781,181,1906
50,8,5227,699,4528,96,4432,81,747,1253,403,72,38,11,560,113,1154
50,9,9098,1711,7387,132,7255,99,1315,2142,687,115,51,16,702,164,1964
50,10,4071,645,3426,60,3366,74,725,996,317,47,30,14,392,82,689
50,11,7469,1632,5837,78,5759,148,623,1695,739,65,27,18,586,116,1742
50,12,8404,1463,6941,130,6811,170,937,1763,748,96,42,20,840,149,2046
50,13,5657,841,4816,115,4701,93,835,1382,478,93,38,10,652,104,1016
50,14,4115,638,3477,67,3410,81,752,1110,277,48,17,9,440,91,585
50,15,19415,3599,15816,276,15540,380,1899,4809,1579,171,71,35,1749,305,4542
50,16,6333,1061,5272,109,5163,67,958,1597,428,69,32,12,532,129,1339
50,17,5431,796,4635,94,4541,105,873,1330,383,72,20,7,593,106,1052
50,18,2360,259,2101,72,2029,29,375,686,152,25,21,12,263,66,400
50,19,1850,338,1512,48,1464,18,285,515,84,36,17,3,245,45,216
50,20,7836,1353,6483,107,6376,83,1402,1983,493,71,48,13,536,157,1590
50,21,5602,866,4736,94,4642,76,804,1341,414,67,31,13,595,111,1190
50,22,5200,891,4309,61,4248,51,838,1192,409,53,39,15,406,94,1151
50,23,7126,1086,6040,110,5930,149,1040,1724,619,78,30,13,695,130,1452
50,24,4588,708,3880,91,3789,58,621,1212,280,47,39,11,580,117,824
50,25,12503,2467,10036,189,9847,150,1499,2072,1280,148,99,32,939,206,3422
50,26,3834,620,3214,86,3128,61,576,1156,185,44,27,4,417,73,585
50,27,4590,834,3756,73,3683,54,758,1120,330,45,35,18,407,81,835
50,28,10077,1656,8421,140,8281,168,1494,2087,1059,113,65,28,793,166,2308
50,29,5012,805,4207,104,4103,58,800,1421,344,40,29,19,389,85,918
50,30,7503,1475,6028,106,5922,97,1260,2214,389,40,44,17,461,147,1253
50,31,5853,924,4929,89,4840,94,871,1425,395,86,38,11,532,112,1276
50,32,8871,1305,7566,203,7363,74,1190,2764,507,108,68,28,995,214,1415
50,33,5216,804,4412,106,4306,80,732,1458,337,64,38,11,570,117,899
50,34,4995,829,4166,62,4104,62,886,1174,327,44,24,9,410,114,1054
50,35,10099,2079,8020,135,7885,219,900,1873,830,110,54,16,865,149,2869
50,36,8702,1259,7443,138,7305,203,1132,2477,659,73,35,25,797,124,1780
50,37,6038,937,5101,85,5016,63,1058,1607,345,74,42,12,497,134,1184
50,38,6844,1084,5760,98,5662,107,1044,1694,555,64,39,13,463,113,1570
50,39,2203,364,1839,46,1793,32,348,663,138,24,20,5,236,57,270
50,40,4492,672,3820,66,3754,64,725,1068,327,59,24,10,493,88,896
50,41,5242,860,4382,74,4308,61,881,1213,410,63,41,17,439,105,1078
50,42,6228,890,5338,93,5245,126,833,1727,451,63,29,18,661,121,1216
50,43,3618,599,3019,90,2929,36,516,1030,236,48,31,13,345,66,608
50,44,2327,401,1926,50,1876,37,390,771,92,19,5,3,238,46,275
50,45,4536,683,3853,95,3758,76,726,1172,307,76,28,11,505,80,777
50,46,9709,1303,8406,176,8230,87,1609,2410,739,117,62,14,928,205,2059
50,47,10640,1758,8882,143,8739,134,1370,2440,908,134,55,28,1000,197,2473
50,48,6309,1131,5178,114,5064,67,908,1693,428,57,51,12,654,114,1080
50,49,7221,1766,5455,81,5374,95,724,1198,732,82,30,24,452,90,1947
50,50,18520,3371,15149,275,14874,211,2118,2876,2079,196,111,49,1334,310,5590
50,51,19514,3688,15826,245,15581,249,2409,3208,1995,219,110,44,1369,301,5677
50,52,9956,1746,8210,121,8089,208,886,2312,726,83,45,20,1059,156,2594
51,1,5036,742,4294,65,4229,40,1252,1241,369,40,27,11,367,98,784
51,2,7576,1164,6412,103,6309,69,1630,2150,428,74,60,12,569,161,1156
51,3,13449,2393,11056,191,10865,179,2428,3248,1042,162,73,26,1016,216,2475
51,4,7317,1106,6211,104,6107,72,1474,2056,400,76,39,26,600,152,1212
51,5,17445,2917,14528,235,14293,173,3300,4367,1078,189,79,39,1519,319,3230
51,6,7962,1827,6135,101,6034,133,967,1997,544,74,25,12,677,122,1483
51,7,3411,616,2795,55,2740,35,612,1187,151,22,19,4,245,44,421
51,8,2570,405,2165,22,2143,24,505,804,118,28,16,7,237,56,348
51,9,7235,1348,5887,97,5790,79,1545,1966,446,76,35,12,495,146,990
51,10,5669,882,4787,110,4677,57,1204,1550,311,55,26,10,483,125,856
51,11,8578,2258,6320,127,6193,109,1100,1999,535,59,45,10,666,125,1545
51,12,4312,726,3586,61,3525,41,955,1201,286,42,23,9,293,88,587
51,13,4145,732,3413,62,3351,28,904,1104,237,44,30,10,340,84,570
51,14,11229,2039,9190,147,9043,154,2061,2770,632,102,64,29,921,189,2121
51,15,2963,484,2479,43,2436,27,717,792,155,17,18,7,257,52,394
51,16,7371,953,6418,112,6306,86,1407,2066,442,46,36,18,768,160,1277
51,17,5587,1198,4389,79,4310,50,1258,1463,287,54,36,10,357,126,669
51,18,3349,573,2776,50,2726,37,676,937,188,36,23,12,253,73,491
51,19,18754,4021,14733,205,14528,284,2150,4888,1271,167,61,29,1552,261,3865
51,20,13882,3545,10337,137,10200,198,1637,3083,976,112,74,29,983,156,2952
51,21,9242,2224,7018,99,6919,175,1078,1895,683,79,41,19,750,103,2096
51,22,10479,2693,7786,122,7664,115,1714,1871,801,101,52,23,608,146,2233
51,23,6334,1186,5148,117,5031,58,1283,1601,327,55,22,14,552,109,1010
51,24,3633,563,3070,58,3012,29,989,863,182,31,19,6,234,88,571
51,25,7720,1776,5944,93,5851,57,1469,1863,436,73,38,12,557,111,1235
51,26,1856,299,1557,22,1535,15,438,589,69,13,9,3,157,25,217
51,27,9107,1785,7322,143,7179,72,2168,2418,387,72,41,18,612,159,1232
51,28,8864,1775,7089,119,6970,82,2331,1856,455,90,71,14,489,157,1425
51,29,5321,874,4447,91,4356,45,1152,1524,283,35,43,11,453,113,697
51,30,11001,1749,9252,146,9106,157,1780,3441,571,94,46,18,963,191,1845
51,31,10274,1539,8735,160,8575,120,1565,3355,548,76,36,21,947,178,1729
51,32,1901,377,1524,28,1496,10,432,519,62,10,12,7,169,41,234
51,33,8905,1698,7207,123,7084,63,2041,1906,467,93,65,17,521,140,1771
51,34,9049,1968,7081,120,6961,67,1815,2021,475,79,47,9,548,123,1777
51,35,11012,2525,8487,166,8321,123,1975,2351,742,98,50,25,821,186,1950
51,36,11167,2602,8565,139,8426,145,1744,1782,1085,108,39,31,725,149,2618
51,37,14195,3282,10913,218,10695,124,2499,2770,1127,141,81,16,940,222,2775
51,38,10618,3306,7312,92,7220,146,1361,1582,809,77,55,17,608,88,2477
51,39,14044,3304,10740,146,10594,230,1766,3478,872,140,71,20,1042,189,2786
51,40,12471,2776,9695,149,9546,144,2010,2276,898,141,66,17,862,153,2979
51,41,9438,2051,7387,109,7278,108,1511,1840,792,100,57,15,597,113,2145
51,42,13183,3549,9634,149,9485,167,2193,1630,1268,123,66,20,753,165,3100
51,43,10996,2757,8239,118,8121,127,1746,2077,866,105,48,20,764,150,2218
51,44,13353,3452,9901,144,9757,228,1798,2330,1191,125,65,17,940,177,2886
52,1,2704,455,2249,41,2208,30,540,674,168,34,23,8,176,72,483
52,2,2194,336,1858,20,1838,22,403,619,156,20,15,4,144,53,402
52,3,1465,250,1215,22,1193,30,250,434,95,12,10,1,89,33,239
52,4,3338,697,2641,65,2576,36,587,897,210,30,16,6,211,58,525
52,5,2831,449,2382,47,2335,18,585,733,174,32,16,6,206,37,528
52,6,3266,554,2712,45,2667,37,735,821,258,48,13,7,203,74,471
52,7,9437,1996,7441,126,7315,155,1257,2158,759,101,62,17,658,177,1971
52,8,4957,825,4132,72,4060,33,1432,988,298,61,37,9,244,76,882
52,9,1632,297,1335,29,1306,16,333,399,105,19,7,9,125,32,261
52,10,3178,574,2604,63,2541,31,800,638,181,40,24,8,161,74,584
52,11,1993,350,1643,24,1619,25,540,467,116,18,12,12,90,88,251
52,12,3517,520,2997,46,2951,37,664,851,244,43,27,4,256,74,751
52,13,5352,1148,4204,85,4119,44,1187,985,356,60,34,9,300,106,1038
52,14,2479,421,2058,60,1998,21,547,717,153,25,13,5,159,61,297
52,15,1190,194,996,13,983,17,234,253,99,19,10,3,71,24,253
52,16,9709,1948,7761,169,7592,137,1563,2059,690,81,41,18,743,180,2080
52,17,5390,813,4577,103,4474,77,988,1170,423,71,24,11,393,126,1191
52,18,4253,683,3570,72,3498,44,1006,1125,269,50,24,9,260,103,608
52,19,2390,498,1892,40,1852,20,467,568,135,34,21,2,177,55,373
52,20,3757,676,3081,54,3027,42,749,831,239,43,22,5,309,70,717
52,21,6915,1193,5722,121,5601,69,1425,1526,506,70,56,9,444,121,1375
52,22,1609,309,1300,26,1274,14,399,391,82,22,9,4,115,43,195
52,23,3030,501,2529,60,2469,50,552,749,218,41,26,7,288,63,475
52,24,2046,353,1693,42,1651,13,508,497,105,15,19,6,97,46,345
52,25,8462,2193,6269,113,6156,75,1483,1875,529,63,38,9,445,134,1505
52,26,2225,367,1858,52,1806,23,470,496,164,18,21,2,160,38,414
52,27,4295,618,3677,72,3605,57,871,960,285,51,30,9,274,69,999
52,28,5859,1116,4743,101,4642,50,1423,1148,445,62,54,14,304,93,1049
52,29,12321,2994,9327,201,9126,165,1804,2375,944,134,75,19,768,211,2631
52,30,4466,1118,3348,78,3270,38,790,853,361,26,22,8,221,53,898
52,31,8096,1578,6518,116,6402,48,2066,1681,590,68,52,17,462,136,1282
52,32,4573,1321,3252,53,3199,32,966,666,363,44,7,8,159,57,897
53,1,3950,616,3334,79,3255,58,440,1031,274,53,37,14,450,73,825
53,2,13246,1605,11641,281,11360,215,1535,2932,1015,145,69,29,1738,228,3454
53,3,3864,623,3241,90,3151,74,552,1059,276,51,26,10,444,74,585
53,4,4284,635,3649,86,3563,76,658,1183,287,52,39,10,484,74,700
53,5,7098,1018,6080,157,5923,143,926,1833,535,93,53,16,804,126,1394
53,6,9095,1392,7703,185,7518,143,868,2693,541,105,45,17,1261,155,1690
53,7,6678,910,5768,140,5628,100,799,2166,411,79,30,8,785,145,1105
53,8,3178,539,2639,47,2592,44,536,982,170,21,12,2,325,73,427
53,9,7651,1294,6357,141,6216,137,788,2166,434,82,43,18,958,153,1437
53,10,8035,1182,6853,196,6657,122,1041,2325,394,85,58,16,945,150,1521
53,11,9712,1724,7988,216,7772,111,1479,2231,638,94,82,19,949,163,2006
53,12,5328,897,4431,111,4320,62,665,1630,266,78,33,8,630,91,857
53,13,4927,785,4142,101,4041,96,768,1220,372,53,43,11,474,97,907
53,14,2828,430,2398,67,2331,40,458,841,162,43,18,5,330,58,376
53,15,5095,831,4264,147,4117,65,635,1600,233,46,38,15,608,120,757
53,16,2633,382,2251,52,2199,39,365,823,150,26,9,8,306,41,432
53,17,11252,1651,9601,220,9381,268,947,2732,823,93,47,13,1425,154,2879
53,18,8056,1418,6638,127,6511,200,717,1730,621,78,40,6,837,128,2154
53,19,11874,1609,10265,287,9978,247,1788,2820,898,167,89,31,1253,229,2456
53,20,11934,1772,10162,282,9880,218,1512,2595,912,133,80,22,1310,237,2861
53,21,10321,1705,8616,246,8370,181,1148,2267,783,111,85,28,1059,187,2521
53,22,5971,887,5084,114,4970,84,916,1741,350,55,29,11,710,114,960
53,23,4046,553,3493,88,3405,60,654,1049,290,24,24,10,432,59,803
53,24,4296,761,3535,98,3437,80,667,1001,320,53,36,9,442,80,749
53,25,5956,976,4980,116,4864,71,759,1599,343,70,39,8,661,104,1210
53,26,3312,548,2764,67,2697,58,597,848,229,29,17,0,354,46,519
53,27,5106,881,4225,112,4113,75,729,1248,306,69,39,10,532,97,1008
53,28,8011,1421,6590,153,6437,222,648,1975,632,61,36,10,862,104,1887
53,29,8643,1616,7027,172,6855,167,781,1663,691,70,39,15,876,119,2434
53,30,4406,1055,3351,74,3277,51,477,727,334,47,28,7,302,52,1252
53,31,7857,1245,6612,183,6429,129,756,2121,495,90,56,16,1011,121,1634
53,32,12850,1560,11290,266,11024,228,1321,3114,951,136,96,26,1561,245,3346
54,1,1169,161,1008,28,980,15,259,328,46,8,10,3,110,26,175
54,2,15280,3290,11990,179,11811,130,2934,2000,2235,214,83,30,683,198,3304
54,3,7991,1450,6541,123,6418,87,2035,1669,487,102,53,13,517,153,1302
54,4,2517,415,2102,60,2042,34,562,504,216,43,21,7,155,59,441
54,5,10218,1735,8483,146,8337,131,2042,1785,1057,152,58,21,743,185,2163
54,6,4426,689,3737,72,3665,58,981,1084,287,55,31,20,383,110,656
54,7,12105,2684,9421,165,9256,121,2051,1719,1675,125,75,22,614,147,2707
54,8,2873,430,2443,36,2407,41,736,587,275,39,23,8,191,47,460
54,9,2566,572,1994,32,1962,26,552,516,162,24,16,5,138,70,453
54,10,5795,821,4974,88,4886,79,1433,1189,415,68,48,19,399,97,1139
54,11,14837,2907,11930,188,11742,131,2474,2286,2116,181,90,20,869,198,3377
54,12,10477,1677,8800,114,8686,147,2045,2401,820,99,55,22,807,166,2124
54,13,5011,641,4370,72,4298,40,1167,1111,369,44,36,15,373,112,1031
54,14,6758,914,5844,111,5733,93,1443,1537,481,68,41,13,533,145,1379
54,15,10524,2238,8286,133,8153,107,2043,2218,933,119,60,14,632,154,1873
54,16,8268,2394,5874,91,5783,95,994,1202,966,67,40,9,364,82,1964
54,17,9550,1867,7683,130,7553,116,1822,1881,707,128,76,19,689,171,1944
54,18,15798,3477,12321,202,12119,158,3106,3094,1142,156,83,43,944,254,3139
54,19,12425,3195,9230,112,9118,295,1130,2359,1143,96,31,27,847,164,3026
54,20,12148,3170,8978,122,8856,327,910,2195,1238,111,37,32,842,127,3037
54,21,17422,3829,13593,166,13427,375,1167,4558,1343,132,49,51,1634,228,3890
54,22,12395,2871,9524,150,9374,329,1094,2424,1167,115,62,38,1026,168,2951
54,23,7679,1127,6552,98,6454,117,1735,1524,641,82,52,21,584,158,1540
54,24,14050,3219,10831,179,10652,174,2679,2645,1059,127,85,41,875,212,2755
54,25,20392,3963,16429,248,16181,267,4031,3955,1615,228,122,41,1411,304,4207
54,26,3362,501,2861,49,2812,45,790,775,249,31,23,9,233,57,600
54,27,18905,3731,15174,264,14910,216,3705,4013,1433,186,107,47,1209,265,3729
54,28,10276,1854,8422,131,8291,162,2084,2298,719,103,47,18,754,176,1930
54,29,7374,1020,6354,114,6240,139,1482,1703,542,98,38,20,644,152,1422
54,30,11913,2756,9157,141,9016,126,1789,1570,2043,125,65,20,464,130,2684
54,31,12091,2357,9734,139,9595,106,2047,1240,2123,148,70,20,441,155,3245
54,32,13841,3025,10816,170,10646,144,2171,2372,1662,134,61,16,792,190,3104
54,33,14474,2600,11874,207,11667,196,2652,2505,1278,187,96,27,975,222,3529
54,34,19672,4012,15660,228,15432,260,3609,3089,1804,189,130,48,1168,292,4843
54,35,13931,3164,10767,152,10615,207,1754,3030,1085,101,56,26,1090,206,3060
54,36,7326,1675,5651,74,5577,118,1015,1075,645,58,31,16,391,70,2158
54,37,11074,2343,8731,110,8621,115,1671,1571,2074,129,52,18,518,128,2345
54,38,17768,3398,14370,230,14140,264,2367,3719,1318,137,65,37,1656,272,4305
54,39,20290,4196,16094,244,15850,474,1963,4464,1560,161,56,50,1887,248,4987
54,40,17533,3248,14285,258,14027,198,3211,3324,1453,163,97,29,1217,310,4025
54,41,15203,3114,12089,201,11888,144,3289,2633,1276,141,82,34,960,237,3092
54,42,16453,2769,13684,193,13491,307,2550,3451,1493,151,77,45,1298,270,3849
54,43,13296,2250,11046,189,10857,206,2063,3092,1022,110,69,33,1128,232,2902
54,44,8050,1612,6438,103,6335,138,901,1720,668,53,23,25,683,100,2024
55,1,7662,1174,6488,120,6368,88,2096,1535,482,102,45,23,493,141,1363
55,2,8169,1690,6479,105,6374,126,1345,1442,659,96,40,20,664,119,1863
55,3,6596,1126,5470,112,5358,72,1397,1513,437,78,33,10,518,111,1189
55,4,3306,549,2757,44,2713,48,701,787,208,33,32,2,253,55,594
55,5,9292,1704,7588,124,7464,95,1751,1825,795,120,46,26,630,126,2050
55,6,1996,316,1680,33,1647,17,432,505,92,28,10,4,162,38,359
55,7,2502,386,2116,33,2083,34,574,559,173,25,13,4,161,43,497
55,8,5297,931,4366,69,4297,61,1185,1273,393,56,33,8,325,90,873
55,9,3924,630,3294,65,3229,79,841,886,326,59,22,10,314,58,634
55,10,3687,620,3067,57,3010,36,872,814,251,46,20,10,259,54,648
55,11,8190,1504,6686,142,6544,100,1745,1501,542,114,48,21,598,130,1745
55,12,1765,258,1507,29,1478,22,380,541,86,17,15,6,126,35,250
55,13,2151,405,1746,48,1698,37,487,510,121,21,14,14,163,32,299
55,14,4319,939,3380,45,3335,37,911,867,295,47,28,14,320,67,749
55,15,2872,412,2460,58,2402,50,610,650,188,42,25,9,274,42,512
55,16,5832,1012,4820,102,4718,65,1298,1181,365,75,29,15,405,131,1154
55,17,5700,947,4753,88,4665,65,1342,1296,363,69,30,11,441,104,944
55,18,2945,453,2492,45,2447,37,631,672,231,35,18,4,214,60,545
55,19,5836,1024,4812,61,4751,62,1256,1145,709,80,42,11,313,85,1048
55,20,4343,838,3505,61,3444,48,927,804,297,51,26,9,282,67,933
55,21,1546,228,1318,38,1280,17,305,411,96,14,14,7,206,22,188
55,22,1232,219,1013,25,988,12,230,345,60,13,8,3,114,21,182
55,23,2399,379,2020,36,1984,57,600,564,140,25,21,7,231,32,307
55,24,3776,653,3123,47,3076,41,849,952,218,39,13,12,242,70,640
55,25,3040,399,2641,36,2605,34,621,669,232,35,19,8,286,50,651
55,26,5630,1273,4357,68,4289,62,1095,1033,410,79,34,8,375,79,1114
55,27,2940,432,2508,34,2474,66,639,659,210,27,10,11,269,69,514
55,28,4358,699,3659,86,3573,56,1090,913,284,69,30,11,335,71,714
55,29,7268,1328,5940,104,5836,132,1168,1587,502,84,29,22,605,126,1581
55,30,7031,2034,4997,101,4896,87,976,1514,454,57,26,17,478,91,1196
55,31,4529,1042,3487,59,3428,51,684,910,332,52,16,7,319,80,977
56,1,12113,1595,10518,215,10303,307,1597,2649,1083,138,80,17,1141,216,3075
56,2,26760,4199,22561,371,22190,775,3220,6816,1978,307,121,71,2567,405,5930
56,3,10745,1413,9332,198,9134,227,1698,2146,1083,111,79,37,919,165,2669
56,4,12533,1927,10606,181,10425,285,1927,2859,1042,165,63,29,1169,179,2707
56,5,6807,869,5938,131,5807,197,948,1286,741,71,33,13,714,115,1689
56,6,14920,1946,12974,238,12736,370,2103,3245,1309,183,77,26,1509,250,3664
56,7,8215,1315,6900,171,6729,169,1242,1567,755,120,44,21,618,149,2044
56,8,8251,1232,7019,124,6895,166,1143,2120,584,107,41,14,829,157,1734
56,9,6732,1088,5644,132,5512,143,934,1334,638,83,48,21,553,89,1669
56,10,15188,2052,13136,257,12879,378,2093,3497,1206,173,87,31,1684,258,3472
56,11,2189,389,1800,27,1773,115,231,522,228,28,7,4,113,26,499
56,12,5201,867,4334,78,4256,130,701,1003,503,85,23,13,380,70,1348
56,13,7875,1061,6814,92,6722,117,1260,1953,605,86,45,17,771,123,1745
56,14,23210,3815,19395,325,19070,533,2812,3915,2783,301,139,58,1828,334,6367
56,15,8662,1228,7434,146,7288,138,1396,2328,557,103,49,18,760,157,1782
56,16,11810,1661,10149,228,9921,153,2004,2928,886,174,78,18,1087,203,2390
56,17,9932,2069,7863,124,7739,338,926,2155,916,104,39,25,704,114,2418
56,18,14850,3316,11534,228,11306,364,1760,2391,1412,189,75,39,952,173,3951
56,19,12735,1716,11019,212,10807,236,1703,3143,960,166,89,39,1420,232,2819
56,20,4530,716,3814,68,3746,96,637,1069,360,45,22,9,305,57,1146
56,21,11160,1460,9700,134,9566,226,1345,2972,961,131,49,32,1030,153,2667
56,22,4393,731,3662,41,3621,180,376,992,524,68,35,13,363,73,997
56,23,12027,1899,10128,199,9929,214,1544,2894,923,131,81,21,1211,153,2757
56,24,10187,1579,8608,178,8430,239,1580,1981,1012,132,67,30,923,178,2288
56,25,16703,2438,14265,290,13975,402,2465,3430,1522,220,114,35,1530,296,3961
56,26,19022,2840,16182,333,15849,407,2553,3991,1687,219,115,34,1929,290,4624
56,27,28800,4328,24472,503,23969,687,3625,6708,2334,338,133,82,2705,499,6858
56,28,23195,3067,20128,368,19760,586,3417,5109,2336,315,120,44,1773,366,5694
56,29,12751,1794,10957,251,10706,292,1787,2876,1208,169,86,22,1124,199,2943
56,30,15011,2410,12601,184,12417,325,1976,5186,855,133,48,34,1194,248,2418
56,31,12301,1742,10559,205,10354,229,1718,3281,961,117,60,37,1105,217,2629
56,32,6891,957,5934,123,5811,128,999,1774,636,85,41,19,610,101,1418
56,33,7087,863,6224,140,6084,73,1278,1974,438,87,52,12,646,136,1388
56,34,8002,1176,6826,104,6722,111,1558,1951,536,90,43,22,793,102,1516
56,35,12535,1703,10832,139,10693,300,1355,4152,772,125,34,27,1116,208,2604
56,36,4000,636,3364,56,3308,44,686,1040,266,35,27,4,337,74,795
56,37,33891,5104,28787,481,28306,841,3562,8378,2662,336,94,76,3422,534,8401
56,38,24335,3571,20764,276,20488,630,2336,6729,1608,186,86,49,2527,379,5958
56,39,16901,3121,13780,192,13588,454,1437,4624,1106,128,52,35,1759,188,3805
56,40,16538,3226,13312,264,13048,341,2077,2297,2178,199,103,34,1067,227,4525
56,41,13606,2885,10721,183,10538,361,1356,2478,1248,135,59,33,940,181,3747
56,42,23225,4119,19106,348,18758,641,2350,6095,1818,182,80,53,1923,274,5342
57,1,5174,953,4221,83,4138,70,1196,1233,291,78,40,10,458,100,662
57,2,9952,2080,7872,155,7717,139,2091,2148,554,112,91,26,854,151,1551
57,3,15620,2930,12690,232,12458,168,3763,3154,1039,185,90,25,1177,251,2606
57,4,22855,4832,18023,336,17687,229,5089,4244,1550,284,131,46,1620,332,4162
57,5,17430,3492,13938,245,13693,335,2761,4318,1216,175,75,42,1583,294,2894
57,6,4935,857,4078,62,4016,51,1086,1251,284,53,37,7,357,72,818
57,7,4246,635,3611,65,3546,53,922,1047,286,55,31,19,355,78,700
57,8,4951,953,3998,88,3910,56,1100,1068,279,81,33,15,377,94,807
57,9,17879,3539,14340,255,14085,219,4207,3352,1204,217,105,38,1242,308,3193
57,10,6113,1013,5100,109,4991,80,1544,1531,265,75,74,13,566,100,743
57,11,16388,3734,12654,224,12430,201,2648,2521,2275,185,90,30,851,208,3421
57,12,13913,4467,9446,147,9299,119,2425,2391,864,93,64,26,616,132,2569
57,13,16702,2936,13766,250,13516,286,2923,3863,1176,153,93,24,1339,268,3391
57,14,10837,1843,8994,195,8799,129,2390,2553,725,134,92,15,938,147,1676
57,15,15150,3970,11180,211,10969,146,2890,2070,1412,181,91,26,699,193,3261
57,16,5376,1015,4361,109,4252,76,1249,1253,309,67,32,18,382,89,777
57,17,12321,3608,8713,133,8580,179,1827,2121,945,102,45,25,729,132,2475
57,18,15620,4336,11284,173,11111,306,1813,3152,1274,124,73,29,1086,174,3080
57,19,25280,6495,18785,255,18530,586,2747,5275,1970,191,100,49,2117,326,5169
57,20,21445,4638,16807,281,16526,353,3161,4964,1561,206,111,43,1743,299,4085
57,21,27369,5107,22262,454,21808,349,5179,5545,2106,329,185,74,2195,459,5387
57,22,15007,3722,11285,175,11110,150,2946,1838,1576,203,100,22,676,157,3442
57,23,15137,2241,12896,215,12681,235,2883,3730,1055,175,80,35,1461,239,2788
57,24,13479,2511,10968,236,10732,198,3300,3185,614,138,101,24,1212,245,1715
57,25,3099,555,2544,52,2492,52,752,727,160,29,25,14,226,41,466
57,26,13017,2381,10636,278,10358,135,3172,2867,648,200,114,30,1220,259,1713
57,27,19783,4595,15188,210,14978,236,3987,3726,1468,211,112,43,1317,249,3629
57,28,11579,2285,9294,180,9114,126,2927,2357,689,150,85,30,840,203,1707
57,29,20024,3933,16091,331,15760,284,4371,4934,1004,205,126,63,1612,338,2823
57,30,14910,4013,10897,188,10709,197,2668,2873,904,145,73,30,1007,194,2618
57,31,8798,1754,7044,161,6883,149,1574,2102,532,115,68,17,871,159,1296
57,32,14665,3200,11465,178,11287,227,2033,3352,1127,135,66,29,1166,178,2974
57,33,24426,4083,20343,303,20040,379,4064,6755,1497,212,96,57,2286,397,4297
57,34,2881,424,2457,45,2412,39,561,730,216,35,19,6,265,55,486
57,35,12268,1720,10548,170,10378,203,2379,3075,921,133,66,26,1000,223,2352
57,36,4539,773,3766,94,3672,48,1047,1230,203,83,31,11,444,98,477
57,37,23656,5116,18540,297,18243,387,3653,5198,1774,191,102,45,1816,258,4819
57,38,21750,5651,16099,355,15744,336,3060,3952,1720,240,133,36,1624,304,4339
57,39,12393,3096,9297,180,9117,112,2238,1677,1124,142,77,18,506,153,3070
57,41,18517,4637,13880,246,13634,168,4099,2887,1243,172,122,29,938,224,3752
57,42,14404,3085,11319,218,11101,141,3094,2143,1352,216,91,23,760,228,3053
57,43,21504,4884,16620,288,16332,209,3813,3255,1995,247,141,52,1204,277,5139
57,44,12623,3557,9066,165,8901,112,2240,1706,1454,135,81,25,539,137,2472
57,45,14275,3207,11068,212,10856,131,2410,2108,1230,176,73,25,721,154,3828
57,46,17612,5353,12259,229,12030,215,2290,2884,1310,132,58,28,1133,178,3802
57,47,20406,4634,15772,308,15464,192,4602,3591,1319,167,121,33,1153,254,4032
57,48,17912,2997,14915,244,14671,237,3503,3290,1595,144,93,32,1210,247,4320
57,49,15394,3493,11901,228,11673,147,3910,2450,970,168,98,31,940,206,2753
57,50,20557,3956,16601,388,16213,272,4825,4431,1101,234,149,52,1683,375,3091
57,51,19453,4643,14810,267,14543,195,4640,3484,1104,208,126,28,1134,263,3361
57,52,12054,3016,9038,155,8883,233,1425,2737,965,103,40,28,912,158,2282
58,1,2154,398,1756,29,1727,34,324,499,187,27,15,3,128,25,485
58,2,8115,1463,6652,120,6532,163,1224,1418,902,102,49,16,472,139,2047
58,3,4619,792,3827,75,3752,52,764,708,440,43,30,11,280,72,1352
58,4,3055,528,2527,42,2485,32,492,705,204,33,20,10,191,52,746
58,5,5841,1223,4618,75,4543,66,934,950,632,57,22,14,292,85,1491
58,6,3820,693,3127,61,3066,52,557,841,289,44,18,4,211,58,992
58,7,6784,1399,5385,105,5280,79,1244,1295,601,65,45,17,376,117,1441
58,8,6104,1216,4888,103,4785,65,814,964,521,60,33,13,396,79,1840
58,9,3228,584,2644,51,2593,51,582,696,284,41,32,7,228,73,599
58,10,3379,629,2750,66,2684,33,627,619,312,41,21,10,199,65,757
58,11,3569,647,2922,63,2859,31,534,652,327,37,28,9,244,53,944
58,12,3209,617,2592,49,2543,68,531,539,296,38,15,7,188,49,812
58,13,3520,556,2964,83,2881,43,430,822,241,41,29,4,212,59,1000
58,14,3288,711,2577,44,2533,35,555,568,262,25,23,3,183,53,826
58,15,3363,568,2795,81,2714,26,497,716,292,27,25,5,164,47,915
58,16,6203,1555,4648,105,4543,133,568,1340,554,53,23,14,339,65,1454
58,17,9057,1685,7372,130,7242,93,1563,1318,1143,103,45,22,435,153,2367
58,18,4743,758,3985,66,3919,51,887,1104,345,50,34,14,353,89,992
58,19,3306,599,2707,40,2667,35,605,648,355,24,27,5,164,43,761
58,20,2937,593,2344,45,2299,61,551,545,266,45,25,7,190,68,541
58,21,4192,661,3531,77,3454,71,755,780,363,40,24,13,292,63,1053
58,22,4840,757,4083,57,4026,55,813,918,420,57,33,14,372,105,1239
58,23,2642,418,2224,33,2191,45,453,597,201,28,17,9,164,50,627
58,24,2430,389,2041,44,1997,36,451,592,160,19,13,4,159,37,526
58,25,3360,568,2792,43,2749,37,590,747,304,31,20,4,193,63,760
58,26,12216,2051,10165,178,9987,150,1761,1661,1639,153,53,24,736,213,3597
58,27,5823,1275,4548,89,4459,60,884,865,566,53,35,16,236,63,1681
58,28,8894,2102,6792,150,6642,144,1093,1424,719,60,25,15,564,98,2500
58,29,5801,1472,4329,103,4226,49,876,739,473,60,27,6,302,61,1633
58,30,12403,2546,9857,198,9659,177,1577,2046,1185,105,64,18,811,160,3516
58,31,6015,1193,4822,90,4732,64,1091,1204,476,57,38,13,349,118,1322
58,32,6001,1075,4926,99,4827,52,938,880,642,56,26,7,323,88,1815
59,1,14144,2022,12122,198,11924,134,3344,2491,1826,115,78,26,798,155,2957
59,2,38597,8550,30047,498,29549,519,6479,7572,3289,355,209,80,2255,461,8330
59,3,6419,1245,5174,82,5092,94,1296,1370,534,44,38,9,398,111,1198
59,4,10100,2108,7992,153,7839,99,1866,2235,889,102,70,23,538,169,1848
59,5,14178,2830,11348,210,11138,214,2418,3189,1058,142,75,26,1031,182,2803
59,6,12667,2146,10521,211,10310,161,2224,2961,912,117,65,33,951,184,2702
59,7,20005,3452,16553,325,16228,249,3598,4462,1793,217,112,43,1394,315,4045
59,8,13508,2655,10853,216,10637,147,2988,2709,1096,132,70,22,753,194,2526
59,9,14202,2209,11993,205,11788,149,2846,3477,988,148,72,27,924,194,2963
59,10,16798,3759,13039,229,12810,149,3343,2237,2746,159,108,29,676,202,3161
59,11,19096,3345,15751,297,15454,132,4271,2760,2857,137,101,45,716,257,4178
59,12,14056,2654,11402,251,11151,128,3221,2530,1052,181,107,17,714,182,3019
59,13,17022,3490,13532,274,13258,166,3121,3443,1415,130,94,27,973,273,3616
59,14,28684,6753,21931,492,21439,273,4925,5707,2190,233,159,51,1660,422,5819
59,15,14057,2230,11827,203,11624,130,2979,2299,1930,119,92,18,692,223,3142
59,16,7637,996,6641,121,6520,128,1342,2010,656,67,50,14,583,120,1550
59,17,12028,2186,9842,196,9646,94,2534,2354,1138,83,86,16,476,151,2714
59,18,22510,5142,17368,329,17039,186,4609,3997,1803,238,169,33,979,353,4672
59,19,30990,8466,22524,476,22048,243,6545,4134,3432,283,156,46,1091,337,5781
59,20,21912,3384,18528,271,18257,430,3095,6307,1592,153,105,43,1997,307,4228
59,21,31372,7754,23618,439,23179,228,6345,3302,4215,256,191,55,914,279,7394
59,22,30514,7194,23320,415,22905,272,5737,4085,4420,267,202,48,1249,291,6334
59,23,24048,5459,18589,294,18295,245,3988,4179,2411,203,101,31,1370,294,5473
59,24,36281,8356,27925,494,27431,334,6544,4824,5268,312,204,62,1574,387,7922
59,25,28471,5329,23142,397,22745,482,4438,6689,2183,281,135,63,1847,379,6248
59,26,33517,8296,25221,708,24513,286,6867,3902,3136,391,265,65,1174,326,8101
59,27,18724,3550,15174,343,14831,136,4271,2738,1511,208,134,48,847,212,4726
59,28,35154,7712,27442,464,26978,532,6067,6120,3290,339,214,87,2115,452,7762
59,29,18311,3600,14711,311,14400,198,3214,3753,1352,198,133,25,1241,272,4014
59,30,12367,2281,10086,197,9889,154,2280,2535,974,117,77,19,870,169,2694
59,31,10971,2038,8933,175,8758,116,2197,2390,744,132,65,23,643,181,2267
59,32,8170,1426,6744,133,6611,81,1753,1550,782,82,54,18,445,104,1742
59,33,48986,9509,39477,633,38844,705,7330,12408,3611,331,196,75,3551,570,10067
59,34,11061,2572,8489,122,8367,438,632,2421,1189,76,34,26,946,82,2523
59,35,19006,5070,13936,216,13720,479,2528,2091,2432,137,117,30,878,156,4872
59,36,20971,5005,15966,210,15756,565,1827,4781,1749,140,74,40,1670,218,4692
59,37,30691,7198,23493,374,23119,854,3247,5303,3374,239,118,67,1900,234,7783
59,38,46717,10033,36684,580,36104,985,5123,11998,3702,308,160,84,4235,497,9012
59,39,21325,6388,14937,222,14715,603,1725,2092,2905,171,85,32,951,109,6042
59,40,31058,7263,23795,350,23445,600,4129,5363,3066,245,144,51,2106,312,7429
59,41,21821,6120,15701,211,15490,610,1913,3324,2321,154,60,46,1271,147,5644
59,42,30821,6478,24343,403,23940,319,5984,4041,4590,267,163,52,1386,365,6773
59,43,11679,1920,9759,161,9598,113,2657,2294,1029,128,105,30,630,217,2395
59,44,27655,7362,20293,307,19986,222,5061,4413,2540,213,166,44,1081,263,5983
59,45,23539,5615,17924,312,17612,167,4744,3666,2522,165,132,42,849,231,5094
59,46,19167,3683,15484,337,15147,179,3980,3527,1566,234,117,25,1015,284,4220
59,47,19207,3115,16092,295,15797,249,3342,4665,1710,152,107,33,1491,273,3775
59,48,29572,4987,24585,389,24196,404,4839,7289,2255,224,126,71,2095,465,6428
59,49,8868,1637,7231,134,7097,132,1671,1744,732,79,46,13,540,142,1998
59,50,9715,1631,8084,123,7961,116,1751,2218,790,84,47,12,752,166,2025
59,51,29393,6351,23042,371,22671,417,4808,7431,2137,240,145,45,2072,392,4984
59,52,19463,5603,13860,234,13626,200,3251,2406,1761,147,93,34,672,168,4894
59,53,29230,9111,20119,369,19750,263,4578,3138,2557,250,154,44,1013,224,7529
59,54,37009,9514,27495,418,27077,523,4197,8466,3065,234,146,66,2547,408,7425
59,55,23646,5806,17840,341,17499,228,4668,3411,3338,214,140,44,1023,262,4171
59,56,15096,3016,12080,206,11874,221,2724,3253,1534,142,68,36,974,207,2715
59,57,29316,5548,23768,483,23285,388,5379,5377,2844,258,161,68,1909,400,6501
59,58,12729,2163,10566,159,10407,111,2566,2287,1657,107,92,14,584,168,2821
59,59,6500,1308,5192,69,5123,69,1353,1411,492,62,36,10,352,98,1240
59,60,10929,1602,9327,249,9078,186,2031,2658,706,99,70,16,861,182,2269
59,61,45477,10758,34719,673,34046,564,7590,10585,3046,346,248,68,2806,551,8242
59,62,34805,10253,24552,463,24089,402,5375,5719,2927,272,167,48,1703,339,7137
59,63,34553,9606,24947,392,24555,530,4257,8244,2466,217,124,54,2239,333,6091
59,64,18840,4899,13941,280,13661,148,3629,2871,1761,216,184,38,693,259,3862
59,65,35557,8014,27543,472,27071,360,5856,7099,3721,270,171,58,2061,471,7004
59,66,22729,5275,17454,263,17191,250,4106,4047,2499,173,137,37,1191,292,4459
59,67,32730,7133,25597,404,25193,317,6345,5200,4110,267,198,51,1633,408,6664
59,68,12268,1910,10358,205,10153,140,2490,3044,761,140,91,27,913,183,2364
59,69,13218,3637,9581,147,9434,90,2656,2185,1174,134,64,12,463,146,2510
59,70,36850,7293,29557,399,29158,651,3039,14284,1914,165,91,79,3214,413,5308
59,71,29410,7326,22084,405,21679,288,5991,4329,3014,244,183,47,1280,284,6019
59,72,34157,6787,27370,550,26820,522,5928,6408,3010,373,211,62,1918,460,7928
59,73,22805,5443,17362,396,16966,180,4269,2393,2677,239,188,60,787,209,5964
59,74,29915,6512,23403,384,23019,497,4794,5863,2501,227,157,59,1973,360,6588
59,75,20545,5711,14834,237,14597,288,2374,3269,1989,143,76,31,1036,150,5241
59,76,20465,4069,16396,288,16108,533,2366,3537,2507,147,68,32,1411,213,5294
59,77,22728,4860,17868,320,17548,156,4695,3028,2844,173,107,39,896,244,5366
59,78,24416,4607,19809,334,19475,377,3936,5300,2238,194,91,35,1738,312,5254
59,79,19211,4205,15006,240,14766,448,1883,3522,2222,157,96,26,1314,155,4943
60,1,12021,2176,9845,173,9672,164,2399,2610,911,105,75,25,803,185,2395
60,2,11464,1843,9621,143,9478,134,2687,2669,821,143,85,19,754,193,1973
60,3,10617,2671,7946,146,7800,155,1507,1817,894,98,75,18,584,134,2518
60,4,15121,3364,11757,198,11559,212,2391,2877,1378,160,108,29,777,203,3424
60,5,7824,1320,6504,107,6397,92,2045,1561,613,80,55,19,424,144,1364
60,6,8269,1602,6667,127,6540,75,1856,1680,517,107,90,15,435,147,1618
60,7,12706,1985,10721,196,10525,171,2529,3252,1019,121,61,22,920,231,2199
60,8,21043,3763,17280,301,16979,259,4205,4144,1959,212,157,58,1217,339,4429
60,9,20126,4208,15918,234,15684,371,2492,5701,1269,131,107,45,1617,292,3659
60,10,11536,2184,9352,179,9173,104,2817,2428,882,144,74,29,611,217,1867
60,11,17500,3598,13902,911,12991,194,2757,2426,1690,135,87,19,779,175,4729
60,12,21725,4257,17468,258,17210,292,4604,3957,1866,190,112,45,1280,363,4501
60,13,5800,954,4846,122,4724,56,1465,1358,366,74,43,16,327,87,932
60,14,11972,1994,9978,189,9789,165,2626,2573,901,159,91,30,835,204,2205
60,15,6273,1035,5238,109,5129,47,1658,1458,307,86,65,11,353,112,1032
60,16,5070,686,4384,73,4311,46,1357,1109,316,69,52,11,318,96,937
60,17,7324,1333,5991,87,5904,64,2017,1527,376,83,64,13,384,88,1288
60,18,5461,1135,4326,58,4268,35,1380,1065,449,81,32,11,252,71,892
60,19,6849,1230,5619,100,5519,67,1669,1292,629,88,49,15,407,111,1192
60,20,25728,4475,21253,422,20831,257,5723,4928,2274,220,173,56,1446,419,5335
60,21,6317,919,5398,101,5297,50,1731,1099,458,85,45,10,292,104,1423
60,22,6328,939,5389,105,5284,78,1549,1434,449,91,50,13,387,130,1103
60,23,20648,4050,16598,311,16287,187,4269,4167,1692,195,110,23,1062,343,4239
60,24,10719,2013,8706,139,8567,109,2617,1922,997,106,67,17,634,151,1947
60,25,12685,2281,10404,155,10249,160,2571,2970,976,108,51,22,794,203,2394
60,26,20911,3977,16934,266,16668,251,4298,4267,1802,218,105,45,1240,368,4074
60,27,12298,2025,10273,175,10098,126,2912,2660,911,135,115,22,748,227,2242
60,28,15681,2833,12848,217,12631,155,3812,3501,1073,144,120,27,953,259,2587
60,29,15363,3399,11964,238,11726,130,3111,3048,1209,149,64,35,808,244,2928
60,30,19566,3907,15659,257,15402,223,3918,4109,1478,190,102,38,1258,309,3777
60,31,8664,1357,7307,133,7174,114,1899,1974,696,88,52,14,547,167,1623
60,32,18176,3453,14723,247,14476,175,3835,2916,2039,217,147,40,1078,300,3729
60,33,13226,2256,10970,196,10774,118,2978,2542,1131,175,107,23,691,231,2778
60,34,23361,4067,19294,332,18962,398,3587,7343,1442,139,94,36,1880,352,3691
60,35,5840,817,5023,100,4923,68,1432,1410,412,72,44,10,402,107,966
60,36,26582,5614,20968,278,20690,461,3453,8468,1461,153,66,52,2197,386,3993
60,37,10916,2248,8668,140,8528,159,1818,2385,788,85,51,25,749,159,2309
60,38,12115,3096,9019,146,8873,116,1541,1130,1175,82,82,21,364,85,4277
60,39,17556,3468,14088,218,13870,191,3339,2894,2296,163,88,36,880,208,3775
60,40,12783,2858,9925,149,9776,182,2083,2558,968,120,79,36,807,153,2790
60,41,14681,3252,11429,198,11231,187,2402,2697,1167,137,97,30,866,208,3440
61,1,7722,1898,5824,107,5717,151,799,1358,671,82,41,9,618,89,1899
61,2,14612,2174,12438,253,12185,214,2052,3369,1176,184,79,25,1498,236,3352
61,3,5648,1131,4517,85,4432,60,787,1079,535,51,24,13,377,85,1421
61,4,6210,868,5342,94,5248,153,1101,1249,551,111,47,17,587,137,1295
61,5,2738,363,2375,42,2333,38,599,803,153,26,17,6,239,55,397
61,6,4613,825,3788,88,3700,83,782,1218,262,55,29,9,395,122,745
61,7,3569,519,3050,60,2990,74,588,1021,208,33,18,7,299,83,659
61,8,3948,570,3378,71,3307,78,727,1006,328,54,25,4,368,86,631
61,9,2250,318,1932,31,1901,43,452,619,146,20,13,4,218,39,347
61,10,8082,1438,6644,145,6499,96,1189,1968,569,114,49,24,875,205,1410
61,11,4657,679,3978,82,3896,68,754,1223,341,54,28,8,449,115,856
61,12,2108,308,1800,35,1765,40,339,637,155,18,15,3,164,38,356
61,13,3269,593,2676,30,2646,29,608,894,222,43,19,7,261,108,455
61,14,7585,1164,6421,147,6274,122,1134,1882,572,107,70,11,716,164,1496
61,15,9614,1777,7837,126,7711,165,1246,1935,821,106,63,20,847,155,2353
61,16,3144,587,2557,56,2501,43,538,814,166,37,30,6,245,83,539
61,17,5610,915,4695,95,4600,74,871,1671,312,51,29,4,551,107,930
61,18,6380,1089,5291,90,5201,52,1181,1484,446,71,47,16,487,111,1306
61,19,3294,533,2761,48,2713,48,668,940,200,36,19,10,266,54,472
61,20,3779,521,3258,61,3197,59,731,1045,244,50,23,13,349,78,605
61,21,3225,553,2672,45,2627,26,636,884,173,31,14,10,305,82,466
61,22,5937,776,5161,119,5042,88,1100,1273,438,87,43,9,532,120,1352
61,23,6600,1120,5480,98,5382,91,1098,1819,383,76,45,14,558,114,1184
61,24,3343,447,2896,56,2840,49,681,817,270,50,20,4,260,64,625
61,25,3113,512,2601,41,2560,43,650,835,185,30,13,8,223,76,497
61,26,3635,523,3112,67,3045,65,670,932,267,35,34,11,278,86,667
61,27,2740,469,2271,49,2222,35,367,897,130,35,19,5,270,85,379
61,28,3021,454,2567,46,2521,51,545,829,199,21,16,5,304,65,486
61,29,3813,531,3282,57,3225,84,633,1023,322,35,20,4,365,75,664
61,30,5375,792,4583,77,4506,106,1030,1395,364,69,32,12,441,100,957
61,31,5327,965,4362,78,4284,68,968,1304,358,45,19,7,429,107,979
61,32,5411,920,4491,86,4405,77,1105,1296,413,83,51,11,330,132,907
61,33,6325,853,5472,102,5370,93,1022,1454,464,73,43,11,676,145,1389
61,34,3371,575,2796,44,2752,26,692,960,237,24,22,12,183,57,539
61,35,4338,569,3769,82,3687,58,838,1091,306,62,27,6,355,121,823
61,36,5363,1098,4265,78,4187,57,964,1512,283,58,26,13,349,104,821
61,37,6265,1119,5146,100,5046,47,1062,1418,441,84,27,7,492,98,1370
61,38,9517,1730,7787,155,7632,136,1255,2197,719,121,39,21,822,139,2183
61,39,6958,1293,5665,109,5556,84,838,1393,703,78,31,13,507,99,1810
61,40,10012,1809,8203,154,8049,135,1457,1954,768,115,68,23,838,154,2537
62,1,19295,3115,16180,346,15834,188,3730,3525,1514,224,155,38,1249,356,4855
62,2,15382,2347,13035,226,12809,135,3431,3083,1164,158,105,21,960,267,3485
62,3,13931,2930,11001,233,10768,232,2074,2538,1238,128,87,23,940,161,3347
62,4,23140,4003,19137,372,18765,341,3556,4115,2116,230,136,38,1743,306,6184
62,5,9781,1289,8492,178,8314,113,1986,2321,799,92,65,19,698,153,2068
62,6,18974,3212,15762,311,15451,154,4359,3774,1457,176,128,41,1036,309,4017
62,7,8561,1523,7038,132,6906,56,1624,1954,551,137,64,10,489,127,1894
62,8,6923,1016,5907,122,5785,53,1478,1680,493,73,48,9,446,109,1396
62,9,6256,1105,5151,99,5052,52,1362,1233,488,76,62,10,346,105,1318
62,10,9619,1110,8509,157,8352,114,1819,2662,645,111,67,19,778,164,1973
62,11,5057,914,4143,60,4083,39,1286,1059,303,54,49,10,317,77,889
62,12,16609,3890,12719,232,12487,198,2863,2995,1327,157,109,27,899,206,3706
62,13,11909,2531,9378,129,9249,160,1975,2035,978,130,78,20,614,139,3120
62,14,17022,3471,13551,202,13349,274,2602,3250,1435,149,85,36,1005,217,4296
62,15,20651,4833,15818,246,15572,244,3597,3546,2083,218,106,36,1025,217,4500
62,16,20545,4946,15599,257,15342,229,3655,3550,1881,213,108,33,1004,235,4434
62,17,14961,2481,12480,241,12239,139,3578,2420,1397,178,121,22,728,211,3445
62,18,8539,1279,7260,139,7121,65,1473,1784,712,83,74,22,487,118,2303
62,19,18199,4388,13811,265,13546,159,3648,2418,1955,179,105,30,662,178,4212
62,20,9161,1206,7955,137,7818,62,1987,2027,721,91,79,17,646,175,2013
62,21,11440,1618,9822,231,9591,127,2191,2610,859,117,71,16,726,218,2656
62,22,15205,3044,12161,270,11891,104,3035,3368,1088,169,96,20,743,203,3065
62,23,7430,1012,6418,140,6278,52,1686,1683,409,90,44,7,407,122,1778
62,24,5284,658,4626,78,4548,70,903,1415,390,48,35,8,309,63,1307
62,25,11620,1873,9747,157,9590,95,2649,2254,897,124,74,19,637,201,2640
62,26,8552,1579,6973,152,6821,63,1412,1803,660,107,62,23,456,138,2097
62,27,8320,1243,7077,131,6946,76,1747,1962,648,82,62,15,502,131,1721
62,28,15166,3134,12032,247,11785,110,3039,2312,1545,161,112,26,668,223,3589
62,29,5913,758,5155,101,5054,63,1057,1735,345,42,40,14,435,94,1229
62,30,14743,2458,12285,190,12095,193,2576,3870,945,102,78,40,1226,262,2803
62,31,15170,4273,10897,197,10700,117,2760,1951,1659,132,95,27,503,141,3315
62,32,14760,3595,11165,206,10959,100,3573,1115,1517,134,142,27,348,130,3873
62,33,16999,2681,14318,286,14032,198,3464,3121,1829,169,134,34,947,254,3882
62,34,17918,2339,15579,332,15247,157,3764,3485,1183,209,125,24,1068,338,4894
62,35,8768,1367,7401,132,7269,68,2099,1772,669,85,66,10,519,147,1834
62,36,16863,2694,14169,236,13933,173,3296,3436,1277,166,99,21,981,232,4252
62,37,19331,3429,15902,245,15657,203,2790,6430,1094,153,102,29,1361,295,3200
62,38,15489,2693,12796,256,12540,140,2941,2284,1542,182,123,26,719,210,4373
62,39,5732,811,4921,108,4813,56,1109,1492,370,58,47,15,338,104,1224
62,40,5771,842,4929,92,4837,49,1277,1297,382,68,36,3,363,73,1289
62,41,12172,2456,9716,208,9508,160,1948,2712,770,109,87,19,774,193,2736
62,42,15097,3146,11951,201,11750,149,2644,2779,1050,144,114,36,825,192,3817
62,43,11433,1730,9703,209,9494,118,2316,3019,872,110,81,20,686,162,2110
62,44,21852,3698,18154,257,17897,213,3772,4802,2011,214,143,32,1174,294,5242
62,45,18311,2411,15900,377,15523,225,3486,4202,1606,185,94,40,1368,312,4005
62,46,21718,3482,18236,339,17897,196,4842,3853,2190,223,132,36,1263,308,4854
62,47,12436,3394,9042,174,8868,122,2381,1457,1053,128,84,13,461,120,3049
62,48,16002,4004,11998,219,11779,143,4159,1852,1423,125,96,30,657,149,3145
62,49,15357,3943,11414,252,11162,103,3354,1643,1460,145,97,16,393,149,3802
62,50,13062,3199,9863,204,9659,149,2799,1472,1152,137,77,17,408,130,3318
62,51,15067,4075,10992,212,10780,143,3323,1555,1298,198,96,19,457,137,3554
62,52,15876,3878,11998,260,11738,106,3192,1356,2937,152,84,22,459,145,3285
62,53,14813,3156,11657,226,11431,126,2976,2049,1400,167,105,28,703,177,3700
62,54,17771,3789,13982,281,13701,142,3396,2732,1860,156,116,20,838,217,4224
62,55,12825,2924,9901,219,9682,83,3109,1484,1466,134,102,16,381,141,2766
62,56,16584,3580,13004,239,12765,120,4027,1997,1809,155,104,34,543,176,3800
62,57,18926,4436,14490,287,14203,152,4114,2364,1627,207,133,33,808,245,4520
62,58,13924,3142,10782,208,10574,203,1763,2604,1214,137,50,29,987,169,3418
62,59,14788,3453,11335,223,11112,121,3240,1886,1338,95,98,29,540,166,3599
62,60,17699,4146,13553,262,13291,140,3480,2015,1714,200,129,29,557,186,4841
62,61,13119,2955,10164,171,9993,111,2654,1567,1244,148,89,21,453,153,3553
62,62,15177,3220,11957,248,11709,111,3136,2370,1045,155,139,24,687,182,3860
62,63,15907,3573,12334,195,12139,102,3516,1915,2113,130,100,22,571,180,3490
62,64,13943,3190,10753,209,10544,118,2939,1931,1195,166,102,29,583,161,3320
62,65,12929,3109,9820,142,9678,154,2147,2360,995,95,59,24,611,142,3091
62,66,14331,4315,10016,188,9828,89,2915,1372,1413,176,94,28,380,123,3238
62,67,14738,3370,11368,250,11118,85,3736,1433,2530,138,100,23,385,149,2539
62,68,17168,3669,13499,281,13218,112,4364,1957,1685,185,123,32,578,220,3962
62,69,18850,3737,15113,313,14800,220,3367,4190,1432,190,125,25,1029,276,3946
62,70,16076,3392,12684,227,12457,183,2997,2973,1262,155,96,34,1017,217,3523
62,71,14946,2138,12808,242,12566,210,2151,3778,969,133,57,25,1318,240,3685
62,72,13772,3488,10284,234,10050,84,2873,1241,2059,149,129,21,405,142,2947
62,73,14853,2902,11951,223,11728,140,3443,2080,1355,158,130,20,704,188,3510
62,74,13716,3582,10134,162,9972,107,3279,1514,1386,123,85,25,414,124,2915
62,75,15013,3369,11644,216,11428,115,3685,1667,1774,177,117,29,415,138,3311
62,76,12980,3204,9776,156,9620,98,2376,1913,1083,145,91,16,533,120,3245
62,77,15508,3222,12286,237,12049,141,3403,2174,1619,149,114,23,661,190,3575
63,1,6476,783,5693,145,5548,94,1021,1298,672,81,33,9,571,115,1654
63,2,8564,1497,7067,177,6890,106,1364,1465,1068,81,73,17,845,125,1746
63,3,2008,387,1621,39,1582,25,282,398,191,21,13,3,164,51,434
63,4,3263,612,2651,64,2587,41,660,553,305,42,31,7,253,48,647
63,5,4006,814,3192,81,3111,59,583,922,331,49,26,13,318,46,764
63,6,7946,1013,6933,147,6786,148,1098,1171,1211,92,40,23,621,112,2270
63,7,2796,494,2302,51,2251,21,378,420,321,29,24,4,192,34,828
63,8,5400,806,4594,102,4492,136,800,805,762,69,27,18,406,77,1392
63,9,4882,717,4165,125,4040,49,754,698,791,54,35,7,336,74,1242
63,10,7701,1500,6201,137,6064,119,926,1096,870,102,38,15,517,85,2296
63,11,9126,2071,7055,122,6933,91,1132,1033,978,83,52,14,471,84,2995
63,12,5580,1031,4549,80,4469,136,492,878,666,52,29,9,463,92,1652
63,13,10202,1744,8458,141,8317,277,662,2283,1045,67,32,17,963,122,2849
63,14,5728,772,4956,116,4840,95,773,994,708,73,35,16,486,107,1553
63,15,6554,1009,5545,131,5414,103,968,1127,918,64,34,14,483,99,1604
63,16,1935,319,1616,47,1569,40,269,288,371,22,10,6,143,31,389
63,17,7739,859,6880,160,6720,109,1218,1421,819,75,51,18,647,138,2224
63,18,1080,179,901,33,868,11,131,162,113,12,15,3,125,21,275
63,19,16482,2569,13913,276,13637,241,2199,3010,1755,181,96,46,1262,263,4584
63,20,5964,1111,4853,83,4770,65,874,708,827,79,33,17,311,76,1780
63,21,2579,485,2094,56,2038,40,279,568,207,14,16,3,212,48,651
63,22,10924,1677,9247,238,9009,121,1856,1904,1248,111,63,26,785,181,2714
63,23,8105,1183,6922,173,6749,130,1065,1169,1220,125,52,27,632,119,2210
63,24,3948,678,3270,77,3193,41,731,686,456,37,27,6,274,58,877
63,25,3438,562,2876,58,2818,56,483,530,544,50,27,13,254,55,806
63,26,6509,1220,5289,130,5159,56,986,1009,845,85,50,12,349,104,1663
63,27,2529,448,2081,60,2021,34,394,437,333,31,7,10,184,48,543
63,28,2180,405,1775,35,1740,25,298,308,263,20,22,2,197,42,563
63,29,4157,751,3406,106,3300,36,564,825,403,36,22,7,394,53,960
63,30,16766,2452,14314,319,13995,197,2498,3083,1752,173,97,29,1368,234,4564
63,31,5484,811,4673,134,4539,54,779,902,673,57,36,12,495,83,1448
63,32,4820,692,4128,103,4025,52,972,811,494,41,26,7,353,77,1192
63,33,14302,1956,12346,273,12073,254,1878,2839,1508,164,63,22,1252,224,3869
63,34,17619,2443,15176,306,14870,393,1993,3242,2015,163,87,29,1597,267,5084
63,35,8922,1309,7613,183,7430,164,1172,1882,849,109,42,21,933,132,2126
63,36,1255,217,1038,20,1018,25,174,180,223,18,15,5,111,10,257
63,37,6872,832,6040,121,5919,212,763,1261,780,78,37,11,714,113,1950
63,38,1651,318,1333,36,1297,17,251,354,160,10,7,2,142,36,318
63,39,3015,379,2636,77,2559,85,476,471,526,24,16,8,229,39,685
63,40,5466,771,4695,102,4593,60,740,777,731,77,31,15,377,92,1693
63,41,2151,448,1703,40,1663,35,295,386,258,23,15,3,177,19,452
63,42,3572,624,2948,84,2864,70,445,508,494,32,26,8,273,51,957
63,43,6772,1210,5562,134,5428,53,1176,1124,783,77,40,13,442,102,1618
63,44,5325,688,4637,117,4520,100,737,833,736,61,32,29,408,105,1479
63,45,2467,384,2083,52,2031,29,286,505,220,23,11,2,242,33,680
63,46,9798,1838,7960,167,7793,101,1573,1431,1142,115,48,20,576,118,2669
63,47,8896,1134,7762,208,7554,146,1267,1337,1272,105,65,23,770,146,2423
63,48,18958,2536,16422,348,16074,329,2304,3330,2194,180,104,41,1723,293,5576
63,49,10777,1338,9439,170,9269,213,1303,1701,1535,138,60,42,879,171,3227
63,50,1924,266,1658,37,1621,27,339,485,168,7,11,2,174,33,375
63,51,7668,1449,6219,90,6129,236,675,1215,951,76,39,15,624,83,2215
63,52,10255,1655,8600,153,8447,244,911,1957,1103,73,38,20,940,127,3034
63,53,6257,1349,4908,81,4827,183,505,1034,712,68,21,16,505,65,1718
63,54,7707,1639,6068,122,5946,148,848,931,920,75,41,15,436,91,2441
63,55,14622,2387,12235,239,11996,294,1435,2809,1483,116,42,40,1418,217,4142
63,56,15883,2866,13017,253,12764,375,1383,2999,1614,124,55,31,1543,222,4418
63,57,12278,1954,10324,194,10130,236,950,3849,786,71,14,24,1315,169,2716
63,58,13387,1698,11689,231,11458,189,1649,2380,1532,121,73,26,1127,180,4181
63,59,20905,3633,17272,385,16887,247,2802,3401,2208,216,109,44,1466,283,6111
63,60,5794,1299,4495,89,4406,76,714,620,745,46,29,10,322,56,1788
63,61,9878,1310,8568,164,8404,200,1022,2321,883,97,29,21,982,176,2673
64,1,2553,384,2169,41,2128,52,178,319,409,32,15,1,442,29,651
64,2,2806,377,2429,44,2385,68,292,472,321,41,8,8,520,20,635
64,3,8473,1097,7376,112,7264,132,1073,1359,941,130,48,18,1084,112,2367
64,4,5893,916,4977,68,4909,122,592,867,732,74,34,10,649,59,1770
64,5,5116,750,4366,102,4264,77,582,970,470,58,14,10,760,65,1258
64,6,7911,1859,6052,104,5948,274,706,1263,886,155,26,12,684,79,1863
64,7,13419,2935,10484,202,10282,252,1434,1872,1885,191,50,18,1005,153,3422
64,8,12358,2945,9413,142,9271,302,949,3128,945,139,42,26,1189,110,2441
64,9,4198,580,3618,65,3553,82,454,899,365,48,16,5,769,68,847
64,10,11649,2121,9528,259,9269,376,1132,2504,978,282,58,25,1446,161,2307
64,11,2921,405,2516,40,2476,44,359,582,254,38,10,3,428,44,714
64,12,6984,1044,5940,127,5813,256,728,1356,537,178,47,15,1164,128,1404
64,13,3588,517,3071,79,2992,163,294,841,245,123,26,5,622,43,630
64,14,5306,775,4531,96,4435,172,517,1097,495,138,17,11,727,83,1178
64,15,10871,2066,8805,214,8591,134,1408,1370,1064,151,42,20,960,133,3309
64,16,2917,488,2429,29,2400,60,268,432,333,34,12,5,432,29,795
64,17,2463,296,2167,36,2131,84,287,385,263,33,13,3,428,28,607
64,18,4303,675,3628,69,3559,62,585,673,376,66,19,10,573,67,1128
64,19,26114,3853,22261,414,21847,511,2880,5199,2283,245,61,55,3540,361,6712
64,20,8157,1423,6734,157,6577,209,608,1340,954,144,33,14,1075,65,2135
64,21,6867,896,5971,152,5819,126,767,1089,737,83,29,14,1005,111,1858
64,22,2150,293,1857,30,1827,31,286,310,189,16,8,7,472,25,483
64,23,17117,2460,14657,290,14367,305,1890,3217,1442,160,40,26,2964,199,4124
64,24,4674,699,3975,89,3886,73,523,891,375,50,18,11,860,66,1019
64,25,12903,1902,11001,227,10774,186,1540,1839,1223,121,23,15,2365,160,3302
64,26,6234,831,5403,122,5281,136,784,901,625,74,25,13,1241,78,1404
64,27,9770,1411,8359,154,8205,218,962,1369,1410,124,59,20,1229,103,2711
64,28,9150,1417,7733,151,7582,161,820,1327,1256,98,33,19,1072,100,2696
64,29,13413,2186,11227,242,10985,257,1207,2086,1441,186,49,22,1601,166,3970
64,30,12809,3379,9430,149,9281,282,1123,2057,1244,118,41,18,1272,106,3020
64,31,18954,3653,15301,268,15033,349,1778,3351,1628,171,41,19,2476,182,5038
64,32,7505,960,6545,118,6427,119,1006,1274,683,82,20,12,1330,83,1818
64,33,4984,1133,3851,110,3741,181,405,1005,348,183,24,11,632,52,900
64,34,19979,3548,16431,334,16097,557,1680,5240,1692,310,88,38,2129,271,4092
64,35,5326,908,4418,111,4307,176,409,1210,345,141,31,14,764,53,1164
64,36,7432,1163,6269,145,6124,199,630,1561,565,198,55,15,1269,112,1520
64,37,6979,1214,5765,99,5666,110,756,1233,649,91,33,23,913,115,1743
64,38,3297,523,2774,75,2699,55,411,591,261,53,27,7,603,39,652
64,39,2828,523,2305,60,2245,76,213,363,279,76,18,7,418,28,767
64,40,5026,687,4339,75,4264,72,645,867,419,58,21,11,791,66,1314
64,41,19044,3100,15944,349,15595,568,1897,4407,1775,384,85,40,2289,235,3915
64,42,12817,2423,10394,969,9425,322,936,2929,949,127,41,24,1185,123,2789
64,43,12906,2889,10017,164,9853,417,941,2957,1142,167,51,23,1164,96,2895
64,44,10124,2637,7487,83,7404,304,712,3099,576,70,24,13,812,86,1708
64,45,21502,4196,17306,325,16981,642,1908,4051,2458,418,105,30,1798,231,5340
64,46,15500,2683,12817,201,12616,369,1563,2766,1654,167,52,36,2098,210,3701
64,47,12792,2367,10425,174,10251,256,1123,2854,967,90,25,20,1857,153,2906
64,48,10672,2046,8626,139,8487,250,986,1976,1076,86,20,16,1403,104,2570
64,49,10531,2104,8427,133,8294,254,909,1790,1042,115,23,16,1168,112,2865
64,50,15994,2999,12995,215,12780,385,1382,3612,1395,201,56,33,1654,172,3890
64,51,8746,1851,6895,117,6778,154,854,1495,855,85,27,14,1057,89,2148
64,52,12921,2201,10720,231,10489,323,1472,2322,1313,209,43,21,1293,165,3328
65,1,9167,1357,7810,164,7646,192,971,1681,1120,117,55,14,863,136,2497
65,2,2984,578,2406,60,2346,74,300,458,409,35,11,1,215,27,816
65,3,1987,249,1738,32,1706,52,199,274,253,25,12,5,222,32,632
65,4,10701,1876,8825,183,8642,234,933,1405,1571,128,47,16,952,119,3237
65,5,3808,610,3198,77,3121,94,421,434,588,57,30,8,320,48,1121
65,6,1227,201,1026,20,1006,36,87,232,173,22,8,4,85,8,351
65,7,3168,447,2721,77,2644,69,265,452,482,37,17,7,270,41,1004
65,8,2883,427,2456,62,2394,52,388,541,300,37,13,9,214,48,792
65,9,1528,255,1273,13,1260,34,188,286,173,15,6,3,131,23,401
65,10,1806,308,1498,50,1448,7,253,319,192,23,8,9,183,23,431
65,11,8215,1439,6776,142,6634,128,1038,1205,1044,84,34,21,655,120,2305
65,12,7755,1384,6371,141,6230,94,978,1576,666,80,26,18,742,137,1913
65,13,2804,460,2344,56,2288,61,209,465,489,37,17,3,262,35,710
65,14,3881,640,3241,83,3158,55,518,604,442,55,20,10,339,75,1040
65,15,2387,418,1969,37,1932,43,352,372,322,17,13,3,149,32,629
65,16,9991,1225,8766,205,8561,183,1391,1772,1031,106,43,17,1131,148,2739
65,17,3937,602,3335,60,3275,64,556,658,452,56,16,9,380,50,1034
65,18,3924,602,3322,70,3252,51,691,655,423,49,16,5,328,52,982
65,19,3786,638,3148,69,3079,68,471,499,541,45,19,6,294,47,1089
65,20,1738,251,1487,24,1463,18,249,344,142,22,11,2,252,21,402
65,21,7956,1122,6834,118,6716,119,1075,1183,1122,96,31,10,586,113,2381
65,22,9081,1341,7740,156,7584,126,1075,1427,1297,91,31,14,772,103,2648
65,23,5103,726,4377,93,4284,66,682,725,599,61,25,6,466,73,1581
65,24,2853,456,2397,54,2343,33,375,570,285,35,17,6,278,56,688
65,25,7780,1291,6489,124,6365,119,1144,1309,923,91,36,12,638,106,1987
65,26,2228,373,1855,44,1811,41,189,449,281,28,12,3,205,27,576
65,27,8710,1578,7132,130,7002,111,1208,1929,690,100,36,14,834,154,1926
65,28,5703,1238,4465,83,4382,100,595,1123,586,58,17,7,418,66,1412
65,29,6595,1512,5083,77,5006,131,721,1208,785,56,22,5,469,61,1548
65,30,5429,1315,4114,67,4047,64,635,690,677,61,19,8,308,54,1531
65,31,5161,1391,3770,64,3706,103,546,847,573,48,16,5,343,51,1174
65,32,5012,1064,3948,62,3886,99,552,900,585,33,27,9,387,42,1252
65,33,9406,1276,8130,132,7998,117,1263,1364,1540,84,42,17,787,125,2659
65,34,8723,1094,7629,140,7489,169,1062,1556,1178,78,27,14,787,123,2495
66,1,22285,3764,18521,338,18183,379,4353,5100,2051,183,78,44,1073,260,4662
66,2,5940,1306,4634,68,4566,119,965,1026,648,83,30,17,292,82,1304
66,3,17618,3393,14225,312,13913,354,2862,3369,2017,194,68,30,919,250,3850
66,4,4030,654,3376,60,3316,82,765,650,672,62,19,12,168,46,840
66,5,16463,2577,13886,310,13576,257,3802,3055,1647,163,81,34,889,146,3502
66,6,3659,707,2952,56,2896,91,570,774,443,54,21,7,232,40,664
66,7,1644,316,1328,26,1302,72,210,226,318,34,9,5,62,18,348
66,8,7522,1948,5574,113,5461,74,1507,1067,591,58,33,10,275,47,1799
66,9,5520,1656,3864,71,3793,99,659,1180,417,63,17,8,194,50,1106
66,10,10470,1728,8742,175,8567,329,1499,1946,1471,122,51,21,518,130,2480
66,11,2108,359,1749,34,1715,59,237,365,403,16,8,4,97,30,496
66,12,18889,3272,15617,311,15306,263,4164,3322,2121,193,97,21,821,236,4068
66,13,7684,1490,6194,128,6066,195,1005,1617,896,116,51,22,475,80,1609
66,14,19510,3236,16274,293,15981,213,5008,4122,1684,176,77,41,925,210,3525
66,15,3344,620,2724,44,2680,56,612,537,390,31,19,7,141,45,842
66,16,1147,183,964,20,944,31,163,209,151,11,4,1,60,12,302
66,17,16805,2561,14244,347,13897,275,3585,2851,1964,181,75,23,918,178,3847
66,18,8442,1394,7048,146,6902,165,1579,1437,1104,105,31,22,382,90,1987
66,19,10517,1805,8712,192,8520,187,1780,2403,1047,118,58,20,510,129,2268
66,20,12515,2440,10075,174,9901,183,2226,2561,1438,98,32,20,639,128,2576
66,21,11257,2499,8758,152,8606,173,1970,2292,1022,72,37,21,646,118,2255
66,22,8230,1852,6378,107,6271,121,1401,1488,844,72,30,24,415,65,1811
66,23,4667,1248,3419,41,3378,143,516,1073,366,46,13,10,213,32,966
66,24,14883,2717,12166,190,11976,244,2973,3772,1060,111,46,20,856,153,2741
66,25,7478,1763,5715,97,5618,136,1235,1463,709,78,28,6,407,60,1496
66,26,8121,2181,5940,95,5845,118,1459,1199,782,52,26,16,270,46,1877
66,27,16205,2436,13769,227,13542,210,3534,4316,1383,142,51,24,834,199,2849
66,28,17075,2889,14186,301,13885,269,3603,3165,2000,171,81,27,846,185,3538
66,29,12573,1818,10755,186,10569,186,2539,2689,1220,139,46,28,745,173,2804
66,30,14127,2112,12015,247,11768,210,3108,2918,1421,142,47,21,831,198,2872
66,31,18515,3013,15502,251,15251,271,4118,4678,1459,179,41,25,955,216,3309
67,1,14501,2588,11913,240,11673,402,2385,4266,674,124,78,48,1740,226,1730
67,2,15515,2927,12588,259,12329,289,3333,4221,709,142,121,39,1462,223,1790
67,3,34331,7055,27276,598,26678,449,7423,9433,1534,302,222,86,2864,524,3841
67,4,14935,3079,11856,254,11602,302,3157,3707,772,144,91,25,1492,245,1667
67,5,38007,6969,31038,590,30448,672,6622,11901,1710,272,171,70,3739,485,4806
67,6,8998,1668,7330,185,7145,160,2176,2372,358,80,81,25,878,165,850
67,7,18849,3621,15228,301,14927,360,3573,5297,840,122,114,44,1821,340,2416
67,8,25278,4482,20796,349,20447,454,4249,7689,1289,175,93,51,2471,353,3623
67,9,37203,7219,29984,571,29413,570,6887,10869,1676,308,215,89,3670,544,4585
67,10,13023,1943,11080,214,10866,237,2549,4269,549,103,58,28,1500,210,1363
67,11,3380,721,2659,63,2596,54,522,1090,105,41,29,12,269,57,417
67,12,17698,3174,14524,329,14195,310,3824,4689,912,146,115,34,1771,301,2093
67,13,9729,1498,8231,161,8070,193,2070,2861,451,88,66,15,1078,126,1122
67,14,30517,5628,24889,489,24400,587,5634,8199,1734,255,138,78,3136,514,4125
67,15,21433,4450,16983,366,16617,267,5118,5290,936,232,142,49,1896,312,2375
67,16,16078,3088,12990,251,12739,288,2986,4736,754,119,66,45,1482,243,2020
67,17,8487,1657,6830,162,6668,184,2029,2052,433,90,68,15,740,125,932
67,18,13844,2250,11594,250,11344,356,2361,4378,650,107,66,37,1565,246,1578
67,19,3040,533,2507,42,2465,67,702,607,199,42,22,3,277,55,491
67,20,11335,2315,9020,203,8817,161,2777,2906,487,153,88,31,959,216,1039
67,21,18073,3505,14568,267,14301,383,3260,4837,953,176,94,43,1887,268,2400
67,22,17486,4805,12681,192,12489,477,2035,3160,1418,119,62,27,1199,156,3836
67,23,10501,2157,8344,174,8170,174,2220,2152,662,138,85,26,756,153,1804
67,24,22929,4541,18388,429,17959,540,3764,5766,1333,195,128,62,2150,332,3689
67,25,8552,1461,7091,196,6895,137,1921,2671,284,79,68,26,808,164,737
67,26,14956,2868,12088,381,11707,267,3329,4031,572,156,103,40,1427,284,1498
67,27,15042,3269,11773,130,11643,619,601,4321,1107,113,27,30,1409,99,3317
67,28,10347,2246,8101,83,8018,585,686,1658,1221,90,39,12,872,69,2786
67,29,11956,2678,9278,143,9135,486,934,2144,1257,84,29,33,951,94,3123
67,30,12512,2429,10083,88,9995,498,645,3674,947,60,21,33,1196,71,2850
67,31,17832,2449,15383,266,15117,444,2582,6248,768,109,74,61,2143,274,2414
67,32,8901,1446,7455,169,7286,311,1715,2230,484,97,72,15,997,149,1216
67,33,17127,3025,14102,248,13854,351,3283,5131,767,154,117,34,1839,286,1892
67,34,12948,2868,10080,255,9825,289,2105,3763,498,138,61,30,1315,215,1411
67,35,10097,1872,8225,245,7980,174,2325,2730,402,100,66,30,930,178,1045
67,36,13830,2942,10888,146,10742,385,1282,4042,804,76,30,20,1323,97,2683
67,37,21450,6070,15380,243,15137,367,1998,2928,1946,136,86,39,1254,161,6222
67,38,14103,3421,10682,161,10521,412,1379,2824,1184,101,39,23,1124,134,3301
67,39,15199,3579,11620,158,11462,564,1516,3029,1399,89,60,32,1251,133,3389
67,40,15814,4199,11615,149,11466,345,1922,2628,1336,92,55,17,1012,134,3925
67,41,12024,3492,8532,128,8404,203,1672,2024,914,77,61,19,704,94,2636
67,42,37620,9053,28567,414,28153,761,5284,9253,2090,242,127,67,3303,391,6635
67,43,35647,5924,29723,484,29239,734,4948,11151,1925,193,151,80,3876,502,5679
67,44,16960,3740,13220,225,12995,320,2481,3741,1259,134,80,32,1404,193,3351
68,1,18749,3079,15670,334,15336,416,3436,5458,1067,159,99,47,2046,352,2256
68,2,19279,2824,16455,319,16136,366,3920,5431,937,200,107,49,2185,403,2538
68,3,27371,5366,22005,408,21597,480,6104,5779,1829,276,118,74,2238,473,4226
68,4,15606,4506,11100,196,10904,309,2574,3001,917,150,91,36,1073,168,2585
68,5,10109,1641,8468,168,8300,182,2245,2587,603,100,69,46,1079,207,1182
68,6,20250,3555,16695,398,16297,345,4575,4860,1185,201,151,59,1844,369,2708
68,7,10245,1778,8467,162,8305,277,1884,3689,401,100,50,25,953,180,746
68,8,15354,3506,11848,246,11602,372,2816,3194,1018,167,81,33,1266,273,2382
68,9,25254,5405,19849,406,19443,563,3973,6830,1307,176,79,61,2456,398,3600
68,10,12026,2137,9889,223,9666,228,2377,3603,569,138,61,21,1153,250,1266
68,11,32466,7284,25182,441,24741,678,4752,9956,1559,251,114,73,2845,493,4020
68,12,13031,2270,10761,210,10551,402,2206,3908,563,117,83,27,1408,206,1631
68,13,17463,2945,14518,270,14248,396,3341,5651,716,163,82,49,1773,294,1783
68,14,7711,1315,6396,138,6258,306,1418,1831,547,88,58,19,829,185,977
68,15,9148,1477,7671,157,7514,184,2027,2186,610,94,71,24,898,190,1230
68,16,14757,4781,9976,270,9706,183,1878,1987,1129,98,51,39,710,135,3496
68,17,26024,5893,20131,452,19679,542,3760,6653,1561,167,101,68,2298,314,4215
68,18,13037,2380,10657,215,10442,383,2790,3271,667,158,77,29,1304,255,1508
68,19,11422,1954,9468,195,9273,196,2667,2891,539,121,63,30,1073,230,1463
68,20,10242,1741,8501,175,8326,294,2006,3064,451,98,59,26,1082,165,1081
68,21,9198,1510,7688,143,7545,249,1913,2446,457,90,58,42,896,182,1212
68,22,10143,1799,8344,200,8144,184,2460,2418,631,134,79,26,846,222,1144
68,23,7100,1502,5598,134,5464,136,1490,1338,558,103,38,18,522,108,1153
68,24,17235,3063,14172,289,13883,337,3736,3891,1039,214,89,41,1548,321,2667
68,25,15071,2799,12272,234,12038,322,2988,3424,1003,160,95,44,1382,301,2319
68,26,15610,2703,12907,238,12669,414,2491,4630,768,142,83,37,1662,259,2183
68,27,36339,8287,28052,554,27498,529,7170,7572,2251,345,156,90,2502,506,6377
68,28,28330,6833,21497,351,21146,742,3891,6729,1579,212,125,65,2510,366,4927
68,29,15829,4592,11237,267,10970,385,1749,3416,1122,107,56,28,1071,150,2886
68,30,12535,3780,8755,208,8547,192,1573,2004,924,90,61,28,710,123,2842
68,31,24240,4661,19579,396,19183,388,4778,5651,1569,205,103,68,2014,430,3977
69,1,6423,1119,5304,97,5207,95,1300,1610,417,51,44,13,601,128,948
69,2,18840,2443,16397,300,16097,428,2849,5866,1189,119,66,42,1870,344,3324
69,3,28246,3889,24357,398,23959,716,3813,8145,2233,211,88,71,2928,542,5212
69,4,9842,1505,8337,206,8131,165,1770,2805,724,100,51,24,943,224,1325
69,5,17142,3093,14049,275,13774,245,3510,4421,1184,143,81,27,1339,316,2508
69,6,12351,1615,10736,205,10531,337,1881,3457,1025,106,62,32,1263,250,2118
69,7,12087,1794,10293,198,10095,244,2100,3006,962,119,60,21,979,214,2390
69,8,25261,5148,20113,325,19788,460,3797,4339,3148,207,137,54,1580,323,5743
69,9,5017,821,4196,59,4137,66,933,1442,344,49,33,7,455,90,718
69,10,21759,2805,18954,229,18725,449,2158,9343,978,98,48,25,2272,313,3041
69,11,18458,3623,14835,160,14675,548,1314,6147,1308,93,35,47,1640,201,3342
69,13,18688,3656,15032,162,14870,1158,739,3131,2961,136,59,47,1263,124,5252
69,14,24793,4391,20402,304,20098,1157,1539,5739,2869,170,71,51,2035,238,6229
69,15,27583,6772,20811,299,20512,715,2379,4974,2801,194,109,56,2059,306,6919
69,16,30642,5948,24694,304,24390,907,2411,8110,2477,197,97,69,2873,371,6878
69,17,16667,2821,13846,137,13709,376,888,7411,698,50,14,25,1429,164,2654
69,18,17069,3184,13885,170,13715,452,1121,5750,1084,76,54,38,1559,190,3391
69,19,20391,4186,16205,189,16016,693,1254,5036,1849,104,54,52,1785,200,4989
69,20,21822,4030,17792,213,17579,966,1409,4488,2423,138,75,54,2046,230,5750
69,21,16281,3094,13187,199,12988,465,1528,4281,1303,76,49,21,1547,178,3540
69,22,22158,5030,17128,267,16861,470,2338,4232,2048,140,80,41,1570,245,5697
69,23,3388,626,2762,74,2688,59,724,842,205,28,14,11,358,67,380
69,24,17320,1988,15332,269,15063,601,2509,4804,1380,160,79,51,1846,310,3323
69,25,30210,4624,25586,457,25129,668,3807,8744,2309,193,116,73,2860,471,5888
69,26,31922,5946,25976,393,25583,724,3472,8680,2275,198,98,58,3132,489,6457
69,27,9621,1345,8276,229,8047,205,1798,2465,766,100,72,19,894,230,1498
69,28,11177,1582,9595,198,9397,226,1723,3421,701,101,57,22,1203,339,1604
69,29,15986,2845,13141,227,12914,244,2928,3836,1154,139,60,33,1371,316,2833
69,30,8284,1413,6871,147,6724,82,1616,1997,643,73,51,20,721,163,1358
69,31,36759,4670,32089,530,31559,955,4739,11861,2351,223,101,105,3949,702,6573
69,32,18424,4061,14363,213,14150,273,2647,4126,1671,113,64,40,1323,228,3665
69,33,24059,4966,19093,304,18789,607,2643,4038,2511,183,86,38,1749,288,6646
69,34,25946,5689,20257,308,19949,624,2782,4578,2658,179,132,57,1767,321,6851
69,35,22309,4496,17813,282,17531,455,2745,4627,2058,138,89,51,1652,285,5431
69,36,17714,3863,13851,207,13644,454,1981,3010,1869,115,78,31,1350,200,4556
69,37,38259,6520,31739,505,31234,517,6763,9549,2841,264,133,63,2699,565,7840
69,38,30678,4397,26281,503,25778,540,5576,7851,2306,207,127,56,2531,466,6118
69,39,21424,4325,17099,300,16799,392,2725,4702,1747,154,93,47,1494,302,5143
69,40,16817,3350,13467,207,13260,442,2026,3333,1727,120,79,31,1269,212,4021
69,41,16191,3524,12667,251,12416,211,2328,2190,2264,157,124,23,771,173,4175
69,42,13272,3824,9448,200,9248,138,1192,1129,1854,92,66,20,449,99,4209
69,43,28452,4839,23613,306,23307,726,2627,8560,2204,185,67,59,2629,376,5874
69,44,33532,6673,26859,478,26381,571,4977,8194,2359,203,148,66,2581,459,6823
69,45,25689,5174,20515,370,20145,402,4116,4710,2640,183,134,37,1431,347,6145
69,46,20877,6318,14559,253,14306,195,1979,2063,2692,123,113,36,655,166,6284
69,47,28302,5466,22836,366,22470,808,2782,6122,2770,192,113,66,2137,279,7201
69,48,18553,3336,15217,229,14988,324,2428,4153,1852,146,71,45,1638,271,4060
69,49,22420,4456,17964,317,17647,300,3488,4019,2387,183,118,31,1278,269,5574
69,50,19385,3087,16298,184,16114,459,1852,6157,1271,110,60,52,1906,266,3981
69,51,21353,2905,18448,223,18225,514,2219,7082,1397,110,61,49,2292,294,4207
69,52,22067,3785,18282,227,18055,398,2073,8304,1165,90,41,46,2054,286,3598
69,53,18119,2745,15374,277,15097,330,3209,5040,1274,116,68,38,1642,317,3063
69,54,20365,4341,16024,248,15776,657,1522,4305,1748,126,47,42,1934,206,5189
69,55,20238,4602,15636,255,15381,398,2295,3697,1802,131,93,31,1441,250,5243
70,1,3272,492,2780,71,2709,38,679,631,255,42,15,10,210,64,765
70,2,4070,611,3459,69,3390,48,907,956,297,36,17,7,233,66,823
70,3,9511,1935,7576,180,7396,88,2456,1231,888,106,62,25,496,107,1937
70,4,2234,359,1875,53,1822,27,449,561,170,28,27,7,154,36,363
70,5,2709,371,2338,52,2286,49,492,661,204,39,18,1,177,43,602
70,6,4100,530,3570,92,3478,52,834,1157,255,41,33,17,265,74,750
70,7,3548,502,3046,90,2956,47,654,861,188,38,24,4,244,72,824
70,8,3446,520,2926,75,2851,43,815,855,208,28,22,5,190,46,639
70,9,9284,1873,7411,154,7257,93,1710,1883,613,78,51,21,558,171,2079
70,10,3843,557,3286,83,3203,75,817,847,278,37,21,11,288,71,758
70,11,7400,1151,6249,125,6124,121,1684,1211,742,102,61,15,416,110,1662
70,12,4569,805,3764,90,3674,48,970,970,335,46,29,9,243,71,953
70,13,7789,1221,6568,148,6420,84,1790,1285,738,100,63,13,440,141,1766
70,14,5054,1274,3780,107,3673,62,719,1054,280,34,30,9,280,89,1116
70,15,4653,643,4010,72,3938,87,936,1162,399,37,21,15,308,84,889
70,16,5531,1005,4526,138,4388,55,1153,1024,481,77,41,23,295,77,1162
70,17,4509,640,3869,96,3773,103,904,995,349,52,31,12,311,84,932
70,18,3636,404,3232,89,3143,56,704,837,268,52,16,5,308,67,830
70,19,3433,501,2932,57,2875,57,714,870,215,49,18,11,269,70,602
70,20,5790,952,4838,109,4729,70,1262,1180,401,69,24,11,331,93,1288
70,21,6750,877,5873,124,5749,132,1239,1618,582,53,40,22,521,107,1435
70,22,10599,2141,8458,261,8197,71,2229,2070,715,134,88,23,550,184,2133
70,23,2901,444,2457,73,2384,36,677,586,228,42,22,6,177,41,569
70,24,5458,831,4627,91,4536,65,1120,1281,418,55,28,8,377,101,1083
70,25,3235,555,2680,79,2601,28,733,715,205,44,21,5,206,61,583
70,26,10289,1955,8334,213,8121,139,1503,2128,823,101,65,21,658,162,2521
70,27,5723,779,4944,119,4825,79,1403,1120,438,90,47,14,342,93,1199
70,28,1942,374,1568,33,1535,30,352,462,143,21,13,2,143,38,331
70,29,12933,2116,10817,242,10575,214,2023,2849,1085,125,56,35,885,207,3096
70,30,7824,1365,6459,152,6307,87,1670,1223,779,87,45,17,480,122,1797
70,31,6932,1248,5684,150,5534,67,1427,1165,635,76,37,16,346,108,1657
70,32,7679,1397,6282,195,6087,64,1782,1519,510,80,40,7,446,122,1517
71,1,7465,1407,6058,155,5903,68,1278,1622,499,62,42,18,404,94,1816
71,2,3707,583,3124,82,3042,63,751,732,328,44,22,7,307,72,716
71,3,6724,1261,5463,208,5255,47,977,1249,533,88,39,18,402,142,1760
71,4,6953,1033,5920,128,5792,159,1028,1494,667,72,40,12,583,135,1602
71,5,12058,2201,9857,219,9638,183,2171,2357,1081,115,69,25,852,182,2603
71,6,12509,2683,9826,169,9657,244,1395,3105,995,88,50,24,882,163,2711
71,7,18898,3145,15753,361,15392,232,3205,3736,1659,193,102,38,1309,291,4627
71,8,9123,1628,7495,161,7334,133,1606,2348,659,67,31,17,708,156,1609
71,9,5105,841,4264,105,4159,80,758,1411,344,53,25,6,532,106,844
71,10,6452,1150,5302,186,5116,75,1082,1451,414,60,30,25,685,139,1155
71,11,5960,1023,4937,138,4799,62,993,1547,338,59,33,16,657,142,952
71,12,7161,1096,6065,108,5957,195,913,1580,808,81,27,16,621,116,1600
71,13,4718,693,4025,102,3923,101,846,963,412,62,30,13,358,81,1057
71,14,12095,2499,9596,179,9417,113,1642,2078,1024,121,45,28,700,146,3520
71,15,4967,883,4084,92,3992,40,966,1010,470,53,32,9,353,98,961
71,16,5543,1083,4460,94,4366,56,1095,1011,489,86,36,15,364,100,1114
71,17,7734,1497,6237,139,6098,68,1315,1286,726,71,56,21,356,136,2063
71,18,3686,689,2997,39,2958,47,728,734,268,49,25,12,209,66,820
71,19,9808,1431,8377,167,8210,143,1533,2589,773,95,30,23,899,182,1943
71,20,8964,1506,7458,169,7289,64,1235,1465,1099,69,61,25,477,161,2633
71,21,2693,467,2226,59,2167,44,451,519,262,26,14,4,240,48,559
71,22,1716,249,1467,54,1413,8,295,429,125,14,6,2,125,31,378
71,23,11086,2025,9061,231,8830,111,1858,2583,810,94,67,14,741,173,2379
71,24,3393,612,2781,59,2722,54,640,664,292,33,19,5,189,69,757
71,25,6651,1076,5575,141,5434,121,1099,1481,647,68,30,18,492,125,1353
71,26,18732,3716,15016,320,14696,330,2372,3844,1681,152,66,45,1434,273,4499
71,27,10047,2211,7836,173,7663,144,1243,2146,837,63,43,16,693,149,2329
71,28,4945,832,4113,87,4026,57,800,1179,400,47,26,9,460,90,958
71,29,2956,538,2418,64,2354,75,498,702,205,26,20,7,267,71,483
71,30,3210,518,2692,66,2626,67,576,715,261,27,28,10,242,49,651
71,31,11781,3410,8371,173,8198,97,1751,1864,1027,94,48,15,463,130,2709
71,32,12243,2406,9837,246,9591,114,2174,2120,1088,125,60,20,700,160,3030
71,33,7068,1328,5740,117,5623,48,1086,1171,690,81,48,10,435,107,1947
71,34,2422,510,1912,40,1872,27,465,492,176,20,19,2,203,31,437
71,35,3088,507,2581,48,2533,31,660,558,287,34,16,5,176,61,705
71,36,2622,380,2242,60,2182,55,427,651,238,33,8,3,215,40,512
71,37,3101,437,2664,61,2603,50,478,716,251,30,16,4,321,56,681
71,38,11277,2320,8957,210,8747,123,1441,2687,835,106,51,21,934,209,2340
71,39,5017,909,4108,81,4027,65,1002,1163,358,40,36,9,330,77,947
71,40,2101,384,1717,47,1670,31,313,461,131,21,16,4,235,44,414
71,41,3327,532,2795,48,2747,82,473,672,365,41,23,7,276,49,759
71,42,4992,803,4189,82,4107,57,1019,1086,336,48,27,5,311,77,1141
71,43,6671,981,5690,153,5537,53,1483,1312,468,89,34,7,462,126,1503
71,44,2990,451,2539,68,2471,53,541,615,204,36,11,3,223,43,742
71,45,4183,630,3553,78,3475,40,839,798,344,48,28,12,251,65,1050
71,46,4229,656,3573,87,3486,82,570,1083,342,33,20,12,414,90,840
71,47,7311,1070,6241,146,6095,116,1322,1577,660,86,37,13,543,133,1608
71,48,9411,1883,7528,180,7348,59,1558,1633,886,110,63,13,523,126,2377
71,49,9056,1979,7077,141,6936,132,1344,1908,758,85,40,10,685,145,1829
71,50,2996,506,2490,56,2434,78,446,768,230,27,18,7,290,45,525
71,51,8173,1225,6948,162,6786,112,1712,1905,595,87,43,15,539,150,1628
71,52,6345,1080,5265,131,5134,81,1004,1540,401,73,21,11,457,97,1449
71,53,13167,2804,10363,250,10113,115,2185,2127,1110,128,60,25,732,190,3441
71,54,8053,2090,5963,137,5826,60,988,1184,659,70,30,15,371,92,2357
71,55,11501,2560,8941,186,8755,238,1217,2772,905,80,31,24,910,174,2404
71,56,9095,2198,6897,143,6754,96,1407,1375,963,97,53,14,397,114,2238
71,57,12708,2962,9746,198,9548,156,1800,2231,1135,111,47,18,746,171,3133
72,1,10829,1547,9282,272,9010,151,2006,2140,1004,153,71,21,798,207,2459
72,2,6271,916,5355,109,5246,91,1158,1578,484,83,37,13,443,120,1239
72,3,4921,990,3931,114,3817,44,923,1124,308,54,24,7,261,77,995
72,4,5354,905,4449,110,4339,63,956,1196,496,81,47,8,330,87,1075
72,5,4713,641,4072,108,3964,56,973,1235,332,60,32,13,384,117,762
72,6,5394,731,4663,102,4561,84,913,1446,478,54,46,17,333,107,1083
72,7,8615,1612,7003,166,6837,139,1402,1941,717,91,54,7,638,164,1684
72,8,7928,986,6942,164,6778,137,1321,2031,683,86,60,17,730,134,1579
72,9,20701,3060,17641,412,17229,293,3668,3998,1931,247,130,40,1598,422,4902
72,10,12378,2211,10167,246,9921,151,2133,2879,837,138,99,31,938,259,2456
72,11,3005,402,2603,45,2558,37,595,780,233,38,18,7,217,66,567
72,12,6214,1065,5149,133,5016,83,1166,1469,430,81,44,14,436,129,1164
72,13,4280,672,3608,106,3502,74,766,909,438,59,30,7,318,90,811
72,14,15473,2926,12547,343,12204,231,2247,3482,1055,181,111,22,1155,286,3434
72,15,6350,841,5509,135,5374,96,1060,1643,502,88,39,11,534,132,1269
72,16,6755,1157,5598,150,5448,66,1238,1629,518,83,53,10,432,117,1302
72,17,7782,1165,6617,172,6445,78,1477,1726,632,108,65,15,557,147,1640
72,18,8889,1649,7240,157,7083,99,1599,2032,591,93,55,14,579,203,1818
72,19,13307,3348,9959,190,9769,332,973,3257,1052,87,38,17,1145,132,2736
72,20,11860,3503,8357,199,8158,204,1174,1468,1143,89,59,27,652,115,3227
72,21,14310,2783,11527,307,11220,342,1149,3317,1128,91,28,26,1298,184,3657
72,22,4937,822,4115,103,4012,64,1028,1160,302,60,45,7,320,96,930
72,23,6928,1131,5797,153,5644,90,1467,1461,590,80,46,17,416,138,1339
72,24,16007,2263,13744,294,13450,187,3066,3280,1520,206,101,37,1068,334,3651
72,25,3193,523,2670,44,2626,49,614,888,202,34,20,5,232,69,513
72,26,9063,1367,7696,199,7497,102,1782,1673,943,114,66,13,618,173,2013
72,27,18763,3486,15277,400,14877,288,2806,4911,1206,195,118,36,1436,332,3549
72,28,7581,1367,6214,175,6039,66,1273,1621,634,121,73,19,568,148,1516
72,29,8626,1177,7449,169,7280,114,1497,2036,664,100,46,18,772,166,1867
72,30,5728,1145,4583,116,4467,79,971,1425,332,79,36,7,450,117,971
72,31,16697,2278,14419,303,14116,258,2876,3135,1742,193,107,37,1341,305,4122
72,32,5664,929,4735,113,4622,70,1169,1240,409,88,55,15,340,131,1105
72,33,4506,686,3820,111,3709,43,874,1067,329,71,45,6,340,81,853
72,34,24470,4416,20054,500,19554,511,2684,4972,2260,212,102,41,2053,411,6308
72,35,16027,3945,12082,384,11698,166,2324,2068,1694,144,105,29,812,182,4174
72,36,11553,2513,9040,204,8836,156,1529,1724,1311,104,61,17,651,140,3143
72,37,22507,3605,18902,421,18481,373,3223,5145,1842,171,103,45,1700,365,5514
72,38,14763,2891,11872,284,11588,258,1507,3011,1316,134,67,20,1186,222,3867
72,39,11576,2414,9162,265,8897,257,1076,1985,1260,97,53,11,865,128,3165
72,40,12940,2455,10485,255,10230,171,1853,2092,1595,131,63,25,858,179,3263
73,1,4723,788,3935,68,3867,83,1006,727,712,50,22,10,262,93,902
73,2,8172,1374,6798,128,6670,293,1005,2245,752,101,47,15,718,179,1315
73,3,12183,2774,9409,160,9249,276,1553,3394,750,71,35,30,977,185,1978
73,4,6344,950,5394,118,5276,194,1133,1482,472,66,17,13,624,123,1152
73,5,10390,1948,8442,192,8250,244,1678,2345,990,103,33,19,800,167,1871
73,6,3732,500,3232,57,3175,119,637,903,337,49,23,11,378,83,635
73,7,11489,2262,9227,224,9003,404,1462,3353,918,136,50,36,842,248,1554
73,8,7451,1117,6334,375,5959,225,847,2609,550,62,29,11,495,131,1000
73,9,8721,1745,6976,138,6838,247,1145,1381,1057,73,34,17,566,92,2226
73,10,7938,1413,6525,105,6420,307,707,1800,838,96,27,14,645,97,1889
73,11,5941,1014,4927,105,4822,98,1155,1312,591,59,29,16,364,98,1100
73,12,4036,558,3478,89,3389,115,756,757,538,46,19,11,291,81,775
73,13,3985,626,3359,81,3278,169,557,881,509,41,23,16,305,66,711
73,14,4285,650,3635,61,3574,180,896,809,436,63,19,13,378,91,689
73,15,6460,931,5529,120,5409,177,1339,1253,641,79,34,11,480,107,1288
73,16,2499,418,2081,53,2028,74,384,724,214,32,14,9,208,62,307
73,17,4461,856,3605,74,3531,108,689,906,370,44,27,5,287,112,983
73,18,10856,1523,9333,169,9164,304,1845,2384,1023,119,55,23,857,199,2355
73,19,11816,1530,10286,159,10127,330,1702,3202,1037,97,25,32,1255,185,2262
73,20,12175,2190,9985,233,9752,276,1794,3109,1239,141,58,25,865,192,2053
73,21,7331,1158,6173,125,6048,160,1281,1633,719,54,44,21,604,153,1379
73,22,5946,940,5006,90,4916,145,1078,1217,609,68,38,21,421,113,1206
73,23,3930,581,3349,98,3251,81,741,836,349,55,11,8,325,87,758
73,24,4953,756,4197,82,4115,121,850,1197,442,39,17,11,419,92,927
73,25,11523,2070,9453,180,9273,245,2058,2430,994,105,49,31,760,198,2403
73,26,4566,829,3737,73,3664,97,785,949,395,67,29,14,311,81,936
73,27,4804,733,4071,81,3990,148,754,1010,578,54,18,6,378,72,972
73,28,8439,1593,6846,162,6684,183,1534,1934,773,81,34,11,671,187,1276
73,29,5385,757,4628,95,4533,161,1115,1255,432,44,27,14,418,100,967
73,30,13048,2613,10435,203,10232,237,2380,2227,1593,128,57,26,840,206,2538
73,31,9870,1837,8033,176,7857,298,1063,1996,1011,99,27,17,799,132,2415
73,32,12427,1992,10435,185,10250,377,1888,3179,923,95,39,29,1144,198,2378
73,33,15762,2271,13491,232,13259,465,2242,3937,1291,132,54,37,1562,275,3264
73,34,12662,1937,10725,208,10517,427,1864,2792,1250,113,39,19,1093,204,2716
73,35,13428,2353,11075,195,10880,341,1873,3577,929,93,41,27,1249,210,2540
73,36,7113,1363,5750,88,5662,271,843,1519,727,59,29,12,541,95,1566
73,37,9941,1588,8353,150,8203,333,1354,2280,886,76,40,23,902,126,2183
74,1,3980,732,3248,58,3190,62,732,1388,194,32,13,8,308,97,356
74,2,9296,1317,7979,133,7846,313,1439,2266,807,74,35,21,1009,216,1666
74,3,11020,2401,8619,96,8523,405,900,3021,720,79,29,21,1140,123,2085
74,4,12393,2583,9810,144,9666,316,1328,2983,899,99,43,27,1233,165,2573
74,5,22902,5620,17282,322,16960,556,2702,5834,1557,175,78,65,1915,352,3726
74,6,5235,916,4319,82,4237,143,598,2003,356,53,20,8,408,94,554
74,7,5449,848,4601,89,4512,194,824,1416,447,55,25,15,550,134,852
74,8,23714,4640,19074,389,18685,577,3791,5983,1794,198,112,52,1898,430,3850
74,9,10439,2305,8134,143,7991,429,854,3120,751,99,40,30,964,160,1544
74,10,14402,3223,11179,187,10992,255,2238,3798,993,133,65,38,960,229,2283
74,11,7850,1188,6662,129,6533,286,1011,2212,561,80,19,19,971,222,1152
74,12,17066,3377,13689,248,13441,463,2199,4943,1196,182,73,37,1695,362,2291
74,13,22479,4307,18172,384,17788,522,3117,5919,1795,272,93,50,1982,446,3592
74,14,10694,1660,9034,171,8863,325,1835,2540,945,111,46,17,951,224,1869
74,15,5911,934,4977,98,4879,155,927,1586,420,77,15,27,651,139,882
74,16,13357,2138,11219,208,11011,466,1995,3478,1043,134,34,41,1505,307,2008
74,17,16464,2612,13852,310,13542,524,2501,4220,1303,169,58,43,1616,337,2771
74,18,19202,3123,16079,301,15778,555,3537,4522,1402,180,84,41,1755,426,3276
74,19,13344,2741,10603,224,10379,408,1882,3277,1238,121,62,34,1080,225,2052
74,20,8314,1388,6926,148,6778,264,1487,1968,756,79,34,27,685,192,1286
74,21,21817,4570,17247,300,16947,839,2298,6186,1350,175,73,57,2375,427,3167
74,22,20257,3893,16364,287,16077,512,2697,7014,1182,148,50,54,1650,342,2428
74,23,3726,612,3114,58,3056,119,487,1205,304,45,8,5,311,85,487
74,24,4734,716,4018,65,3953,146,885,1178,371,50,24,12,452,108,727
74,25,5866,973,4893,68,4825,161,863,1859,474,68,26,12,456,89,817
74,26,11545,1506,10039,182,9857,378,1408,4521,671,111,46,25,1153,301,1243
74,27,15308,3366,11942,263,11679,356,1852,3850,1201,157,66,39,1280,311,2567
74,28,8919,1140,7779,135,7644,364,1200,2409,703,67,27,35,1078,206,1555
74,29,33162,5455,27707,465,27242,945,4474,8315,2508,317,101,76,3436,589,6481
74,30,31729,5309,26420,411,26009,1035,3011,10545,1829,187,80,79,3621,468,5154
74,31,25064,6293,18771,268,18503,541,3039,5783,1981,175,86,60,1841,392,4605
74,32,7891,1757,6134,111,6023,120,1298,2083,536,88,35,15,584,158,1106
74,33,35334,6157,29177,503,28674,1042,4068,8978,2751,305,99,94,3726,542,7069
74,34,25811,5516,20295,363,19932,670,3106,6543,2079,219,94,58,2308,447,4408
75,15,10490,2068,8422,83,8339,364,491,3278,660,39,10,22,853,76,2546
75,16,12364,2551,9813,110,9703,509,444,3015,993,38,17,27,995,70,3595
75,17,21101,4084,17017,192,16825,947,708,4793,1710,89,35,29,1641,125,6748
75,18,17384,3347,14037,158,13879,675,800,4511,1350,81,41,31,1341,162,4887
75,19,36051,6493,29558,321,29237,1403,1561,9164,3001,177,83,73,3123,295,10357
75,20,25916,4718,21198,243,20955,746,985,9358,1249,90,33,47,2420,196,5831
75,21,31093,5680,25413,243,25170,579,1338,14644,875,81,19,49,2729,233,4623
75,22,23630,4596,19034,204,18830,449,1106,10975,772,73,15,49,1905,179,3307
75,23,35826,6903,28923,340,28583,1347,1396,9496,2667,149,65,52,3101,262,10048
75,24,49812,9744,40068,436,39632,2324,2099,8234,5901,304,126,80,3353,319,16892
75,25,85380,15769,69611,792,68819,3746,3379,15353,9703,494,171,166,6174,609,29024
75,26,87785,16790,70995,882,70113,3056,4882,19374,8166,492,191,145,7172,832,25803
75,27,106763,21555,85208,1243,83965,3620,6237,18784,11383,732,305,205,7873,1000,33826
75,28,81440,15748,65692,844,64848,2842,4141,17575,7433,466,189,162,6792,746,24502
75,29,136521,26281,110240,1303,108937,3404,7144,43531,8002,597,203,256,12528,1264,32008
75,30,91778,18285,73493,654,72839,1268,4062,47233,2324,190,61,144,6281,693,10583
75,31,92854,18146,74708,847,73861,2253,4671,32728,5353,372,142,161,7563,720,19898
75,32,101049,21687,79362,1030,78332,4238,5150,15253,12019,716,318,195,6059,675,33709
75,33,96890,21620,75270,1000,74270,3465,4990,16692,11690,653,322,166,4949,670,30673
75,34,109195,22690,86505,1168,85337,4260,5919,15491,14850,811,373,213,5812,833,36775
76,1,4150,663,3487,46,3441,65,950,1039,284,30,22,8,297,82,664
76,2,5346,907,4439,86,4353,40,1219,1526,265,45,34,13,302,103,806
76,3,8872,1371,7501,120,7381,73,1479,2072,731,74,65,9,543,142,2193
76,4,5687,840,4847,94,4753,58,1204,1345,437,54,40,26,405,103,1081
76,5,8070,1403,6667,123,6544,65,1747,1423,593,79,68,8,336,135,2090
76,6,17551,3401,14150,284,13866,145,3040,3224,1839,269,141,35,1038,313,3822
76,7,30243,4801,25442,427,25015,439,3648,7850,2683,267,101,64,2826,468,6669
76,8,8052,1130,6922,137,6785,140,1402,2178,620,73,47,19,653,172,1481
76,9,7286,1116,6170,120,6050,54,1183,1719,627,79,47,15,488,138,1700
76,10,10424,1338,9086,152,8934,133,1826,1988,1026,126,69,27,721,168,2850
76,11,17470,2662,14808,300,14508,240,2864,4373,1590,175,94,33,1273,297,3569
76,12,12286,1739,10547,185,10362,171,2089,3233,1284,148,59,22,886,180,2290
76,13,20111,3111,17000,285,16715,307,3108,4515,2053,196,95,40,1540,339,4522
76,14,13796,2735,11061,214,10847,148,2330,2424,1726,125,83,22,750,190,3049
76,15,6155,975,5180,97,5083,61,1120,1320,492,79,45,7,412,89,1458
76,16,19567,3231,16336,280,16056,254,3220,3712,1961,205,128,40,1218,323,4995
76,17,17705,4054,13651,273,13378,161,2661,2684,1678,197,102,34,765,264,4832
76,18,13261,2030,11231,194,11037,102,2857,2902,1143,141,91,31,781,244,2745
76,19,20214,3865,16349,285,16064,148,3711,3953,2309,202,140,40,1004,317,4240
76,20,6569,808,5761,145,5616,58,1110,1659,582,88,52,13,423,89,1542
76,21,21471,4610,16861,295,16566,283,3285,4032,2046,239,138,53,1132,283,5075
76,22,3738,556,3182,39,3143,32,575,924,307,35,30,10,210,43,977
76,23,8517,1723,6794,147,6647,103,1793,2108,491,83,51,9,535,165,1309
76,24,10774,1565,9209,188,9021,114,2063,2479,1051,152,88,17,738,184,2135
76,25,9515,1836,7679,187,7492,90,2169,2099,665,99,58,25,557,207,1523
76,26,20655,3790,16865,341,16524,218,3125,2936,2740,210,102,27,1087,254,5825
76,27,10382,2472,7910,150,7760,156,1050,2633,1014,94,37,13,648,96,2019
76,29,11842,3871,7971,199,7772,98,1709,1186,1630,120,70,25,345,95,2494
76,30,14960,4156,10804,287,10517,151,2149,2008,1954,137,88,25,667,158,3180
76,31,10047,2273,7774,177,7597,243,794,2274,1110,79,32,19,742,129,2175
76,32,18302,4672,13630,338,13292,314,2053,3825,1949,159,83,28,1133,192,3556
76,33,21084,4468,16616,306,16310,197,3381,3726,2149,260,121,53,1319,333,4771
76,34,3940,662,3278,78,3200,27,902,1032,207,37,37,7,265,74,612
76,35,6182,885,5297,110,5187,62,1211,1447,522,54,45,13,355,102,1376
76,36,16391,3341,13050,239,12811,191,2334,2321,1770,176,91,24,817,186,4901
76,37,27305,4742,22563,417,22146,347,4110,6040,2729,292,145,62,2019,408,5994
76,38,8920,1562,7358,143,7215,97,1658,2329,630,86,65,18,576,163,1593
76,39,14575,2303,12272,205,12067,172,2196,3520,1655,118,88,28,869,230,3191
76,40,3711,519,3192,61,3131,40,657,935,282,46,29,11,296,52,783
76,41,23157,4071,19086,366,18720,220,4123,4026,2145,270,152,40,1460,368,5916
76,42,10398,2133,8265,125,8140,274,802,2370,1083,89,28,26,750,129,2589
76,43,6915,1276,5639,70,5569,203,343,1937,670,50,13,18,664,77,1594
76,44,6586,1323,5263,79,5184,177,503,1324,689,59,25,15,567,73,1752
76,45,5912,1145,4767,84,4683,156,601,1033,728,59,18,15,381,49,1643
76,46,7741,1870,5871,91,5780,177,618,1573,713,51,40,18,518,65,2007
76,47,12798,2603,10195,153,10042,291,1369,2010,1574,120,58,24,823,160,3613
76,48,15116,2367,12749,242,12507,181,2738,3365,1599,174,73,30,1114,269,2964
76,49,6250,910,5340,103,5237,72,1339,1463,529,77,42,14,421,130,1150
76,50,7425,1395,6030,117,5913,70,1033,1703,648,80,43,16,500,127,1693
76,51,15149,2975,12174,225,11949,160,1993,1845,2214,135,67,23,678,176,4658
76,52,9589,1392,8197,134,8063,117,1920,2186,666,116,50,20,618,201,2169
76,53,8568,1284,7284,146,7138,86,1558,2112,756,84,64,18,485,138,1837
76,54,8023,1045,6978,130,6848,104,1471,1929,631,88,61,17,589,148,1810
76,55,15469,2630,12839,226,12613,227,2214,3342,1309,166,90,35,1148,222,3860
76,56,17853,3571,14282,309,13973,329,1957,4595,1760,168,73,38,1255,225,3573
76,57,15298,4147,11151,322,10829,162,2117,2212,1822,153,98,17,700,168,3380
76,58,7314,2227,5087,143,4944,45,864,791,891,56,46,13,280,59,1899
76,59,12497,3827,8670,220,8450,70,1775,1316,1529,136,60,14,422,126,3002
76,60,19250,3568,15682,190,15492,412,1480,5938,1308,127,59,33,1809,245,4081
76,61,19301,4163,15138,301,14837,164,2979,2739,2387,213,102,36,958,243,5016
76,62,13643,3253,10390,220,10170,184,1696,2629,1834,119,100,26,724,140,2718
76,63,13777,2699,11078,188,10890,124,2424,1457,2957,175,103,12,518,147,2973
76,64,14846,2304,12542,282,12260,110,2331,1938,1677,198,97,32,703,185,4989
76,65,19884,3955,15929,225,15704,427,1930,4785,1779,124,64,27,1574,258,4736
76,66,19787,3581,16206,302,15904,265,2919,3964,1944,169,103,39,1351,277,4873
76,67,12597,2591,10006,198,9808,184,1850,1486,1590,150,73,17,625,157,3676
76,68,7249,1450,5799,89,5710,190,715,1189,851,72,31,13,446,81,2122
76,69,15029,2819,12210,217,11993,159,2112,1737,2984,161,77,28,641,141,3953
76,70,13618,2534,11084,219,10865,219,1660,2037,1668,151,87,24,753,151,4115
77,1,9216,1876,7340,130,7210,97,1945,2017,685,94,46,20,515,201,1590
77,2,28610,6416,22194,359,21835,406,4253,7049,1951,189,93,49,2015,601,5229
77,3,9790,1766,8024,120,7904,206,1546,2743,686,60,37,27,794,195,1610
77,4,9674,2137,7537,147,7390,136,1871,1942,767,102,49,24,589,189,1721
77,5,11219,1867,9352,146,9206,210,1947,2701,903,77,34,24,865,232,2213
77,6,30048,7296,22752,354,22398,413,4681,6143,2598,185,92,66,1716,442,6062
77,7,26315,5904,20411,349,20062,353,4927,5858,1916,239,110,45,1610,463,4541
77,8,23390,4573,18817,307,18510,371,4009,5808,1857,211,92,48,1641,379,4094
77,9,29935,5909,24026,446,23580,298,6298,6102,2582,268,102,49,1741,435,5705
77,10,7597,1261,6336,118,6218,102,1689,1771,644,65,29,9,441,150,1318
77,11,10686,2150,8536,152,8384,121,2399,2493,708,97,43,13,639,207,1664
77,12,18149,4012,14137,229,13908,253,3435,3917,1462,168,68,35,1020,362,3188
77,13,30430,6550,23880,284,23596,735,3032,8108,2204,196,96,68,2719,492,5946
77,14,19810,4402,15408,224,15184,360,2368,4400,1710,122,45,37,1638,313,4191
77,15,11279,2337,8942,146,8796,111,2382,2581,959,105,47,19,550,181,1861
77,16,8314,1503,6811,146,6665,134,1635,1928,700,95,29,16,525,182,1421
77,17,26566,5906,20660,351,20309,300,4023,5497,2070,208,107,36,1402,345,6321
77,18,21710,5204,16506,318,16188,268,3058,3948,1771,131,85,50,1288,349,5240
77,19,12678,2827,9851,161,9690,252,1559,2871,974,76,41,31,1028,222,2636
77,20,20995,4810,16185,359,15826,248,3551,3638,2053,171,90,38,1014,291,4732
77,21,24346,4806,19540,337,19203,535,3441,5214,2189,228,88,56,1813,404,5235
77,22,15803,2990,12813,240,12573,190,3319,3217,1312,152,66,30,972,327,2988
77,23,11058,2337,8721,169,8552,97,2388,2287,901,99,44,16,625,215,1880
77,24,20529,4283,16246,303,15943,317,3267,4403,1758,175,95,30,1322,352,4224
77,25,13732,3166,10566,190,10376,129,2514,2886,1015,109,64,16,728,231,2684
77,26,9546,1846,7700,139,7561,156,2038,2133,814,95,50,29,604,199,1443
77,27,17296,3429,13867,245,13622,271,3290,4098,1364,165,79,21,1126,393,2815
77,28,17386,3843,13543,235,13308,279,2846,3776,1390,145,53,30,1198,308,3283
77,29,5887,1010,4877,78,4799,90,1294,1508,370,53,24,18,371,141,930
77,30,21187,5210,15977,247,15730,327,2614,4125,1851,121,73,44,1348,239,4988
77,31,21364,4772,16592,324,16268,270,3269,4611,1688,147,72,45,1284,283,4599
77,32,33268,7531,25737,392,25345,517,4486,7800,2594,256,124,74,2315,554,6625
77,33,28153,6581,21572,386,21186,405,3336,5712,2427,202,93,50,1940,472,6549
77,34,21687,5478,16209,406,15803,324,2408,2958,2144,174,76,38,1213,362,6106
77,35,31094,7267,23827,392,23435,526,2935,6322,2625,193,83,60,2346,429,7916
77,36,20971,4915,16056,279,15777,289,2843,3682,2064,174,77,40,1196,271,5141
77,37,16608,3709,12899,245,12654,181,2985,2973,1994,142,64,19,868,221,3207
77,38,19120,4391,14729,278,14451,365,1957,3204,2042,137,60,36,1345,256,5049
77,39,16949,4458,12491,222,12269,323,1218,2455,1721,125,49,36,958,171,5213
77,40,21012,4949,16063,284,15779,280,2552,4145,1810,184,51,44,1427,323,4963
77,41,31686,7917,23769,536,23233,453,3849,4659,3021,207,101,59,1947,666,8271
77,42,24158,5438,18720,297,18423,387,3027,4341,2188,192,83,64,1692,427,6022
77,43,34422,7365,27057,408,26649,599,4405,8092,2615,250,91,95,2799,580,7123
78,1,21813,4553,17260,296,16964,308,3163,5537,1491,161,65,51,1584,373,4231
78,2,17708,3118,14590,284,14306,280,3345,4336,1409,157,96,40,1138,311,3194
78,3,20110,4484,15626,213,15413,397,1338,6606,1058,89,39,37,1840,185,3824
78,4,26795,5481,21314,279,21035,617,1806,9212,1297,121,43,66,2868,297,4708
78,5,35634,6447,29187,424,28763,931,2751,10250,2450,183,82,89,3917,555,7555
78,6,23783,5299,18484,312,18172,563,2672,4473,2015,176,98,45,1814,289,6027
78,7,14190,2539,11651,176,11475,218,2357,3713,1040,107,44,33,1111,227,2625
78,8,18927,3150,15777,226,15551,356,2583,5671,1256,187,57,57,1683,352,3349
78,9,29718,6601,23117,321,22796,694,2633,6759,2272,196,72,60,2782,372,6956
78,10,29019,5780,23239,430,22809,379,4914,6048,2796,239,122,61,1776,464,6010
78,11,21290,4769,16521,243,16278,507,1474,7110,915,96,22,51,2189,281,3633
78,12,20869,5992,14877,287,14590,266,1682,2961,2031,113,52,36,908,172,6369
78,13,20257,4038,16219,187,16032,459,1498,6634,1070,104,27,45,2084,250,3861
78,14,29671,7867,21804,398,21406,386,3441,5006,2575,205,104,46,1683,359,7601
78,15,32304,5272,27032,404,26628,805,3417,10048,1996,206,77,69,3210,584,6216
78,16,28973,6578,22395,341,22054,530,2602,7574,1981,160,74,47,2487,337,6262
78,17,14329,3295,11034,163,10871,214,1284,4217,887,73,30,17,1101,157,2891
78,18,38794,7146,31648,485,31163,845,4272,10379,2912,250,111,103,3690,663,7938
78,19,16095,2526,13569,209,13360,381,2012,4349,1278,124,65,40,1452,307,3352
78,20,26142,6437,19705,284,19421,474,2226,7068,2086,135,68,46,2117,295,4906
78,21,18210,4163,14047,184,13863,362,1415,5796,982,74,44,45,1620,221,3304
78,22,26933,5261,21672,265,21407,503,1726,10411,1184,123,50,48,2778,335,4249
78,23,28941,7178,21763,349,21414,478,2743,5459,2595,207,97,79,2007,354,7395
78,24,13488,3642,9846,220,9626,118,940,1221,1724,89,63,24,518,127,4802
78,25,24566,5202,19364,283,19081,460,2530,6648,1622,134,75,59,2255,348,4950
78,26,21179,4272,16907,210,16697,331,1682,7773,1028,84,31,39,1993,274,3462
78,27,19074,3683,15391,150,15241,375,1394,8189,597,58,17,28,1866,208,2509
78,28,41689,9075,32614,560,32054,1005,3051,7855,3615,298,115,81,4271,549,11214
78,29,27451,5719,21732,308,21424,621,2671,8101,1462,134,49,71,2955,340,5020
78,30,21791,4284,17507,206,17301,497,1527,7939,1033,84,28,43,2225,274,3651
78,31,10894,2045,8849,115,8734,350,578,3218,645,60,19,29,1368,128,2339
78,32,22731,4269,18462,182,18280,343,1597,9751,864,77,31,44,2090,243,3240
78,33,21185,4971,16214,300,15914,274,3275,3558,2019,157,111,54,1198,253,5015
78,34,35928,8185,27743,458,27285,613,3119,7121,3242,277,110,64,3006,456,9277
78,35,16696,3592,13104,160,12944,367,1169,5527,878,86,31,39,1685,169,2993
78,36,27417,5947,21470,340,21130,487,2496,6323,2206,172,74,71,2475,440,6386
78,37,14177,2832,11345,192,11153,261,1481,3776,1040,113,44,41,1194,232,2971
78,38,30935,6703,24232,392,23840,561,2861,6096,2671,271,111,76,2630,448,8115
78,39,16913,3845,13068,230,12838,358,1766,3615,1298,140,57,34,1280,205,4085
79,1,3971,611,3360,98,3262,43,544,883,343,44,31,6,331,65,972
79,2,7532,1248,6284,163,6121,99,992,1943,521,94,62,20,764,149,1477
79,3,4016,569,3447,63,3384,57,495,750,347,85,33,7,369,85,1156
79,4,16389,2706,13683,346,13337,267,1633,3763,1128,207,108,32,1850,280,4069
79,5,5086,838,4248,103,4145,92,625,1047,452,90,29,8,424,102,1276
79,6,8716,1286,7430,175,7255,117,930,1304,921,155,61,17,668,154,2928
79,7,10491,1542,8949,291,8658,168,1085,2283,710,144,77,20,1076,189,2906
79,8,4450,600,3850,90,3760,94,495,850,389,75,31,7,435,87,1297
79,9,12155,1685,10470,268,10202,137,1548,3431,753,145,75,19,1474,283,2337
79,10,4508,781,3727,108,3619,51,607,920,327,72,19,10,295,72,1246
79,11,8043,1224,6819,173,6646,148,990,1636,688,111,37,24,757,195,2060
79,12,8124,1105,7019,126,6893,166,940,1506,763,89,42,12,730,164,2481
79,13,4515,772,3743,99,3644,79,620,898,313,73,33,10,389,75,1154
79,14,5434,821,4613,96,4517,115,770,974,561,80,35,12,452,131,1387
79,15,5195,808,4387,110,4277,114,633,1103,494,62,29,11,548,118,1165
79,16,6962,1087,5875,139,5736,130,721,1193,671,90,46,18,518,107,2242
79,17,3688,524,3164,69,3095,57,541,876,330,37,22,10,323,64,835
79,18,8305,1171,7134,211,6923,101,883,2211,500,122,46,28,966,154,1912
79,19,4022,626,3396,81,3315,77,558,721,351,65,26,10,326,70,1111
79,20,23775,4007,19768,417,19351,487,1844,4355,2247,263,108,44,2188,323,7492
79,21,17781,3643,14138,247,13891,361,1514,3192,1646,182,78,31,1341,248,5298
79,22,15577,2558,13019,326,12693,266,1561,3322,1226,181,104,22,1348,257,4406
79,23,11071,1502,9569,194,9375,171,1079,1950,1027,132,63,29,1025,219,3680
79,24,3162,401,2761,71,2690,39,511,742,241,39,18,8,265,62,765
79,25,11858,1864,9994,250,9744,176,1398,2066,1009,159,75,51,1047,254,3509
79,26,7204,1052,6152,144,6008,92,1053,1511,619,97,39,9,532,152,1904
79,27,4259,700,3559,101,3458,56,576,925,303,81,29,13,376,80,1019
79,28,4183,714,3469,85,3384,56,611,818,373,44,32,1,282,79,1088
79,29,5364,769,4595,138,4457,83,631,1410,411,97,36,12,562,112,1103
79,30,3301,449,2852,75,2777,62,496,870,219,50,17,12,296,68,687
79,31,8567,1557,7010,173,6837,123,1058,1782,633,116,48,17,656,184,2220
79,32,10268,1729,8539,195,8344,116,1277,2073,885,151,62,22,748,218,2792
79,33,12739,2647,10092,175,9917,280,858,2154,1308,118,61,15,1034,152,3937
80,1,12920,3042,9878,198,9680,106,2194,2454,1069,93,85,16,642,179,2842
80,2,10953,2534,8419,185,8234,99,1966,1873,925,95,74,12,524,171,2495
80,3,5064,723,4341,65,4276,41,1075,1229,375,53,27,16,355,99,1006
80,4,5876,780,5096,103,4993,39,1350,1326,447,57,38,6,338,120,1272
80,5,6117,885,5232,85,5147,70,1276,1348,498,97,41,16,412,110,1279
80,6,13268,2418,10850,201,10649,91,2596,2241,1271,169,90,19,874,201,3097
80,7,11661,3136,8525,147,8378,106,1856,1580,1129,87,58,24,552,145,2841
80,8,7644,1934,5710,104,5606,73,1315,962,745,75,51,10,346,81,1948
80,9,10952,2472,8480,146,8334,198,1644,1736,1094,83,59,23,637,135,2725
80,10,15796,3046,12750,187,12563,235,2240,2316,2047,161,86,22,938,203,4315
80,11,8453,1433,7020,164,6856,49,1669,1613,1100,97,70,14,350,153,1741
80,12,4174,561,3613,64,3549,32,961,943,264,46,40,5,245,62,951
80,13,15138,2107,13031,209,12822,217,2420,3641,1202,121,76,22,1369,260,3494
80,14,5005,671,4334,75,4259,36,1178,1019,434,56,31,7,292,87,1119
80,15,5317,827,4490,87,4403,46,1284,1133,324,58,51,7,288,100,1112
80,16,3302,491,2811,54,2757,18,804,734,270,36,29,6,179,83,598
80,17,7270,977,6293,118,6175,91,1539,1743,534,79,63,17,569,96,1444
80,18,16123,2819,13304,267,13037,165,3296,2733,1397,184,109,41,960,282,3870
80,19,4932,801,4131,76,4055,32,1096,1164,336,48,43,10,311,80,935
80,20,8339,1250,7089,113,6976,56,2027,1311,713,81,63,10,408,151,2156
80,21,9948,1977,7971,152,7819,72,2129,1742,766,110,86,18,577,166,2153
80,22,9732,1362,8370,200,8170,59,1832,1834,1093,132,100,22,436,167,2495
80,23,5997,813,5184,107,5077,44,1418,1239,491,54,39,15,344,121,1312
80,24,9239,1784,7455,119,7336,66,1995,1665,740,127,95,27,442,161,2018
80,25,4593,724,3869,72,3797,27,993,1020,357,45,43,14,285,89,924
80,26,8086,1234,6852,110,6742,70,1655,1877,560,78,50,17,577,142,1716
80,27,9237,1710,7527,150,7377,67,1955,1670,742,126,71,21,568,151,2006
80,28,9364,1566,7798,147,7651,89,2091,1851,775,92,75,18,520,173,1967
80,29,7497,1020,6477,148,6329,42,1539,1423,745,84,60,11,399,118,1908
80,30,6071,951,5120,83,5037,43,1397,1076,598,96,85,15,285,101,1341
80,31,6551,1002,5549,96,5453,52,1465,1535,452,59,51,8,296,134,1401
80,32,5003,740,4263,71,4192,29,1113,1040,372,54,53,7,280,92,1152
80,33,12370,2546,9824,176,9648,90,2397,2392,919,150,99,20,662,244,2675
80,34,13921,2253,11668,176,11492,114,3110,2448,1474,153,96,17,689,184,3207
80,35,5819,861,4958,76,4882,60,1190,1440,332,73,39,16,418,150,1164
80,36,5970,988,4982,73,4909,32,1601,1054,513,68,66,5,277,102,1191
80,37,6643,1133,5510,83,5427,62,1481,1175,497,86,62,9,335,137,1583
80,38,9727,1929,7798,131,7667,66,2076,1732,712,120,69,21,526,185,2160
80,39,9918,1797,8121,158,7963,67,2260,2534,573,79,60,24,517,153,1696
80,40,9125,1543,7582,147,7435,72,2006,1828,835,90,93,17,438,184,1872
80,41,10217,1303,8914,159,8755,136,2014,2420,765,104,41,17,789,180,2289
80,42,14863,3192,11671,177,11494,254,1582,2963,1352,120,93,29,1182,186,3733
80,43,10561,2137,8424,116,8308,223,784,3042,815,64,22,20,968,130,2240
80,44,11822,2621,9201,145,9056,245,1554,2238,1121,109,61,17,839,166,2706
80,45,9527,2753,6774,108,6666,101,1147,985,945,67,43,7,425,80,2866
80,46,9339,1449,7890,184,7706,49,1680,1358,1495,106,81,11,403,159,2364
81,1,2360,336,2024,37,1987,34,362,516,189,24,19,6,314,26,497
81,2,7468,1332,6136,137,5999,143,796,1579,718,64,23,13,560,73,2030
81,3,665,111,554,8,546,16,130,146,48,7,0,0,79,7,113
81,4,2903,418,2485,61,2424,48,531,645,219,40,25,11,323,40,542
81,5,3589,408,3181,72,3109,63,628,659,365,40,9,4,329,48,964
81,6,6922,1057,5865,116,5749,63,1040,720,1040,81,35,11,327,57,2375
81,7,3027,397,2630,69,2561,100,440,617,407,36,20,6,251,41,643
81,8,9288,1698,7590,138,7452,153,1423,1783,802,95,29,19,639,119,2390
81,9,3086,456,2630,52,2578,112,433,661,276,40,19,6,276,58,697
81,10,2002,233,1769,39,1730,64,317,386,250,16,11,3,183,27,473
81,11,7630,960,6670,142,6528,129,1357,1560,730,85,36,18,608,128,1877
81,12,17101,2866,14235,284,13951,328,2716,3339,1866,160,75,33,1279,216,3939
81,13,12316,2214,10102,232,9870,149,2204,2313,1103,119,54,22,645,114,3147
81,14,9968,1343,8625,191,8434,144,1913,1947,945,115,43,17,708,147,2455
81,15,3003,439,2564,87,2477,45,442,685,227,36,14,6,253,52,717
81,16,3816,403,3413,89,3324,86,682,883,343,51,15,4,392,57,811
81,17,19697,2788,16909,334,16575,464,2751,3956,2235,210,83,51,1481,290,5054
81,18,4465,607,3858,95,3763,88,708,861,560,55,18,10,356,82,1025
81,19,10831,1878,8953,194,8759,123,1996,2414,808,112,47,18,747,155,2339
81,20,2418,276,2142,37,2105,59,358,348,327,34,12,9,196,32,730
81,21,2146,237,1909,56,1853,38,286,488,208,22,11,3,235,31,531
81,22,1618,255,1363,41,1322,13,271,409,105,14,9,3,164,25,309
81,23,3395,444,2951,69,2882,49,471,515,395,41,9,6,273,41,1082
81,24,5919,731,5188,137,5051,122,1155,1081,607,67,37,12,548,75,1347
81,25,7145,950,6195,81,6114,243,1036,1274,894,93,47,9,539,111,1868
81,26,7362,825,6537,173,6364,151,1297,1500,691,86,34,12,740,128,1725
81,27,5289,615,4674,116,4558,78,1107,1383,413,56,24,14,436,79,968
81,28,5295,787,4508,121,4387,88,1042,962,505,63,36,18,381,77,1215
81,29,3622,417,3205,69,3136,88,535,706,412,52,14,8,286,69,966
81,30,2353,353,2000,35,1965,65,437,422,312,27,8,5,167,32,490
81,31,1993,296,1697,60,1637,46,250,337,189,42,12,4,248,35,474
81,32,2727,292,2435,63,2372,65,443,422,277,26,10,9,241,55,824
81,33,2833,411,2422,39,2383,40,434,600,231,30,6,9,231,48,754
81,34,1411,201,1210,27,1183,66,191,216,206,20,6,4,93,21,360
81,35,4814,563,4251,104,4147,73,946,939,491,64,26,9,402,90,1107
81,36,10470,1227,9243,263,8980,142,1660,1714,1137,106,35,27,824,133,3202
81,37,9592,1422,8170,185,7985,168,1463,1562,1160,87,39,18,639,135,2714
81,38,9777,1408,8369,187,8182,175,1297,1993,960,94,23,16,795,124,2705
81,39,5967,955,5012,103,4909,62,912,669,807,54,27,9,277,55,2037
81,40,7555,1271,6284,172,6112,136,1065,1838,583,67,16,10,637,97,1663
81,41,7978,1581,6397,136,6261,90,1281,1536,683,75,36,12,504,99,1945
81,42,8978,1532,7446,114,7332,125,1440,1906,744,81,40,19,538,109,2330
81,43,9231,1298,7933,166,7767,104,1377,1427,998,92,39,13,601,112,3004
81,44,7894,1204,6690,150,6540,156,922,1703,844,54,22,9,662,108,2060
81,45,7654,1014,6640,118,6522,169,948,1554,782,60,25,13,638,86,2247
81,46,8311,1315,6996,147,6849,101,1313,1925,708,69,34,12,679,106,1902
82,1,3710,507,3203,70,3133,43,791,810,362,47,12,11,265,66,726
82,2,5158,665,4493,105,4388,80,843,1175,488,42,21,7,363,81,1288
82,3,1601,247,1354,32,1322,29,242,410,169,20,11,3,136,29,273
82,4,4805,1076,3729,70,3659,64,875,889,393,39,14,8,277,68,1032
82,5,11048,1533,9515,219,9296,162,2114,2350,1055,124,44,28,771,178,2470
82,6,2159,305,1854,46,1808,64,294,443,253,23,9,2,204,35,481
82,7,11818,1477,10341,202,10139,172,2485,2294,1104,114,58,22,839,186,2865
82,8,4046,496,3550,74,3476,82,838,891,370,37,11,14,286,80,867
82,9,3634,460,3174,68,3106,120,641,899,335,36,8,8,323,56,680
82,10,2118,302,1816,37,1779,33,378,414,168,27,14,4,174,47,520
82,11,5968,1046,4922,109,4813,115,1128,1228,544,66,24,9,413,73,1213
82,12,2425,315,2110,23,2087,56,457,544,264,24,15,4,189,52,482
82,13,3040,397,2643,61,2582,77,633,618,343,40,11,5,210,49,596
82,14,1818,243,1575,29,1546,32,299,442,186,24,13,3,142,27,378
82,15,7901,1112,6789,148,6641,111,1458,1677,754,75,25,16,527,103,1895
82,16,6472,1105,5367,116,5251,104,853,1458,565,64,16,12,402,72,1705
82,17,15154,2138,13016,297,12719,188,3233,3003,1369,151,83,25,930,227,3510
82,18,2677,368,2309,51,2258,50,451,623,276,27,11,5,253,42,520
82,19,10518,1378,9140,208,8932,138,2240,2248,873,116,55,13,708,160,2381
82,20,4007,639,3368,66,3302,116,523,720,515,45,27,9,342,68,937
82,21,5005,703,4302,87,4215,75,1047,972,420,67,26,13,374,85,1136
82,22,7600,1163,6437,161,6276,100,1404,1447,683,86,36,29,473,116,1902
82,23,7259,980,6279,122,6157,117,1363,1400,761,80,36,20,530,113,1737
82,24,4821,557,4264,83,4181,82,990,1021,494,47,17,19,331,70,1110
82,25,7781,1282,6499,135,6364,78,1692,1559,650,86,21,6,440,107,1725
82,26,5797,937,4860,132,4728,81,1095,1253,494,52,12,15,353,57,1316
82,27,7615,1348,6267,119,6148,124,975,1733,649,67,14,14,526,81,1965
82,28,4520,833,3687,72,3615,81,739,877,440,37,13,10,311,66,1041
82,29,7776,1368,6408,116,6292,138,1311,1613,656,68,24,14,505,92,1871
82,30,7061,1322,5739,108,5631,155,836,1655,680,38,17,19,478,78,1675
83,1,2615,400,2215,35,2180,76,485,689,310,16,12,8,134,43,407
83,2,8499,1473,7026,128,6898,175,1800,1737,925,82,37,22,478,111,1531
83,3,27457,4843,22614,322,22292,550,5146,8068,2170,174,68,45,1601,378,4092
83,4,11545,2002,9543,168,9375,200,2800,2602,1117,121,51,24,590,178,1692
83,5,20745,4064,16681,290,16391,269,4647,4764,1789,168,56,35,1033,277,3353
83,6,5608,941,4667,70,4597,128,1284,1357,496,47,18,20,318,81,848
83,7,12835,2496,10339,161,10178,211,2135,4635,732,77,26,23,557,150,1632
83,8,1298,187,1111,17,1094,46,214,301,146,11,7,3,66,22,278
83,9,7219,1230,5989,112,5877,182,1376,1879,697,66,19,7,372,104,1175
83,10,16643,2996,13647,219,13428,264,3631,3752,1628,132,40,24,918,270,2769
83,11,37545,7715,29830,429,29401,518,7893,9631,2627,281,88,42,1978,504,5839
83,12,16712,3105,13607,191,13416,299,3309,5012,1101,108,44,26,965,287,2265
83,13,39093,7585,31508,473,31035,480,8206,11617,2003,237,84,64,2156,472,5716
83,14,24404,4551,19853,292,19561,325,4694,8778,1198,146,54,43,1079,252,2992
83,15,18486,3799,14687,221,14466,320,3236,5491,1265,110,48,33,869,213,2881
83,16,14922,2482,12440,188,12252,280,3075,4116,1091,130,41,17,810,186,2506
83,17,17244,3385,13859,244,13615,213,4231,4088,1144,142,61,29,802,264,2641
83,18,34463,6533,27930,370,27560,491,5937,11261,2192,191,58,61,1904,426,5039
83,19,10696,1959,8737,165,8572,125,2530,2188,1067,69,41,19,517,170,1846
83,20,17073,3012,14061,214,13847,249,3956,4220,1337,147,44,36,986,262,2610
83,21,26084,4230,21854,357,21497,441,6010,6035,2323,204,90,50,1560,343,4441
83,22,18293,3294,14999,215,14784,264,2815,7736,816,88,55,29,764,202,2015
83,23,4759,918,3841,73,3768,99,865,1080,515,49,25,12,245,83,795
83,24,25697,6313,19384,315,19069,306,4941,4438,2811,191,99,41,969,243,5030
83,25,22504,3875,18629,291,18338,330,4786,5862,1802,174,60,44,1286,292,3702
83,26,4737,706,4031,61,3970,74,1217,1154,423,41,12,8,202,81,758
83,27,6806,1702,5104,87,5017,48,1442,1386,550,55,26,7,273,75,1155
83,28,15413,3739,11674,238,11436,196,2999,2952,1257,131,55,25,641,162,3018
83,29,17581,3857,13724,232,13492,240,3328,4020,1264,135,71,22,967,211,3234
83,30,7043,1423,5620,80,5540,121,1093,1937,501,53,21,11,484,93,1226
83,31,6318,1853,4465,60,4405,113,894,1345,489,35,23,17,307,60,1122
83,32,19308,4348,14960,201,14759,274,3318,5325,1292,117,47,30,976,220,3160
83,33,7005,1310,5695,88,5607,127,1143,2047,433,54,14,17,470,109,1193
83,34,17533,3644,13889,194,13695,279,3073,5082,1133,96,51,19,1076,215,2671
83,35,9552,2258,7294,118,7176,149,1673,2035,778,64,27,11,470,107,1862
83,36,30829,5562,25267,404,24863,455,6006,9245,2024,182,84,61,1742,386,4678
83,37,22380,4220,18160,273,17887,273,4830,6773,1155,140,46,32,1105,308,3225
83,38,22982,4542,18440,274,18166,330,4441,6037,1868,171,73,38,1331,339,3538
83,39,29512,5504,24008,274,23734,333,5114,11365,1230,141,57,41,1464,349,3640
83,40,29342,5927,23415,352,23063,409,5906,8518,1813,169,70,35,1675,397,4071
83,41,20057,3813,16244,298,15946,282,4203,5160,1368,143,78,37,1158,254,3263
83,42,27919,5261,22658,392,22266,423,5090,7149,2342,223,70,49,1605,368,4947
83,43,20424,3960,16464,247,16217,367,3415,6366,1331,128,43,37,1101,262,3167
84,1,15569,2694,12875,216,12659,346,2972,3559,1521,141,58,26,842,220,2974
84,2,22152,4415,17737,298,17439,458,4531,4058,2119,178,66,34,1149,232,4614
84,3,11728,2637,9091,155,8936,217,1790,1665,1301,73,37,18,497,98,3240
84,4,4216,615,3601,86,3515,71,764,1212,389,24,9,4,283,54,705
84,5,27226,4557,22669,396,22273,366,7698,5501,2425,216,100,45,1350,291,4281
84,6,19505,3666,15839,291,15548,197,5036,3847,1745,133,56,30,884,235,3385
84,7,3729,534,3195,61,3134,118,654,954,376,35,13,9,232,47,696
84,8,14353,2266,12087,218,11869,400,2576,3504,1441,122,49,28,873,181,2695
84,9,21845,4051,17794,311,17483,350,5335,5024,1716,183,65,29,1063,249,3469
84,10,29439,5326,24113,378,23735,453,7241,6891,2401,228,108,43,1487,357,4526
84,11,30252,5786,24466,419,24047,475,7489,6728,2404,206,93,35,1383,364,4870
84,12,4952,628,4324,57,4267,127,840,1605,386,40,16,7,345,54,847
84,13,31989,5067,26922,460,26462,708,6890,7445,2895,272,90,76,1910,399,5777
84,14,3981,514,3467,109,3358,88,879,875,434,53,19,4,214,43,749
84,15,7972,993,6979,127,6852,216,1696,1868,784,89,27,15,467,106,1584
84,16,20937,3705,17232,298,16934,246,4974,5087,1638,119,53,33,1213,304,3267
84,17,17337,3090,14247,269,13978,225,4311,4480,1142,102,33,22,980,234,2449
84,18,14216,2237,11979,180,11799,245,3270,3593,1258,107,39,23,868,163,2233
84,19,26039,5027,21012,375,20637,556,4434,5431,2757,192,78,60,1713,331,5085
84,20,2062,332,1730,42,1688,58,396,401,229,28,9,7,102,47,411
84,21,10082,1570,8512,179,8333,219,1816,2504,938,105,33,23,657,134,1904
84,22,9986,1765,8221,152,8069,148,2466,2020,872,73,52,14,569,133,1722
84,23,23716,4602,19114,305,18809,397,4710,4574,2330,160,64,51,1188,266,5069
84,24,14769,3540,11229,164,11065,378,1817,3072,1378,102,40,14,801,137,3326
85,1,7843,1233,6610,142,6468,114,1295,2270,570,98,48,24,627,184,1238
85,2,6370,988,5382,114,5268,65,1215,1266,551,82,37,7,392,115,1538
85,3,23918,4052,19866,442,19424,306,3229,6858,1503,253,130,48,2323,458,4316
85,4,13051,1714,11337,361,10976,170,1594,3585,912,225,74,32,1454,255,2675
85,5,12042,1783,10259,294,9965,111,1463,4064,622,151,63,25,1295,261,1910
85,6,15939,1800,14139,363,13776,227,1937,4203,1086,219,92,36,2042,323,3611
85,7,15668,2394,13274,280,12994,267,1759,3814,1341,201,86,26,1450,301,3749
85,8,20477,2677,17800,578,17222,366,1985,6031,1281,291,127,44,2940,438,3719
85,9,7132,999,6133,137,5996,99,1027,1729,576,94,41,13,624,139,1654
85,10,4162,840,3322,75,3247,89,538,1052,363,83,28,11,345,81,657
85,11,16961,3025,13936,303,13633,189,2435,4219,1125,170,73,23,1319,331,3749
85,12,8806,1214,7592,157,7435,138,1175,2062,779,130,40,16,792,187,2116
85,13,6521,840,5681,142,5539,94,927,1605,483,83,32,10,730,119,1456
85,14,23857,2818,21039,543,20496,425,2900,6379,1824,290,159,44,2986,486,5003
85,15,20600,2750,17850,500,17350,354,2038,6142,1281,302,116,42,2845,519,3711
85,16,15495,2019,13476,338,13138,241,2328,4063,1123,203,81,40,1569,319,3171
85,17,12929,1976,10953,189,10764,188,1967,3756,948,107,45,21,974,252,2506
85,18,8691,1587,7104,118,6986,165,1131,2691,557,74,32,18,630,118,1570
85,19,8526,1319,7207,146,7061,143,1450,2171,630,129,64,26,836,184,1428
85,20,21833,2574,19259,528,18731,394,2577,5799,1603,268,130,55,2581,459,4865
85,21,17189,2173,15016,460,14556,202,2020,5056,997,238,107,39,2169,391,3337
85,22,8850,993,7857,199,7658,154,1210,2533,694,124,57,14,1029,191,1652
85,23,22988,3998,18990,393,18597,496,1987,4856,1881,242,94,33,2214,325,6469
85,24,39708,6789,32919,592,32327,643,5023,11843,2467,361,157,69,3134,690,7940
85,25,12336,1375,10961,236,10725,143,1646,4117,759,153,73,43,1509,260,2022
85,26,38001,5841,32160,660,31500,504,5370,11563,2414,426,181,69,3397,756,6820
85,27,6426,948,5478,139,5339,92,910,1562,478,78,44,12,597,91,1475
85,28,7199,911,6288,128,6160,130,960,1734,651,98,52,19,730,140,1646
85,29,15478,2635,12843,276,12567,198,2215,4940,963,187,72,39,1196,268,2489
85,30,15791,2197,13594,271,13323,186,2480,4842,1021,164,78,21,1323,319,2889
85,31,34032,5256,28776,613,28163,759,3068,7180,2988,369,171,54,3350,526,9698
86,1,2296,397,1899,47,1852,21,291,533,171,29,26,6,139,33,603
86,2,2816,448,2368,66,2302,17,360,654,204,31,14,7,214,75,726
86,3,11364,2759,8605,160,8445,160,1441,2447,921,96,56,19,837,157,2311
86,4,8877,1468,7409,162,7247,141,1303,1751,804,91,53,14,644,128,2318
86,5,6458,1065,5393,137,5256,77,926,1277,530,106,48,10,461,88,1733
86,6,5886,1003,4883,118,4765,89,890,1217,445,81,26,21,449,94,1453
86,7,7570,1003,6567,228,6339,62,1559,1444,627,89,71,15,541,151,1780
86,8,6501,1092,5409,106,5303,111,946,1405,508,91,45,5,495,123,1574
86,9,3780,620,3160,72,3088,53,499,720,377,58,27,5,244,101,1004
86,10,4105,578,3527,81,3446,43,799,912,326,46,21,8,347,76,868
86,11,6970,1167,5803,138,5665,95,1441,1374,583,70,54,9,446,124,1469
86,12,9233,1852,7381,189,7192,94,1479,2170,605,111,60,18,776,151,1728
86,13,8385,1237,7148,175,6973,154,1190,1714,729,100,56,17,698,149,2166
86,14,6635,1016,5619,149,5470,91,987,1360,647,92,45,7,421,123,1697
86,15,5081,767,4314,98,4216,70,886,1105,383,66,25,13,396,76,1196
86,16,3664,536,3128,57,3071,40,686,932,253,48,21,8,292,55,736
86,17,7717,1309,6408,165,6243,76,950,1626,679,82,52,17,573,137,2051
86,18,2942,443,2499,85,2414,52,525,648,199,48,15,8,211,65,643
86,19,12846,1870,10976,259,10717,201,1780,2680,1095,170,69,19,1064,245,3394
86,20,5291,764,4527,86,4441,88,892,1233,444,52,26,14,427,98,1167
86,21,10475,2031,8444,147,8297,240,1050,1816,1071,109,38,12,788,134,3039
86,22,12230,2471,9759,154,9605,299,1075,2172,1099,88,52,29,975,130,3686
86,23,10239,1635,8604,162,8442,181,1405,2073,934,111,69,19,930,187,2533
86,24,10355,1238,9117,175,8942,211,1295,2031,1034,105,62,19,890,198,3097
86,25,4021,594,3427,101,3326,47,618,1000,309,45,28,4,262,83,930
86,26,2314,385,1929,47,1882,22,350,613,133,27,20,3,135,58,521
86,27,3850,607,3243,70,3173,32,808,945,269,42,39,11,297,74,656
86,28,11129,1399,9730,200,9530,233,1313,2123,1230,134,58,21,998,210,3210
86,29,7033,980,6053,135,5918,119,902,1339,663,88,57,7,572,145,2026
86,30,11773,1668,10105,225,9880,251,1665,2396,1050,133,85,22,1045,247,2986
86,31,8756,1231,7525,153,7372,147,1621,1722,791,100,54,21,707,184,2025
86,32,10719,2436,8283,184,8099,114,1636,1635,1007,111,53,16,647,155,2725
86,33,12313,2335,9978,161,9817,406,820,2392,1396,85,32,20,1002,160,3504
86,34,11198,2427,8771,152,8619,277,920,2054,978,112,42,23,873,158,3182
86,35,13274,2114,11160,213,10947,241,1299,2654,1079,151,67,38,1215,220,3983
86,36,8831,1824,7007,104,6903,288,534,2025,847,73,28,20,745,95,2248
86,37,15936,3300,12636,253,12383,327,1581,2297,1665,147,80,18,1131,214,4923
86,38,10790,2488,8302,192,8110,165,1599,1699,952,103,67,10,678,137,2700
87,1,15335,1733,13602,318,13284,236,2204,2556,1817,153,81,31,1141,239,4826
87,2,12737,1648,11089,218,10871,165,2141,1787,1892,151,76,14,753,193,3699
87,3,5313,821,4492,113,4379,75,762,970,613,76,34,16,332,83,1418
87,4,4440,696,3744,83,3661,50,715,711,558,59,33,9,272,63,1191
87,5,4382,695,3687,78,3609,69,672,745,494,49,33,8,251,60,1228
87,6,4420,728,3692,109,3583,61,592,574,599,43,33,14,255,75,1337
87,7,3223,551,2672,70,2602,33,518,520,374,47,26,6,196,52,830
87,8,3480,616,2864,80,2784,28,577,810,261,37,23,9,214,56,769
87,9,4681,663,4018,85,3933,89,461,664,881,56,22,3,237,62,1458
87,10,2869,497,2372,57,2315,56,367,390,459,34,16,3,166,43,781
87,11,4401,737,3664,79,3585,92,547,680,449,36,21,5,284,70,1401
87,12,4951,1022,3929,85,3844,112,529,854,553,42,21,8,292,67,1366
87,13,4261,828,3433,60,3373,120,362,998,417,36,17,8,300,45,1070
87,14,5154,1185,3969,90,3879,55,825,497,567,43,29,8,185,50,1620
87,15,2725,482,2243,51,2192,21,408,544,243,30,30,4,180,43,689
87,16,2802,495,2307,64,2243,47,415,571,273,40,27,6,174,58,632
87,17,5858,806,5052,118,4934,97,985,870,742,78,46,19,370,76,1651
87,18,6049,803,5246,106,5140,121,916,927,765,89,36,15,392,113,1766
87,19,8066,968,7098,173,6925,111,1353,1115,1185,91,47,15,566,131,2311
87,20,3183,513,2670,68,2602,49,471,496,436,31,10,5,209,54,841
87,21,6892,792,6100,141,5959,117,964,1220,843,66,25,21,518,116,2069
87,22,4011,618,3393,95,3298,23,531,670,604,43,24,7,250,54,1092
87,23,5267,743,4524,100,4424,101,809,885,586,53,23,6,360,86,1515
87,24,8925,1192,7733,186,7547,136,1208,1368,1287,69,53,18,581,120,2707
87,25,3715,487,3228,87,3141,55,670,591,454,51,22,7,257,49,985
87,26,7927,1105,6822,148,6674,106,1176,1177,1095,79,59,9,462,106,2405
87,27,2484,403,2081,65,2016,38,337,445,320,23,17,5,147,28,656
87,28,3340,582,2758,91,2667,19,515,592,368,33,26,8,216,50,840
87,29,8411,1276,7135,198,6937,81,1125,1516,781,72,51,18,501,129,2663
87,30,8375,1705,6670,112,6558,155,801,2013,696,63,24,19,580,96,2111
87,31,9738,1405,8333,153,8180,155,1040,1630,969,82,40,15,798,136,3315
87,32,8289,1384,6905,1101,5804,103,967,1004,734,53,28,11,453,75,2376
87,33,8357,1250,7107,172,6935,107,1059,1545,850,81,28,17,663,103,2482
87,34,4010,804,3206,66,3140,96,385,738,438,35,18,8,266,40,1116
87,35,8433,1420,7013,136,6877,101,1109,1022,1100,77,30,14,471,110,2843
87,36,13288,2110,11178,211,10967,246,1583,2410,1474,133,43,35,996,159,3888
87,37,16930,2190,14740,291,14449,235,2197,3061,1753,148,67,35,1269,217,5467
87,38,6367,1026,5341,109,5232,55,885,924,960,65,55,11,347,81,1849
87,39,5069,981,4088,81,4007,68,630,712,538,44,33,11,276,53,1642
87,40,5605,1045,4560,89,4471,89,559,954,573,47,26,10,406,86,1721
87,41,4410,698,3712,92,3620,93,501,630,502,33,28,11,291,40,1491
87,42,6741,1322,5419,121,5298,59,950,839,801,70,54,14,312,67,2132
88,1,2852,547,2305,51,2254,47,605,628,197,34,13,1,194,47,488
88,2,2114,316,1798,44,1754,32,579,374,152,34,8,3,113,42,417
88,3,11598,1791,9807,213,9594,133,2487,2336,875,165,59,20,956,245,2318
88,4,4577,703,3874,94,3780,48,934,991,305,64,39,18,312,107,962
88,5,8852,1566,7286,153,7133,119,1812,1639,725,88,48,26,618,163,1895
88,6,15084,2796,12288,279,12009,177,3268,2821,1126,169,90,26,988,269,3075
88,7,5118,813,4305,92,4213,67,1007,1051,462,58,24,14,393,94,1043
88,8,5791,1117,4674,108,4566,74,1270,1066,490,77,50,14,423,112,990
88,9,3432,578,2854,58,2796,59,734,821,225,38,24,5,237,64,589
88,10,3850,629,3221,70,3151,54,818,777,308,59,28,12,295,74,726
88,11,4663,616,4047,80,3967,51,1019,1087,349,71,28,13,408,118,823
88,12,18579,3623,14956,320,14636,283,2566,3728,1405,177,81,47,1485,308,4556
88,13,9630,1758,7872,188,7684,107,2523,1515,901,128,75,26,594,162,1653
88,14,8295,1337,6958,152,6806,145,1102,1823,1008,153,53,24,675,143,1680
88,15,4046,799,3247,63,3184,28,852,827,281,61,28,8,305,80,714
88,16,8624,1578,7046,131,6915,114,1487,1641,850,107,70,24,591,163,1868
88,17,1942,315,1627,43,1584,18,355,483,131,25,16,4,157,54,341
88,18,9988,1757,8231,130,8101,100,1715,2390,702,99,58,25,773,209,2030
88,19,5801,1006,4795,130,4665,89,1142,1440,388,86,49,10,460,122,879
88,20,1861,299,1562,34,1528,29,439,338,165,24,17,4,145,34,333
88,21,9528,1713,7815,188,7627,128,2079,2066,601,124,63,20,645,174,1727
88,22,8955,1889,7066,136,6930,95,2006,1691,682,106,44,19,483,162,1642
88,23,25174,4395,20779,484,20295,419,4524,5379,1850,297,146,62,2218,529,4871
88,24,14162,2399,11763,287,11476,221,2825,2982,1036,159,82,29,950,245,2947
88,25,15406,2569,12837,352,12485,252,2549,3224,1268,260,99,33,1523,358,2919
88,26,7519,1528,5991,125,5866,114,1742,1313,583,118,51,22,478,117,1328
88,27,12016,2191,9825,272,9553,162,2711,2121,954,193,87,29,874,279,2143
88,28,9959,1914,8045,147,7898,128,1726,2139,838,133,54,26,721,182,1951
88,29,8136,1327,6809,141,6668,114,1805,1806,532,103,49,22,666,197,1374
88,30,25242,4837,20405,407,19998,438,4094,5120,1907,248,121,52,2001,399,5618
88,31,12616,2628,9988,202,9786,181,2564,2347,866,115,62,23,835,198,2595
89,1,7889,1364,6525,119,6406,152,1511,1751,677,85,42,20,582,148,1438
89,2,4180,707,3473,59,3414,53,725,909,464,33,30,8,252,80,860
89,3,10113,2054,8059,142,7917,183,1535,2084,838,92,59,23,735,164,2204
89,4,5209,1438,3771,68,3703,68,689,809,408,32,41,6,263,55,1332
89,5,8677,1711,6966,127,6839,92,1452,1836,642,85,47,20,636,121,1908
89,6,3708,630,3078,56,3022,41,746,993,249,35,19,7,263,84,585
89,7,5562,1061,4501,68,4433,52,1378,1122,414,78,41,12,329,100,907
89,8,2316,379,1937,22,1915,25,582,545,160,26,16,2,155,51,353
89,9,3524,583,2941,59,2882,42,670,1009,183,27,29,11,274,76,561
89,10,4676,898,3778,50,3728,53,976,1261,295,43,25,12,322,81,660
89,11,6958,1120,5838,119,5719,98,1488,1865,452,92,34,16,399,126,1149
89,12,4719,726,3993,69,3924,85,898,955,457,76,27,12,369,84,961
89,13,2563,462,2101,29,2072,41,450,521,230,30,12,8,181,53,546
89,14,2462,403,2059,45,2014,40,466,549,233,30,11,2,187,50,446
89,15,2406,372,2034,41,1993,32,505,619,190,15,12,6,171,43,400
89,16,3814,751,3063,51,3012,40,939,836,268,36,22,5,237,70,559
89,17,2363,406,1957,25,1932,26,451,561,173,24,11,3,214,28,441
89,18,2514,437,2077,32,2045,29,442,623,212,36,7,7,180,47,462
89,19,10119,2411,7708,148,7560,141,1912,2091,731,83,42,15,582,158,1805
89,20,3916,688,3228,56,3172,56,793,883,285,48,17,12,298,63,717
89,21,2330,375,1955,32,1923,36,391,673,182,27,11,1,172,47,383
89,22,12212,2114,10098,196,9902,143,2826,2365,1041,132,93,23,705,269,2305
89,23,1887,308,1579,24,1555,31,316,461,137,10,7,4,162,47,380
89,24,2261,332,1929,33,1896,28,448,638,131,28,16,2,134,48,423
89,25,4979,1059,3920,68,3852,29,967,989,355,58,28,8,239,75,1104
89,26,4171,790,3381,52,3329,68,934,937,315,41,28,4,274,85,643
89,27,3986,740,3246,59,3187,68,737,860,353,54,23,10,291,68,723
89,28,8629,1586,7043,113,6930,94,1805,1660,679,103,54,18,604,170,1743
89,29,8900,2218,6682,121,6561,108,1350,1947,625,76,31,14,603,122,1685
89,30,15636,3323,12313,251,12062,247,2654,3444,1228,153,66,22,1056,267,2925
89,31,5905,940,4965,78,4887,84,1378,1405,471,67,42,14,376,123,927
89,32,5365,1096,4269,76,4193,76,905,1091,545,60,43,9,286,89,1089
89,33,7838,1342,6496,131,6365,149,1542,1703,747,73,32,13,569,138,1399
89,34,3781,642,3139,48,3091,86,685,778,374,44,22,13,247,56,786
89,35,3593,548,3045,66,2979,50,591,794,383,51,15,8,288,65,734
89,36,4808,848,3960,70,3890,47,1074,1181,339,46,28,9,284,100,782
89,37,6744,1360,5384,87,5297,92,1392,1606,484,72,18,16,507,112,998
89,38,7059,1291,5768,89,5679,133,796,1900,506,40,22,11,547,130,1594
89,39,8896,1842,7054,122,6932,104,1764,1428,979,87,45,21,483,138,1883
89,40,11379,2918,8461,159,8302,127,2025,2162,825,106,70,29,651,176,2131
89,41,8484,1322,7162,146,7016,105,1574,1995,593,84,42,16,649,158,1800
89,42,8727,1640,7087,141,6946,172,1295,1880,687,59,44,12,716,145,1936
90,1,5562,1254,4308,84,4224,128,790,1202,499,45,24,12,422,52,1050
90,2,7425,1490,5935,130,5805,75,1588,1410,635,85,36,15,387,95,1479
90,3,6217,866,5351,118,5233,104,1387,1318,491,62,29,18,466,123,1235
90,4,9900,1675,8225,188,8037,201,2023,1775,930,137,68,18,797,186,1902
90,5,4238,617,3621,85,3536,67,953,819,399,43,32,13,302,76,832
90,6,7607,1444,6163,124,6039,142,1210,1574,648,69,41,15,586,94,1660
90,7,7570,1855,5715,102,5613,129,848,1499,699,62,43,21,575,84,1653
90,8,4806,1177,3629,68,3561,73,803,793,430,48,31,15,301,62,1005
90,9,4226,1066,3160,79,3081,66,590,519,557,43,18,10,188,26,1064
90,10,7893,1133,6760,132,6628,143,1593,1573,749,77,46,12,643,133,1659
90,11,8031,1213,6818,112,6706,146,1605,1755,656,71,29,19,690,129,1606
90,12,5205,1046,4159,103,4056,47,1052,888,471,62,30,16,276,86,1128
90,13,7151,1295,5856,105,5751,56,1830,1392,566,96,48,14,427,102,1220
90,14,4514,1274,3240,75,3165,63,707,518,491,49,27,10,234,43,1023
90,15,4544,977,3567,79,3488,76,807,856,326,39,21,7,336,52,968
91,1,27409,5387,22022,366,21656,455,3884,5874,2498,221,111,61,2068,484,6000
91,2,21883,4902,16981,313,16668,319,2918,3955,2117,171,81,36,1303,346,5422
91,3,20503,3630,16873,240,16633,550,1481,5954,1502,105,40,44,2188,272,4497
91,4,24163,5260,18903,277,18626,447,2923,4671,2357,210,80,52,1924,469,5493
91,5,17157,3889,13268,143,13125,323,1530,3410,1314,108,32,21,1172,1551,3664
91,6,13740,3595,10145,175,9970,170,1693,1819,1520,97,64,20,658,173,3756
91,7,11347,2041,9306,169,9137,203,1622,2472,1192,88,46,22,876,224,2392
91,8,20794,4163,16631,333,16298,303,3176,4246,2026,171,79,38,1374,364,4521
91,9,15018,2606,12412,224,12188,338,2132,3280,1550,141,52,27,1223,268,3177
91,10,24793,5754,19039,448,18591,418,2772,3770,2463,220,99,34,1489,372,6954
91,11,17064,3171,13893,226,13667,285,3051,3525,1648,132,78,40,1262,369,3277
91,13,17385,2869,14516,197,14319,389,1672,4210,1577,162,47,37,1747,356,4122
91,14,27726,5778,21948,407,21541,493,3227,5797,2439,218,98,37,2171,422,6639
91,15,14049,2918,11131,190,10941,352,1022,2103,1671,97,36,39,1257,179,4185
91,16,27403,5576,21827,375,21452,447,4030,6441,2355,234,80,49,2110,562,5144
91,17,11116,2009,9107,163,8944,149,2207,2501,1004,105,41,20,786,244,1887
91,18,10692,1756,8936,178,8758,181,1840,2899,830,107,32,28,771,252,1818
91,19,15267,3240,12027,193,11834,281,1579,2895,1262,76,51,25,1030,1145,3490
91,20,25967,5273,20694,345,20349,402,3635,6046,2219,192,86,55,2187,489,5038
91,21,17491,3152,14339,193,14146,593,1043,3710,1632,109,53,56,1910,258,4782
91,22,27166,5423,21743,324,21419,820,2242,5398,2649,194,90,58,2459,409,7100
91,23,15205,3624,11581,231,11350,228,1902,2549,1547,98,48,33,822,234,3889
91,24,19078,3536,15542,277,15265,329,2839,4511,1631,146,60,46,1556,351,3796
91,25,20583,4262,16321,322,15999,332,2459,3939,2036,132,53,30,1419,326,5273
91,26,16613,3395,13218,225,12993,282,1941,3476,1427,113,57,31,1199,271,4196
91,27,18492,4261,14231,300,13931,227,2553,3489,1879,135,51,27,1117,294,4159
91,28,23511,4830,18681,318,18363,348,3248,5375,1918,143,65,50,1706,363,5147
91,29,18544,3832,14712,244,14468,392,2237,3776,1811,145,59,32,1378,445,4193
91,30,15699,2676,13023,156,12867,478,835,4325,1248,69,29,31,1709,191,3952
91,31,16566,3833,12733,255,12478,220,2250,2846,2170,109,49,36,922,260,3616
91,32,24530,4558,19972,319,19653,454,3036,6393,1936,147,50,51,1972,540,5074
91,33,12626,2658,9968,185,9783,272,1536,2242,1366,90,49,16,883,226,3103
91,34,16555,3911,12644,221,12423,189,2004,2145,1878,117,55,22,692,925,4396
91,35,15907,2792,13115,203,12912,305,1958,3632,1441,135,57,46,1378,314,3646
91,36,26235,5043,21192,219,20973,429,2584,4158,2153,137,49,19,1406,4661,5377
91,37,11559,3185,8374,120,8254,222,1428,1722,1346,86,50,22,606,163,2609
91,38,17663,4030,13633,216,13417,260,1996,2961,1675,118,50,36,1014,737,4570
91,39,20224,5199,15025,266,14759,300,1599,2545,2014,125,68,31,1023,249,6805
91,40,10808,3376,7432,197,7235,105,832,975,1536,72,41,16,331,100,3227
91,41,14609,3004,11605,175,11430,293,1718,2871,1474,109,39,34,1066,262,3564
91,42,11309,2481,8828,149,8679,206,1093,1799,1283,81,43,26,800,131,3217
91,43,12843,2886,9957,200,9757,238,1033,1374,1646,126,64,22,774,141,4339
92,1,30871,6060,24811,536,24275,744,2076,7364,2629,183,86,87,3118,348,7640
92,2,23789,5197,18592,289,18303,524,1543,5289,1962,123,69,48,1746,231,6768
92,3,21253,4082,17171,227,16944,530,1341,6188,1388,121,43,43,1996,245,5049
92,4,20608,4687,15921,281,15640,382,1682,2513,3298,175,77,56,1069,197,6191
92,5,16746,3612,13134,231,12903,422,1056,4717,1176,76,34,45,1478,160,3739
92,6,17951,3374,14577,158,14419,323,825,8197,588,45,17,32,1519,152,2721
92,7,22070,4207,17863,270,17593,384,1103,9021,961,73,23,28,1876,238,3886
92,8,27558,5729,21829,390,21439,583,1541,8673,1770,108,48,39,2332,253,6092
92,9,22598,4076,18522,270,18252,604,1285,6073,1737,86,46,57,2388,264,5712
92,10,21656,4298,17358,265,17093,456,1562,4884,1890,138,54,43,1997,264,5805
92,11,27071,4991,22080,309,21771,674,1572,9552,1397,118,45,44,2880,293,5196
92,12,22169,4057,18112,237,17875,662,1475,5873,1725,132,37,38,2186,290,5457
92,13,22438,5249,17189,310,16879,559,1573,3346,2467,140,85,43,1398,211,7057
92,14,13459,3211,10248,146,10102,226,1109,2148,1501,105,47,33,803,131,3999
92,15,18440,3690,14750,171,14579,488,1223,5030,1427,91,43,41,1797,241,4198
92,16,20414,4528,15886,242,15644,424,1157,6705,1029,75,33,49,1927,203,4042
92,17,30162,6749,23413,439,22974,554,2059,8453,1866,119,57,67,2644,285,6870
92,18,29233,5829,23404,353,23051,484,1880,10363,1471,110,49,70,2768,307,5549
92,19,17300,3509,13791,212,13579,353,1218,5412,1129,88,32,27,1636,192,3492
92,20,10914,2650,8264,174,8090,140,889,1023,2220,99,41,18,330,102,3228
92,21,19917,4343,15574,244,15330,450,1154,5318,1314,95,33,47,1965,202,4752
92,22,27651,6257,21394,331,21063,670,1651,6512,2117,143,61,70,2671,309,6859
92,23,27057,5420,21637,311,21326,551,1819,7765,2102,157,65,48,2042,283,6494
92,24,19228,3413,15815,191,15624,350,1046,8423,784,80,16,24,1703,195,3003
92,25,18852,4162,14690,207,14483,485,1412,2367,3340,158,78,42,1141,168,5292
92,26,24998,5229,19769,264,19505,605,1656,6778,1827,134,61,45,2217,267,5915
92,27,27851,5527,22324,289,22035,825,1763,6023,2556,171,86,51,2416,304,7840
92,28,17064,4046,13018,237,12781,373,1514,2174,2414,138,73,37,969,177,4912
92,29,10239,2638,7601,171,7430,169,625,859,1468,68,34,22,443,81,3661
92,30,20472,3254,17218,147,17071,235,894,12361,366,47,15,35,1256,141,1721
92,31,16531,2710,13821,110,13711,174,645,9999,283,20,7,22,1036,114,1411
92,32,30729,6304,24425,440,23985,526,2942,7173,2864,221,91,65,2343,404,7356
92,33,28189,5597,22592,470,22122,629,2306,7869,1997,182,54,58,2492,331,6204
92,34,35540,7212,28328,394,27934,758,2460,10302,2277,200,73,80,3655,457,7672
92,35,18973,3529,15444,153,15291,381,1279,7934,667,66,20,30,1843,208,2863
92,36,16419,3292,13127,142,12985,406,810,4769,1077,76,12,29,1795,165,3846
92,37,14837,2876,11961,219,11742,424,830,4206,1033,59,27,46,1369,166,3582
92,38,26458,5110,21348,425,20923,538,1823,7547,1898,137,59,57,2430,260,6174
92,39,17512,3079,14433,161,14272,507,1088,4118,1588,95,41,38,1624,176,4997
92,40,12332,3328,9004,225,8779,126,1073,1748,1356,90,42,20,502,111,3711
92,41,15850,3115,12735,301,12434,329,1191,3228,1575,91,49,37,1211,191,4532
92,42,12842,3280,9562,209,9353,208,1103,1712,1577,93,49,30,624,102,3855
92,43,15217,3289,11928,161,11767,379,1029,3000,1420,113,48,40,1376,210,4152
92,44,10076,2614,7462,168,7294,167,758,822,2094,64,54,22,289,53,2971
92,45,17004,3751,13253,246,13007,305,1407,2739,2286,128,73,36,1097,169,4767
93,1,15788,4753,11035,229,10806,195,1420,1496,2268,94,100,21,451,107,4654
93,2,10427,3161,7266,127,7139,142,889,1176,1405,71,55,21,308,65,3007
93,3,26900,7893,19007,364,18643,277,2291,3124,2997,147,67,29,915,185,8611
93,4,16271,4041,12230,186,12044,295,2065,3491,1494,85,60,29,1001,204,3320
93,5,17296,4656,12640,257,12383,402,1358,1918,3081,115,57,30,682,135,4605
93,6,24508,6785,17723,363,17360,205,2895,3117,3403,145,95,27,800,236,6437
93,7,21088,6472,14616,315,14301,214,1555,1856,2783,130,83,36,649,151,6844
93,8,12376,3120,9256,204,9052,177,1242,1585,1446,100,41,31,570,116,3744
93,9,26403,7445,18958,342,18616,252,3375,3727,2899,187,106,41,1080,266,6683
93,10,14431,3869,10562,252,10310,130,1169,1376,2105,86,62,13,421,107,4841
93,11,19981,5757,14224,277,13947,167,2578,2688,2258,166,82,32,772,174,5030
93,12,23893,6821,17072,299,16773,250,1827,3024,2548,132,74,36,1188,203,7491
93,13,22176,5290,16886,336,16550,316,2720,4461,2013,155,60,32,1375,273,5145
93,14,23530,5426,18104,311,17793,252,3575,4584,2102,144,59,42,1216,284,5535
93,15,20471,5155,15316,224,15092,230,3076,3758,1991,130,49,30,1022,290,4516
93,16,18269,5212,13057,218,12839,422,1449,1578,3098,139,76,32,680,141,5224
93,17,18628,4528,14100,142,13958,806,908,1931,3434,162,58,14,834,133,5678
93,18,13021,3164,9857,124,9733,278,1296,2757,1136,90,29,33,854,197,3063
93,19,39313,8832,30481,526,29955,740,3785,7684,3754,258,112,76,2645,508,10393
93,20,19551,5329,14222,222,14000,353,1866,2605,2620,109,83,40,844,165,5315
93,21,12644,3373,9271,171,9100,244,929,1464,1726,76,59,21,441,111,4029
93,22,11404,2693,8711,146,8565,139,1364,2511,1008,74,39,23,638,154,2615
93,23,21682,4545,17137,251,16886,670,1586,3777,2732,144,94,33,1093,202,6555
93,24,20345,5544,14801,243,14558,274,1873,4319,1668,103,49,33,1074,165,5000
93,25,13014,3394,9620,170,9450,228,1370,1638,1874,106,73,20,490,120,3531
93,26,22645,5788,16857,389,16468,315,2528,4154,2205,126,76,32,1256,251,5525
93,27,22080,7008,15072,311,14761,293,1585,1715,3320,170,84,37,598,151,6808
93,28,12542,3729,8813,156,8657,274,831,1114,1896,124,71,25,437,103,3782
93,29,17660,4708,12952,225,12727,368,1290,1708,2587,141,91,34,664,117,5727
93,30,13544,3841,9703,158,9545,339,944,1446,2000,103,60,37,559,107,3950
93,31,22470,5973,16497,326,16171,305,2292,2675,2721,121,75,46,865,189,6882
93,32,15830,4902,10928,350,10578,134,1404,1535,2055,97,52,29,439,108,4725
93,33,20550,5347,15203,306,14897,238,2701,2702,2956,152,82,37,916,213,4900
93,34,15258,2991,12267,193,12074,261,1901,3758,1309,91,48,33,1021,207,3445
93,35,12201,3353,8848,172,8676,146,1063,1449,1253,72,32,25,419,124,4093
93,36,17003,4627,12376,183,12193,492,1283,1763,2860,138,49,29,684,132,4763
93,37,18288,4075,14213,344,13869,287,2068,2551,1884,153,61,34,946,195,5690
93,38,11037,2460,8577,154,8423,322,743,1563,1572,85,73,17,502,85,3461
93,39,17072,4978,12094,256,11838,180,1299,1638,2206,100,56,28,516,148,5667
93,40,18946,5479,13467,282,13185,169,1942,2594,2043,115,76,41,796,156,5253
94,1,13899,2856,11043,186,10857,334,1268,2422,1507,103,54,22,890,189,4068
94,2,19658,4302,15356,289,15067,267,2289,3368,2137,129,66,31,1086,378,5316
94,3,8981,2378,6603,161,6442,109,900,1231,1280,57,35,16,324,88,2402
94,4,15494,3432,12062,207,11855,281,1407,4051,1278,64,33,28,1265,220,3228
94,5,16174,3583,12591,197,12394,415,1225,2602,1664,116,46,32,1171,160,4963
94,6,10338,2363,7975,116,7859,217,953,1755,1499,64,26,22,640,119,2564
94,7,27803,6053,21750,262,21488,623,1963,7645,2019,156,60,55,2185,333,6449
94,8,10297,2212,8085,135,7950,140,1134,2464,855,72,17,18,661,148,2441
94,9,19459,3901,15558,224,15334,375,1986,2873,2876,148,62,37,1165,221,5591
94,10,13927,2896,11031,164,10867,306,1163,3155,1309,77,53,31,1012,172,3589
94,11,14879,3570,11309,175,11134,258,1369,1978,2369,121,63,29,770,144,4033
94,12,18828,4173,14655,266,14389,376,1594,3472,1784,121,42,36,1367,242,5355
94,13,13517,3038,10479,152,10327,346,946,1325,2975,119,56,19,547,114,3880
94,14,14394,3463,10931,171,10760,383,1087,1815,2392,129,52,28,685,143,4046
94,15,11996,2710,9286,143,9143,309,968,2796,1007,68,28,22,974,140,2831
94,16,20228,4973,15255,256,14999,426,1620,2903,2574,151,77,34,1236,210,5768
94,17,16572,3222,13350,213,13137,387,1606,4166,1329,101,54,34,1345,271,3844
94,18,17335,3495,13840,258,13582,347,2059,3824,1444,118,65,36,1247,278,4164
94,19,22178,5426,16752,169,16583,491,1438,6576,1286,84,27,49,1982,252,4398
94,20,11014,2671,8343,173,8170,126,1193,1292,1662,78,30,24,450,128,3187
94,21,22010,5032,16978,242,16736,550,1873,6117,1415,140,47,40,1774,254,4526
94,22,14668,3333,11335,137,11198,324,762,5193,706,54,33,25,1156,146,2799
94,23,20811,3892,16919,236,16683,461,1835,6644,1277,101,47,55,2002,318,3943
94,24,16407,3117,13290,178,13112,451,1322,4705,1081,77,30,38,1592,239,3577
94,25,15955,3371,12584,233,12351,206,1701,3587,1529,108,59,34,1093,204,3830
94,26,17664,3422,14242,225,14017,280,2159,4832,1213,112,38,37,1350,585,3411
94,27,12870,3277,9593,139,9454,274,1228,1666,1884,106,36,14,664,113,3469
94,28,13298,2982,10316,198,10118,177,1909,2279,1551,88,37,21,701,176,3179
94,29,9974,2858,7116,104,7012,94,1312,1190,1087,71,28,19,451,216,2544
94,30,16800,3520,13280,141,13139,576,1044,3635,1836,86,49,39,1449,179,4246
94,31,14783,2696,12087,133,11954,517,742,4076,996,69,19,22,1513,142,3858
94,32,14089,3900,10189,209,9980,205,1214,1789,2067,102,43,29,530,128,3873
94,33,15687,4141,11546,205,11341,230,1494,2099,2322,125,58,27,730,127,4129
94,34,15465,3896,11569,249,11320,439,1273,1843,2396,124,48,33,888,151,4125
94,35,12687,3403,9284,180,9104,147,1130,1648,1895,76,30,22,593,113,3450
94,36,20210,4915,15295,315,14980,294,1611,3430,2106,124,63,50,823,204,6275
94,37,15002,3960,11042,163,10879,306,1268,2317,1534,106,40,28,977,173,4130
94,38,27620,6094,21526,365,21161,466,2902,5841,2421,166,84,55,2322,369,6535
94,39,16735,3138,13597,171,13426,503,1012,4582,1159,86,36,49,1799,196,4004
94,40,9600,2217,7383,165,7218,175,955,1494,1065,81,40,14,444,132,2818
94,41,13522,3157,10365,137,10228,216,1352,1987,2259,115,40,18,664,132,3445
94,42,13888,2610,11278,180,11098,223,1455,2710,1604,104,58,31,985,192,3736
94,43,14277,3440,10837,212,10625,229,1066,2392,1544,99,48,34,681,141,4391
94,44,16821,3463,13358,203,13155,241,2044,4270,1461,108,48,37,1279,258,3409
94,45,12077,2304,9773,100,9673,268,1017,4425,591,62,18,23,1079,169,2021
94,46,17032,3485,13547,232,13315,355,1727,4249,1320,82,47,31,1427,292,3785
94,47,10098,2750,7348,134,7214,88,1093,934,1560,70,43,20,334,129,2943
94,48,15398,3821,11577,195,11382,327,1408,1908,2501,113,47,28,842,150,4058
94,49,15152,3797,11355,203,11152,254,1323,1997,2324,115,57,22,748,157,4155
95,1,14657,3846,10811,229,10582,169,1537,2077,1686,102,35,23,659,130,4164
95,2,20705,5518,15187,257,14930,334,2346,2979,2476,169,121,40,1065,245,5155
95,3,20150,4199,15951,296,15655,246,3432,3461,2026,208,113,39,1094,313,4723
95,4,14165,3430,10735,191,10544,156,1664,1854,1938,105,61,24,658,139,3945
95,5,25649,6081,19568,322,19246,411,2917,5003,2403,150,63,47,1856,343,6053
95,6,15679,3361,12318,213,12105,220,2114,3532,1350,102,51,31,1011,199,3495
95,7,16161,3730,12431,204,12227,297,1657,3657,1206,111,51,42,1321,220,3665
95,8,20760,4573,16187,288,15899,313,2476,4893,1909,159,66,36,1277,264,4506
95,9,29669,7240,22429,349,22080,507,2737,7019,2454,174,76,50,1967,368,6728
95,10,17872,4210,13662,221,13441,322,1836,3347,1564,144,75,36,1328,263,4526
95,11,20799,4812,15987,273,15714,296,2588,4232,1728,154,87,45,1439,261,4884
95,12,6706,1910,4796,118,4678,48,443,834,690,35,18,7,215,40,2348
95,13,20785,5493,15292,352,14940,197,2968,3594,1662,113,67,19,826,218,5276
95,14,18737,3279,15458,219,15239,329,2439,5289,1407,134,50,43,1495,302,3751
95,15,25203,5083,20120,379,19741,361,4156,5332,2184,199,103,55,1658,373,5320
95,16,11693,2046,9647,156,9491,246,1990,2946,900,126,54,27,826,198,2178
95,17,8733,1386,7347,140,7207,156,1546,2248,643,71,32,18,648,165,1680
95,18,17999,3431,14568,198,14370,348,1887,5310,1340,97,38,44,1342,190,3774
95,19,16699,4289,12410,201,12209,363,1578,3068,1486,129,61,37,1153,206,4128
95,20,17639,3337,14302,209,14093,355,1948,4627,1456,111,40,34,1529,378,3615
95,21,18328,4158,14170,261,13909,302,2312,2942,1833,177,58,23,1162,233,4867
95,22,16421,3750,12671,216,12455,273,1906,3204,1504,122,53,37,1119,205,4032
95,23,14985,4255,10730,231,10499,134,1203,2351,1304,106,32,25,476,127,4741
95,24,15271,3493,11778,185,11593,244,1514,4070,1084,95,28,28,1177,177,3176
95,25,25019,5952,19067,373,18694,448,3053,5009,2196,190,90,52,1728,356,5572
95,26,15368,2855,12513,207,12306,288,2587,3533,1370,123,46,33,1111,282,2933
95,27,8166,1315,6851,121,6730,191,1190,2260,666,73,24,21,638,171,1496
95,28,16442,3525,12917,216,12701,259,2254,3918,1416,113,58,34,1222,277,3150
95,29,32301,7706,24595,466,24129,535,2981,5102,2953,256,112,79,2110,397,9604
95,30,21563,5634,15929,332,15597,155,3073,2736,2104,159,77,31,846,218,6198
95,31,20817,4533,16284,240,16044,386,2508,4499,1777,125,65,40,1737,314,4593
95,33,13225,3981,9244,154,9090,80,761,2896,932,70,39,8,362,73,3869
95,34,13148,2136,11012,160,10852,247,1750,3399,1098,109,41,28,1099,210,2871
95,35,20892,5799,15093,317,14776,189,2351,3310,1764,124,52,19,748,188,6031
95,36,18471,5134,13337,239,13098,194,1835,2257,2193,123,70,30,754,169,5473
95,37,19754,4589,15165,304,14861,416,2058,3496,1806,152,72,42,1359,235,5225
95,38,9466,2320,7146,196,6950,93,848,1199,1099,55,32,10,307,65,3242
95,39,31529,6836,24693,560,24133,615,3327,5370,2965,276,100,61,2465,393,8561
95,40,13184,3118,10066,159,9907,184,1332,3010,1107,68,29,27,896,144,3110
ZA,1,7334,3149,4185,306,3879,50,172,708,166,31,56,13,139,33,2511
ZA,2,5831,2493,3338,239,3099,44,171,685,160,34,42,6,134,21,1802
ZA,3,9770,5738,4032,218,3814,32,143,742,173,26,26,12,136,27,2497
ZA,4,19599,7881,11718,825,10893,146,584,2645,646,107,111,37,665,113,5839
ZA,5,5481,2359,3122,299,2823,44,135,852,140,23,26,8,116,26,1453
ZA,6,3661,1578,2083,157,1926,22,82,591,89,23,13,3,78,11,1014
ZA,7,6257,3330,2927,228,2699,63,110,474,125,22,29,7,119,23,1727
ZA,8,6014,2952,3062,224,2838,25,156,716,134,23,34,5,100,11,1634
ZA,9,3368,2099,1269,129,1140,19,43,351,56,6,9,7,24,14,611
ZA,10,1586,938,648,19,629,9,55,143,25,9,6,0,32,6,344
ZA,11,8947,4109,4838,231,4607,98,294,1343,282,48,44,18,290,49,2141
ZA,12,5111,3145,1966,164,1802,27,88,414,136,9,13,9,63,13,1030
ZA,13,11632,5828,5804,365,5439,73,263,937,557,46,44,17,272,40,3190
ZA,14,6976,3472,3504,225,3279,34,109,539,145,26,31,9,143,25,2218
ZA,15,6088,3151,2937,176,2761,23,113,450,95,13,31,9,101,28,1898
ZA,16,10805,5058,5747,492,5255,76,305,993,245,30,41,13,240,54,3258
ZA,17,5941,2647,3294,272,3022,38,170,624,140,23,27,13,136,31,1820
ZA,18,13752,6890,6862,392,6470,135,342,1610,414,51,49,17,356,71,3425
ZA,19,5937,2999,2938,216,2722,20,127,582,109,16,21,7,130,23,1687
ZA,20,4087,1741,2346,114,2232,38,104,732,148,9,25,6,111,25,1034
ZA,21,3874,1699,2175,159,2016,32,118,506,93,14,28,6,82,11,1126
ZA,22,5711,2669,3042,259,2783,44,127,573,152,27,37,7,125,16,1675
ZA,24,6950,3722,3228,256,2972,45,133,553,122,20,24,10,101,26,1938
ZA,26,7958,3157,4801,269,4532,102,247,1280,273,32,27,16,285,36,2234
ZA,27,10336,4021,6315,406,5909,101,446,1732,345,44,48,13,282,60,2838
ZA,28,2923,1859,1064,86,978,15,25,187,26,6,6,5,28,9,671
ZA,30,10728,5558,5170,386,4784,61,227,1328,312,40,47,12,219,41,2497
ZA,31,7189,3519,3670,251,3419,47,196,772,178,33,30,2,159,30,1972
ZA,32,11707,5793,5914,384,5530,79,309,1057,314,39,53,13,303,51,3312
ZA,33,6196,2950,3246,213,3033,35,136,523,171,27,18,7,170,23,1923
ZA,34,3342,2075,1267,29,1238,19,61,421,35,11,5,2,40,16,628
ZA,35,8597,3558,5039,374,4665,71,239,1160,233,34,50,16,204,31,2627
ZA,36,11614,5056,6558,559,5999,66,218,1621,211,39,32,21,203,26,3562
ZA,37,7412,3301,4111,396,3715,37,169,624,129,26,38,7,156,25,2504
ZA,38,8061,3766,4295,363,3932,58,218,911,217,30,45,20,206,40,2187
ZA,39,5909,2684,3225,299,2926,39,168,665,139,18,24,15,121,24,1713
ZA,40,8865,4053,4812,365,4447,46,295,1173,199,32,53,12,163,28,2446
ZA,41,10157,4645,5512,479,5033,98,247,1289,307,40,42,17,291,46,2656
ZA,42,5404,2383,3021,299,2722,63,137,785,169,28,23,14,173,30,1300
ZA,43,6998,3560,3438,241,3197,60,204,682,196,36,27,10,165,24,1793
ZB,1,1513,735,778,61,717,4,38,175,17,16,8,1,46,4,408
ZB,2,3499,1879,1620,72,1548,37,50,310,103,17,12,6,83,18,912
ZB,3,3561,1680,1881,157,1724,15,81,486,59,20,17,4,64,14,964
ZB,4,4722,2029,2693,121,2572,46,112,800,211,30,19,8,146,28,1172
ZB,5,4667,1844,2823,171,2652,45,111,754,186,33,23,10,209,35,1246
ZB,6,4685,2266,2419,116,2303,48,108,631,178,20,19,5,156,26,1112
ZB,7,11772,5158,6614,484,6130,70,287,1480,391,80,53,28,358,66,3317
ZB,9,5546,2785,2761,174,2587,55,122,695,200,36,18,13,179,24,1245
ZB,10,2538,1448,1090,74,1016,16,57,237,57,14,15,3,47,8,562
ZB,11,3310,1873,1437,75,1362,27,85,494,94,16,12,3,84,7,540
ZB,12,4601,2477,2124,185,1939,16,99,438,107,20,27,3,101,26,1102
ZB,13,8486,3921,4565,421,4144,29,182,1004,200,45,49,16,201,35,2383
ZB,15,8289,4038,4251,385,3866,54,248,1047,200,62,56,18,227,48,1906
ZB,16,6235,2855,3380,253,3127,44,190,814,187,45,32,12,175,42,1586
ZB,17,6719,2605,4114,416,3698,45,196,966,114,35,37,15,192,23,2075
ZB,18,2013,1097,916,39,877,5,23,312,26,4,6,0,20,2,479
ZB,19,3230,1460,1770,136,1634,18,53,411,59,20,11,2,86,9,965
ZB,20,6586,3407,3179,220,2959,55,121,641,168,34,33,12,155,29,1711
ZB,21,4580,2058,2522,251,2271,32,109,791,125,20,23,9,145,24,993
ZB,23,1501,797,704,33,671,16,47,202,29,6,11,2,24,3,331
ZB,24,10827,6579,4248,492,3756,32,150,726,224,50,31,9,245,38,2251
ZB,25,9337,4442,4895,436,4459,64,230,1172,273,69,40,15,276,40,2280
ZB,26,7830,3569,4261,374,3887,63,205,1032,185,45,43,18,200,39,2057
ZB,27,7454,3914,3540,232,3308,40,157,872,208,45,28,6,195,27,1730
ZB,28,11689,5503,6186,469,5717,101,339,1735,331,64,58,20,378,75,2616
ZB,29,4831,2511,2320,135,2185,34,117,665,123,40,22,13,128,23,1020
ZB,30,4024,2277,1747,101,1646,48,97,363,125,25,18,7,86,16,861
ZB,31,7124,3343,3781,227,3554,82,157,824,256,39,28,13,223,29,1903
ZB,32,7062,3446,3616,360,3256,41,144,749,122,31,28,11,146,34,1950
ZB,33,7734,3224,4510,297,4213,85,168,1259,322,59,39,25,350,60,1846
ZB,34,9865,4162,5703,413,5290,90,215,1137,316,63,42,15,302,50,3060
ZB,35,5500,2418,3082,150,2932,77,175,825,272,39,25,16,231,45,1227
ZB,36,8126,4315,3811,297,3514,46,142,933,154,37,27,14,159,40,1962
ZB,37,4268,2335,1933,202,1731,25,99,397,107,16,26,8,87,13,953
ZB,38,8715,4223,4492,439,4053,61,205,896,204,52,52,16,195,54,2318
ZB,39,13195,6323,6872,575,6297,95,253,1526,407,78,64,29,416,80,3349
ZB,40,9132,4495,4637,412,4225,68,213,951,242,45,49,26,252,48,2331
ZB,41,6975,3259,3716,302,3414,53,155,855,236,44,41,12,219,40,1759
ZB,42,7626,3562,4064,241,3823,76,163,1111,269,40,38,16,263,42,1805
ZB,43,7413,3259,4154,294,3860,44,148,1250,192,28,30,15,177,34,1942
ZB,44,10653,4260,6393,479,5914,85,298,1595,418,51,64,21,368,60,2954
ZB,45,8058,3623,4435,423,4012,81,234,1071,235,50,45,15,271,51,1959
ZB,46,9578,4264,5314,537,4777,72,214,1444,250,59,51,22,306,51,2308
ZB,47,9847,4901,4946,468,4478,52,174,1101,122,31,54,10,207,50,2677
ZB,48,7987,3507,4480,308,4172,83,189,1266,296,39,18,18,303,53,1907
ZC,1,627,375,252,3,249,13,38,69,15,2,3,0,11,3,95
ZC,2,1966,995,971,30,941,19,98,285,68,11,4,2,49,9,396
ZC,3,3621,1637,1984,81,1903,69,224,556,158,25,12,9,135,21,694
ZC,4,7058,3360,3698,178,3520,67,373,863,263,50,27,4,261,30,1582
ZC,5,2923,1524,1399,65,1334,29,155,374,91,25,6,7,79,17,551
ZC,6,958,445,513,130,383,1,36,137,23,7,2,1,29,1,146
ZC,7,8235,3382,4853,202,4651,127,638,1142,379,61,24,15,374,61,1830
ZC,8,4508,2068,2440,114,2326,30,300,508,224,39,18,13,142,26,1026
ZC,9,2189,1205,984,27,957,15,43,205,96,11,6,5,40,8,528
ZC,10,10050,4186,5864,209,5655,176,579,1500,541,79,24,30,465,68,2193
ZC,11,1499,572,927,36,891,24,95,282,83,10,4,3,51,7,332
ZC,12,2030,1006,1024,20,1004,27,68,406,21,4,9,8,28,19,414
ZC,13,7695,4071,3624,104,3520,72,214,1333,307,26,16,7,126,26,1393
ZC,14,1882,1165,717,42,675,7,87,144,36,7,6,1,27,6,354
ZC,15,1040,577,463,12,451,21,68,121,54,4,2,1,25,11,144
ZC,16,4283,3121,1162,33,1129,29,34,393,53,11,2,7,38,11,551
ZC,17,3028,1649,1379,76,1303,15,160,317,72,17,7,3,55,11,646
ZC,18,3627,1983,1644,107,1537,15,171,346,80,22,6,6,75,17,799
ZC,19,9655,4385,5270,287,4983,87,539,1193,388,68,30,26,319,64,2269
ZD,1,7804,2103,5701,180,5521,143,534,961,455,59,21,12,571,58,2707
ZD,2,8840,3220,5620,203,5417,74,544,971,357,42,38,9,351,55,2976
ZD,3,5014,1428,3586,119,3467,80,380,475,252,38,18,9,387,50,1778
ZD,4,10505,2515,7990,354,7636,212,784,1601,679,64,35,17,566,98,3580
ZD,5,9568,3003,6565,242,6323,125,722,1054,453,50,47,19,392,57,3404
ZD,6,3877,1253,2624,106,2518,48,350,549,171,23,14,5,159,30,1169
ZD,7,11104,3905,7199,353,6846,110,636,947,636,66,50,22,278,76,4025
ZD,8,19146,5862,13284,458,12826,306,1252,2193,1140,123,72,43,826,154,6717
ZD,9,10843,4230,6613,268,6345,113,792,1080,428,66,33,15,364,53,3401
ZD,10,11584,4556,7028,248,6780,111,795,1095,467,49,38,17,373,49,3786
ZD,11,13560,5079,8481,284,8197,119,820,1254,493,63,80,23,369,55,4921
ZD,12,7600,2493,5107,138,4969,87,453,1292,319,36,23,10,675,57,2017
ZD,13,14180,5020,9160,312,8848,182,860,1823,569,74,44,30,717,89,4460
ZD,14,9595,2908,6687,216,6471,172,603,1460,460,47,39,21,539,65,3065
ZD,15,9200,3241,5959,167,5792,138,615,1300,392,54,35,16,460,56,2726
ZD,16,14172,3226,10946,359,10587,144,1125,1260,553,81,49,29,346,71,6929
ZD,17,13209,3093,10116,357,9759,171,1015,1276,456,73,46,25,365,81,6251
ZD,18,11521,3677,7844,280,7564,199,517,808,563,70,35,19,1230,63,4060
ZD,19,11472,3620,7852,312,7540,214,638,1245,602,63,36,21,1086,64,3571
ZD,20,20112,8896,11216,506,10710,134,1274,1747,518,73,52,22,561,96,6233
ZD,21,17783,6909,10874,452,10422,172,1657,1544,708,79,43,27,522,109,5561
ZD,22,4862,2140,2722,98,2624,50,221,492,172,16,15,4,148,22,1484
ZD,23,10058,3755,6303,337,5966,174,479,1166,442,62,32,16,525,79,2991
ZD,24,14089,5154,8935,376,8559,208,752,1609,624,77,69,30,802,116,4272
ZD,25,17120,6261,10859,547,10312,280,823,1725,759,92,65,28,843,90,5607
ZD,26,4479,1659,2820,119,2701,26,313,382,113,17,11,5,80,18,1736
ZD,27,16295,5449,10846,494,10352,255,985,2496,705,103,61,42,526,98,5081
ZD,28,11113,3983,7130,318,6812,190,522,1790,520,72,34,21,393,71,3199
ZD,29,13563,4506,9057,394,8663,229,759,2101,619,76,62,34,526,79,4178
ZD,30,21311,7723,13588,465,13123,266,1492,2520,762,123,75,30,791,117,6947
ZD,31,5845,2302,3543,115,3428,42,341,469,192,28,26,6,129,32,2163
ZD,32,16302,6575,9727,322,9405,168,1031,1295,688,73,64,28,517,75,5466
ZD,33,5653,1991,3662,119,3543,46,335,575,128,23,44,13,140,29,2210
ZD,34,16074,4814,11260,585,10675,227,1278,1937,733,108,47,27,699,125,5494
ZD,35,10678,3257,7421,389,7032,119,963,1188,347,63,56,22,445,102,3727
ZD,36,5594,2179,3415,141,3274,55,276,520,196,24,26,3,287,37,1850
ZD,37,12408,4277,8131,376,7755,138,613,758,685,83,58,25,293,61,5041
ZD,38,9183,3530,5653,216,5437,120,601,1143,329,52,35,13,429,41,2674
ZD,39,9810,3426,6384,192,6192,170,695,1484,383,40,36,30,520,59,2775
ZD,40,9529,3625,5904,301,5603,89,594,841,264,34,36,13,263,41,3428
ZD,41,14180,4746,9434,271,9163,196,993,1959,592,78,47,36,778,97,4387
ZD,42,9708,2902,6806,200,6606,153,746,1323,390,46,32,19,452,76,3369
ZD,43,16888,5877,11011,523,10488,230,1044,1938,730,107,73,48,533,99,5686
ZD,44,13167,3979,9188,421,8767,204,1099,1788,568,79,61,26,634,119,4189
ZD,45,12008,4604,7404,303,7101,85,760,890,363,60,67,27,249,62,4538
ZD,46,13639,5225,8414,448,7966,165,565,1092,513,75,45,21,619,71,4800
ZD,47,18273,5575,12698,511,12187,464,1065,2924,971,114,55,48,1052,141,5353
ZD,48,9834,4132,5702,243,5459,75,691,863,363,47,41,10,279,48,3042
ZD,49,16057,5138,10919,565,10354,259,1147,2174,681,105,69,30,764,140,4985
ZM,1,2399,1010,1389,124,1265,37,41,504,22,12,15,12,59,26,537
ZM,2,3854,2032,1822,74,1748,26,27,765,29,10,10,9,48,22,802
ZM,3,3624,1653,1971,65,1906,26,32,1235,38,9,12,9,108,19,418
ZM,4,3738,1851,1887,125,1762,20,30,1185,32,10,4,1,53,10,417
ZM,5,4081,1665,2416,152,2264,68,52,1456,42,24,21,10,89,38,464
ZM,6,3910,1835,2075,88,1987,39,16,1099,37,11,5,8,38,16,718
ZM,7,2798,1210,1588,74,1514,30,40,656,45,21,7,9,44,11,651
ZM,8,5962,3503,2459,129,2330,46,110,713,62,25,17,19,159,30,1149
ZM,9,3698,1824,1874,90,1784,31,39,1196,22,14,4,8,39,24,407
ZM,10,5063,2666,2397,86,2311,63,114,882,79,21,14,13,136,38,951
ZM,11,4491,2526,1965,85,1880,62,70,646,67,18,6,14,126,16,855
ZM,12,4891,2651,2240,86,2154,54,51,908,65,22,17,8,128,23,878
ZM,13,4204,2332,1872,112,1760,52,47,703,101,12,6,10,89,26,714
ZM,14,5083,2795,2288,71,2217,24,79,1293,40,19,12,4,72,16,658
ZM,15,4172,2422,1750,95,1655,84,39,667,46,21,17,7,52,34,688
ZM,16,3366,1900,1466,61,1405,23,17,755,31,4,3,4,44,10,514
ZM,17,3753,1820,1933,81,1852,40,102,743,80,12,7,8,121,11,728
ZM,18,4938,2424,2514,58,2456,25,25,1256,56,22,6,13,51,13,989
ZM,19,3388,1612,1776,43,1733,39,65,874,50,12,9,9,49,12,614
ZN,1,20776,16322,4454,54,4400,94,86,833,158,74,36,13,106,27,2973
ZN,2,35642,19763,15879,386,15493,343,966,4013,487,185,103,56,540,98,8702
ZN,3,109049,37754,71295,1929,69366,1899,9357,39456,2282,615,346,210,3933,708,10560
ZP,1,135806,69939,65867,1729,64138,2477,4230,29125,2005,395,370,306,3645,2148,19437
ZP,2,26021,13430,12591,284,12307,453,433,5749,282,63,62,35,447,148,4635
ZP,3,7261,3691,3570,81,3489,137,144,1542,54,21,16,12,335,62,1166
ZP,4,5428,2546,2882,71,2811,109,128,1272,39,25,24,5,136,49,1024
ZP,5,6897,2805,4092,53,4039,107,107,1463,73,17,23,10,507,42,1690
ZP,6,5229,2131,3098,63,3035,109,109,1460,39,11,15,10,69,35,1178
ZS,1,4923,2193,2730,99,2631,43,416,488,399,103,23,13,194,64,888
ZW,1,8940,2494,6446,39,6407,100,152,2414,76,42,48,29,410,43,3093
ZX,1,22685,14408,8277,244,8033,208,975,3504,473,85,44,28,473,92,2151
ZZ,1,157767,104831,52936,542,52394,3231,2998,19755,3729,321,94,171,6574,694,14827
ZZ,2,73912,52648,21264,363,20901,1058,1180,8367,2104,152,74,88,1591,219,6068
ZZ,3,88133,59723,28410,269,28141,1948,927,9443,2117,204,61,88,3904,365,9084
ZZ,4,95182,46980,48202,432,47770,2915,3270,16690,4679,370,166,218,6639,679,12144
ZZ,5,80761,53215,27546,305,27241,1462,2028,10651,2979,253,93,113,2269,324,7069
ZZ,6,79508,29458,50050,514,49536,2441,3982,20335,4187,488,155,200,7168,880,9700
ZZ,7,89643,54981,34662,318,34344,3473,1446,10363,2592,248,97,138,4911,431,10645
ZZ,8,109763,84466,25297,292,25005,1011,1321,12256,1926,203,112,92,1722,315,6047
ZZ,9,98997,59887,39110,321,38789,1010,1395,12307,4378,209,78,87,2615,269,16441
ZZ,10,89859,46782,43077,566,42511,1320,3254,17882,2484,206,101,147,3779,441,12897
ZZ,11,80061,42911,37150,488,36662,2078,2194,15252,2328,189,106,115,4695,431,9274
